#Ack,ack_ewma(ms),send_ewma(ms),rtt_ratio,cwnd (Bytes),Last Router Ocupation Ack Arriaval(Packets),Last Router Ocupation Packet Sent(Packets),Network Situation,AckArrival(ms),TSInsideAck(ms),RTTAck(ms)
7301,8,0,499,18980,0,1,1,120977,120478,499
10221,5.6,0,504,21900,0.056,1,1,120982,120478,504
13141,2.72,0,506,24820,0.0512,1,1,120984,120478,506
14601,161.344,0,707,27740,0.01024,0.01,1,121185,120478,707
219701,28,18,465,45594,0.46,0.49,1,123306,122841,465
222621,24,23.6,463,44049,0.42,0.45,1,123329,122866,463
225541,19.2,29.52,450,40880,0.396,0.43,1,123347,122897,450
228461,12.64,16.304,448,40880,0.4072,0.43,1,123358,122910,448
231381,7.328,12.8608,442,40880,0.37744,0.43,1,123364,122922,442
234301,3.0656,2.57216,444,40880,0.371488,0.43,1,123366,122922,444
237221,2.21312,0.514432,446,40880,0.370298,0.43,1,123368,122922,446
240141,2.04262,0.102886,448,40880,0.37006,0.43,1,123370,122922,448
243061,2.00852,0.0205773,450,40880,0.370012,0.43,1,123372,122922,450
245981,2.0017,0.00411545,452,40880,0.338002,0.43,1,123374,122922,452
248901,6.80034,0.000823091,460,40880,0.3316,0.61,1,123382,122922,460
251821,22.1601,21.6002,459,40880,0.26632,0.43,1,123408,122949,459
254741,92.432,40.32,524,42340,0.093264,1,1,123518,122994,524
257661,33.6864,62.464,475,43800,0.146653,1,1,123537,123062,475
260581,148.337,21.2928,641,43800,0.349331,0.46,1,123714,123073,641
263501,57.6675,168.259,471,43800,0.381866,0.41,1,123749,123278,471
266421,42.7335,74.4517,459,45260,0.436373,0.41,1,123788,123329,459
269341,16.5467,38.0903,440,45260,0.431275,0.37,1,123798,123358,440
272261,6.50934,12.4181,438,45260,0.430255,0.37,1,123802,123364,438
275181,2.90187,4.08361,438,45260,0.478051,0.37,1,123804,123366,438
278101,2.18037,2.41672,438,45260,0.48761,0.37,1,123806,123368,438
281021,2.03607,2.08334,438,45260,0.457522,0.37,1,123808,123370,438
283941,2.00721,2.01667,438,46720,0.451504,0.33,1,123810,123372,438
286861,2.00144,2.00333,438,46720,0.450301,0.33,1,123812,123374,438
289781,6.80029,6.80067,438,46720,0.48206,0.25,1,123820,123382,438
292701,17.3601,22.1601,432,46720,0.488412,0.25,1,123840,123408,432
295621,86.672,4.43203,536,46720,0.457682,0.05,1,123944,123408,536
298541,18.9344,88.8864,428,46720,0.451536,0.16,1,123946,123518,428
301461,16.5869,32.9773,425,46720,0.410307,0.4,1,123962,123537,425
304381,157.717,148.195,441,46720,0.458061,0.39,1,124155,123714,441
307301,61.9435,57.6391,444,48180,0.499612,0.39,1,124193,123749,444
310221,41.9887,11.5278,481,48180,0.539922,0.45,1,124230,123749,481
313141,17.1977,33.5056,453,48180,0.563985,0.43,1,124241,123788,453
316061,6.63955,14.7011,447,48180,0.584797,0.43,1,124245,123798,447
318981,2.92791,6.14022,445,48180,0.556959,0.49,1,124247,123802,445
321901,2.18558,2.82804,445,48180,0.567392,0.49,1,124249,123804,445
324821,2.83712,2.16561,446,48180,0.585478,0.45,1,124252,123806,446
327741,2.16742,2.03312,446,48180,0.589096,0.45,1,124254,123808,446
330661,2.03348,2.00662,446,48180,0.589819,0.45,1,124256,123810,446
333581,2.0067,2.00132,446,48180,0.589964,0.49,1,124258,123812,446
336501,6.80134,6.80027,446,48180,0.557993,0.49,1,124266,123820,446
339421,17.3603,17.3601,446,48180,0.583599,0.45,1,124286,123840,446
342341,83.4721,86.672,442,48180,0.63672,0.45,1,124386,123944,442
345261,18.2944,18.9344,442,48180,0.647344,0.4,1,124388,123946,442
348181,18.0589,16.5869,444,48180,0.633469,0.47,1,124406,123962,444
351101,159.612,157.717,446,48180,0.622694,0.47,1,124601,124155,446
354021,62.3224,31.5435,484,49640,0.668539,0.51,1,124639,124155,484
356941,43.6645,36.7087,485,49640,0.677708,0.55,1,124678,124193,485
359861,18.3329,36.9417,460,49640,0.687542,0.57,1,124690,124230,460
362781,6.86658,16.1883,453,49640,0.737508,0.59,1,124694,124241,453
365701,2.97332,6.43767,451,49640,0.715502,0.55,1,124696,124245,451
368621,2.19466,2.88753,451,49640,0.7111,0.57,1,124698,124247,451
371541,2.03893,2.17751,451,49640,0.71022,0.59,1,124700,124249,451
374461,2.00779,2.8355,450,49640,0.710044,0.59,1,124702,124252,450
377381,2.00156,2.1671,450,49640,0.710009,0.59,1,124704,124254,450
380301,2.00031,2.03342,450,49640,0.710002,0.59,1,124706,124256,450
383221,6.80006,2.00668,456,49640,0.71,0.55,1,124714,124258,456
386141,18.16,6.80134,469,49640,0.726,0.59,1,124735,124266,469
389061,86.032,17.3603,552,49640,0.7772,0.65,2,124838,124286,552
391981,18.8064,83.4721,454,49640,0.79544,0.65,2,124840,124386,454
394901,13.3613,18.2944,464,49640,0.791088,0.63,2,124852,124388,464
396361,163.472,18.0589,647,49640,0.822218,0.62,2,125053,124406,647
399281,35.0944,159.612,455,49640,0.876444,0.62,2,125056,124601,455
402201,34.2189,31.9224,489,49640,0.871289,0.68,2,125090,124601,489
405121,41.2438,36.7845,494,49640,0.910258,0.68,2,125133,124639,494
408041,18.6488,38.5569,468,49640,0.902052,0.69,2,125146,124678,468
410961,6.92975,17.3114,460,49640,0.90041,0.75,2,125150,124690,460
413881,2.98595,6.66228,458,49640,0.900082,0.71,2,125152,124694,458
416801,2.19719,2.93246,458,49640,0.900016,0.71,2,125154,124696,458
419721,2.03944,2.18649,458,49640,0.916003,0.71,2,125156,124698,458
422641,2.00789,2.0373,458,49640,0.919201,0.71,2,125158,124700,458
425561,2.00158,2.00746,458,49640,0.91984,0.71,2,125160,124702,458
428481,2.00032,2.00149,458,49640,0.919968,0.71,2,125162,124704,458
431401,7.60006,2.0003,465,49640,0.943994,0.71,2,125171,124706,465
434321,19.92,6.80006,480,49640,0.948799,0.73,2,125194,124714,480
437241,87.184,18.16,563,49640,0.94976,0.79,2,125298,124735,563
440161,19.0368,86.032,462,49640,0.949952,0.8,2,125300,124838,462
584701,9,108,479,49640,0.6,1,1,126720,126241,479
587621,9.8,27.2,482,49640,0.592,1,1,126730,126248,482
590541,162.76,10.24,677,49640,0.4064,1,1,126931,126254,677
593461,50.152,179.648,477,51100,0.45728,1,1,126953,126476,477
596381,31.6304,54.3296,481,51100,0.483456,1,1,126980,126499,481
599301,19.9261,29.2659,475,51100,0.448691,1,1,126997,126522,475
602221,39.9852,34.6532,484,51100,0.233738,1,1,127042,126558,484
605141,17.597,14.9306,486,51100,0.0867476,1,1,127054,126568,486
608061,13.1194,11.7861,487,51100,0.0253495,1,1,127066,126579,487
610981,10.6239,11.9572,485,51100,0.14107,1,1,127076,126591,485
613901,12.5248,11.1914,487,51100,0.116214,1,1,127089,126602,487
616821,12.105,11.8383,487,51100,0.0632428,1,1,127101,126614,487
619741,11.221,12.7677,485,51100,0.0366486,1,1,127112,126627,485
622661,9.4442,10.5535,484,51100,0.0313297,1,1,127121,126637,484
625581,5.08884,10.1107,478,51100,0.0782659,0.96,1,127125,126647,478
628501,6.61777,10.0221,475,51100,0.0556532,0.65,1,127132,126657,475
631421,26.1236,45.2044,452,51100,0.0511306,0.6,1,127163,126711,452
634341,11.6247,16.2409,451,52560,0.522226,0.59,1,127171,126720,451
637261,9.52494,11.2482,450,52560,0.616445,0.36,1,127180,126730,450
640181,157.105,163.05,443,52560,0.163289,0.36,1,127374,126931,443
643101,47.421,32.6099,463,52560,0.0406578,0.47,1,127394,126931,463
646021,31.8842,24.122,469,54020,0.0161316,0.49,1,127422,126953,469
888381,18,14,496,74460,0.86,1,2,129368,128872,496
891301,17.2,14,499,74460,0.836,1,2,129385,128886,499
894221,15.44,23.6,488,75920,0.8312,1,2,129400,128912,488
897141,17.488,31.92,472,75920,0.75024,1,2,129418,128946,472
900061,16.2976,18.384,473,75920,0.654048,1,1,129434,128961,473
902981,12.8595,3.6768,485,77380,0.64281,1,1,129446,128961,485
905901,20.1719,11.9354,493,77380,0.592562,1,1,129468,128975,493
908821,16.0344,15.1871,492,77380,0.542512,1,1,129483,128991,492
911741,17.6069,14.2374,496,77380,0.500502,1,1,129501,129005,496
914661,9.92138,12.4475,492,78840,0.4921,1,1,129509,129017,492
917581,9.18428,10.4895,491,78840,0.47442,1,1,129518,129027,491
920501,9.83685,9.2979,492,78840,0.438884,1,1,129528,129036,492
923421,8.36737,6.65958,494,80300,0.399777,1,1,129536,129042,494
926341,10.4735,13.3319,490,80300,0.391955,1,1,129547,129057,490
929261,12.4947,13.8664,489,80300,0.318391,1,1,129560,129071,489
932181,10.4989,2.77328,499,80300,0.279678,1,1,129570,129071,499
935101,13.2998,13.3547,497,81760,0.207936,1,1,129584,129087,497
938021,12.26,16.2709,492,81760,0.145587,1,1,129596,129104,492
940941,76.052,18.4542,565,81760,0.485117,1,1,129688,129123,565
943861,16.8104,68.4908,486,83220,0.553024,0.84,1,129690,129204,486
946781,24.1621,40.8982,478,83220,0.518605,1,1,129716,129238,478
949701,46.4324,55.3796,471,83220,0.399721,1,1,129768,129297,471
952621,23.6865,24.6759,472,84680,0.335944,1,1,129786,129314,472
955541,19.9373,4.93519,491,84680,0.235189,0.82,1,129805,129314,491
958461,15.1875,15.387,487,84680,0.167038,0.84,1,129819,129332,487
961381,15.0375,17.4774,484,86140,0.161408,0.86,1,129834,129350,484
964301,12.6075,17.8955,478,86140,0.152282,0.83,1,129846,129368,478
967221,4.1215,17.1791,463,86140,0.134456,0.83,1,129848,129385,463
970141,9.6243,15.4358,459,87600,0.162891,0.73,1,129859,129400,459
973061,12.3249,17.4872,454,87600,0.328578,0.63,1,129872,129418,454
975981,13.665,16.2974,452,87600,0.329716,0.63,1,129886,129434,452
978901,12.333,3.25949,464,89060,0.249943,0.64,1,129898,129434,464
981821,17.6666,10.2519,471,89060,0.393989,0.58,1,129917,129446,471
984741,13.9333,19.6504,462,89060,0.294798,0.53,1,129930,129468,462
987661,15.5867,15.9301,463,90520,0.21096,0.49,1,129946,129483,463
990581,4.71733,17.586,447,90520,0.162192,0.49,1,129948,129501,447
993501,5.74347,9.9172,445,90520,0.0564384,0.47,1,129954,129509,445
996421,6.74869,9.18344,443,90520,0.0192877,0.43,1,129961,129518,443
999341,7.74974,9.83669,441,91980,0.0118575,0.43,1,129969,129528,441
1002261,6.34995,1.96734,447,91980,0.00237151,0.39,1,129975,129528,447
1005181,6.86999,6.79347,446,91980,0.000474301,0.39,1,129982,129536,446
1008101,10.974,10.1587,447,93440,0.584095,0.3,1,129994,129547,447
1011021,6.9948,12.4317,440,93440,0.700819,0.27,1,130000,129560,440
1013941,2.99896,10.4863,432,93440,0.724164,0.19,1,130002,129570,432
1016861,7.79979,13.2973,427,93440,0.712833,0.13,1,130011,129584,427
1019781,21.56,12.2595,440,94900,0.662567,0.57,1,130036,129596,440
1022701,86.712,76.0519,451,94900,0.572513,0.57,1,130139,129688,451
1025621,18.9424,15.2104,453,94900,0.554503,0.57,1,130141,129688,453
1028541,15.7885,4.64208,466,96360,0.582901,0.51,1,130156,129690,466
1031461,42.3577,21.7284,489,96360,0.63658,0.37,1,130205,129716,489
1034381,10.0715,45.9457,439,96360,0.679316,0.32,1,130207,129768,439
1037301,9.21431,23.5891,430,97820,0.687863,0.21,1,130216,129786,430
1040221,17.0429,19.9178,430,97820,0.657573,0.15,1,130235,129805,430
1043141,13.0086,15.1836,428,97820,0.683515,0.15,1,130247,129819,428
1046061,13.8017,3.03671,442,99280,0.656703,0.16,1,130261,129819,442
1048981,12.3603,12.6073,439,99280,0.699341,0.15,1,130273,129834,439
1051901,4.07207,12.1215,429,99280,0.707868,0.13,1,130275,129846,429
1054821,2.41441,4.02429,429,100740,0.677574,0.17,1,130277,129848,429
1057741,16.4829,9.60486,438,100740,0.687515,0.37,1,130297,129859,438
1060661,13.6966,12.321,438,100740,0.689503,0.33,1,130310,129872,438
1063581,9.13932,13.6642,432,102200,0.657901,0.33,1,130318,129886,432
1066501,17.0279,2.73284,451,102200,0.63558,0.23,1,130337,129886,451
1069421,15.4056,10.1466,454,102200,0.615116,0.43,1,130352,129898,454
1072341,9.48111,17.2293,443,103660,0.627023,0.27,1,130360,129917,443
1075261,3.49622,13.8459,432,103660,0.661405,0.19,1,130362,129930,432
1078181,6.29924,15.5692,423,103660,0.700281,0.15,1,130369,129946,423
1081101,2.85985,4.71383,423,105120,0.708056,0.03,1,130371,129948,423
1084021,4.57197,5.74277,422,105120,0.741611,0.01,1,130376,129954,422
1086941,6.51439,6.74855,422,105120,0.748322,0.01,1,130383,129961,422
1089861,6.90288,1.34971,429,105120,0.701664,0.01,1,130390,129961,429
1092781,35.7806,6.66994,464,106580,0.708333,0,1,130433,129969,464
1095701,11.1561,6.13399,463,106580,0.693667,0,1,130438,129975,463
1098621,3.83122,6.8268,458,106580,0.690733,0.73,1,130440,129982,458
1101541,9.56624,10.9654,457,108040,0.722147,0.73,1,130451,129994,457
1104461,5.91325,6.99307,456,108040,0.744429,0.73,1,130456,130000,456
1107381,2.78265,2.99861,456,108040,0.748886,0.71,1,130458,130002,456
1110301,2.95653,7.79972,450,108040,0.733777,0.71,1,130461,130011,450
1113221,25.3913,1.55994,481,109500,0.778755,0.65,2,130492,130011,481
1116141,81.0783,20.312,551,109500,0.899751,0.55,2,130587,130036,551
1119061,17.8157,86.4624,450,110960,0.92395,0.55,2,130589,130139,450
1121981,5.16313,18.8925,450,110960,0.92879,0.59,2,130591,130141,450
1470781,39,50,465,61100,0,0.57,1,132342,131877,465
1500101,41.4,56.4,449,45040,0.344,0.65,1,132384,131935,449
1512581,163.48,164.88,451,23140,0.0768,0.53,1,132578,132127,451
1524641,72.696,78.576,444,15840,0.05536,0.42,1,132628,132184,444
1536321,2,50,423,115340,0.33,0.05,1,133051,132628,423
1539241,2,10,425,116800,0.33,0.05,1,133053,132628,425
1542161,2,2,427,116800,0.33,0.05,1,133055,132628,427
1545081,2,0.4,429,116800,0.338,0.05,1,133057,132628,429
1548001,2,0.08,431,118260,0.3076,0.05,1,133059,132628,431
1550921,2,0.016,433,118260,0.30152,0.05,1,133061,132628,433
1553841,2,0.0032,435,118260,0.316304,0.05,1,133063,132628,435
1556761,2,0.00064,437,119720,0.319261,0.05,1,133065,132628,437
1559681,2,0.000128,439,119720,0.319852,0.05,1,133067,132628,439
1562601,2,2.56e-05,441,119720,0.31197,0.05,1,133069,132628,441
1565521,2,5.12e-06,443,121180,0.326394,0.05,1,133071,132628,443
1568441,2,1.024e-06,445,121180,0.337279,0.05,1,133073,132628,445
1571361,2,2.048e-07,447,121180,0.355456,0.05,1,133075,132628,447
1574281,2,4.096e-08,449,122640,0.351091,0.05,1,133077,132628,449
1577201,2,8.19199e-09,451,122640,0.318218,0.05,1,133079,132628,451
1580121,2,1.6384e-09,453,122640,0.359644,0.05,1,133081,132628,453
1583041,2,3.2768e-10,455,122640,0.367929,0.05,1,133083,132628,455
1585961,2,6.55359e-11,457,124100,0.361586,0.05,1,133085,132628,457
1588881,2,1.31072e-11,459,124100,0.336317,0.05,1,133087,132628,459
1591801,2,2.62144e-12,461,124100,0.299263,0.05,1,133089,132628,461
1594721,2,5.24287e-13,463,124100,0.259853,0.05,1,133091,132628,463
1597641,2,1.04857e-13,465,124100,0.219971,0.05,1,133093,132628,465
1600561,2,2.09715e-14,467,125560,0.187994,0.05,1,133095,132628,467
1603481,2,4.1943e-15,469,125560,0.357599,0.05,1,133097,132628,469
1606401,11.6,8.3886e-16,483,125560,0.38352,0.05,1,133111,132628,483
1609321,11.92,1.67772e-16,495,125560,0.380704,0.05,1,133123,132628,495
1612241,13.584,3.35544e-17,509,127020,0.372141,0.05,1,133137,132628,509
1615161,11.5168,6.71088e-18,520,127020,0.354428,0.05,1,133148,132628,520
1618081,6.30336,1.34218e-18,525,127020,0.318886,0.05,1,133153,132628,525
1621001,3.66067,2.68435e-19,528,127020,0.327777,0.05,1,133156,132628,528
1623921,2.33213,5.3687e-20,530,127020,0.305555,0.05,1,133158,132628,530
1626841,2.06643,1.07374e-20,532,128480,0.309111,0.05,1,133160,132628,532
1629761,2.01329,2.14748e-21,534,128480,0.277822,0.05,1,133162,132628,534
1632681,2.00266,4.29496e-22,536,128480,0.295564,0.05,1,133164,132628,536
1635601,2.00053,8.58992e-23,538,128480,0.267113,0.05,1,133166,132628,538
1638521,2.00011,1.71798e-23,540,128480,0.229423,1,1,133168,132628,540
1641441,34.8,81.6,481,128480,0.293885,0.85,1,133211,132730,481
1644361,70.96,90.72,468,129940,0.338777,0.85,1,133291,132823,468
1647281,169.392,18.144,662,129940,0.299755,0.35,1,133485,132823,662
1650201,35.4784,184.429,438,129940,0.291951,0.33,1,133487,133049,438
1653121,8.69568,38.4858,438,129940,0.25839,0.33,1,133489,133051,438
1656041,3.33914,9.29715,438,131400,0.251678,0.33,1,133491,133053,438
1658961,2.26783,3.45943,438,131400,0.250336,0.34,1,133493,133055,438
1660881,1.25357,2.29189,437,131400,0.266067,0.3,1,133494,133057,437
1663801,1.85071,2.05838,437,131400,0.261213,0.3,1,133496,133059,437
1666721,1.97014,0.411675,439,131400,0.228243,0.3,1,133498,133059,439
1669641,1.99403,1.68234,439,132860,0.189649,0.32,1,133500,133061,439
1672561,1.99881,1.93647,439,132860,0.14993,0.32,1,133502,133063,439
1675441,1.99976,1.98729,439,132860,0.109986,0.31,1,133504,133065,439
1678361,1.99995,3.59746,437,132860,0.253997,0.31,1,133506,133069,437
1681281,1.99999,0.719492,439,132860,0.250799,0.31,1,133508,133069,439
1684201,2,0.143898,441,134320,0.21016,0.33,1,133510,133069,441
1687121,2,1.62878,441,134320,0.170032,0.34,1,133512,133071,441
1690001,2,1.92576,441,134320,0.250006,0.36,1,133514,133073,441
1692921,2,9.98515,431,134320,0.234001,0.36,1,133516,133085,431
1695841,2,1.99703,433,134320,0.1988,0.36,1,133518,133085,433
1698761,2,0.399406,435,135780,0.15976,0.36,1,133520,133085,435
1701681,2,0.0798812,437,135780,0.127952,0.36,1,133522,133085,437
1704601,2,0.0159762,439,135780,0.24159,0.36,1,133524,133085,439
1707521,2,0.00319525,441,135780,0.232318,0.36,1,133526,133085,441
1710441,2,0.000639049,443,135780,0.198464,0.33,1,133528,133085,443
1713361,2,1.60013,443,135780,0.167693,0.29,1,133530,133087,443
1715381,1.2,1.92003,442,135780,0.145539,0.21,1,133531,133089,442
1718301,1.84,3.58401,440,137240,0.229108,0.21,1,133533,133093,440
1721221,1.968,0.716801,442,137240,0.213822,0.21,1,133535,133093,442
1724141,1.9936,0.14336,444,137240,0.178764,0.18,1,133537,133093,444
1726821,8.39872,1.62867,452,137240,0.203753,0.45,1,133547,133095,452
1729741,4.87974,9.12573,445,137240,0.176751,0.39,1,133551,133106,445
1732661,8.97595,5.82515,450,137240,0.25935,0.38,1,133561,133111,450
1735581,3.39519,10.765,440,137240,0.24387,0.37,1,133563,133123,440
1738501,10.279,13.353,438,137240,0.288774,0.35,1,133575,133137,438
1741421,10.0558,11.4706,437,138700,0.321755,0.31,1,133585,133148,437
1743041,4.41116,6.29412,435,138700,0.336351,0.27,1,133588,133153,435
1745961,2.48223,8.45882,428,138700,0.30727,0.27,1,133590,133162,428
1748881,2.09645,1.69176,430,138700,0.301454,0.27,1,133592,133162,430
1751801,2.01929,0.338353,432,138700,0.340291,0.27,1,133594,133162,432
1754721,2.00386,0.0676706,434,138700,0.316058,0.27,1,133596,133162,434
1757601,2.00077,0.0135341,436,138700,0.311212,0.28,1,133598,133162,436
1760521,2.00015,2.40271,435,138700,0.286242,0.26,1,133600,133165,435
1762801,2.00003,1.28054,436,140160,0.249248,0.31,1,133602,133166,436
1765721,6.80001,7.45611,435,140160,0.24985,0.31,1,133610,133175,435
1768641,31.76,30.2912,437,140160,0.39397,0.31,1,133648,133211,437
1770501,8.752,6.05824,440,140160,0.406794,0.35,1,133651,133211,440
1772161,63.3504,65.2116,437,140160,0.457359,0.37,1,133728,133291,437
1775081,164.67,19.4423,619,140160,0.531472,0.29,1,133918,133299,619
1776741,33.734,152.688,434,140160,0.530294,0.28,1,133919,133485,434
1779661,8.3468,38.5377,426,141620,0.562059,0.28,1,133921,133495,426
1782581,3.26936,7.70754,428,141620,0.536412,0.28,1,133923,133495,428
1785501,2.25387,1.54151,430,141620,0.531282,0.28,1,133925,133495,430
1788421,2.05077,0.308301,432,141620,0.530257,0.28,1,133927,133495,432
1791341,2.01015,0.0616603,434,141620,0.530051,0.28,1,133929,133495,434
1793381,2.00203,0.0123321,436,141620,0.49801,0.12,1,133931,133495,436
1796301,2.00041,6.40247,430,141620,0.459602,0.12,1,133933,133503,430
1799221,2.00008,1.28049,432,143080,0.41992,0.12,1,133935,133503,432
1802141,2.00002,0.256099,434,143080,0.379984,0.12,1,133937,133503,434
1804821,2,0.0512197,436,143080,0.339997,0.29,1,133939,133503,436
1807741,2,8.01024,428,143080,0.467999,0.29,1,133941,133513,428
1810661,2,1.60205,430,143080,0.4616,0.29,1,133943,133513,430
1813581,2,0.32041,432,143080,0.42832,0.29,1,133945,133513,432
1816501,2,0.0640819,434,143080,0.389664,0.29,1,133947,133513,434
1819381,2,0.0128164,436,143080,0.501933,0.14,1,133949,133513,436
1822301,2,6.40256,430,144540,0.492387,0.14,1,133951,133521,430
1825221,2,1.28051,432,144540,0.458477,0.14,1,133953,133521,432
1828141,2,0.256103,434,144540,0.419695,0.14,1,133955,133521,434
1830821,2,0.0512205,436,144540,0.379939,0.16,1,133957,133521,436
1833741,2,7.21024,429,144540,0.459988,0.16,1,133959,133530,429
1836661,2,1.44205,431,144540,0.443998,0.16,1,133961,133530,431
1839581,2,0.28841,433,144540,0.4088,0.16,1,133963,133530,433
1842261,2,0.0576819,435,144540,0.50576,0.27,1,133965,133530,435
1845181,2,1.61154,435,144540,0.501152,0.27,1,133967,133532,435
1847461,6.8,0.322307,443,144540,0.46023,0.26,1,133975,133532,443
1850381,2.96,9.66446,433,146000,0.412046,0.26,1,133977,133544,433
1853301,2.192,1.93289,435,146000,0.370409,0.26,1,133979,133544,435
1855781,10.8384,0.386578,448,146000,0.402082,0.28,1,133992,133544,448
1858701,3.76768,12.0773,435,146000,0.416416,0.28,1,133994,133559,435
1860561,1.55354,2.41546,436,146000,0.403283,0.34,1,133995,133559,436
1863481,9.91071,10.0831,436,146000,0.416657,0.34,1,134007,133571,436
1865761,3.58214,2.01662,438,146000,0.459331,0.37,1,134009,133571,438
1868681,10.3164,10.0033,438,146000,0.451866,0.37,1,134021,133583,438
1870341,4.46329,2.00066,441,146000,0.466373,0.37,1,134024,133583,441
1873261,2.49266,8.40013,433,146000,0.469275,0.37,1,134026,133593,433
1876181,2.09853,1.68003,435,146000,0.525855,0.37,1,134028,133593,435
1879101,2.01971,0.336005,437,147460,0.529171,0.37,1,134030,133593,437
1880741,2.00394,0.0672011,439,147460,0.497834,0.26,1,134032,133593,439
1883661,2.00079,6.41344,433,147460,0.499567,0.26,1,134034,133601,433
1886581,2.00016,1.28269,435,147460,0.467913,0.26,1,134036,133601,435
1889501,2.00003,0.256538,437,147460,0.461583,0.26,1,134038,133601,437
1892181,6.80001,0.0513075,445,147460,0.412317,0.38,1,134046,133601,445
1895101,2.96,8.01026,437,147460,0.370463,0.38,1,134048,133611,437
1897381,34.992,1.60205,480,147460,0.490093,0.43,1,134091,133611,480
1900301,9.3984,33.1204,442,147460,0.562019,0.43,1,134094,133652,442
1902581,66.6797,6.62408,523,147460,0.616404,0.45,1,134175,133652,523
1904661,166.136,66.1248,633,147460,0.755281,0.53,2,134366,133733,633
1907581,34.8272,170.025,439,148920,0.783056,0.53,2,134368,133929,439
1910501,8.56544,34.005,441,148920,0.788611,0.53,2,134370,133929,441
1913421,3.31309,6.801,443,148920,0.789722,0.53,2,134372,133929,443
1916341,2.26262,1.3602,445,148920,0.789944,0.53,2,134374,133929,445
1918801,2.05252,0.27204,447,148920,0.789989,0.35,2,134376,133929,447
1921721,2.0105,7.25441,440,148920,0.757998,0.35,2,134378,133938,440
1924641,2.0021,1.45088,442,148920,0.7196,0.35,1,134380,133938,442
1927561,2.00042,0.290176,444,148920,0.67992,0.35,1,134382,133938,444
1930481,2.00008,0.0580353,446,150380,0.639984,0.35,1,134384,133938,446
1932321,1.20002,0.0116071,447,150380,0.735997,0.38,1,134385,133938,447
1935241,1.84,7.20232,440,150380,0.723199,0.38,1,134387,133947,440
1938161,1.968,1.44046,442,150380,0.68864,0.38,1,134389,133947,442
1941081,1.9936,0.288093,444,150380,0.649728,0.38,1,134391,133947,444
1943761,1.99872,0.0576186,446,150380,0.609946,0.43,1,134393,133947,446
1946681,1.99974,5.61152,441,150380,0.569989,0.43,1,134395,133954,441
1949601,1.99995,1.1223,443,150380,0.529998,0.43,1,134397,133954,443
1952521,1.99999,0.224461,445,150380,0.706,0.43,1,134399,133954,445
1955441,2,0.0448922,447,150380,0.7092,0.43,1,134401,133954,447
1957701,2,0.00897844,449,150380,0.67784,0.44,1,134403,133954,449
1960621,2,5.6018,444,150380,0.639568,0.44,1,134405,133961,444
1963541,2,1.12036,446,150380,0.599914,0.44,1,134407,133961,446
1966021,3.6,0.224072,450,150380,0.527983,0.44,1,134411,133961,450
1968941,2.32,7.24481,443,151840,0.697596,0.44,1,134413,133970,443
1971861,2.064,1.44896,445,151840,0.699519,0.44,1,134415,133970,445
1974781,2.0128,0.289793,447,151840,0.667904,0.44,1,134417,133970,447
1977461,5.20256,0.0579585,453,151840,0.709581,0.42,1,134423,133970,453
1979541,10.6405,4.81159,459,151840,0.725916,0.43,1,134435,133976,459
1982461,3.7281,12.9623,446,151840,0.777183,0.43,2,134437,133991,446
1984321,1.54562,2.59246,447,151840,0.771437,0.47,2,134438,133991,447
1987241,6.70912,7.71849,446,151840,0.786287,0.47,2,134446,134000,446
1990161,2.94182,1.5437,448,151840,0.757257,0.47,2,134448,134000,448
1993061,11.7884,0.30874,462,151840,0.815452,0.53,2,134462,134000,462
1995981,3.95767,13.6617,447,151840,0.82709,0.53,2,134464,134017,447
1998261,5.59153,2.73235,453,151840,0.821418,0.47,2,134470,134017,453
2000961,2.71831,7.74647,446,151840,0.820284,0.53,2,134472,134026,446
2003881,2.14366,4.74929,444,151840,0.796057,0.53,2,134474,134030,444
2006801,2.02873,0.949859,446,153300,0.759211,0.53,2,134476,134030,446
2008661,3.60575,0.189972,450,153300,0.735842,0.48,1,134480,134030,450
2011581,3.12115,9.63799,441,153300,0.683168,0.48,1,134483,134042,441
2014501,2.22423,1.9276,443,153300,0.760634,0.48,2,134485,134042,443
2017421,2.04485,0.38552,445,153300,0.744127,0.48,1,134487,134042,445
2019681,2.00897,0.0771039,447,153300,0.740825,0.36,1,134489,134042,447
2022601,3.60179,4.81542,445,153300,0.716165,0.36,1,134493,134048,445
2024261,11.9204,0.963084,459,153300,0.815233,0.49,2,134507,134048,459
2025921,4.78407,10.5926,449,153300,0.819047,0.58,2,134510,134061,449
2028001,26.5568,28.5185,448,153300,0.875809,0.55,2,134542,134094,448
2030921,11.7114,11.3037,449,153300,0.847162,0.55,2,134550,134101,449
2032581,70.3423,2.26074,534,153300,0.929432,0.65,2,134635,134101,534
2076501,2,0,454,154760,0.9,0.71,2,134855,134401,454
2079421,2,0,456,154760,0.868,0.71,2,134857,134401,456
2082341,2,0,458,154760,0.8456,0.71,2,134859,134401,458
2084581,3.6,0,462,154760,0.76112,0.53,2,134863,134401,462
2087501,2.32,7.2,455,154760,0.944224,0.53,2,134865,134410,455
2090421,2.064,1.44,457,154760,0.932845,0.53,2,134867,134410,457
2093341,2.0128,0.288,459,154760,0.914569,0.53,2,134869,134410,459
2096021,3.60256,0.0576,463,156220,0.894914,0.79,2,134873,134410,463
2098941,2.32051,8.01152,455,156220,0.842983,0.79,2,134875,134420,455
2101861,2.0641,1.6023,457,156220,0.968597,0.79,2,134877,134420,457
2104781,2.01282,0.320461,459,156220,0.961719,0.79,2,134879,134420,459
2106421,4.40256,0.0640921,464,156220,0.904344,0.66,2,134884,134420,464
2108081,2.48051,4.81282,460,156220,0.860869,0.77,2,134886,134426,460
2111001,9.2961,10.5626,459,156220,0.972174,0.77,2,134897,134438,459
2148041,2,0,458,157680,0.94,0.78,2,134952,134494,458
2150961,2,0,460,157680,0.908,0.78,2,134954,134494,460
2152801,1.2,0,461,157680,0.8936,0.84,2,134955,134494,461
2222501,2,0,467,159140,1,1,2,135344,134877,467
2225421,2,0,469,159140,0.984,1,2,135346,134877,469
2228341,2,0,471,159140,0.9648,1,2,135348,134877,471
2522861,64,0,539,46500,0.3,1,1,137047,136508,539
2529301,19.2,63.2,468,46500,0.212,1,1,137055,136587,468
2541141,26.24,33.44,470,44180,0.1304,1,1,137083,136613,470
2546761,77.248,58.688,495,36280,0.09808,1,1,137173,136678,495
2582321,31.4496,34.1376,487,34820,0.123616,0.63,1,137193,136706,487
2782841,45,51,442,37320,0.01,0.37,1,138752,138310,442
2803441,29.8,34.2,438,31480,0.01,0.17,1,138778,138340,438
2808221,64.36,71.64,430,15420,0.002,0.29,1,138851,138421,430
2817361,35.272,34.328,433,13960,0.0644,0.1,1,138879,138446,433
2820281,206.254,54.0656,623,90520,0.08488,0.01,1,139128,138505,623
2823201,99.6509,208.413,449,91980,0.016976,0,1,139201,138752,449
2826121,99.1302,120.883,449,91980,0.0033952,0.08,1,139300,138851,449
2829041,21.426,46.5765,423,93440,0.00867904,0.08,1,139302,138879,423
2831961,5.88521,9.3153,425,93440,0.0257358,0.08,1,139304,138879,425
2834881,2.77704,1.86306,427,93440,0.00514716,0.08,1,139306,138879,427
2837801,2.15541,0.372612,429,93440,0.0410294,0.08,1,139308,138879,429
2840721,2.03108,0.0745224,431,94900,0.0162059,0.08,1,139310,138879,431
2843641,2.00622,0.0149045,433,94900,0.0272412,0.08,1,139312,138879,433
2846561,2.00124,0.0029809,435,94900,0.0294482,0.08,1,139314,138879,435
2849481,2.00025,0.000596179,437,94900,0.0458896,0.08,1,139316,138879,437
2852401,2.00005,0.000119236,439,94900,0.0491779,0.08,1,139318,138879,439
2855321,2.00001,2.38472e-05,441,96360,0.0658356,0.08,1,139320,138879,441
2858241,2,4.76943e-06,443,96360,0.0691671,0.08,1,139322,138879,443
2861161,2,9.53887e-07,445,96360,0.0698334,0.08,1,139324,138879,445
2864081,2,1.90777e-07,447,96360,0.0699667,0.08,1,139326,138879,447
2867001,2,3.81555e-08,449,96360,0.0699933,0.08,1,139328,138879,449
2869921,2,7.63109e-09,451,96360,0.0859987,0.08,1,139330,138879,451
2872841,2,1.52622e-09,453,97820,0.0891997,0.08,1,139332,138879,453
2875761,2,3.05244e-10,455,97820,0.0898399,0.08,1,139334,138879,455
2878681,2,6.10487e-11,457,97820,0.089968,0.08,1,139336,138879,457
2881601,2,1.22097e-11,459,97820,0.0899936,0.08,1,139338,138879,459
2884521,2,2.44195e-12,461,97820,0.0899987,0.08,1,139340,138879,461
2887441,2,4.8839e-13,463,97820,0.106,0.08,1,139342,138879,463
2890361,2,9.76779e-14,465,97820,0.1092,0.08,1,139344,138879,465
2893281,2,1.95356e-14,467,97820,0.10984,0.08,1,139346,138879,467
2896201,2,3.90712e-15,469,99280,0.109968,0.08,1,139348,138879,469
2899121,2,7.81423e-16,471,99280,0.109994,0.08,1,139350,138879,471
2902041,10.8,1.56285e-16,484,99280,0.125999,0.08,1,139363,138879,484
2904961,6.16,3.12569e-17,489,99280,0.1132,0.08,1,139368,138879,489
2907881,5.232,6.25139e-18,494,99280,0.0946399,0.09,1,139373,138879,494
2910801,144.246,199.2,424,99280,0.282928,0.09,1,139552,139128,424
2913721,84.8493,39.84,494,99280,0.0565856,0,1,139622,139128,494
2916641,96.1699,66.368,520,100740,0.0113171,0,1,139721,139201,520
2919561,20.834,92.4736,423,100740,0.0422634,0.01,1,139723,139300,423
2922481,5.76679,20.0947,423,100740,0.0164527,0.03,1,139725,139302,423
2925401,2.75336,5.61894,423,100740,0.0112905,0,1,139727,139304,423
2928321,2.95067,2.72379,424,100740,0.00225811,0.05,1,139730,139306,424
2931241,2.19013,2.14476,424,100740,0.0404516,0.05,1,139732,139308,424
2934161,2.03803,0.428952,426,100740,0.0480903,0.01,1,139734,139308,426
2937081,2.00761,1.68579,426,100740,0.0496181,0.03,1,139736,139310,426
2940001,2.00152,1.93716,426,102200,0.0499236,0.03,1,139738,139312,426
2942921,2.0003,1.98743,426,102200,0.0179847,0.05,1,139740,139314,426
2945841,2.00006,1.99749,426,102200,0.0115969,0.05,1,139742,139316,426
2948761,2.00001,1.9995,426,102200,0.0103194,0.07,1,139744,139318,426
2951681,2,1.9999,426,102200,0.0100639,0.07,1,139746,139320,426
2954601,2,1.99998,426,102200,0.0260128,0.07,1,139748,139322,426
2957521,2,2,426,102200,0.0292026,0.07,1,139750,139324,426
2960441,2,2,426,102200,0.0298405,0.07,1,139752,139326,426
2963361,2,2,426,102200,0.0299681,0.09,1,139754,139328,426
2966281,2,2,426,102200,0.0299936,0.09,1,139756,139330,426
2969201,2,0.4,428,102200,0.0299987,0.09,1,139758,139330,428
2972121,2,1.68,428,102200,0.0299997,0.09,1,139760,139332,428
2975041,2,1.936,428,103660,0.0299999,0.09,1,139762,139334,428
2977961,2,1.9872,428,103660,0.03,0.09,1,139764,139336,428
2980881,2,1.99744,428,103660,0.03,0.09,1,139766,139338,428
2983801,2,1.99949,428,103660,0.03,0.11,1,139768,139340,428
2986721,2,1.9999,428,103660,0.03,0.11,1,139770,139342,428
2989641,2,1.99998,428,103660,0.046,0.11,1,139772,139344,428
2992561,2,2,428,103660,0.0492,0.11,1,139774,139346,428
2995481,2,2,428,103660,0.04984,0.11,1,139776,139348,428
2998401,2,2,428,103660,0.049968,0.13,1,139778,139350,428
3001321,9.2,10.8,426,103660,0.0659936,0.11,1,139789,139363,426
3004241,6.64,6.16,427,103660,0.0371987,0.09,1,139795,139368,427
3007161,5.328,5.232,427,105120,0.0474397,0.33,1,139800,139373,427
3010081,151.466,144.246,436,105120,0.177488,0,1,139988,139552,436
3013001,75.0931,84.8493,422,105120,0.0354976,0,1,140044,139622,422
3015921,94.2186,16.9699,521,105120,0.00709952,0,1,140143,139622,521
3018841,20.4437,82.594,424,105120,0.0254199,0.05,1,140145,139721,424
3021761,5.68874,18.1188,424,105120,0.061084,0.01,1,140147,139723,424
3024681,2.73775,5.22376,424,105120,0.0362168,0.01,1,140149,139725,424
3027601,2.14755,2.64475,424,105120,0.00724336,0,1,140151,139727,424
3030521,2.02951,2.92895,423,105120,0.0254487,0.05,1,140153,139730,423
3033441,2.0059,2.18579,423,105120,0.0290897,0.05,1,140155,139732,423
3036361,2.00118,2.03716,423,105120,0.0298179,0.05,1,140157,139734,423
3039281,2.00024,2.00743,423,105120,0.0299636,0.05,1,140159,139736,423
3042201,2.00005,2.00149,423,106580,0.0299927,0.01,1,140161,139738,423
3045121,2.00001,2.0003,423,106580,0.0299985,0.01,1,140163,139740,423
3048041,2,2.00006,423,106580,0.0299997,0.01,1,140165,139742,423
3050961,2,2.00001,423,106580,0.0299999,0.01,1,140167,139744,423
3053881,2,2,423,106580,0.03,0.03,1,140169,139746,423
3056801,2,2,423,106580,0.046,0.03,1,140171,139748,423
3059721,2,2,423,106580,0.0492,0.03,1,140173,139750,423
3062641,2,2,423,106580,0.04984,0.03,1,140175,139752,423
3065561,2,2,423,106580,0.049968,0.03,1,140177,139754,423
3068481,2,2,423,106580,0.0499936,0.03,1,140179,139756,423
3071401,2,2,423,106580,0.0499987,0.03,1,140181,139758,423
3074321,2,2,423,106580,0.0659997,0.03,1,140183,139760,423
3077241,2,0.4,425,106580,0.0772,0.03,1,140185,139760,425
3080161,2,1.68,425,106580,0.07144,0.03,1,140187,139762,425
3083081,2,1.936,425,106580,0.070288,0.03,1,140189,139764,425
3086001,2,1.9872,425,106580,0.0700576,0.03,1,140191,139766,425
3088921,2,1.99744,425,106580,0.0700115,0.03,1,140193,139768,425
3091841,2,1.99949,425,106580,0.0700023,0.05,1,140195,139770,425
3094761,2,1.9999,425,108040,0.0700005,0.05,1,140197,139772,425
3097681,2,1.99998,425,108040,0.0700001,0.05,1,140199,139774,425
3100601,2,2,425,108040,0.07,0.05,1,140201,139776,425
3103521,8.4,2,433,108040,0.086,0.07,1,140211,139778,433
3106441,6.48,9.2,428,108040,0.0892,0.03,1,140217,139789,428
3109361,2.896,6.64,424,108040,0.08984,0.05,1,140219,139795,424
3112281,3.7792,5.328,423,108040,0.105968,0.21,1,140223,139800,423
3115201,158.356,151.466,432,108040,0.237194,0,1,140420,139988,432
3118121,68.4712,75.0931,422,108040,0.199439,0,1,140466,140044,422
3121041,93.6942,94.2186,423,108040,0.0798877,0.03,1,140566,140143,423
3123961,20.3388,20.4437,423,108040,0.0559775,0.07,1,140568,140145,423
3126881,5.66777,5.68874,423,108040,0.0191955,0.03,1,140570,140147,423
3129801,2.73355,2.73775,423,108040,0.0118391,0,1,140572,140149,423
3132721,2.14671,2.14755,423,108040,0.00236782,0.03,1,140574,140151,423
3135641,2.02934,2.02951,423,108040,0.00847356,0.03,1,140576,140153,423
3138561,2.00587,2.0059,423,108040,0.00969471,0.03,1,140578,140155,423
3141481,2.00117,2.00118,423,108040,0.00993894,0.03,1,140580,140157,423
3144401,2.00023,2.00024,423,108040,0.00998779,0.03,1,140582,140159,423
3147321,2.00005,0.400047,425,108040,0.00999756,0.03,1,140584,140159,425
3150241,2.00001,1.68001,425,109500,0.00999951,0.03,1,140586,140161,425
3153161,2,1.936,425,109500,0.0099999,0.03,1,140588,140163,425
3156081,2,1.9872,425,109500,0.00999998,0.03,1,140590,140165,425
3159001,2,1.99744,425,109500,0.01,0.03,1,140592,140167,425
3161921,2.8,1.99949,426,109500,0.042,0.05,1,140595,140169,426
3164841,2.16,1.9999,426,109500,0.0484,0.05,1,140597,140171,426
3167761,2.032,1.99998,426,109500,0.04968,0.05,1,140599,140173,426
3170681,2.0064,2,426,109500,0.049936,0.05,1,140601,140175,426
3173601,2.00128,2,426,109500,0.0499872,0.05,1,140603,140177,426
3176521,2.00026,2,426,109500,0.0179974,0.05,1,140605,140179,426
3179441,2.00005,2,426,109500,0.0115995,0.07,1,140607,140181,426
3182361,2.00001,2,426,109500,0.0103199,0.08,1,140609,140183,426
3185281,2,2,426,109500,0.010064,0.07,1,140611,140185,426
3188201,2,2,426,109500,0.0100128,0.07,1,140613,140187,426
3191121,2,2,426,109500,0.0100026,0.07,1,140615,140189,426
3194041,2,2,426,109500,0.0100005,0.07,1,140617,140191,426
3196961,2,2,426,109500,0.0100001,0.07,1,140619,140193,426
3199881,2,2,426,109500,0.01,0.07,1,140621,140195,426
3202801,2,2,426,109500,0.01,0.07,1,140623,140197,426
3205721,2,2,426,109500,0.01,0.07,1,140625,140199,426
3208641,2,2,426,109500,0.01,0.09,1,140627,140201,426
3211561,9.2,8.4,427,109500,0.026,0.09,1,140638,140211,427
3214481,6.64,6.48,427,109500,0.0292,0.09,1,140644,140217,427
3217401,2.928,2.896,427,109500,0.04584,0.11,1,140646,140219,427
3220321,3.7856,3.7792,427,109500,0.049168,0.27,1,140650,140223,427
3223241,165.557,158.356,436,109500,0.209834,0.19,1,140856,140420,436
3226161,63.5114,68.4712,428,109500,0.249967,0.05,1,140894,140466,428
3229081,87.9023,93.6942,422,109500,0.0499933,0.05,1,140988,140566,422
3232001,19.1805,20.3388,422,109500,0.00999867,0.01,1,140990,140568,422
3234921,5.43609,5.66777,422,109500,0.0259997,0.01,1,140992,140570,422
3237841,2.68722,2.73355,422,109500,0.00519995,0,1,140994,140572,422
3240761,2.13744,2.14671,422,109500,0.09704,0.01,1,140996,140574,422
3243681,2.02749,2.02934,422,109500,0.115408,0.01,1,140998,140576,422
3246601,2.0055,2.00587,422,109500,0.119082,0.01,1,141000,140578,422
3249521,2.0011,2.00117,422,109500,0.119816,0.01,1,141002,140580,422
3252441,2.00022,2.00023,422,109500,0.127963,0.01,1,141004,140582,422
3255361,2.00004,2.00005,422,109500,0.129593,0.01,1,141006,140584,422
3258281,2.00001,0.400009,424,110960,0.129919,0.01,1,141008,140584,424
3261201,2,1.68,424,110960,0.129984,0.01,1,141010,140586,424
3264121,2,1.936,424,110960,0.129997,0.01,1,141012,140588,424
3267041,2,1.9872,424,110960,0.129999,0.01,1,141014,140590,424
3269961,2,1.99744,424,110960,0.13,0.05,1,141016,140592,424
3272881,2,2.79949,423,110960,0.146,0.05,1,141018,140595,423
3275801,2,2.1599,423,110960,0.1492,0.05,1,141020,140597,423
3278721,2,2.03198,423,110960,0.14984,0.05,1,141022,140599,423
3281641,2,2.0064,423,110960,0.149968,0.05,1,141024,140601,423
3284561,2,2.00128,423,110960,0.149994,0.01,1,141026,140603,423
3287481,2,2.00026,423,110960,0.149999,0.01,1,141028,140605,423
3290401,2,2.00005,423,110960,0.15,0.01,1,141030,140607,423
3293321,2,2.00001,423,110960,0.15,0.01,1,141032,140609,423
3296241,2,2,423,110960,0.15,0.01,1,141034,140611,423
3299161,2,2,423,110960,0.15,0.01,1,141036,140613,423
3302081,2,2,423,110960,0.15,0.01,1,141038,140615,423
3305001,2,2,423,110960,0.15,0.01,1,141040,140617,423
3307921,2,2,423,110960,0.15,0.01,1,141042,140619,423
3310841,2,2,423,110960,0.15,0.01,1,141044,140621,423
3313761,2,2,423,110960,0.15,0.01,1,141046,140623,423
3316681,2,2,423,110960,0.15,0.01,1,141048,140625,423
3319601,10.8,2,434,110960,0.15,0.03,1,141061,140627,434
3322521,6.96,9.2,429,110960,0.15,0.03,1,141067,140638,429
3325441,2.992,6.64,425,110960,0.118,0.05,1,141069,140644,425
3328361,3.7984,2.928,427,110960,0.0796,0.05,1,141073,140646,427
3329821,161.56,3.7856,624,110960,0.45592,0.25,1,141274,140650,624
3332741,47.5119,165.557,437,110960,0.507184,0.26,1,141293,140856,437
3335661,35.1024,63.5114,431,110960,0.565437,0,1,141325,140894,431
3338581,79.8205,87.9023,428,110960,0.113087,0,1,141416,140988,428
3341501,17.5641,19.1805,428,110960,0.0226175,0.03,1,141418,140990,428
3344421,5.11282,5.43609,428,110960,0.00452349,0,1,141420,140992,428
3347341,2.62256,2.68722,428,110960,0.000904699,0.12,1,141422,140994,428
3350261,2.12451,2.13744,428,110960,0.0241809,0.12,1,141424,140996,428
3353181,2.0249,2.02749,428,110960,0.116836,0.12,1,141426,140998,428
3356101,2.00498,2.0055,428,110960,0.135367,0.12,1,141428,141000,428
3359021,2.001,2.0011,428,110960,0.139073,0.13,1,141430,141002,428
3361941,2.0002,2.00022,428,110960,0.139815,0.13,1,141432,141004,428
3364861,2.00004,2.00004,428,110960,0.131963,0.13,1,141434,141006,428
3367781,2.00001,0.400009,430,110960,0.130393,0.13,1,141436,141006,430
3370701,2,1.68,430,110960,0.130079,0.13,1,141438,141008,430
3373621,2,1.936,430,110960,0.130016,0.13,1,141440,141010,430
3376541,2,1.9872,430,110960,0.130003,0.13,1,141442,141012,430
3379461,2,1.99744,430,110960,0.130001,0.13,1,141444,141014,430
3382381,2,1.99949,430,110960,0.13,0.15,1,141446,141016,430
3385301,2,1.9999,430,110960,0.13,0.15,1,141448,141018,430
3388221,2,1.99998,430,110960,0.13,0.15,1,141450,141020,430
3391141,2,2,430,110960,0.122,0.15,1,141452,141022,430
3394061,2,2,430,110960,0.1204,0.15,1,141454,141024,430
3396981,2,2,430,110960,0.12008,0.15,1,141456,141026,430
3399901,2,2,430,110960,0.120016,0.15,1,141458,141028,430
3402821,2,2,430,110960,0.128003,0.15,1,141460,141030,430
3405741,2,2,430,110960,0.129601,0.15,1,141462,141032,430
3408661,2,2,430,110960,0.12992,0.15,1,141464,141034,430
3411581,2,2,430,110960,0.129984,0.15,1,141466,141036,430
3414501,2.8,2,431,110960,0.145997,0.15,1,141469,141038,431
3417421,2.16,2,431,110960,0.149199,0.15,1,141471,141040,431
3420341,2.032,2,431,110960,0.14984,0.15,1,141473,141042,431
3423261,2.0064,2,431,110960,0.149968,0.15,1,141475,141044,431
3426181,2.00128,2,431,110960,0.149994,0.15,1,141477,141046,431
3429101,6.80026,2,437,110960,0.117999,0.15,1,141485,141048,437
3432021,6.16005,10.8,430,110960,0.1116,0.15,1,141491,141061,430
3434941,3.63201,6.96,427,110960,0.12632,0.11,1,141494,141067,427
3437861,4.7264,2.992,430,110960,0.113264,0.07,1,141499,141069,430
3439321,161.745,3.7984,627,110960,0.454653,0.55,1,141700,141073,627
3442241,66.7491,161.56,469,110960,0.418931,0.52,1,141743,141274,469
3445161,38.1498,47.5119,481,110960,0.419786,0.58,1,141774,141293,481
3448081,62.83,35.1024,518,110960,0.491957,0,1,141843,141325,518
3451001,14.166,79.8205,429,110960,0.474391,0,1,141845,141416,429
3453921,4.4332,17.5641,429,110960,0.470878,0,1,141847,141418,429
3456841,2.48664,5.11282,429,110960,0.446176,0,1,141849,141420,429
3459761,2.09733,2.62256,429,110960,0.409235,0.03,1,141851,141422,429
3462681,2.01947,2.12451,429,110960,0.369847,0.14,1,141853,141424,429
3465601,2.00389,2.0249,429,110960,0.369969,0.14,1,141855,141426,429
3468521,2.00078,2.00498,429,110960,0.489994,0.14,1,141857,141428,429
3471441,2.00016,2.001,429,110960,0.513999,0.14,1,141859,141430,429
3474361,2.00003,2.0002,429,110960,0.5188,0.13,1,141861,141432,429
3477281,2.00001,2.00004,429,110960,0.51976,0.13,1,141863,141434,429
3480201,2,2.00001,429,110960,0.527952,0.13,1,141865,141436,429
3483121,2,2,429,110960,0.52959,0.13,1,141867,141438,429
3485461,2,2,429,110960,0.529918,0.13,1,141869,141440,429
3488381,2,2,429,110960,0.537984,0.13,1,141871,141442,429
3491301,2,2,429,110960,0.539597,0.13,1,141873,141444,429
3494221,2,2,429,110960,0.539919,0.13,1,141875,141446,429
3497141,2,2,429,110960,0.539984,0.13,1,141877,141448,429
3500061,2,2,429,110960,0.539997,0.12,1,141879,141450,429
3502981,2,2,429,110960,0.539999,0.12,1,141881,141452,429
3505901,2,2,429,110960,0.54,0.12,1,141883,141454,429
3508821,2,2,429,110960,0.508,0.12,1,141885,141456,429
3511741,2,2,429,110960,0.5176,0.13,1,141887,141458,429
3514661,2,2,429,110960,0.51952,0.13,1,141889,141460,429
3517581,2,2,429,110960,0.519904,0.13,1,141891,141462,429
3520501,2,2,429,110960,0.519981,0.13,1,141893,141464,429
3523421,2,2,429,110960,0.519996,0.15,1,141895,141466,429
3526341,2,2.8,428,110960,0.519999,0.15,1,141897,141469,428
3529261,2,2.16,428,110960,0.52,0.15,1,141899,141471,428
3532181,2,2.032,428,110960,0.52,0.15,1,141901,141473,428
3535101,2,2.0064,428,110960,0.52,0.15,1,141903,141475,428
3538021,6.8,2.00128,434,110960,0.512,0.11,1,141911,141477,434
3540941,6.16,6.80026,432,110960,0.5104,0.11,1,141917,141485,432
3543861,2.832,6.16005,428,110960,0.52608,0.13,1,141919,141491,428
3546781,2.1664,3.63201,427,110960,0.529216,0.11,1,141921,141494,427
3548241,161.233,4.7264,623,110960,0.617843,0.54,1,142122,141499,623
3551161,88.2467,161.745,492,110960,0.603569,0.41,1,142192,141700,492
3554081,40.8493,66.7491,478,110960,0.688714,0.42,1,142221,141743,478
3586201,2,2,449,110960,0.9,0.52,2,142310,141861,449
3589121,2,2,449,110960,0.98,0.53,2,142312,141863,449
4009461,16,18,491,17520,0.33,1,1,146916,146425,491
4012381,14.4,3.6,505,20440,0.338,0.15,1,146930,146425,505
4015301,301.28,365.52,422,23360,0.1716,0.15,1,147303,146881,422
4018221,61.856,73.104,424,26280,0.10632,0.09,1,147305,146881,424
4021141,36.3712,29.8208,435,29200,0.133264,0.09,1,147335,146900,435
4024061,8.87424,5.96416,437,32120,0.138653,0.33,1,147337,146900,437
4026981,13.7748,13.9928,436,35040,0.163731,0.33,1,147352,146916,436
4029901,4.35497,2.79857,438,37960,0.168746,0.34,1,147354,146916,438
4032821,12.071,11.7597,438,40880,0.169749,0.34,1,147368,146930,438
4035741,4.0142,2.35194,440,43800,0.16995,0.13,1,147370,146930,440
4038661,288.803,298.87,427,46720,0.23399,0.13,1,147730,147303,427
4041581,59.3606,59.7741,429,49640,0.246798,0.09,1,147732,147303,429
4044501,13.4721,13.5548,429,52560,0.24936,0.09,1,147734,147305,429
4047421,4.29442,2.71096,431,54020,0.249872,0.14,1,147736,147305,431
4050341,21.6589,24.5422,427,55480,0.257974,0.14,1,147762,147335,427
4053261,5.93178,4.90844,429,56940,0.227595,0.14,1,147764,147335,429
4056181,2.78636,2.58169,429,58400,0.189519,0.14,1,147766,147337,429
4059101,2.15727,0.516337,431,59860,0.149904,0.17,1,147768,147337,431
4062021,8.43145,12.1033,426,61320,0.181981,0.17,1,147778,147352,426
4064941,3.28629,2.42065,428,62780,0.204396,0.17,1,147780,147352,428
4067861,2.25726,2.08413,428,64240,0.240879,0.17,1,147782,147354,428
4070781,2.05145,0.416826,430,65700,0.216176,0.17,1,147784,147354,430
4073701,10.0103,11.2834,428,67160,0.275235,0.17,1,147796,147368,428
4076621,3.60206,2.25667,430,68620,0.319047,0.17,1,147798,147368,430
4079541,2.32041,2.05133,430,70080,0.295809,0.17,1,147800,147370,430
4082461,2.06408,0.410267,432,71540,0.291162,0.25,1,147802,147370,432
4085381,288.413,288.082,432,73000,0.290232,0.25,1,148162,147730,432
4088301,59.2826,57.6164,434,74460,0.322046,0.25,1,148164,147730,434
4091221,13.4565,13.1233,434,75920,0.296409,0.25,1,148166,147732,434
4094141,4.2913,2.62466,436,77380,0.291282,0.25,1,148168,147732,436
4097061,2.45826,2.12493,436,78840,0.290256,0.25,1,148170,147734,436
4099981,2.09165,0.424986,438,78840,0.290051,0.25,1,148172,147734,438
4102901,2.01833,1.685,438,78840,0.30601,0.26,1,148174,147736,438
4105821,13.2037,21.137,428,80300,0.405202,0.26,1,148190,147762,428
4108741,4.24073,4.2274,430,80300,0.39304,0.22,1,148192,147762,430
4111661,2.44815,2.44548,430,80300,0.390608,0.18,1,148194,147764,430
4114581,2.08963,2.0891,430,80300,0.358122,0.18,1,148196,147766,430
4117501,2.01793,0.417819,432,80300,0.351624,0.14,1,148198,147766,432
4120421,2.00359,1.68356,432,80300,0.350325,0.19,1,148200,147768,432
4123341,8.40072,8.33671,432,80300,0.350065,0.19,1,148210,147778,432
4126261,3.28014,1.66734,434,80300,0.382013,0.21,1,148212,147778,434
4129181,2.25603,1.93347,434,80300,0.388403,0.25,1,148214,147780,434
4132101,2.05121,1.98669,434,80300,0.35768,0.25,1,148216,147782,434
4135021,2.01024,0.397339,436,81760,0.351536,0.21,1,148218,147782,436
4137941,2.00205,1.67947,436,81760,0.350307,0.29,1,148220,147784,436
4140861,10.0004,9.93589,436,81760,0.398061,0.29,1,148232,147796,436
4143781,3.60008,1.98718,438,81760,0.423612,0.33,1,148234,147796,438
4146701,2.32002,1.99744,438,81760,0.396722,0.29,1,148236,147798,438
4149621,2.864,1.99949,439,81760,0.407344,0.29,1,148239,147800,439
4152541,2.1728,0.399897,441,81760,0.425469,0.29,1,148241,147800,441
4155461,2.03456,1.67998,441,81760,0.429094,0.29,1,148243,147802,441
4158381,284.407,288.336,436,81760,0.477819,0.29,1,148598,148162,436
4161301,58.4814,57.6672,438,81760,0.519564,0.33,1,148600,148162,438
4164221,13.2963,13.1334,438,83220,0.495913,0.29,1,148602,148164,438
4167141,4.25925,4.22669,438,83220,0.523183,0.29,1,148604,148166,438
4170061,2.45185,0.845337,440,83220,0.528637,0.29,1,148606,148166,440
4172981,2.09037,1.76907,440,83220,0.497727,0.29,1,148608,148168,440
4175901,2.01807,1.95381,440,83220,0.491545,0.29,1,148610,148170,440
4178821,2.00361,1.99076,440,83220,0.506309,0.31,1,148612,148172,440
4181741,2.00072,1.99815,440,83220,0.509262,0.31,1,148614,148174,440
4184661,11.6001,0.39963,454,83220,0.509852,0.43,1,148628,148174,454
4187581,3.92003,12.8799,440,83220,0.50997,0.39,1,148630,148190,440
4190501,2.38401,4.17599,440,83220,0.509994,0.39,1,148632,148192,440
4193421,2.0768,2.4352,440,84680,0.509999,0.35,1,148634,148194,440
4196341,2.01536,2.08704,440,84680,0.51,0.35,1,148636,148196,440
4199261,2.00307,2.01741,440,84680,0.51,0.35,1,148638,148198,440
4202181,8.40061,2.00348,448,84680,0.526,0.35,1,148648,148200,448
4205101,3.28012,8.4007,440,84680,0.5292,0.39,1,148650,148210,440
4208021,2.25602,3.28014,440,84680,0.52984,0.39,1,148652,148212,440
4210941,2.0512,2.25603,440,84680,0.529968,0.35,1,148654,148214,440
4213861,2.01024,2.05121,440,84680,0.529994,0.35,1,148656,148216,440
4216781,2.00205,2.01024,440,84680,0.529999,0.35,1,148658,148218,440
4219701,2.00041,2.00205,440,84680,0.53,0.41,1,148660,148220,440
4222621,11.6001,10.0004,442,86140,0.562,0.43,1,148674,148232,442
4225541,3.92002,3.60008,442,86140,0.5684,0.39,1,148676,148234,442
4228461,2.384,2.32002,442,86140,0.56968,0.41,1,148678,148236,442
4231381,2.0768,2.864,441,86140,0.569936,0.43,1,148680,148239,441
4234301,2.01536,2.1728,441,86140,0.569987,0.43,1,148682,148241,441
4237221,2.00307,2.03456,441,86140,0.569997,0.49,1,148684,148243,441
4240141,288.401,284.407,446,86140,0.682,0.53,1,149044,148598,446
4243061,59.2801,58.4814,446,86140,0.7364,0.53,1,149046,148600,446
4245981,13.456,11.6963,448,86140,0.71528,0.49,1,149048,148600,448
4248901,4.2912,3.93925,448,86140,0.711056,0.53,1,149050,148602,448
4251821,2.45824,2.38785,448,87600,0.742211,0.53,1,149052,148604,448
4254741,2.09165,2.07757,448,87600,0.716442,0.49,1,149054,148606,448
4257661,2.01833,2.01551,448,87600,0.711288,0.49,1,149056,148608,448
4260581,2.00367,2.0031,448,87600,0.710258,0.51,1,149058,148610,448
4263501,2.00073,2.00062,448,87600,0.710051,0.51,1,149060,148612,448
4266421,11.6001,2.00012,460,87600,0.74201,0.51,1,149074,148614,460
4269341,3.92003,11.6,448,87600,0.748402,0.51,1,149076,148628,448
4272261,2.38401,3.92,448,87600,0.74968,0.51,1,149078,148630,448
4275181,2.0768,2.384,448,87600,0.749936,0.51,1,149080,148632,448
4278101,2.01536,2.0768,448,87600,0.749987,0.51,1,149082,148634,448
4281021,2.00307,2.01536,448,89060,0.749997,0.51,1,149084,148636,448
4283941,2.00061,2.00307,448,89060,0.749999,0.53,1,149086,148638,448
4286861,8.40012,8.40061,448,89060,0.766,0.53,2,149096,148648,448
4289781,3.28002,3.28012,448,89060,0.7692,0.53,2,149098,148650,448
4292701,2.256,2.25602,448,89060,0.80184,0.53,2,149100,148652,448
4295621,2.0512,2.0512,448,89060,0.776368,0.53,2,149102,148654,448
4298541,2.81024,2.01024,449,89060,0.787274,0.53,2,149105,148656,449
4301461,2.16205,2.00205,449,89060,0.789455,0.53,2,149107,148658,449
4304381,2.03241,2.00041,449,89060,0.789891,0.53,2,149109,148660,449
4307301,11.6065,0.400082,463,89060,0.773978,0.57,2,149123,148660,463
4310221,3.9213,11.28,451,90520,0.770796,0.57,2,149125,148674,451
4313141,2.38426,3.856,451,90520,0.770159,0.57,2,149127,148676,451
4316061,2.07685,2.3712,451,90520,0.770032,0.57,2,149129,148678,451
4318981,2.01537,2.07424,451,90520,0.770006,0.57,2,149131,148680,451
4321901,2.00307,2.01485,451,90520,0.770001,0.57,2,149133,148682,451
4323361,161.201,2.00297,650,90520,0.882,0.71,2,149334,148684,650
4916321,79,82,434,64240,0.45,0,1,153205,152771,434
4919241,31.8,33.2,433,64240,0.306,0.01,1,153225,152792,433
4922161,56.76,23.44,475,64240,0.2452,0.01,1,153288,152813,475
4925081,41.752,52.688,453,64240,0.18504,0.23,1,153326,152873,453
4928001,53.9504,34.5376,480,64240,0.205008,0.84,1,153383,152903,480
4930921,39.5901,33.3075,483,64240,0.193002,0.84,1,153419,152936,483
4933841,17.518,24.2615,473,65700,0.2706,0.9,1,153431,152958,473
4936761,17.1036,16.0523,476,65700,0.19012,1,1,153448,152972,476
4939681,13.8207,12.0105,478,65700,0.174024,1,1,153461,152983,478
4942601,12.3641,13.6021,476,65700,0.186805,1,1,153473,152997,476
4945521,9.67283,11.5204,474,65700,0.205361,0.73,1,153482,153008,474
4948441,41.1346,35.9041,481,65700,0.257072,0.73,1,153531,153050,481
4951361,9.82691,7.18082,483,65700,0.267414,0.73,1,153533,153050,483
4954281,3.56538,1.43616,485,67160,0.269483,0.73,1,153535,153050,485
4957201,2.31308,0.287233,487,67160,0.285897,0.73,1,153537,153050,487
4960121,2.06262,0.0574465,489,67160,0.289179,0.73,1,153539,153050,489
4963041,2.01252,0.0114893,491,67160,0.289836,0.73,1,153541,153050,491
4965961,2.0025,0.00229786,493,67160,0.289967,0.88,1,153543,153050,493
4968881,18.8005,42.4005,463,67160,0.337993,0.88,1,153566,153103,463
4971801,18.1601,8.48009,481,67160,0.347599,0.87,1,153584,153103,481
4974721,5.23202,12.896,469,67160,0.34952,0.91,1,153586,153117,469
4977641,7.4464,9.7792,468,67160,0.365904,0.45,1,153594,153126,468
4980561,37.4893,65.1558,434,67160,0.417181,0.27,1,153639,153205,434
4983481,21.8979,29.0312,432,67160,0.411436,0.23,1,153657,153225,432
4986401,52.3796,56.2062,429,67160,0.442287,0.17,1,153717,153288,429
4989321,42.4759,41.6412,431,68620,0.544457,0.21,1,153757,153326,431
4992241,54.8952,53.9283,432,68620,0.580891,0.19,1,153815,153383,432
4995161,40.579,39.5857,433,68620,0.684178,0.19,1,153852,153419,433
4998081,14.5158,7.91713,441,68620,0.672836,0.29,1,153860,153419,441
5001001,15.7032,11.1834,445,68620,0.654567,0.17,1,153876,153431,445
5003921,15.1406,15.8367,443,68620,0.666913,0.17,1,153891,153448,443
5006841,12.6281,13.5673,442,68620,0.669383,0.19,1,153903,153461,442
5009761,8.92563,12.3135,438,68620,0.685877,0.21,1,153911,153473,438
5012681,45.7851,9.66269,484,68620,0.769175,0.27,2,153966,153482,484
5015601,10.757,41.1325,437,68620,0.753835,0.27,2,153968,153531,437
5018521,3.7514,9.82651,437,68620,0.750767,0.27,2,153970,153533,437
5021441,2.35028,3.5653,437,70080,0.750153,0.29,2,153972,153535,437
5024361,2.07006,2.31306,437,70080,0.750031,0.29,2,153974,153537,437
5027281,2.01401,2.06261,437,70080,0.750006,0.29,2,153976,153539,437
5030201,2.0028,2.01252,437,70080,0.750001,0.29,2,153978,153541,437
5033121,2.00056,2.0025,437,70080,0.75,0.35,2,153980,153543,437
5036041,20.4001,18.8005,439,70080,0.75,0.35,2,154005,153566,439
5038961,19.28,18.1601,440,70080,0.766,0.35,2,154024,153584,440
5041881,5.456,5.23202,440,70080,0.7692,0.37,2,154026,153586,440
5044801,7.4912,7.4464,440,70080,0.78584,0.43,2,154034,153594,440
5047721,39.0982,37.4893,442,70080,0.805168,0.41,2,154081,153639,442
5050641,21.4196,21.8979,441,70080,0.809034,0.45,2,154098,153657,441
5053561,54.6839,52.3796,444,70080,0.809807,0.45,2,154161,153717,444
5056481,46.9368,10.4759,489,71540,0.841961,0.57,2,154206,153717,489
5059401,56.5874,34.0952,508,71540,0.896392,0.59,2,154265,153757,508
5374761,12,5,479,73000,0.82,1,2,156340,155861,479
5377681,15.2,10.6,483,73000,0.7,1,1,156356,155873,483
5380601,11.84,10.92,483,73000,0.692,1,1,156367,155884,483
5383521,13.568,12.584,484,73000,0.7064,1,1,156381,155897,484
5386441,13.9136,15.3168,482,73000,0.69328,1,1,156395,155913,482
5389361,11.5827,10.2634,484,73000,0.722656,1,1,156406,155922,484
5392281,10.3165,5.25267,490,73000,0.728531,1,1,156416,155926,490
5395201,10.0633,11.4505,487,73000,0.697706,1,1,156426,155939,487
5398121,8.41266,11.0901,484,73000,0.707541,1,1,156434,155950,484
5401041,8.08253,7.81802,485,73000,0.677508,1,1,156442,155957,485
5403961,8.81651,7.9636,486,73000,0.703502,1,1,156451,155965,486
5406881,12.1633,3.19272,497,73000,0.7087,1,1,156464,155967,497
5409801,8.83266,14.2385,488,73000,0.70974,1,1,156472,155984,488
5412721,46.5665,52.4477,482,73000,0.853948,1,2,156528,156046,482
5415641,39.7133,47.2895,474,73000,0.83479,1,2,156566,156092,474
5418561,26.3427,23.8579,479,73000,0.846958,0.98,2,156589,156110,479
5421481,39.6685,36.7716,482,73000,0.753392,1,2,156632,156150,482
5424401,47.1337,53.7543,473,73000,0.950678,0.98,2,156681,156208,473
5725161,22,43,488,59860,0.43,1,1,158574,158086,488
5728081,23.6,28.6,487,61320,0.462,0.92,1,158598,158111,487
5731001,22.32,28.92,480,62780,0.4684,0.9,1,158620,158140,480
5733921,23.664,16.984,490,64240,0.53368,0.89,1,158644,158154,490
5736841,15.9328,29.7968,471,65700,0.642736,0.79,1,158658,158187,471
5739761,17.5866,21.1594,470,67160,0.632547,0.71,1,158676,158206,470
5742681,18.7173,22.6319,466,67160,0.598509,0.59,1,158695,158229,466
5745601,17.3435,22.9264,460,67160,0.591702,0.51,1,158712,158252,460
5748521,12.2687,21.3853,450,67160,0.55834,0.46,1,158723,158273,450
5751441,16.0537,14.6771,454,67160,0.575668,0.32,1,158740,158286,454
5754361,19.2107,22.9354,449,68620,0.771134,0.21,2,158760,158311,449
5757281,19.0421,23.7871,444,68620,0.818227,0.11,2,158779,158335,444
5770561,2,0,431,68620,0.61,0.27,1,158929,158498,431
5773481,2,0,433,70080,0.61,0.27,1,158931,158498,433
5776401,42.8,0,486,70080,0.578,0.27,1,158984,158498,486
5779321,10.16,43.2,434,70080,0.5876,0.27,1,158986,158552,434
5782241,24.432,8.64,462,70080,0.57352,0.43,1,159014,158552,462
5785161,6.4864,19.328,442,70080,0.570704,0.47,1,159016,158574,442
5788081,21.2973,23.0656,443,70080,0.586141,0.47,1,159041,158598,443
5791001,24.2595,4.61312,468,70080,0.605228,0.47,1,159066,158598,468
5793921,6.45189,18.5226,448,70080,0.609046,0.55,1,159068,158620,448
5796841,22.8904,22.9045,451,70080,0.561809,0.55,1,159095,158644,451
5799761,14.9781,4.5809,464,71540,0.472362,0.67,1,159108,158644,464
5802681,4.59562,12.1162,452,71540,0.454472,0.63,1,159110,158658,452
5805601,12.9191,16.8232,449,71540,0.466895,0.59,1,159125,158676,449
5808521,18.5838,18.5646,450,71540,0.469379,0.59,1,159145,158695,450
5811441,15.7168,17.3129,448,71540,0.501876,0.55,1,159160,158712,448
5814361,15.9434,12.2626,453,71540,0.524375,0.58,1,159176,158723,453
5817281,23.9887,16.0525,462,71540,0.576875,0.58,1,159202,158740,462
5820201,17.5977,3.2105,478,71540,0.603375,0.82,1,159218,158740,478
5823121,21.1195,16.6421,480,71540,0.608675,0.83,1,159240,158760,480
5826041,38.6239,18.5284,504,73000,0.673735,1,1,159283,158779,504
5828961,20.5248,31.7057,485,73000,0.686747,1,1,159299,158814,485
5831881,15.305,19.1411,483,73000,0.769349,0.89,2,159313,158830,483
5834801,53.461,18.2282,528,73000,0.84987,0.61,2,159376,158848,528
5837721,13.0922,66.8456,452,73000,0.849974,0.61,2,159379,158927,452
5840641,4.21844,14.9691,452,73000,0.849995,0.61,2,159381,158929,452
5843561,2.44369,4.59383,452,73000,0.897999,0.57,2,159383,158931,452
5846481,39.6887,43.3188,448,73000,0.9076,0.59,2,159432,158984,448
5849401,9.53775,10.2638,448,74460,0.90952,0.57,2,159434,158986,448
6119501,34,24,481,56940,0.37,0.91,1,161099,160618,481
6122421,26,24,481,58400,0.29,0.86,1,161123,160642,481
6125341,22,26.4,475,59860,0.282,0.61,1,161144,160669,475
6128261,39.6,50.08,463,61320,0.0564,0.49,1,161188,160725,463
6131181,33.52,30.816,469,61320,0.08328,0.39,1,161220,160751,469
6134101,23.504,34.1632,455,61320,0.312656,0.35,1,161241,160786,455
6137021,21.5008,26.8326,451,61320,0.342531,0.19,1,161262,160811,451
6139941,23.5002,28.5665,446,61320,0.380506,0.12,1,161286,160840,446
6142861,23.9,28.1133,442,61320,0.420101,0.07,1,161310,160868,442
6145781,21.58,27.2227,436,61320,0.44402,0.01,1,161331,160895,436
6148701,23.516,23.0445,438,61320,0.304804,0,1,161355,160917,438
6151621,15.1032,19.0089,433,61320,0.276961,0.03,1,161368,160935,433
6154541,33.4206,23.8018,446,61320,0.0953922,0.29,1,161406,160960,446
6157461,18.6841,19.1604,443,62780,0.0270784,0.15,1,161421,160978,443
6160381,16.5368,21.4321,437,62780,0.413416,0.09,1,161437,161000,437
6163301,16.1074,9.88641,446,62780,0.394683,0.21,1,161453,161007,446
6164081,38.4215,18.7773,469,62780,0.422937,0.57,1,161497,161028,469
6167001,21.2843,37.3555,444,62780,0.508587,0.57,1,161514,161070,444
6169921,5.85686,7.47109,446,62780,0.541717,0.57,1,161516,161070,446
6172841,14.7714,1.49422,463,62780,0.548343,0.37,1,161533,161070,463
6175761,4.55427,23.4988,436,62780,0.549669,0.37,1,161535,161099,436
6178681,15.3109,4.69977,454,62780,0.613934,0.27,1,161553,161099,454
6181601,4.66217,20.14,432,62780,0.626787,0.28,1,161555,161123,432
6184521,15.3324,20.828,429,62780,0.629357,0.28,1,161573,161144,429
6187441,38.2665,4.1656,473,62780,0.517871,0,1,161617,161144,473
6190361,47.6533,36.0331,479,62780,0.423574,0.09,1,161667,161188,479
6193281,20.7307,32.8066,461,64240,0.404715,0.37,1,161681,161220,461
6196201,21.7461,23.3613,462,64240,0.536943,0.35,1,161703,161241,462
6199121,21.9492,21.4723,463,64240,0.547389,0.39,1,161725,161262,463
6202041,27.5898,23.4945,468,64240,0.581478,0.43,1,161754,161286,468
6204961,19.918,23.8989,462,64240,0.604296,0.45,1,161772,161310,462
6207881,18.3836,21.5798,459,64240,0.672859,0.27,1,161790,161331,459
6210801,9.27672,23.516,442,64240,0.670572,0.27,1,161797,161355,442
6213721,25.8553,15.1032,459,64240,0.606114,0.05,1,161827,161368,459
6216641,6.77107,33.4206,423,64240,0.609223,0.01,1,161829,161406,423
6219561,32.5542,18.6841,447,64240,0.689845,0.51,1,161868,161421,447
6222481,16.1108,16.5368,443,64240,0.705969,0.39,1,161880,161437,443
6225401,8.82217,16.1074,434,64240,0.725194,0.43,1,161887,161453,434
6228321,59.3644,38.4215,462,65700,0.889039,0.53,2,161959,161497,462
6231241,13.4729,21.2843,447,65700,0.921808,0.55,2,161961,161514,447
6263361,22,22,449,65700,0.95,0.59,2,162174,161725,449
6447321,17,28,490,67160,0.83,1,2,163499,163009,490
6450241,26.6,31.2,487,67160,0.806,1,2,163528,163041,487
6453161,14.12,13.44,489,67160,0.8092,1,2,163539,163050,489
6456081,13.224,13.088,489,67160,0.80184,1,2,163552,163063,489
6459001,19.4448,35.4176,469,67160,0.736368,1,1,163573,163104,469
6461921,15.889,20.6835,467,67160,0.699274,1,1,163588,163121,467
6464841,35.1778,21.7367,485,67160,0.531855,1,1,163628,163143,485
6467761,31.8356,22.7473,493,67160,0.434371,1,1,163659,163166,493
6470681,19.1671,30.1495,477,67160,0.382874,1,1,163675,163198,477
6473601,16.6334,16.4299,480,67160,0.340575,1,1,163691,163211,480
6476521,16.1267,18.486,477,67160,0.300115,1,1,163707,163230,477
6479441,15.2253,10.8972,483,67160,0.276023,1,1,163722,163239,483
6482361,23.8451,18.1794,489,67160,0.671205,0.99,1,163748,163259,489
6485281,18.369,18.0359,488,67160,0.766241,1,2,163765,163277,488
6488201,14.0738,20.4072,480,67160,0.769248,1,2,163778,163298,480
6491121,56.4148,58.4814,479,67160,0.70585,0.91,1,163845,163366,479
6494041,20.083,20.4963,479,67160,0.75717,0.93,2,163856,163377,479
6496961,10.4166,12.0993,477,67160,0.735434,1,1,163864,163387,477
6499881,19.6833,19.2199,478,67160,0.715087,1,1,163886,163408,478
6502801,13.5367,14.244,477,67160,0.727017,1,1,163898,163421,477
6505721,16.3073,21.2488,471,67160,0.713403,0.93,1,163915,163444,471
6508641,16.8615,19.4498,469,67160,0.742681,0.93,1,163932,163463,469
6511561,16.9723,19.09,467,67160,0.812536,0.83,2,163949,163482,467
6514481,15.3945,17.418,465,67160,0.778507,0.8,2,163964,163499,465
6558281,65,67,459,67160,0.57,0.77,1,164304,163845,459
6561201,21,22.2,458,67160,0.506,0.73,1,164314,163856,458
6564121,9,10.84,456,67160,0.4612,0.71,1,164320,163864,456
6567041,19.4,19.768,456,67160,0.53224,0.73,1,164342,163886,456
6569961,13.48,13.5536,456,67160,0.562448,0.71,1,164354,163898,456
6572881,17.096,16.3107,457,67160,0.60049,0.75,1,164372,163915,457
6575801,17.0192,16.8621,457,67160,0.624098,0.83,1,164389,163932,457
6578721,20.2038,16.9724,461,67160,0.61282,0.77,1,164410,163949,461
6581641,15.2408,15.3945,460,67160,0.642564,1,1,164424,163964,460
6584561,25.4482,23.0789,463,67160,0.632513,1,1,164452,163989,463
6587481,17.0896,9.41578,472,67160,0.614503,1,1,164467,163995,472
6590401,15.4179,13.0832,473,67160,0.6269,1,1,164482,164009,473
6593321,35.8836,18.6166,494,67160,0.69338,0.95,1,164523,164029,494
6596241,19.9767,14.9233,496,67160,0.706676,1,1,164539,164043,496
6599161,21.5953,26.1847,489,67160,0.709335,1,1,164561,164072,489
6602081,13.9191,24.4369,477,67160,0.709867,1,1,164573,164096,477
6605001,12.3838,16.0874,475,67160,0.709973,1,1,164585,164110,475
6607921,12.0768,14.4175,473,67160,0.709995,1,1,164597,164124,473
6610841,16.0154,14.0835,476,67160,0.661999,1,1,164614,164138,476
6613761,13.6031,14.0167,475,67160,0.7004,0.95,1,164627,164152,475
6616681,40.3206,46.0033,468,67160,0.70808,0.89,1,164674,164206,468
6619601,17.6641,23.6007,462,67160,0.757616,0.87,2,164686,164224,462
6622521,15.5328,16.7201,462,67160,0.751523,0.57,2,164701,164239,462
6625441,42.3066,55.344,446,67160,0.782305,0.49,2,164750,164304,446
6628361,14.8613,19.0688,444,68620,0.756461,0.45,2,164758,164314,444
6631281,10.1723,8.61376,447,68620,0.783292,0.55,2,164767,164320,447
6634201,22.0345,19.3228,450,68620,0.820658,0.57,2,164792,164342,450
6637121,14.0069,13.4646,450,68620,0.796132,0.61,2,164804,164354,450
6640041,17.2014,17.0929,450,68620,0.839226,0.63,2,164822,164372,450
6642961,17.8403,17.0186,451,68620,0.847845,0.61,2,164840,164389,451
6645881,21.1681,20.2037,452,68620,0.833569,0.65,2,164862,164410,452
6648801,16.2336,15.2407,453,68620,0.846714,0.63,2,164877,164424,453
6651721,25.6467,25.4481,453,68620,0.881343,0.61,2,164905,164452,453
6654641,17.1293,17.0896,453,68620,0.872268,0.63,2,164920,164467,453
6657561,17.0259,15.4179,455,68620,0.886454,0.71,2,164937,164482,455
6926201,15,13,496,83220,0.81,1,2,166710,166214,496
6929121,12.6,15.4,492,83220,0.842,1,2,166722,166230,492
6932041,18.52,15.88,496,83220,0.9124,1,2,166742,166246,496
6934961,19.704,26.376,487,83220,0.93448,1,2,166762,166275,487
6937881,19.9408,18.0752,491,83220,0.938896,1,2,166782,166291,491
6940801,18.3882,22.015,486,84680,0.923779,1,2,166800,166314,486
6943721,17.2776,18.003,486,84680,0.896756,1,2,166817,166331,486
6946641,19.4555,15.6006,491,84680,0.843351,1,2,166837,166346,491
6949561,13.4911,13.5201,490,84680,0.81667,1,2,166849,166359,490
6952481,10.6982,2.70402,500,86140,0.763334,1,2,166859,166359,500
6955401,20.5396,24.5408,493,86140,0.656667,1,1,166882,166389,493
6958321,24.1079,30.5082,486,86140,0.571333,1,1,166907,166421,486
6961241,24.8216,18.1016,496,86140,0.538267,1,1,166932,166436,496
7231341,95,107,476,77380,0.23,0.88,1,168799,168323,476
7276601,59,69.4,466,77380,0.486,0.67,1,168849,168383,466
7282441,123.8,137.08,452,55480,0.1532,0.6,1,168989,168537,452
7297681,43.96,48.216,450,78840,0.50264,0.57,1,169013,168563,450
7300601,23.192,16.8432,459,80300,0.540528,0.59,1,169031,168572,459
7303521,15.8384,17.7686,455,80300,0.468106,0.53,1,169045,168590,455
7306441,15.1677,17.1537,453,81760,0.765621,0.49,2,169060,168607,453
7309361,14.2335,16.2307,451,81760,0.777124,0.45,2,169074,168623,451
7312281,58.8467,23.2461,496,81760,0.531425,0.25,1,169144,168648,496
7315201,13.3693,49.4492,442,81760,0.466285,0.25,1,169146,168704,442
7318121,4.27387,9.88985,444,81760,0.437257,0.25,1,169148,168704,444
7321041,2.45477,1.97797,446,83220,0.431451,0.25,1,169150,168704,446
7323961,2.09095,0.395594,448,83220,0.39829,0.25,1,169152,168704,448
7326881,2.01819,0.0791187,450,83220,0.391658,0.25,1,169154,168704,450
7329801,2.00364,0.0158237,452,83220,0.390332,0.23,1,169156,168704,452
7332721,122.801,76.0032,510,84680,0.166066,0.55,1,169309,168799,510
7335641,26.1601,55.2006,462,84680,0.105213,0.55,1,169311,168849,462
7338561,6.83203,11.0401,464,84680,0.0770427,0.55,1,169313,168849,464
7341481,2.96641,2.20803,466,84680,0.0554085,0.55,1,169315,168849,466
7344401,76.5933,0.441605,561,86140,0.0510817,0.07,1,169410,168849,561
7347321,16.9187,112.088,423,86140,0.0502163,0.07,1,169412,168989,423
7350241,4.98373,22.4177,425,86140,0.0180433,0.07,1,169414,168989,425
7353161,2.59675,4.48353,427,86140,0.00360865,0.07,1,169416,168989,427
7356081,2.11935,0.896706,429,87600,0.0247217,0.07,1,169418,168989,429
7359001,2.02387,0.179341,431,87600,0.0289443,0.07,1,169420,168989,431
7361921,2.00477,0.0358683,433,87600,0.0297889,0.07,1,169422,168989,433
7364841,2.00095,0.00717365,435,87600,0.0299578,0.07,1,169424,168989,435
7367761,2.00019,0.00143473,437,87600,0.0299916,0.07,1,169426,168989,437
7370681,2.00004,0.000286946,439,89060,0.0459983,0.59,1,169428,168989,439
7373601,27.6,19.2001,449,89060,0.00919966,0.59,1,169462,169013,449
7376521,7.12,3.84001,451,89060,0.00983993,0.59,1,169464,169013,451
7379441,9.424,0.768002,461,89060,0.025968,0.55,1,169474,169013,461
7382361,16.2848,14.5536,461,89060,0.0451936,0.45,1,169492,169031,461
7385281,4.85696,14.1107,449,89060,0.0490387,0.84,1,169494,169045,449
7388201,20.9714,14.8221,459,90520,0.129808,0.78,1,169519,169060,459
7391121,13.7943,14.1644,457,90520,0.129962,0.47,1,169531,169074,457
7394041,45.9589,58.8329,441,90520,0.113992,0.45,1,169585,169144,441
7396961,10.7918,13.3666,441,90520,0.110798,0.43,1,169587,169146,441
7399881,3.75835,4.27332,441,90520,0.11016,0.43,1,169589,169148,441
7402801,2.35167,0.854663,443,90520,0.110032,0.43,1,169591,169148,443
7405721,2.07033,1.77093,443,91980,0.0780064,0.39,1,169593,169150,443
7408641,2.01407,1.95419,443,91980,0.0716013,0.39,1,169595,169152,443
7411561,2.00281,1.99084,443,91980,0.0703203,0.39,1,169597,169154,443
7414481,2.00056,1.99817,443,91980,0.070064,0.11,1,169599,169156,443
7417401,106,122.8,422,91980,0.0700128,0.09,1,169731,169309,422
7420321,22.8,26.1599,422,93440,0.0700026,0.07,1,169733,169311,422
7423241,6.16,6.83198,422,93440,0.0700005,0.05,1,169735,169313,422
7426161,2.832,2.9664,422,93440,0.0700001,0.05,1,169737,169315,422
7429081,76.5664,0.593279,517,93440,0.022,0.05,1,169832,169315,517
7432001,16.9133,76.1187,424,93440,0.0444,0.05,1,169834,169410,424
7434921,4.98266,16.8237,424,94900,0.01688,0.01,1,169836,169412,424
7437841,2.59653,4.96475,424,94900,0.027376,0,1,169838,169414,424
7440761,2.11931,2.59295,424,94900,0.0294752,0.03,1,169840,169416,424
7443681,2.02386,2.11859,424,94900,0.029895,0.03,1,169842,169418,424
7446601,2.00477,2.02372,424,94900,0.029979,0.03,1,169844,169420,424
7449521,2.00095,2.00474,424,94900,0.0459958,0.03,1,169846,169422,424
7452441,2.00019,2.00095,424,96360,0.0491992,0.03,1,169848,169424,424
7455361,2.00004,2.00019,424,96360,0.0498398,0.03,1,169850,169426,424
7458281,2.00001,0.400038,426,96360,0.049968,0.05,1,169852,169426,426
7461201,26,1.68001,456,96360,0.0819936,0,1,169884,169428,456
7464121,6.8,27.536,424,96360,0.120399,0.01,1,169886,169462,424
7467041,10.16,7.1072,433,96360,0.11208,0.03,1,169897,169464,433
7469961,18.032,9.42144,443,96360,0.0464159,0.05,1,169917,169474,443
7472881,5.2064,16.2843,427,96360,0.0332832,0.05,1,169919,169492,427
7475801,2.64128,4.85686,427,97820,0.0466566,0.15,1,169921,169494,427
7478721,19.7283,20.9714,426,97820,0.113331,0.13,1,169945,169519,426
7481641,11.9457,13.7943,424,97820,0.142666,0.11,1,169955,169531,424
7484561,46.3891,45.9589,425,97820,0.0685333,0.11,1,170010,169585,425
7487481,10.8778,10.7918,425,97820,0.0537066,0.11,1,170012,169587,425
7490401,3.77556,3.75835,425,97820,0.0507413,0.11,1,170014,169589,425
7493321,2.35511,2.35167,425,97820,0.0501483,0.11,1,170016,169591,425
7496241,2.07102,0.470334,427,97820,0.0500297,0.07,1,170018,169591,427
7499161,2.0142,1.69407,427,99280,0.0500059,0.07,1,170020,169593,427
7502081,2.00284,1.93881,427,99280,0.0500012,0.07,1,170022,169595,427
7505001,2.00057,1.98776,427,99280,0.0500002,0.07,1,170024,169597,427
7507921,103.6,1.99755,554,99280,0.066,0.07,1,170153,169599,554
7510841,22.32,106,424,99280,0.0692,0.07,1,170155,169731,424
7513761,6.064,22.7999,424,99280,0.06984,0.07,1,170157,169733,424
7516681,2.8128,6.15998,424,99280,0.069968,0.07,1,170159,169735,424
7519601,2.16256,2.832,424,99280,0.0699936,0.01,1,170161,169737,424
7522521,75.6325,76.5664,423,99280,0.0539987,0.05,1,170255,169832,423
7525441,16.7265,16.9133,423,100740,0.0507997,0.05,1,170257,169834,423
7528361,4.9453,3.38266,425,100740,0.0501599,0.01,1,170259,169834,425
7531281,2.58906,2.27653,425,100740,0.050032,0.03,1,170261,169836,425
7534201,2.11781,2.05531,425,100740,0.0500064,0.03,1,170263,169838,425
7537121,2.02356,2.01106,425,100740,0.0180013,0.03,1,170265,169840,425
7540041,2.00471,2.00221,425,100740,0.0276003,0.03,1,170267,169842,425
7542961,2.00094,2.00044,425,100740,0.0295201,0.05,1,170269,169844,425
7545881,2.00019,2.00009,425,100740,0.029904,0.05,1,170271,169846,425
7548801,3.60004,2.00002,427,102200,0.0299808,0.05,1,170275,169848,427
7551721,2.32001,2,427,102200,0.0299962,0.05,1,170277,169850,427
7554641,2.064,2,427,102200,0.0299992,0.09,1,170279,169852,427
7557561,25.2128,26,426,102200,0.142,0.13,1,170310,169884,426
7560481,6.64256,6.8,426,102200,0.1644,0.11,1,170312,169886,426
7563401,7.72851,10.16,423,102200,0.13688,0.03,1,170320,169897,423
7566321,18.3457,18.032,424,102200,0.147376,0.03,1,170341,169917,424
7569241,5.26914,5.2064,424,102200,0.149475,0.03,1,170343,169919,424
7572161,2.65383,1.04128,426,102200,0.149895,0.05,1,170345,169919,426
7575081,22.9308,1.80826,452,102200,0.117979,0.13,1,170373,169921,452
7578001,12.5862,19.5617,438,102200,0.143596,0.15,1,170383,169945,438
7580921,42.5172,11.9123,478,102200,0.164719,0.05,1,170433,169955,478
7583841,10.1034,46.3825,425,103660,0.168944,0.05,1,170435,170010,425
7586761,3.62069,10.8765,425,103660,0.169789,0.05,1,170437,170012,425
7589681,2.32414,3.7753,425,103660,0.169958,0.05,1,170439,170014,425
7592601,2.06483,2.35506,425,103660,0.169992,0.05,1,170441,170016,425
7595521,2.01297,2.07101,425,103660,0.169998,0.05,1,170443,170018,425
7598441,2.00259,2.0142,425,103660,0.186,0.05,1,170445,170020,425
7601361,2.00052,2.00284,425,103660,0.1892,0.05,1,170447,170022,425
7604281,2.0001,2.00057,425,103660,0.18984,0.07,1,170449,170024,425
7607201,103.6,103.6,425,103660,0.205968,0.07,1,170578,170153,425
7610121,22.32,22.32,425,103660,0.209194,0.07,1,170580,170155,425
7613041,6.064,6.064,425,103660,0.209839,0.07,1,170582,170157,425
7615961,2.8128,2.8128,425,105120,0.209968,0.07,1,170584,170159,425
7618881,2.16256,2.16256,425,105120,0.209994,0.05,1,170586,170161,425
7621801,73.2325,75.6325,422,105120,0.0499987,0.05,1,170677,170255,422
7624721,16.2465,15.1265,424,105120,0.0499997,0.05,1,170679,170255,424
7627641,4.8493,4.6253,424,105120,0.0499999,0.05,1,170681,170257,424
7630561,2.56986,2.52506,424,105120,0.05,0.05,1,170683,170259,424
7633481,2.11397,2.10501,424,105120,0.05,0.05,1,170685,170261,424
7636401,2.02279,2.021,424,105120,0.018,0.01,1,170687,170263,424
7639321,2.00456,2.0042,424,105120,0.0116,0.03,1,170689,170265,424
7642241,2.00091,2.00084,424,105120,0.01032,0.03,1,170691,170267,424
7645161,2.00018,2.00017,424,105120,0.010064,0.03,1,170693,170269,424
7648081,2.00004,2.00003,424,105120,0.0100128,0.03,1,170695,170271,424
7651001,5.20001,3.60001,426,105120,0.0100026,0.03,1,170701,170275,426
7653921,2.64,2.32,426,105120,0.0100005,0.03,1,170703,170277,426
7656841,2.128,2.064,426,105120,0.0100001,0.17,1,170705,170279,426
7659761,26.8256,25.2128,428,105120,0.09,0.17,1,170738,170310,428
7662681,6.96512,6.64256,428,106580,0.106,0.13,1,170740,170312,428
7665601,7.79302,7.72851,428,106580,0.0772,0.15,1,170748,170320,428
7668521,17.5586,18.3457,427,106580,0.08744,0.15,1,170768,170341,427
7671441,5.11172,5.26914,427,106580,0.121488,0.15,1,170770,170343,427
7674361,2.62234,2.65383,427,106580,0.128298,0.11,1,170772,170345,427
7677281,24.5245,22.9308,429,106580,0.12966,0.15,1,170802,170373,429
7680201,12.9049,12.5862,429,106580,0.0979319,0.17,1,170812,170383,429
7683121,43.381,42.5172,430,106580,0.123586,0.17,1,170863,170433,430
7686041,10.2762,8.50345,432,106580,0.160717,0.17,1,170865,170433,432
7688961,3.65524,3.30069,432,106580,0.168143,0.17,1,170867,170435,432
7691881,2.33105,2.26014,432,106580,0.169629,0.17,1,170869,170437,432
7694801,2.06621,2.05203,432,106580,0.137926,0.17,1,170871,170439,432
7697721,2.01324,2.01041,432,106580,0.131585,0.17,1,170873,170441,432
7700641,2.00265,2.00208,432,106580,0.130317,0.19,1,170875,170443,432
7703561,2.00053,2.00042,432,108040,0.130063,0.19,1,170877,170445,432
7706481,2.00011,2.00008,432,108040,0.130013,0.19,1,170879,170447,432
7709401,104.4,2.00002,560,108040,0.194003,0.21,1,171009,170449,560
7712321,22.48,103.6,433,108040,0.206801,0.21,1,171011,170578,433
7715241,6.096,22.32,433,108040,0.20936,0.21,1,171013,170580,433
7718161,2.8192,6.064,433,108040,0.209872,0.21,1,171015,170582,433
7721081,2.16384,2.8128,433,108040,0.209974,0.21,1,171017,170584,433
7724001,2.03277,2.16256,433,108040,0.209995,0.01,1,171019,170586,433
7726921,64.4066,73.2325,422,108040,0.177999,0.05,1,171099,170677,422
7729841,14.4813,16.2465,422,108040,0.1716,0.05,1,171101,170679,422
7732761,4.49626,4.8493,422,108040,0.20232,0.05,1,171103,170681,422
7735681,2.49925,2.56986,422,108040,0.208464,0.05,1,171105,170683,422
7738601,2.09985,2.11397,422,108040,0.177693,0.01,1,171107,170685,422
7741521,2.01997,2.02279,422,108040,0.171539,0.01,1,171109,170687,422
7744441,2.00399,2.00456,422,108040,0.170308,0.01,1,171111,170689,422
7747361,2.0008,2.00091,422,108040,0.170062,0.01,1,171113,170691,422
7750281,2.00016,2.00018,422,108040,0.170012,0.01,1,171115,170693,422
7753201,2.00003,2.00004,422,108040,0.170002,0.01,1,171117,170695,422
7756121,8.40001,5.20001,426,108040,0.17,0.01,1,171127,170701,426
7759041,3.28,2.64,426,109500,0.17,0.01,1,171129,170703,426
7761961,2.256,2.128,426,109500,0.202,0.11,1,171131,170705,426
7764881,26.0512,26.8256,425,109500,0.3524,0.11,1,171163,170738,425
7767801,6.81024,5.36512,427,109500,0.35048,0.11,1,171165,170738,427
7770721,7.76205,2.67302,433,109500,0.350096,0.07,1,171173,170740,433
7773641,17.5524,6.9346,445,109500,0.350019,0.09,1,171193,170748,445
7776561,5.11048,17.3869,427,109500,0.366004,0.13,1,171195,170768,427
7779481,2.6221,5.07738,427,109500,0.369201,0.13,1,171197,170770,427
7782401,24.5244,2.61548,455,109500,0.36984,0.13,1,171227,170772,455
7785321,12.9049,24.5231,435,109500,0.369968,0.09,1,171237,170802,435
7788241,44.981,12.9046,478,109500,0.369994,0.13,1,171290,170812,478
7791161,10.5962,43.3809,429,109500,0.369999,0.17,1,171292,170863,429
7794081,3.71924,10.2762,429,109500,0.37,0.17,1,171294,170865,429
7797001,2.34385,3.65524,429,109500,0.37,0.17,1,171296,170867,429
7799921,2.06877,2.33105,429,109500,0.37,0.13,1,171298,170869,429
7802841,2.01375,2.06621,429,109500,0.37,0.13,1,171300,170871,429
7805761,2.00275,2.01324,429,109500,0.37,0.13,1,171302,170873,429
7808681,2.00055,2.00265,429,109500,0.37,0.13,1,171304,170875,429
7811601,2.00011,2.00053,429,109500,0.37,0.13,1,171306,170877,429
7814521,2.00002,2.00011,429,109500,0.37,0.21,1,171308,170879,429
7817441,106.8,104.4,432,109500,0.386,0.21,1,171441,171009,432
7820361,22.96,22.48,432,109500,0.3892,0.21,1,171443,171011,432
7823281,6.192,6.096,432,109500,0.38984,0.21,1,171445,171013,432
7826201,2.8384,2.8192,432,109500,0.421968,0.21,1,171447,171015,432
7829121,2.16768,2.16384,432,109500,0.428394,0.21,1,171449,171017,432
7832041,2.03354,2.03277,432,109500,0.397679,0.17,1,171451,171019,432
7834961,62.8067,64.4066,430,109500,0.551536,0.17,1,171529,171099,430
7837881,14.1613,14.4813,430,109500,0.582307,0.21,1,171531,171101,430
7840801,4.43227,4.49626,430,109500,0.588461,0.21,1,171533,171103,430
7843721,2.48645,2.49925,430,109500,0.589692,0.17,1,171535,171105,430
7846641,2.09729,2.09985,430,109500,0.589938,0.17,1,171537,171107,430
7849561,2.01946,2.01997,430,109500,0.589988,0.17,1,171539,171109,430
7852481,2.00389,2.00399,430,109500,0.589998,0.17,1,171541,171111,430
7855401,2.00078,2.0008,430,109500,0.589999,0.17,1,171543,171113,430
7858321,2.00016,2.00016,430,109500,0.59,0.17,1,171545,171115,430
7861241,2.00003,2.00003,430,109500,0.59,0.17,1,171547,171117,430
7864161,14.8,8.40001,438,109500,0.686,0.17,1,171565,171127,438
7867081,4.56,1.68,440,110960,0.7372,0.17,1,171567,171127,440
7870001,2.512,1.936,440,110960,0.74744,0.21,1,171569,171129,440
7872921,26.1024,1.9872,470,110960,0.781488,0.39,2,171601,171131,470
7875841,6.82048,25.9974,440,110960,0.788298,0.35,2,171603,171163,440
7878761,7.7641,6.79949,446,110960,0.78966,0.35,2,171611,171165,446
7881681,18.3528,7.7599,459,110960,0.773932,0.35,2,171632,171173,459
7884601,5.27056,17.552,441,110960,0.770786,0.37,2,171634,171193,441
7887521,2.65411,5.1104,441,110960,0.770157,0.37,2,171636,171195,441
7890441,24.5308,2.62208,469,110960,0.770032,0.37,2,171666,171197,469
7893361,12.9062,24.5244,449,110960,0.770006,0.37,2,171676,171227,449
7896281,44.9812,12.9049,492,110960,0.802001,0.37,2,171729,171237,492
7899201,10.5962,44.981,441,110960,0.8084,0.37,2,171731,171290,441
7902121,3.71925,10.5962,441,110960,0.80968,0.37,2,171733,171292,441
7905041,2.34385,3.71924,441,110960,0.809936,0.37,2,171735,171294,441
7907961,2.06877,2.34385,441,110960,0.809987,0.37,2,171737,171296,441
7910881,2.01375,2.06877,441,110960,0.809997,0.37,2,171739,171298,441
7913801,2.00275,2.01375,441,110960,0.81,0.37,2,171741,171300,441
7916721,2.00055,2.00275,441,110960,0.81,0.37,2,171743,171302,441
7919641,2.00011,2.00055,441,110960,0.81,0.37,2,171745,171304,441
7922561,2.00002,2.00011,441,110960,0.81,0.37,2,171747,171306,441
7925481,107.6,2.00002,573,110960,0.842,0.39,2,171881,171308,573
7928401,23.12,106.8,442,110960,0.8484,0.39,2,171883,171441,442
7931321,6.224,22.96,442,110960,0.84968,0.39,2,171885,171443,442
7934241,2.8448,6.192,442,110960,0.849936,0.43,2,171887,171445,442
7937161,2.16896,2.8384,442,110960,0.849987,0.43,2,171889,171447,442
7940081,2.03379,2.16768,442,110960,0.849997,0.39,2,171891,171449,442
8600201,106,93,438,50923,0.57,0.15,1,175882,175444,438
8611881,16,17,434,44251,0.64,0.44,1,175966,175532,434
8614801,46.4,21.8,465,42583,0.408,0.67,1,176020,175555,465
8617721,18.08,24.36,451,40880,0.3616,0.67,1,176031,175580,451
8620641,6.816,4.872,455,40880,0.32032,0.61,1,176035,175580,455
8623561,11.7632,12.9744,453,40880,0.328064,0.53,1,176048,175595,453
8626481,12.7526,16.9949,448,40880,0.393613,0.48,1,176061,175613,448
8629401,15.3505,15.399,449,40880,0.406723,0.39,1,176077,175628,449
8632321,43.0701,23.0798,474,40880,0.425344,1,1,176127,175653,474
8635241,17.414,8.61596,480,40880,0.429069,1,1,176138,175658,480
8638161,12.2828,1.72319,491,40880,0.429814,1,1,176149,175658,491
8641081,8.85656,0.344638,499,40880,0.437963,1,1,176157,175658,499
8644001,3.37131,6.46893,493,40880,0.407593,1,1,176159,175666,493
8646921,44.6743,12.4938,534,42340,0.505519,0.66,1,176214,175680,534
8649841,119.335,79.2988,576,43800,0.749104,1,1,176352,175776,576
8787081,17,15,487,49640,0.93,1,2,177631,177144,487
8790001,105.8,121.4,467,49640,0.402,1,1,177759,177292,467
8792921,72.36,57.08,490,49640,0.2484,1,1,177823,177333,490
8795841,36.872,26.616,499,49640,0.18568,1,1,177851,177352,499
8798761,21.7744,19.7232,499,49640,0.157136,1,1,177869,177370,499
8801681,20.3549,15.9446,504,49640,0.103427,1,1,177889,177385,504
8804601,20.071,35.9889,483,49640,0.0926854,1,1,177909,177426,483
8807521,24.0142,21.5978,490,49640,0.490537,1,1,177934,177444,490
8810441,19.2028,18.7196,490,49640,0.570107,1,1,177952,177462,490
8813361,20.6406,18.1439,493,49640,0.490022,1,1,177973,177480,493
8816281,18.5281,14.0288,498,49640,0.450004,1,1,177991,177493,498
8819201,20.5056,32.4058,482,49640,0.370001,1,1,178012,177530,482
8822121,13.7011,20.0812,477,49640,0.322,1,1,178024,177547,477
8825041,20.3402,16.0162,484,49640,0.2564,1,1,178046,177562,484
8827961,9.66804,14.4032,477,49640,0.16328,0.95,1,178053,177576,477
8830881,12.3336,13.2806,477,49640,0.216656,0.9,1,178066,177589,477
8833801,16.8667,22.6561,470,49640,0.0993312,0.93,1,178084,177614,470
8836721,13.7733,18.1312,466,49640,0.0598662,0.27,1,178097,177631,466
8839641,80.3547,106.026,435,49640,0.0359732,0.21,1,178194,177759,435
8842561,63.2709,72.4052,430,49640,0.00719465,0.17,1,178253,177823,430
8845481,35.0542,36.881,430,49640,0.265439,0.15,1,178281,177851,430
8848401,18.2108,21.7762,426,49640,0.285088,0.09,1,178295,177869,426
8851321,18.8422,20.3552,425,49640,0.641018,0.09,1,178314,177889,425
8854241,19.7684,20.071,425,49640,0.696203,0.59,1,178334,177909,425
8857161,42.3537,24.0142,448,49640,0.595241,0.59,1,178382,177934,448
8860081,21.2707,19.2028,446,49640,0.559048,0.47,1,178398,177952,446
8863001,19.4541,20.6406,444,49640,0.53581,0.44,1,178417,177973,444
8865921,14.2908,18.5281,439,49640,0.547162,0.35,1,178430,177991,439
8868841,18.0582,20.5056,437,49640,0.549432,0.31,1,178449,178012,437
8871761,10.8116,13.7011,434,49640,0.565886,0.24,1,178458,178024,434
8874681,14.1623,20.3402,427,49640,0.569177,0.14,1,178473,178046,427
8877601,9.23247,9.66804,428,49640,0.569835,0.23,1,178481,178053,428
8880521,12.2465,12.3336,428,49640,0.521967,0.07,1,178494,178066,428
8883441,13.6493,16.8667,424,49640,0.512393,0.05,1,178508,178084,424
8886361,11.5299,13.7733,422,49640,0.494479,0.03,1,178519,178097,422
8889281,79.906,80.3547,422,49640,0.522896,0,1,178616,178194,422
8892201,63.1812,63.2709,422,49640,0.104579,0.33,1,178675,178253,422
8895121,46.2362,35.0542,436,49640,0.0769158,0.29,1,178717,178281,436
8898041,38.8472,18.2108,459,49640,0.119383,0.73,1,178754,178295,459
8900961,18.9694,18.8422,454,49640,0.143877,0.71,1,178768,178314,454
8903881,17.3939,19.7684,451,49640,0.164775,0.57,1,178785,178334,451
8906801,41.8788,42.3537,451,49640,0.184955,0.55,1,178833,178382,451
8909721,19.5758,21.2707,449,49640,0.204991,0.53,1,178847,178398,449
8912641,18.3152,19.4541,448,49640,0.208998,0.55,1,178865,178417,448
8915561,13.263,14.2908,447,49640,0.2098,0.55,1,178877,178430,447
8918481,19.4526,18.0582,449,49640,0.20996,0.57,1,178898,178449,449
8921401,11.0905,10.8116,449,49640,0.225992,0.57,1,178907,178458,449
8924321,13.4181,14.1623,448,49640,0.229198,0.57,1,178921,178473,448
8927241,7.48362,9.23247,446,49640,0.22984,0.51,1,178927,178481,446
8930161,11.0967,12.2465,445,49640,0.197968,0.51,1,178939,178494,445
8933081,13.4193,13.6493,445,49640,0.223594,0.49,1,178953,178508,445
8936001,12.2839,11.5299,446,49640,0.228719,0.53,1,178965,178519,446
8938921,78.4568,79.906,444,49640,0.293744,0,1,179060,178616,444
8941841,45.2914,63.1812,422,49640,0.162749,0.07,1,179097,178675,422
8944761,43.4583,46.2362,423,49640,0.0565498,0.13,1,179140,178717,423
8947681,43.0917,38.8472,429,49640,0.0513099,0.15,1,179183,178754,429
8950601,19.8183,18.9694,429,49640,0.066262,0.17,1,179197,178768,429
8953521,17.5637,17.3939,429,49640,0.101252,0.19,1,179214,178785,429
8956441,42.7127,41.8788,430,49640,0.14825,0.21,1,179263,178833,430
8959361,19.7425,19.5758,430,49640,0.19765,0.21,1,179277,178847,430
8962281,18.3485,18.3152,430,49640,0.20753,0.21,1,179295,178865,430
8965201,13.2697,13.263,430,49640,0.177506,0.21,1,179307,178877,430
8968121,21.0539,19.4526,432,49640,0.155501,0.23,1,179330,178898,432
8971041,10.6108,11.0905,431,49640,0.1831,0.23,1,179338,178907,431
8973961,13.3222,13.4181,431,49640,0.15662,0.23,1,179352,178921,431
8976881,7.46443,7.48362,431,49640,0.215324,0.19,1,179358,178927,431
8979801,11.0929,11.0967,431,49640,0.227065,0.23,1,179370,178939,431
8982721,13.4186,13.4193,431,49640,0.197413,0.23,1,179384,178953,431
8985641,12.2837,12.2839,431,49640,0.191483,0.31,1,179396,178965,431
8988561,81.6567,78.4568,435,49640,0.286297,0.13,1,179495,179060,435
8991481,37.1313,45.2914,424,49640,0.273259,0.03,1,179521,179097,424
8994401,41.0263,43.4583,423,49640,0.238652,0.05,1,179563,179140,423
8997321,43.4053,43.0917,424,51100,0.24773,0.07,1,179607,179183,424
9000241,20.6811,19.8183,425,51100,0.241546,0.11,1,179622,179197,425
9003161,19.3362,17.5637,427,51100,0.232309,0.16,1,179641,179214,427
9006081,45.4672,42.7127,430,51100,0.270462,0.21,1,179693,179263,430
9009001,20.2934,19.7425,430,51100,0.286092,0.21,1,179707,179277,430
9011921,18.4587,18.3485,430,51100,0.289218,0.17,1,179725,179295,430
9014841,13.2917,13.2697,430,51100,0.289844,0.15,1,179737,179307,430
9017761,20.2583,21.0539,429,51100,0.289969,0.19,1,179759,179330,429
9020681,10.4517,10.6108,429,51100,0.289994,0.15,1,179767,179338,429
9023601,14.8903,13.3222,431,51100,0.257999,0.23,1,179783,179352,431
9026521,7.77807,7.46443,431,51100,0.3316,0.23,1,179789,179358,431
9029441,11.1556,11.0929,431,51100,0.36232,0.19,1,179801,179370,431
9032361,13.4311,13.4186,431,51100,0.368464,0.19,1,179815,179384,431
9035281,13.0862,12.2837,432,51100,0.353693,0.31,1,179828,179396,432
9038201,84.2172,81.6567,435,51100,0.414739,0.27,1,179930,179495,435
9041121,38.4434,37.1313,436,52560,0.442948,0.23,1,179957,179521,436
9044041,37.2887,41.0263,431,52560,0.41659,0.23,1,179994,179563,431
9046961,44.2577,8.20525,477,52560,0.419318,0.25,1,180040,179563,477
9049881,20.8515,36.8411,448,52560,0.411864,0.24,1,180055,179607,448
9052801,18.5703,19.3682,451,52560,0.442373,0.23,1,180073,179622,451
9055721,46.1141,19.0736,485,52560,0.480475,0.28,1,180126,179641,485
9058641,20.4228,45.4147,447,52560,0.472095,0.29,1,180140,179693,447
9061561,18.4846,20.2829,451,52560,0.470419,0.29,1,180158,179707,451
9064481,13.2969,18.4566,445,52560,0.470084,0.29,1,180170,179725,445
9067401,20.2594,13.2913,455,54020,0.518017,0.29,1,180192,179737,455
9070321,10.4519,20.2583,441,54020,0.527603,0.29,1,180200,179759,441
9073241,17.2904,10.4517,452,54020,0.545521,0.25,1,180219,179767,452
9076161,9.05807,14.8903,443,54020,0.629104,0.35,1,180226,179783,443
9079081,11.4116,7.77807,449,54020,0.661821,0.37,1,180238,179789,449
9082001,13.4823,11.1556,451,54020,0.668364,0.37,1,180252,179801,451
9084921,13.8965,13.4311,451,54020,0.669673,0.35,1,180266,179815,451
9087841,85.9793,13.0862,542,54020,0.709935,0.43,1,180370,179828,542
9090761,18.7959,84.2172,442,55480,0.717987,0.45,1,180372,179930,442
9093681,25.3592,38.4434,442,55480,0.727597,0.41,1,180399,179957,442
9096601,34.6718,37.2887,442,55480,0.777519,0.42,2,180436,179994,442
9099521,44.5344,44.2577,443,55480,0.803504,0.41,2,180483,180040,443
9102441,20.9069,20.8515,443,55480,0.864701,0.45,2,180498,180055,443
9105361,19.3814,18.5703,444,55480,0.90094,0.49,2,180517,180073,444
9108281,47.0763,46.1141,445,55480,0.868188,0.47,2,180571,180126,445
9119961,24,0,469,56940,0.93,0.53,2,180639,180170,469
9122881,11.2,17.6,455,56940,0.93,0.53,2,180647,180192,455
9368161,15,7,430,51100,0.33,0.05,1,182584,182154,430
9371081,11,7.8,432,52560,0.218,0.05,1,182594,182162,432
9411961,45,17,459,59860,0.73,0.55,1,182996,182537,459
9414881,18.6,20.2,450,59860,0.794,0.43,2,183008,182558,450
9417801,8.52,12.84,445,59860,0.8068,0.33,2,183014,182569,445
9420721,3.304,14.568,432,59860,0.80936,0.19,2,183016,182584,432
9423641,6.2608,10.9136,429,59860,0.793872,0.19,2,183023,182594,429
9426561,39.6522,2.18272,477,59860,0.918774,1,2,183071,182594,477
9590081,18,13,492,70080,0.91,1,2,184337,183845,492
9593001,19.6,12.2,500,70080,0.87,1,2,184357,183857,500
9595921,18.32,11.24,507,70080,0.87,1,2,184375,183868,507
9598841,18.064,13.448,511,70080,0.774,1,2,184393,183882,511
9601761,32.4128,45.0896,494,70080,0.6108,1,1,184429,183935,494
9604681,21.6826,23.4179,495,70080,0.49816,1,1,184448,183953,495
9607601,17.1365,15.8836,497,70080,0.411632,1,1,184464,183967,497
9610521,13.8273,11.1767,500,70080,0.362326,1,1,184477,183977,500
9613441,16.3655,2.23534,517,70080,0.256465,1,1,184494,183977,517
9616361,16.0731,6.84707,525,70080,0.179293,1,1,184510,183985,525
9619281,14.4146,31.7694,501,70080,0.0758586,1,1,184524,184023,501
9622201,15.6829,17.5539,503,70080,0.0391717,1,1,184540,184037,503
9625121,40.7366,17.1108,533,70080,0.0158343,1,1,184587,184054,533
9628041,28.1473,61.0222,486,70080,0.00316687,1,1,184612,184126,486
9630961,34.4295,27.4044,503,70080,0.0326334,1,1,184648,184145,503
9633881,23.6859,21.4809,504,70080,0.0145267,1,1,184669,184165,504
9636801,16.7372,19.4962,500,70080,0.0109053,1,1,184684,184184,500
9639721,16.9474,26.2992,489,70080,0.0421811,1,1,184701,184212,489
9642641,17.7895,22.0598,486,70080,0.0484362,1,1,184719,184233,486
9645561,29.9579,18.012,502,70080,0.0976872,1,1,184752,184250,502
9648481,18.7916,18.0024,500,70080,0.123537,1,1,184768,184268,500
9651401,7.75832,18.0005,487,71540,0.112707,0.94,1,184773,184286,487
9654321,8.75166,16.4001,480,71540,0.142541,0.94,1,184782,184302,480
9657241,11.3503,16.88,475,71540,0.116508,0.91,1,184794,184319,475
9660161,15.0701,17.776,473,71540,0.143302,0.86,1,184810,184337,473
9663081,12.614,19.5552,465,71540,0.21266,0.87,1,184822,184357,465
9666001,13.7228,18.311,461,71540,0.194532,0.75,1,184836,184375,461
9668921,15.5446,18.0622,459,71540,0.294906,0.57,1,184852,184393,459
9671841,23.1089,32.4124,448,71540,0.530981,0.47,1,184877,184429,448
9674761,15.0218,21.6825,442,71540,0.594196,0.39,1,184890,184448,442
9677681,11.8044,17.1365,437,71540,0.606839,0.35,1,184901,184464,437
9680601,9.56087,13.8273,433,71540,0.609368,0.23,1,184910,184477,433
9683521,12.3122,16.3655,429,71540,0.769874,0.16,2,184923,184494,429
9686441,12.0624,16.0731,425,71540,0.753975,0.05,2,184935,184510,425
9689361,12.0125,14.4146,423,71540,0.798795,0.03,2,184947,184524,423
9692281,15.2025,15.6829,423,71540,0.647759,0.01,1,184963,184540,423
9695201,39.8405,40.7366,422,71540,0.777552,0,2,185009,184587,422
9698121,27.9681,28.1473,422,71540,0.62751,0.04,1,185034,184612,422
9709801,17,17,423,71540,0.79,0.05,2,185124,184701,423
9712721,17.8,17.8,423,71540,0.71,0.11,1,185142,184719,423
9715641,31.56,29.96,425,71540,0.55,0.13,1,185177,184752,425
9718561,22.312,18.792,429,71540,0.326,0.13,1,185197,184768,429
9721481,7.6624,3.7584,433,71540,0.2812,0.11,1,185201,184768,433
9724401,7.13248,4.75168,435,71540,0.25624,0.15,1,185208,184773,435
9727321,12.6265,8.15034,440,71540,0.187248,0.11,1,185222,184782,440
9730241,17.7253,11.2301,447,71540,0.18945,0.15,1,185241,184794,447
9733161,10.7451,15.046,440,71540,0.25389,0.23,1,185250,184810,440
9736081,14.149,12.6092,443,71540,0.250778,0.19,1,185265,184822,443
9739001,30.8298,13.7218,464,71540,0.282156,0.32,1,185300,184836,464
9741921,26.966,15.5444,474,71540,0.288431,0.59,1,185326,184852,474
9744841,16.5932,23.1089,463,71540,0.289686,0.61,1,185340,184877,463
9747761,12.1186,15.0218,461,71540,0.369937,0.61,1,185351,184890,461
9750681,8.82373,11.8044,458,71540,0.353987,0.61,1,185359,184901,458
9753601,19.3647,9.56087,471,71540,0.350798,0.81,1,185381,184910,471
9756521,15.8729,12.3122,473,71540,0.36616,0.75,1,185396,184923,473
9759441,4.77459,12.0624,463,71540,0.369232,0.81,1,185398,184935,463
9762361,11.3549,12.0125,464,71540,0.321846,0.61,1,185411,184947,464
9765281,47.071,15.2025,504,71540,0.424369,0.81,1,185467,184963,504
9768201,25.4142,39.8405,478,71540,0.444874,0.59,1,185487,185009,478
9771121,43.4828,27.9681,501,71540,0.480975,1,1,185535,185034,501
9774041,24.6966,34.3936,485,71540,0.488195,0.85,1,185555,185070,485
9776961,10.5393,23.6787,471,71540,0.473639,0.79,1,185562,185091,471
9779881,14.1079,17.5357,470,71540,0.534728,0.79,1,185577,185107,470
9782801,12.4216,17.1071,465,71540,0.530946,0.69,1,185589,185124,465
9785721,23.2843,17.8214,473,71540,0.546189,0.51,1,185615,185142,473
9788641,15.8569,31.5643,452,71540,0.549238,0.27,1,185629,185177,452
9791561,6.37137,22.3129,436,71540,0.549848,0.27,1,185633,185197,436
9794481,6.07427,7.66257,438,71540,0.549969,0.25,1,185639,185201,438
9797401,12.4149,7.13251,445,71540,0.549994,0.17,1,185653,185208,445
9800321,19.283,12.6265,452,71540,0.549999,0.19,1,185674,185222,452
9803241,10.2566,17.7253,441,71540,0.55,0.27,1,185682,185241,441
9806161,14.8513,10.7451,448,71540,0.55,0.25,1,185698,185250,448
9809081,32.5703,14.149,470,71540,0.566,0.29,1,185735,185265,470
9812001,27.3141,30.8298,461,71540,0.6012,0.29,1,185761,185300,461
9814921,19.8628,26.966,453,71540,0.60824,0.29,1,185779,185326,453
9817841,11.9726,16.5932,449,71540,0.641648,0.39,1,185789,185340,449
9820761,8.79451,12.1186,446,71540,0.66433,0.35,1,185797,185351,446
9823681,20.9589,8.82373,462,71540,0.700866,0.35,1,185821,185359,462
9826601,13.7918,19.3647,452,71540,0.708173,0.37,1,185833,185381,452
9829521,4.35836,15.8729,439,71540,0.709635,0.37,1,185835,185396,439
9832441,12.8717,4.77459,452,71540,0.757927,0.31,2,185850,185398,452
9835361,50.5743,11.3549,499,71540,0.703585,0.45,1,185910,185411,499
9838281,24.5149,47.071,461,71540,0.708717,0.45,1,185928,185467,461
9841201,46.503,25.4142,493,71540,0.773743,0.49,2,185980,185487,493
9844121,25.3006,43.4828,465,71540,0.802749,0.49,2,186000,185535,465
9847041,12.2601,24.6966,454,71540,0.82455,0.47,2,186009,185555,454
9849961,14.452,10.5393,462,71540,0.78091,0.55,2,186024,185562,462
9852881,13.2904,14.1079,460,71540,0.852182,0.53,2,186037,185577,460
9855801,23.4581,12.4216,474,71540,0.850436,0.55,2,186063,185589,474
9858721,15.8916,23.2843,462,71540,0.850087,0.55,2,186077,185615,462
9861641,6.37832,15.8569,452,71540,0.850017,0.55,2,186081,185629,452
9864561,6.07566,6.37137,454,71540,0.850003,0.55,2,186087,185633,454
9867481,13.2151,6.07427,463,71540,0.850001,0.55,2,186102,185639,463
9870401,18.643,12.4149,469,71540,0.882,0.55,2,186122,185653,469
9873321,10.1286,19.283,456,71540,0.8884,0.55,2,186130,185674,456
9876241,15.6257,10.2566,465,71540,0.88968,0.55,2,186147,185682,465
9879161,33.5251,14.8513,487,71540,0.889936,0.57,2,186185,185698,487
9882081,28.305,32.5703,477,71540,0.873987,0.61,2,186212,185735,477
9885001,21.661,27.3141,471,71540,0.870797,0.61,2,186232,185761,471
9887921,13.1322,19.8628,464,71540,0.88616,0.65,2,186243,185779,464
9890841,10.6264,11.9726,464,71540,0.889232,0.67,2,186253,185789,464
9893761,21.3253,8.79451,480,71540,0.889846,0.71,2,186277,185797,480
9896681,15.4651,20.9589,470,71540,0.905969,0.71,2,186291,185821,470
9899601,4.69301,13.7918,460,71540,0.909194,0.71,2,186293,185833,460
9902521,13.7386,4.35836,474,71540,0.909839,0.77,2,186309,185835,474
10476301,31,30,475,71120,0.01,1,1,190303,189828,475
10480681,70.2,76.4,467,71120,0.266,0.91,1,190383,189916,467
10492361,20.44,22.48,466,71540,0.3332,0.72,1,190391,189925,466
10498201,27.288,38.896,452,71120,0.53864,0.52,1,190420,189968,452
10502581,30.2576,38.1792,445,70700,0.595728,0.48,1,190451,190006,445
10521561,11.6515,14.8358,443,71540,0.671146,0.09,1,190458,190015,443
10569321,61,45,437,73000,0.54,0,1,190641,190204,437
10572241,24.2,26.6,430,74460,0.588,0.01,1,190656,190226,430
10575161,19.24,18.92,431,75920,0.5576,0.03,1,190674,190243,431
10578081,19.848,18.984,432,75920,0.53552,0,1,190694,190262,432
10581001,10.3696,11.7968,430,75920,0.403104,0.01,1,190702,190272,430
10583921,38.8739,27.1594,445,75920,0.392621,0.28,1,190748,190303,445
10586841,26.9748,25.4319,444,77380,0.438524,0.3,1,190772,190328,444
10589761,21.395,20.2864,445,77380,0.335705,0.27,1,190792,190347,445
10592681,27.479,20.8573,453,77380,0.251141,0.35,1,190821,190368,453
10595601,29.4958,22.5715,460,78840,0.234228,0.47,1,190851,190391,460
10598521,22.6992,18.1143,464,78840,0.246846,0.63,1,190872,190408,464
10601441,32.5398,21.2229,477,78840,0.313369,0.61,1,190907,190430,477
10604361,12.108,21.0446,463,78840,0.326674,0.69,1,190914,190451,463
10607281,4.02159,9.80891,458,80300,0.329335,0.69,1,190916,190458,458
10610201,2.40432,1.96178,460,80300,0.329867,0.69,1,190918,190458,460
10613121,2.08086,0.392357,462,80300,0.297973,0.69,1,190920,190458,462
10616041,2.01617,0.0784713,464,80300,0.307595,0.69,1,190922,190458,464
10618961,46.0032,0.0156943,521,80300,0.277519,0.92,1,190979,190458,521
10621881,22.8006,52.0031,473,81760,0.271504,0.84,1,190996,190523,473
10624801,35.7601,17.6006,503,81760,0.318301,0.75,1,191035,190532,503
10627721,8.75203,41.9201,457,81760,0.29566,0.75,1,191037,190580,457
10630641,3.35041,8.38402,459,81760,0.307132,0.75,1,191039,190580,459
10633561,2.27008,1.6768,461,81760,0.309426,0.75,1,191041,190580,461
10636481,2.05402,0.335361,463,83220,0.277885,0.75,1,191043,190580,463
10639401,2.0108,0.0670722,465,83220,0.271577,0.54,1,191045,190580,465
10642321,34.0022,48.8134,446,83220,0.302315,0.54,1,191087,190641,446
10645241,19.6004,9.76268,462,83220,0.308463,0.6,1,191103,190641,462
10648161,5.52009,13.9525,449,83220,0.277693,0.55,1,191105,190656,449
10651081,13.104,17.1905,446,83220,0.303539,0.53,1,191120,190674,446
10654001,13.8208,19.4381,440,84680,0.404708,0.37,1,191134,190694,440
10656921,9.96416,10.2876,441,84680,0.408942,0.39,1,191143,190702,441
10659841,38.7928,38.8575,441,84680,0.393788,0.39,1,191189,190748,441
10662761,26.1586,7.7715,464,84680,0.406758,0.45,1,191212,190748,464
10665681,15.6317,20.7543,453,84680,0.409351,0.31,1,191225,190772,453
10668601,25.5263,20.1509,461,86140,0.45787,0.23,1,191253,190792,461
10671521,6.70527,27.2302,434,86140,0.467574,0.23,1,191255,190821,434
10674441,26.1411,29.446,435,86140,0.565515,0.25,1,191286,190851,435
10677361,22.8282,22.6892,436,86140,0.601103,0.33,1,191308,190872,436
10680281,33.3656,32.5378,437,86140,0.576221,0.33,1,191344,190907,437
10683201,10.6731,12.1076,435,86140,0.603244,0.33,1,191349,190914,435
10686121,3.73463,2.42151,437,87600,0.608649,0.33,1,191351,190914,437
10689041,2.34693,2.0843,437,87600,0.60973,0.33,1,191353,190916,437
10691961,2.06939,2.01686,437,87600,0.609946,0.29,1,191355,190918,437
10694881,2.01388,2.00337,437,87600,0.609989,0.31,1,191357,190920,437
10697801,43.6028,2.00067,489,87600,0.705998,0.27,1,191411,190922,489
10700721,10.3206,46.0001,434,87600,0.7252,0.27,1,191413,190979,434
10703641,17.2641,22.8,436,87600,0.76104,0.33,2,191432,190996,436
10706561,33.8528,35.76,435,89060,0.752208,0.29,2,191470,191035,435
10709481,8.37056,8.752,435,89060,0.750442,0.31,2,191472,191037,435
10712401,3.27411,3.3504,435,89060,0.750088,0.31,2,191474,191039,435
10715321,2.25482,2.27008,435,89060,0.766018,0.31,2,191476,191041,435
10718241,2.05096,0.454016,437,89060,0.801204,0.27,2,191478,191041,437
10721161,2.01019,1.6908,437,89060,0.776241,0.27,2,191480,191043,437
10724081,34.002,1.93816,477,89060,0.835248,0.31,2,191522,191045,477
10727001,19.6004,33.9876,451,89060,0.86305,0.31,2,191538,191087,451
10729921,5.52008,19.5975,437,90520,0.91661,0.27,2,191540,191103,437
10732841,15.504,5.51951,453,90520,0.927322,0.31,2,191558,191105,453
10735761,4.7008,13.1039,440,90520,0.929464,0.43,2,191560,191120,440
10738681,12.9402,13.8208,441,90520,0.913893,0.41,2,191575,191134,441
10972281,13,5,528,100740,0.91,1,2,192842,192314,528
10975201,15.4,5.8,538,100740,0.95,1,2,192858,192320,538
11029221,23,28,442,69220,0.38,0.15,1,193467,193025,442
11107201,54.2,66.4,428,68200,0.292,0.13,1,193529,193101,428
11110121,230.04,222.88,440,71540,0.5944,0.13,1,193803,193363,440
11113041,61.208,62.976,436,73000,0.65488,0.09,1,193822,193386,436
11115961,29.8416,25.3952,442,74460,0.730976,0.31,1,193844,193402,442
11118881,15.5683,17.079,439,75920,0.746195,0.31,1,193856,193417,439
11121801,27.1137,18.6158,450,75920,0.781239,0.29,2,193886,193436,450
11124721,18.2227,14.9232,452,77380,0.804248,0.38,2,193902,193450,452
11127641,16.4445,16.5846,451,77380,0.80885,0.39,2,193918,193467,451
11130561,6.48891,14.5169,441,77380,0.85777,0.41,2,193922,193481,441
11133481,13.2978,10.1034,447,77380,0.851554,0.37,2,193937,193490,447
11136401,21.8596,11.6207,459,77380,0.882311,0.27,2,193961,193502,459
11139321,5.97191,23.9241,434,77380,0.888462,0.27,2,193963,193529,434
11142241,2.79438,4.78483,436,77380,0.889692,0.27,2,193965,193529,436
11145161,2.15888,0.956965,438,77380,0.889939,0.27,2,193967,193529,438
11148081,2.03178,0.191393,440,77380,0.889988,0.27,2,193969,193529,440
11151001,2.00636,0.0382786,442,77380,0.889998,0.27,2,193971,193529,442
11153921,2.00127,0.00765572,444,78840,0.89,0.27,2,193973,193529,444
11156841,2.00025,0.00153114,446,78840,0.89,0.27,2,193975,193529,446
11159761,2.00005,0.000306229,448,78840,0.89,0.27,2,193977,193529,448
11344201,38,30,483,83220,0.71,1,1,195239,194756,483
11347121,22.8,15.6,490,83220,0.646,1,1,195258,194768,490
11350041,18.96,13.52,495,83220,0.6012,1,1,195276,194781,495
11352961,18.992,15.504,498,83220,0.56024,1,1,195295,194797,498
11355881,15.7984,3.1008,513,84680,0.520048,1,1,195310,194797,513
11358801,12.7597,12.6202,510,84680,0.48001,1,1,195322,194812,510
11361721,15.3519,14.524,511,84680,0.400002,1,1,195338,194827,511
11364641,12.6704,14.9048,508,84680,0.392,1,1,195350,194842,508
11366101,16.1341,12.581,513,84680,0.3424,1,1,195367,194854,513
11388001,361.627,424.916,433,57060,0.12448,0.03,1,195815,195382,433
11415741,133.125,154.583,422,57060,0.080896,0.21,1,195891,195469,422
11481441,171.425,170.117,429,57060,0.280179,0.15,1,196072,195643,429
11484361,67.085,47.6233,453,59860,0.464036,0.02,1,196113,195660,453
11487281,27.817,47.1247,424,61320,0.564807,0.07,1,196131,195707,424
11490201,31.1634,34.2249,425,62780,0.584961,0.07,1,196163,195738,425
11493121,16.6327,8.44499,436,64240,0.508992,0.07,1,196176,195740,436
11495121,8.92654,13.689,428,65700,0.541798,0.01,1,196183,195755,428
11496161,15.3853,21.1378,422,65700,0.53236,0.07,1,196200,195778,422
11499081,56.6771,44.2276,439,67160,0.418472,0.11,1,196267,195828,439
11502001,21.7354,18.4455,440,67160,0.427694,0.21,1,196280,195840,440
11504921,18.7471,19.6891,438,67160,0.445539,0.09,1,196298,195860,438
11507841,11.7494,18.3378,430,67160,0.417108,0.07,1,196308,195878,430
11510761,7.94988,14.0676,424,67160,0.427422,0.01,1,196315,195891,424
11513681,6.38998,6.81351,425,67160,0.397484,0.01,1,196321,195896,425
11516601,6.878,6.1627,426,68620,0.359497,0,1,196328,195902,426
11519521,6.1756,6.83254,425,68620,0.303899,0,1,196334,195909,425
11522441,48.4351,6.16651,478,68620,0.16478,0.81,1,196393,195915,478
11525361,101.687,15.6333,575,68620,0.248956,0.33,1,196508,195933,575
11528281,21.9374,114.327,438,68620,0.233791,0.33,1,196510,196072,438
11531201,5.98748,22.8653,440,70080,0.246758,0.33,1,196512,196072,440
11534121,2.7975,4.57307,442,70080,0.265352,0.33,1,196514,196072,442
11537041,2.1595,0.914613,444,70080,0.26907,0.33,1,196516,196072,444
11539961,2.0319,0.182923,446,70080,0.269814,0.51,1,196518,196072,446
11542881,34.0064,32.8366,447,70080,0.349963,0.51,1,196560,196113,447
11545801,20.4013,6.56732,464,70080,0.365993,0.59,1,196577,196113,464
11548721,5.68026,15.7135,448,70080,0.401199,0.59,1,196579,196131,448
11551641,25.1361,28.7427,446,70080,0.45624,0.59,1,196609,196163,446
11554561,16.2272,5.74854,460,71540,0.451248,0.49,1,196623,196163,460
11557481,4.84544,11.5497,449,71540,0.45025,0.55,1,196625,196176,449
11560401,5.76909,7.90994,448,71540,0.46605,0.53,1,196631,196183,448
11563321,13.1538,15.182,446,71540,0.51721,0.39,1,196646,196200,446
11566241,53.0308,56.6364,442,71540,0.543442,0.43,1,196709,196267,442
11569161,22.6062,21.7273,444,71540,0.564688,0.45,1,196724,196280,444
11572081,17.3212,18.7455,442,71540,0.616938,0.41,1,196740,196298,442
11575001,11.4642,11.7491,442,73000,0.595388,0.43,1,196750,196308,442
11577921,6.29285,7.94982,440,73000,0.623078,0.39,1,196755,196315,440
11580841,2.85857,6.38996,436,73000,0.628615,0.39,1,196757,196321,436
11583761,2.17171,1.27799,438,73000,0.629723,0.35,1,196759,196321,438
11586681,2.03434,5.8556,433,73000,0.629945,0.29,1,196761,196328,433
11589601,46.0069,5.97112,484,73000,0.613989,0.13,1,196818,196334,484
11592521,108.401,48.3942,549,73000,0.818798,0.27,2,196942,196393,549
11595441,23.2803,101.679,436,74460,0.85976,0.23,2,196944,196508,436
11598361,6.25605,21.9358,436,74460,0.835952,0.25,2,196946,196510,436
11601281,2.85121,5.98715,436,74460,0.83119,0.27,2,196948,196512,436
11604201,2.17024,2.79743,436,74460,0.830238,0.27,2,196950,196514,436
11607121,2.03405,2.15949,436,74460,0.830048,0.27,2,196952,196516,436
11610041,2.00681,2.0319,436,74460,0.846009,0.37,2,196954,196518,436
11612961,37.2014,34.0064,440,74460,0.881202,0.37,2,197000,196560,440
11615881,22.6403,20.4013,442,75920,0.92024,0.41,2,197019,196577,442
11618801,6.12805,5.68026,442,75920,0.928048,0.47,2,197021,196579,442
11901361,406,454,421,43325,0.69,0.03,1,198984,198563,421
11904281,93.2,96.4,429,40880,0.578,0.03,1,198999,198570,429
11907201,20.24,25.68,423,40880,0.5556,0.03,1,199001,198578,423
11910121,5.648,5.136,425,40820,0.51912,0.03,1,199003,198578,425
11913041,2.7296,1.0272,427,40820,0.511824,0.03,1,199005,198578,427
11915961,2.14592,0.20544,429,40820,0.510365,0.03,1,199007,198578,429
11918821,6.82918,0.041088,437,40820,0.814073,0.11,2,199015,198578,437
11921741,47.7658,22.4082,467,40820,0.618815,0.32,1,199073,198606,467
11924661,23.9532,41.2816,439,42340,0.563763,0.27,1,199091,198652,439
11927581,19.9906,21.8563,441,43800,0.584753,0.31,1,199110,198669,441
11930501,26.3981,20.3713,449,45260,0.364951,0.01,1,199138,198689,449
11933421,85.2796,88.8743,443,45260,0.12899,0.01,1,199238,198795,443
11936341,44.2559,44.1748,444,45260,0.081798,0.23,1,199272,198828,444
11939261,44.8512,33.635,458,45260,0.18436,0.41,1,199317,198859,458
11942181,77.7702,85.927,445,45260,0.284872,0.69,1,199403,198958,445
11945101,65.154,37.9854,481,45260,0.336974,0.55,1,199465,198984,481
11948021,14.6308,21.1971,466,46720,0.363395,0.51,1,199467,199001,466
11950941,4.52616,5.83942,466,46720,0.368679,0.51,1,199469,199003,466
11953861,2.50523,2.76788,466,46720,0.369736,0.51,1,199471,199005,466
11956781,2.10105,2.15358,466,46720,0.369947,0.89,1,199473,199007,466
11959701,38.8202,6.83072,506,46720,0.417989,0.57,1,199521,199015,506
11962621,9.36404,47.7661,450,46720,0.427598,0.57,1,199523,199073,450
11965541,14.6728,9.55323,466,46720,0.44552,0.55,1,199539,199073,466
11968461,4.53456,16.3106,450,46720,0.449104,0.59,1,199541,199091,450
11971381,16.1069,18.4621,450,46720,0.433821,0.59,1,199560,199110,450
11974301,12.0214,3.69243,461,46720,0.462764,0.31,1,199571,199110,461
11977221,73.6043,23.1385,522,48180,0.532553,0.07,1,199660,199138,522
11980141,44.3209,84.6277,459,48180,0.594511,0.07,1,199697,199238,459
11983061,50.4642,44.1255,477,48180,0.622902,0.21,1,199749,199272,477
11985981,80.4928,44.8251,520,48180,0.70858,0.31,1,199837,199317,520
11988901,69.6986,77.765,501,48180,0.789716,0.35,2,199904,199403,501
11991821,15.5397,65.153,441,48180,0.805943,0.37,2,199906,199465,441
11994741,4.70794,14.6306,441,48180,0.809189,0.37,2,199908,199467,441
11997661,2.54159,4.52612,441,48180,0.809838,0.37,2,199910,199469,441
12000581,2.10832,2.50522,441,48180,0.809968,0.37,2,199912,199471,441
12003501,2.02166,2.10104,441,48180,0.809994,0.43,2,199914,199473,441
12006421,41.2043,38.8202,444,48180,0.857999,0.43,2,199965,199521,444
12009341,9.84087,9.36404,444,48180,0.8676,0.45,2,199967,199523,444
12012261,13.1682,14.6728,442,48180,0.86952,0.45,2,199981,199539,442
12015181,4.23363,4.53456,442,48180,0.869904,0.43,2,199983,199541,442
12018101,17.6467,16.1069,444,48180,0.853981,0.47,2,200004,199560,444
12021021,11.5293,12.0214,443,48180,0.818796,0.47,2,200014,199571,443
12023941,76.7059,2.40428,536,49640,0.923759,0.55,2,200107,199571,536
12140741,16,4,493,49640,0.9,1,2,201341,200848,493
12143661,12,5.6,498,49640,0.868,1,2,201352,200854,498
12146581,12,11.52,497,49640,0.8936,1,2,201364,200867,497
12149501,11.2,5.504,504,49640,0.89072,1,2,201375,200871,504
12152421,11.04,24.3008,486,49640,0.858144,1,2,201386,200900,486
12155341,12.608,12.0602,490,49640,0.811629,1,2,201399,200909,490
12158261,11.3216,11.212,490,49640,0.754326,1,2,201410,200920,490
12210821,378.264,408.642,452,33580,0.574865,0.55,1,201880,201428,452
12213741,90.8529,100.128,448,35040,0.538973,0.32,1,201899,201451,448
12216661,98.9706,84.0257,469,36500,0.723795,0.17,1,202000,201531,469
12228341,8,14,450,42340,0.45,0.41,1,202259,201809,450
12231261,22.4,18,457,43800,0.546,0.53,1,202285,201828,457
12234181,9.28,18,445,43800,0.5332,0.49,1,202291,201846,445
12237101,7.456,10.8,443,43800,0.59464,0.45,1,202298,201855,443
12240021,13.4912,9.36,449,43800,0.590928,0.57,1,202313,201864,449
12242941,9.09824,7.472,450,43800,0.590186,0.53,1,202321,201871,450
12245861,6.61965,8.6944,447,45260,0.590037,0.53,1,202327,201880,447
12248781,14.9239,16.9389,445,45260,0.590007,0.53,1,202344,201899,445
12251701,91.7848,3.38778,556,45260,0.670001,0.77,1,202455,201899,556
12254621,19.957,81.4776,457,45260,0.686,1,1,202457,202000,457
12257541,53.5914,57.0955,468,45260,0.7852,1,2,202519,202051,468
12432741,59,21,515,36500,0.27,0.8,1,204312,203797,515
12435661,29.4,60.2,467,37960,0.35,0.54,1,204334,203867,467
12438581,61.08,68.04,466,39420,0.51,0.74,1,204403,203937,466
12441501,131.416,131.208,468,40880,0.43,0.58,1,204552,204084,468
12444421,41.4832,46.2416,462,42340,0.382,0.43,1,204571,204109,462
12447341,30.6966,36.4483,456,42340,0.2764,0.35,1,204599,204143,456
12450261,19.7393,32.0897,442,43800,0.14328,0.35,1,204616,204174,442
12453181,15.1479,16.8179,443,43800,0.564656,0.31,1,204630,204187,443
12456101,11.8296,16.1636,438,43800,0.632931,0.25,1,204641,204203,438
12459021,9.56591,9.63272,439,43800,0.614586,0.21,1,204650,204211,439
12461941,9.11318,14.7265,432,43800,0.546917,0.25,1,204659,204227,432
12464861,22.6226,23.7453,432,43800,0.501383,0.25,1,204685,204253,432
12467781,50.9245,4.74906,490,43800,0.316277,0.27,1,204743,204253,490
12470701,11.7849,48.1498,433,43800,0.295255,0.37,1,204745,204312,433
12473621,23.957,27.23,438,43800,0.211051,0.37,1,204772,204334,438
12476541,65.5914,5.44599,514,43800,0.21021,0.55,1,204848,204334,514
12479461,14.7183,56.2892,447,43800,0.210042,0.41,1,204850,204403,447
12482381,115.744,130.458,439,43800,0.274008,0.41,1,204991,204552,439
12485301,35.1487,26.0916,454,45260,0.334802,0.37,1,205006,204552,454
12488221,24.6297,20.4183,457,45260,0.39496,0.25,1,205028,204571,457
12491141,6.52595,26.4837,431,45260,0.374992,0.11,1,205030,204599,431
12494061,34.9052,18.8967,456,45260,0.450998,0.67,1,205072,204616,456
12496981,15.781,14.9793,453,45260,0.4982,0.65,1,205083,204630,453
12499901,10.3562,11.7959,451,45260,0.52364,0.61,1,205092,204641,451
12502821,6.07124,9.55917,447,45260,0.560728,0.53,1,205097,204650,447
12505741,9.21425,9.11183,448,45260,0.568146,0.49,1,205107,204659,448
12508661,22.6429,22.6224,448,45260,0.569629,0.27,1,205133,204685,448
12511581,38.1286,50.9245,432,46720,0.601926,0.29,1,205175,204743,432
12514501,9.22571,11.7849,432,46720,0.608385,0.19,1,205177,204745,432
12517421,23.4451,23.957,432,46720,0.657677,0.21,1,205204,204772,432
12520341,66.289,65.5914,433,46720,0.731535,0.21,1,205281,204848,433
12523261,14.8578,14.7183,433,46720,0.746307,0.29,1,205283,204850,433
12526181,120.572,115.744,439,46720,0.877261,0.29,2,205430,204991,439
12529101,37.7143,23.1487,456,46720,0.903452,0.35,2,205447,204991,456
12672181,116,143,459,49640,0.44,1,1,206835,206376,459
12675101,43.2,42.2,467,49640,0.4,1,1,206860,206393,467
12678021,40.64,21.24,491,49640,0.344,1,1,206900,206409,491
12680941,22.528,16.248,494,49640,0.2848,1,1,206918,206424,494
12683861,22.1056,35.2496,476,49640,0.24096,1,1,206940,206464,476
12686781,16.4211,19.8499,475,49640,0.264192,1,1,206955,206480,475
12689701,16.8842,15.17,478,49640,0.220838,1,1,206972,206494,478
12692621,9.77684,14.234,472,49640,0.244168,1,1,206980,206508,472
12695541,24.3554,15.6468,484,49640,0.280834,1,1,207008,206524,484
12698461,24.0711,17.5294,490,49640,0.272167,0.99,1,207032,206542,490
12701381,19.2142,17.1059,491,49640,0.286433,1,1,207050,206559,491
12704301,16.6428,21.8212,484,49640,0.289287,1,1,207066,206582,484
12707221,16.9286,14.7642,488,49640,0.225857,1,1,207083,206595,488
12710141,13.7857,14.9528,486,49640,0.413171,1,1,207096,206610,486
12713061,11.5571,18.1906,478,49640,0.442634,0.94,1,207107,206629,478
12715981,52.7114,61.2381,469,49640,0.352527,0.96,1,207170,206701,469
12718901,22.5423,26.6476,466,49640,0.270505,0.44,1,207185,206719,466
12721821,78.9085,98.1295,443,49640,0.494101,0.39,1,207278,206835,443
12724741,31.7817,39.6259,438,49640,0.49082,0.33,1,207298,206860,438
12727661,35.1563,39.9252,434,49640,0.802164,0.27,2,207334,206900,434
12730581,21.4313,22.385,434,49640,0.816433,0.23,2,207352,206918,434
12756861,28,17,446,49640,0.85,0.46,2,207529,207083,446
12759781,13.6,13.8,443,49640,0.866,0.45,2,207539,207096,443
12762701,10.72,11.56,442,49640,0.8372,0.33,2,207549,207107,442
12765621,46.944,52.712,435,49640,0.76744,0.25,2,207605,207170,435
12768541,26.9888,22.5424,442,49640,0.785488,0.55,2,207627,207185,442
12771461,84.5978,78.9085,448,49640,0.869098,0.49,2,207726,207278,448
12774381,28.9196,31.7817,443,49640,0.917819,0.88,2,207741,207298,443
12934981,19,12,485,56940,0.77,1,2,209263,208778,485
12937901,19,16,487,56940,0.674,1,1,209282,208795,487
12940821,19.8,3.2,507,56940,0.5748,1,1,209302,208795,507
12943741,16.76,14.24,506,58400,0.52296,1,1,209318,208812,506
12946661,16.152,24.448,495,58400,0.432592,1,1,209334,208839,495
12949581,19.2304,14.4896,503,58400,0.350518,1,1,209354,208851,503
12952501,19.0461,24.4979,495,58400,0.302104,1,1,209373,208878,495
12955421,17.4092,18.4996,495,58400,0.204421,1,1,209390,208895,495
12958341,29.8818,17.2999,511,58400,0.0408841,1,1,209423,208912,511
12961261,29.9764,33.06,504,59860,0.0881768,1,1,209453,208949,504
12964181,18.7953,20.212,503,59860,0.0736354,1,1,209469,208966,503
12967101,18.1591,18.4424,503,59860,0.0227271,1,1,209487,208984,503
12970021,16.4318,22.0885,496,59860,0.0125454,1,1,209503,209007,496
12972941,15.2864,18.0177,494,59860,0.0265091,1,1,209518,209024,494
12975861,19.8573,31.6035,480,59860,0.0133018,1,1,209539,209059,480
12978781,79.9715,91.1207,469,59860,0.0266604,1,1,209634,209165,469
12981701,29.5943,18.2241,486,59860,0.0133321,0.95,1,209651,209165,486
12984621,38.7189,19.6448,507,61320,0.00266641,0.88,1,209692,209185,507
12987541,17.3438,38.329,476,61320,0.00853328,0.81,1,209704,209228,476
12990461,13.8688,20.4658,473,61320,0.00170666,0.77,1,209717,209244,473
12993381,16.3738,19.2932,471,61320,0.152341,0.65,1,209734,209263,471
12996301,14.4747,19.0586,466,61320,0.150468,0.55,1,209748,209282,466
12999221,4.49495,19.8117,448,61320,0.118094,0.51,1,209750,209302,448
13002141,8.89899,16.7623,442,62780,0.111619,0.41,1,209760,209318,442
13005061,13.7798,16.1525,441,62780,0.254324,0.33,1,209775,209334,441
13007981,15.556,19.2305,437,62780,0.170865,0.29,1,209791,209354,437
13010901,16.7112,19.0461,435,62780,0.0341729,0.18,1,209808,209373,435
13013821,11.3422,17.4092,428,62780,0.382835,0,1,209818,209390,428
13016741,29.4684,29.8818,429,62780,0.684567,0,1,209852,209423,429
13019661,26.6937,5.97637,455,62780,0.624913,0.1,1,209878,209423,455
13022581,15.7387,25.1953,438,62780,0.644983,0.07,1,209891,209453,438
13025501,16.7477,17.8391,439,62780,0.632997,0.01,1,209908,209469,439
13028421,16.9495,17.9678,438,62780,0.598599,0.01,1,209925,209487,438
13031341,15.3899,16.3936,437,62780,0.55972,0.03,1,209940,209503,437
13034261,19.078,15.2787,442,64240,0.471944,0.01,1,209960,209518,442
13037181,79.8156,19.8557,516,64240,0.230389,0.03,1,210055,209539,516
13040101,29.5631,79.9711,438,64240,0.134078,0.01,1,210072,209634,438
13043021,7.51262,29.5942,423,65700,0.0828156,0,1,210074,209651,423
13045941,33.5025,38.7188,422,65700,0.0165631,0.01,1,210114,209692,422
13048861,16.3005,17.3438,422,65700,0.0113126,0,1,210126,209704,422
13051781,21.6601,13.8688,432,65700,0.0102625,0.19,1,210149,209717,432
13054701,16.332,16.3738,430,65700,0.0580525,0.15,1,210164,209734,430
13057621,12.0664,14.4747,427,65700,0.0356105,0.11,1,210175,209748,427
13060541,5.61328,4.49495,429,67160,0.0631221,0.11,1,210179,209750,429
13063461,12.3227,0.89899,443,67160,0.108624,0.11,1,210193,209750,443
13066381,12.8645,8.1798,446,67160,0.141725,0.29,1,210206,209760,446
13069301,7.37291,13.636,437,67160,0.148345,0.15,1,210212,209775,437
13072221,33.4746,15.5272,461,67160,0.053669,0,1,210252,209791,461
13075141,10.6949,16.7054,449,68620,0.0507338,0.47,1,210257,209808,449
13078061,37.339,11.3411,483,68620,0.114147,0.76,1,210301,209818,483
13080981,30.6678,29.4682,478,68620,0.158829,0.61,1,210330,209852,478
13083901,18.9336,26.6936,468,68620,0.183766,0.65,1,210346,209878,468
13086821,14.1867,15.7387,468,68620,0.204753,0.63,1,210359,209891,468
13089741,10.8373,16.7477,461,68620,0.208951,0.59,1,210369,209908,461
13092661,13.3675,16.9495,458,70080,0.24179,0.55,1,210383,209925,458
13095581,4.27349,15.3899,445,70080,0.248358,0.45,1,210385,209940,445
13098501,12.0547,19.078,439,70080,0.313672,0.17,1,210399,209960,439
13101421,71.2109,79.8156,430,70080,0.342734,0.11,1,210485,210055,430
13104341,26.2422,29.5631,428,71540,0.348547,0.11,1,210500,210072,428
13107261,6.84844,5.91262,430,71540,0.349709,0.07,1,210502,210072,430
13110181,27.7697,2.78252,461,71540,0.269942,0,1,210535,210074,461
13113101,15.1539,32.5565,433,71540,0.205988,0.01,1,210547,210114,433
13116021,22.2308,16.1113,445,71540,0.0971977,0.01,1,210571,210126,445
13118941,15.6462,21.6223,436,73000,0.10744,0.07,1,210585,210149,436
13121861,14.3292,16.3245,435,73000,0.0614879,0.03,1,210599,210164,435
13124781,4.46585,12.0649,426,73000,0.0522976,0.07,1,210601,210175,426
13127701,4.09317,5.61298,426,73000,0.0504595,0.12,1,210605,210179,426
13130621,13.6186,12.3226,428,74460,0.130092,0.15,1,210621,210193,428
13133541,12.3237,12.8645,427,74460,0.162018,0.15,1,210633,210206,427
13136461,7.26475,7.3729,427,74460,0.168404,0.03,1,210639,210212,427
13139381,31.0529,33.4746,424,74460,0.153681,0.03,1,210676,210252,424
13142301,11.0106,6.69492,430,74460,0.150736,0.05,1,210682,210252,430
13145221,39.0021,5.33898,471,75920,0.230147,0.13,1,210728,210257,471
13148141,32.6004,36.2678,458,75920,0.278029,0.17,1,210759,210301,458
13151061,20.1201,30.4536,446,75920,0.303606,0.19,1,210776,210330,446
13153981,15.224,18.8907,444,75920,0.340721,0.21,1,210790,210346,444
13156901,11.8448,14.1781,442,77380,0.364144,0.21,1,210801,210359,442
13159821,3.96896,10.8356,434,77380,0.368829,0.25,1,210803,210369,434
13162741,14.3938,13.3671,437,77380,0.385766,0.25,1,210820,210383,437
13165661,4.47876,4.27342,437,77380,0.389153,0.33,1,210822,210385,437
13168581,12.0958,12.0547,437,78840,0.453831,0.35,1,210836,210399,437
13171501,71.2192,71.2109,437,78840,0.514766,0.35,1,210922,210485,437
13174421,27.0438,14.2422,453,78840,0.526953,0.35,1,210938,210485,453
13177341,7.00877,14.8484,440,78840,0.529391,0.35,1,210940,210500,440
13180261,21.4018,4.56969,463,80300,0.529878,0.25,1,210965,210502,463
13183181,10.6804,27.3139,438,80300,0.561976,0.19,1,210973,210535,438
13186101,20.5361,15.0628,449,80300,0.568395,0.07,1,210996,210547,449
13189021,5.70721,22.2126,427,81760,0.569679,0.11,1,210998,210571,427
13191941,9.14144,15.6425,423,81760,0.585936,0.05,1,211008,210585,423
13194861,14.6283,14.3285,425,81760,0.605187,0.05,1,211024,210599,425
13197781,4.52566,4.4657,425,81760,0.609037,0.05,1,211026,210601,425
13200701,4.90513,4.09314,426,83220,0.609807,0.05,1,211031,210605,426
13203621,13.781,0.818628,442,83220,0.641962,0.15,1,211047,210605,442
13206541,13.1562,12.9637,439,83220,0.632392,0.17,1,211060,210621,439
13209461,7.43124,12.1927,433,83220,0.646478,0.17,1,211066,210633,433
13212381,31.8862,7.23855,465,84680,0.713296,0.15,1,211104,210639,465
13215301,11.1772,31.0477,434,84680,0.726659,0.15,1,211110,210676,434
13218221,3.83545,11.0095,430,84680,0.729332,0.25,1,211112,210682,430
13221141,40.7671,39.0019,434,84680,0.809866,0.29,2,211162,210728,434
13224061,34.5534,32.6004,436,86140,0.793973,0.31,2,211195,210759,436
13226981,22.1107,20.1201,438,86140,0.806795,0.35,2,211214,210776,438
13229901,15.6221,15.224,438,86140,0.809359,0.35,2,211228,210790,438
13232821,12.7244,3.0448,450,87600,0.841872,0.37,2,211240,210790,450
13235741,4.14489,9.40896,441,87600,0.848374,0.37,2,211242,210801,441
13238661,16.029,3.48179,458,87600,0.881675,0.39,2,211261,210803,458
13241581,4.8058,14.2964,443,89060,0.856335,0.39,2,211263,210820,443
13244501,2.56116,4.45927,443,89060,0.867267,0.47,2,211265,210822,443
13247421,13.3122,12.0919,445,89060,0.917453,0.53,2,211281,210836,445
13537961,50,56,460,91980,0.33,0.65,1,213117,212657,460
13548181,52.4,56,457,90020,0.25,0.45,1,213170,212713,457
13559861,69.68,82.4,442,90440,0.362,0.43,1,213244,212802,442
13565701,20.336,23.68,441,90020,0.4004,0.37,1,213252,212811,441
13587601,19.2672,22.336,438,87520,0.39208,0.09,1,213271,212833,438
13592181,45.4534,58.8672,422,68120,0.310416,0.02,1,213323,212901,422
13598421,22.6907,26.1734,421,65620,0.166083,0.01,1,213340,212919,421
13617761,22.9381,23.6347,421,62700,0.105217,0.39,1,213363,212942,421
13620681,54.9876,53.5269,423,93440,0.125043,0.39,1,213426,213003,423
13623601,12.5975,10.7054,425,94900,0.177009,0.01,1,213428,213003,425
13626521,4.1195,2.14108,427,94900,0.155402,0.01,1,213430,213003,427
13629441,2.4239,0.428215,429,94900,0.11908,0.01,1,213432,213003,429
13632361,2.08478,0.0856431,431,94900,0.127816,0.01,1,213434,213003,431
13635281,2.01696,0.0171286,433,96360,0.0975632,0.01,1,213436,213003,433
13638201,2.00339,0.00342572,435,96360,0.139513,0.01,1,213438,213003,435
13641121,2.00068,0.000685145,437,96360,0.179903,0.39,1,213440,213003,437
13643761,53.2001,51.2001,439,96360,0.12398,0.33,1,213506,213067,439
13646681,48.24,50.24,436,97820,0.0487961,0.33,1,213553,213117,436
13649601,11.248,10.048,438,97820,0.0337592,0.23,1,213555,213117,438
13652521,43.8496,44.4096,437,97820,0.0627518,0.41,1,213607,213170,437
13655441,75.9699,74.4819,439,97820,0.11655,0.29,1,213691,213252,439
13658361,73.594,71.6964,441,99280,0.23931,0.09,1,213764,213323,441
13661281,31.5188,46.3393,422,99280,0.263862,0.09,1,213785,213363,422
13664201,7.90376,9.26785,424,99280,0.300772,0.09,1,213787,213363,424
13667121,3.18075,1.85357,426,100740,0.276154,0.09,1,213789,213363,426
13670041,2.23615,0.370714,428,100740,0.271231,0.09,1,213791,213363,428
13672961,2.04723,0.0741428,430,100740,0.238246,0.09,1,213793,213363,430
13675881,2.00945,0.0148286,432,102200,0.199649,0.09,1,213795,213363,432
13678801,2.00189,0.00296571,434,102200,0.19193,0.09,1,213797,213363,434
13681721,2.00038,0.000593142,436,102200,0.206386,0.09,1,213799,213363,436
13684641,2.00008,0.000118628,438,102200,0.209277,0.09,1,213801,213363,438
13687561,2.00002,2.37257e-05,440,103660,0.209855,0.09,1,213803,213363,440
13690481,2,4.74514e-06,442,103660,0.225971,0.09,1,213805,213363,442
13693401,2,9.49028e-07,444,103660,0.229194,0.09,1,213807,213363,444
13696321,2,1.89806e-07,446,103660,0.229839,0.09,1,213809,213363,446
13699241,2,3.79611e-08,448,103660,0.229968,0.09,1,213811,213363,448
13702161,2,7.59222e-09,450,105120,0.245994,0.09,1,213813,213363,450
13705081,2,1.51844e-09,452,105120,0.249199,0.13,1,213815,213363,452
13708001,30,50.4,426,105120,0.29784,0.13,1,213852,213426,426
13710921,7.6,10.08,428,105120,0.307568,0.13,1,213854,213426,428
13713841,3.12,2.016,430,105120,0.309514,0.19,1,213856,213426,430
13716761,2.224,2.0032,430,105120,0.309903,0.19,1,213858,213428,430
13719681,2.0448,0.40064,432,106580,0.309981,0.15,1,213860,213428,432
13722601,2.00896,1.68013,432,106580,0.309996,0.11,1,213862,213430,432
13725521,2.00179,1.93603,432,106580,0.309999,0.13,1,213864,213432,432
13728441,2.00036,1.98721,432,106580,0.31,0.09,1,213866,213434,432
13731361,2.00007,1.99744,432,106580,0.31,0.15,1,213868,213436,432
13734281,2.00001,1.99949,432,106580,0.326,0.19,1,213870,213438,432
13737201,2,1.9999,432,106580,0.3292,0.11,1,213872,213440,432
13740121,46.8,53.2,424,108040,0.34584,0.11,1,213930,213506,424
13743041,46.96,10.64,471,108040,0.349168,0.03,1,213977,213506,471
13745961,10.992,39.728,426,108040,0.349834,0.03,1,213979,213553,426
13748881,44.5984,9.5456,477,108040,0.445967,0.07,1,214032,213555,477
13751801,79.3197,43.5091,513,108040,0.497193,0.13,1,214120,213607,513
13754721,17.4639,75.9018,431,109500,0.507439,0.27,1,214122,213691,431
13757641,64.2928,73.5804,434,109500,0.621488,0.27,1,214198,213764,434
13760561,27.2586,31.5161,431,109500,0.660298,0.31,1,214216,213785,431
13763481,7.05171,7.90321,431,109500,0.63606,0.31,1,214218,213787,431
13766401,3.01034,1.58064,433,110960,0.631212,0.27,1,214220,213787,433
13769321,2.20207,1.91613,433,110960,0.662242,0.27,1,214222,213789,433
13772241,2.04041,1.98323,433,110960,0.636449,0.23,1,214224,213791,433
13775161,2.00808,1.99665,433,110960,0.63129,0.19,1,214226,213793,433
13778081,2.00162,1.99933,433,110960,0.630258,0.19,1,214228,213795,433
13781001,2.00032,1.99987,433,110960,0.646052,0.21,1,214230,213797,433
13783921,2.00006,1.99997,433,112420,0.64921,0.21,1,214232,213799,433
13786841,2.00001,1.99999,433,112420,0.649842,0.21,1,214234,213801,433
13789761,2,0.399999,435,112420,0.649968,0.21,1,214236,213801,435
13792681,2,1.68,435,112420,0.649994,0.23,1,214238,213803,435
13795601,2,1.936,435,112420,0.649999,0.23,1,214240,213805,435
13798521,2,1.9872,435,112420,0.666,0.23,1,214242,213807,435
13801441,2,1.99744,435,113880,0.6692,0.23,1,214244,213809,435
13804361,2,1.99949,435,113880,0.66984,0.25,1,214246,213811,435
13807281,2,1.9999,435,113880,0.669968,0.25,1,214248,213813,435
13810201,2,1.99998,435,113880,0.669994,0.31,1,214250,213815,435
13813121,31.6,30,437,113880,0.693999,0.31,1,214289,213852,437
13816041,7.92,7.6,437,113880,0.7308,0.31,1,214291,213854,437
13818961,3.184,3.12,437,113880,0.73816,0.31,1,214293,213856,437
13821881,2.2368,2.224,437,113880,0.707632,0.31,1,214295,213858,437
13824801,2.04736,0.4448,439,115340,0.709526,0.31,1,214297,213858,439
13827721,2.00947,1.68896,439,115340,0.709905,0.31,1,214299,213860,439
13830641,2.00189,1.93779,439,115340,0.709981,0.31,1,214301,213862,439
13833561,2.00038,1.98756,439,115340,0.709996,0.31,1,214303,213864,439
13836481,2.00008,1.99751,439,115340,0.709999,0.31,1,214305,213866,439
13839401,2.00002,1.9995,439,115340,0.726,0.33,1,214307,213868,439
13842321,2,1.9999,439,115340,0.7292,0.33,1,214309,213870,439
13845241,2,1.99998,439,115340,0.72984,0.35,1,214311,213872,439
13848161,46,46.8,438,115340,0.841968,0.35,2,214368,213930,438
13851081,50.8,46.96,443,116800,0.896394,0.35,2,214420,213977,443
13854001,11.76,10.992,443,116800,0.875279,0.47,2,214422,213979,443
13856921,46.352,44.5984,445,116800,0.919056,0.51,2,214477,214032,445
14257161,32,40,547,57940,0.17,0.81,1,216427,215880,547
14279201,173.6,245.6,459,36040,0.074,1,1,216636,216177,459
14279641,89.92,49.12,528,17500,0.5188,0.61,1,216705,216177,528
14287961,22.784,79.424,447,17500,0.57576,0.48,1,216711,216264,447
14297921,29.3568,40.6848,447,14140,0.635152,0.3,1,216742,216295,447
14517161,205,237,483,70080,0.53,0.71,1,218580,218097,483
14520081,62.6,88.2,459,71540,0.506,0.69,1,218607,218148,459
14523001,25.32,28.04,462,73000,0.5252,0.68,1,218623,218161,462
14525921,15.464,17.608,460,74460,0.64104,0.58,1,218636,218176,460
14528841,12.6928,17.1216,455,74460,0.680208,0.56,1,218648,218193,455
14531761,12.1386,14.6243,453,74460,0.672042,0.55,1,218660,218207,453
14534681,15.2277,13.3249,456,74460,0.558408,0.49,1,218676,218220,456
14537601,11.0455,13.065,453,74460,0.551682,0.51,1,218686,218233,453
14540521,11.8091,12.213,453,74460,0.582336,0.49,1,218698,218245,453
14543441,3.96182,11.2426,444,74460,0.572467,0.49,1,218700,218256,444
14546361,2.39236,2.24852,446,74460,0.554493,0.49,1,218702,218256,446
14549281,2.07847,0.449704,448,74460,0.566899,0.49,1,218704,218256,448
14552201,2.01569,0.0899408,450,74460,0.55338,0.49,1,218706,218256,450
14555121,2.00314,0.0179882,452,74460,0.534676,0.49,1,218708,218256,452
14558041,2.00063,0.00359763,454,74460,0.530935,0.49,1,218710,218256,454
14560961,2.00013,0.000719526,456,75920,0.530187,0.49,1,218712,218256,456
14563881,2.00003,0.000143905,458,75920,0.530037,0.43,1,218714,218256,458
14566801,82,95.2,441,75920,0.306007,0.43,1,218816,218375,441
14569721,18,19.04,443,75920,0.261202,0.43,1,218818,218375,443
14572641,5.2,3.808,445,75920,0.23624,0.43,1,218820,218375,445
14575561,2.64,0.7616,447,75920,0.215248,0.43,1,218822,218375,447
14578481,2.128,0.15232,449,75920,0.21105,0.43,1,218824,218375,449
14581401,2.0256,0.030464,451,75920,0.17821,0.43,1,218826,218375,451
14584321,2.00512,0.0060928,453,75920,0.171642,0.53,1,218828,218375,453
14587241,158.801,164.001,446,75920,0.746328,0.53,1,219026,218580,446
14590161,51.7602,32.8002,471,77380,0.861266,0.5,2,219051,218580,471
14593081,11.952,28.16,446,77380,0.884253,0.53,2,219053,218607,446
14889461,75,78,455,55060,0.19,0.01,1,221190,220735,455
14935261,127,154.8,421,54227,0.478,0.27,1,221330,220909,421
14938181,79.8,68.56,442,53393,0.5356,0.31,1,221398,220956,442
14941101,37.56,31.312,447,51723,0.37112,0.25,1,221425,220978,447
14944021,30.712,31.8624,444,50054,0.194224,0.5,1,221454,221010,444
14946941,26.9424,23.9725,448,48385,0.126845,0.39,1,221480,221032,448
14949861,15.7885,19.9945,442,46720,0.065369,0.33,1,221493,221051,442
14952781,20.7577,16.7989,448,45260,0.0130738,0.37,1,221515,221067,448
14955701,22.5515,22.5598,447,43800,0.0426148,0.35,1,221538,221091,447
14958621,14.9103,23.712,436,42340,0.032523,0.35,1,221551,221115,436
14961541,4.58206,4.74239,438,40880,0.0305046,0.35,1,221553,221115,438
14964461,8.11641,0.948478,447,40880,0.0141009,0.31,1,221562,221115,447
14967381,17.6233,20.9897,441,40880,0.0108202,0.33,1,221582,221141,441
14970301,13.9247,12.9979,443,40880,0.058164,0.19,1,221595,221152,443
14973221,22.7849,32.9996,430,40880,0.0356328,0.19,1,221620,221190,430
14976141,6.15699,6.59992,432,40880,0.0311266,0.19,1,221622,221190,432
14979061,2.8314,1.31998,434,40880,0.0302253,0.19,1,221624,221190,434
14981981,2.16628,0.263997,436,40880,0.0300451,0.21,1,221626,221190,436
14984901,46.0333,22.4528,465,40880,0.094009,0.11,1,221683,221218,465
14987821,74.8066,12.4906,537,42340,0.106802,0.55,1,221765,221228,537
14990741,73.3613,84.0981,508,42340,0.22136,0.33,1,221838,221330,508
14993661,44.2723,92.8196,450,43800,0.260272,0.11,1,221875,221425,450
14996581,40.8545,62.5639,435,43800,0.284054,0,1,221915,221480,435
14999501,43.3709,40.5128,444,43800,0.128811,0.03,1,221959,221515,444
15002421,20.6742,36.9026,423,43800,0.113762,0.01,1,221974,221551,423
15005341,12.1348,16.1805,422,43800,0.0627524,0.01,1,221984,221562,422
15008261,20.027,19.2361,424,43800,0.0205505,0.07,1,222006,221582,424
15011181,12.8054,14.2472,422,43800,0.0281101,0.03,1,222017,221595,422
15014101,22.5611,22.8494,422,45260,0.029622,0.03,1,222042,221620,422
15017021,6.11222,6.16989,422,45260,0.0299244,0.03,1,222044,221622,422
15019941,2.82244,2.83398,422,45260,0.0459849,0.03,1,222046,221624,422
15022861,2.16449,2.1668,422,45260,0.049197,0.11,1,222048,221626,422
15025781,50.8329,46.0334,428,45260,0.0658394,0.11,1,222111,221683,428
15028701,76.5666,9.20667,511,45260,0.165168,0.11,1,222194,221683,511
15031621,76.9133,67.4413,506,46720,0.217034,0.25,1,222271,221765,506
15034541,16.9827,71.8883,435,46720,0.227407,0.27,1,222273,221838,435
15037461,31.3965,43.9777,433,46720,0.261481,0.29,1,222308,221875,433
15040381,40.6793,40.7955,436,46720,0.284296,0.09,1,222351,221915,436
15043301,35.3359,43.3591,426,46720,0.304859,0.11,1,222385,221959,426
15046221,17.4672,20.6718,424,46720,0.324972,0.05,1,222398,221974,424
15049141,9.89343,12.1344,422,46720,0.328994,0.01,1,222406,221984,422
15052061,19.5787,20.0269,422,46720,0.265799,0.03,1,222428,222006,422
15054981,12.7157,12.8054,422,48180,0.23716,0.03,1,222439,222017,422
15057901,21.7431,2.56107,446,48180,0.135432,0.03,1,222463,222017,446
15060821,5.94863,20.5122,423,48180,0.147086,0.03,1,222465,222042,423
15063741,2.78973,5.70244,423,48180,0.117417,0.05,1,222467,222044,423
15066661,2.15795,2.74049,423,48180,0.111483,0.05,1,222469,222046,423
15069581,51.6316,2.1481,485,48180,0.0622967,0.07,1,222533,222048,485
15072501,81.5263,50.8296,511,48180,0.132459,0.19,1,222622,222111,511
15075421,17.9053,76.5659,430,48180,0.146492,0.23,1,222624,222194,430
15078341,67.5811,76.9132,433,48180,0.197298,0.23,1,222704,222271,433
15081261,15.1162,16.9826,433,48180,0.20746,0.27,1,222706,222273,433
15084181,33.4232,31.3965,436,48180,0.257492,0.29,1,222744,222308,436
15087101,41.8846,40.6793,437,48180,0.299498,0.31,1,222788,222351,437
15090021,35.5769,35.3359,437,48180,0.3079,0.33,1,222822,222385,437
15092941,16.7154,17.4672,436,48180,0.34158,0.33,1,222834,222398,436
15095861,9.74308,9.89343,436,48180,0.316316,0.25,1,222842,222406,436
15098781,15.5486,19.5787,431,48180,0.327263,0.25,1,222859,222428,431
15101701,11.1097,3.91574,441,49640,0.345453,0.23,1,222869,222428,441
15104621,18.2219,9.58315,450,49640,0.365091,0.11,1,222889,222439,450
15107541,5.24439,21.1166,428,49640,0.369018,0.15,1,222891,222463,428
15110461,2.64888,5.82333,428,49640,0.369804,0.11,1,222893,222465,428
15113381,2.12978,2.76467,428,49640,0.385961,0.11,1,222895,222467,428
15116301,50.026,2.15293,488,49640,0.389192,0.05,1,222957,222469,488
15119221,84.4052,51.6306,517,49640,0.485838,0.15,1,223050,222533,517
15122141,18.481,81.5261,430,49640,0.505168,0.15,1,223052,222622,430
15125061,70.0962,17.9052,511,49640,0.525034,0.21,1,223135,222624,511
15127981,15.6192,67.581,433,49640,0.529007,0.21,1,223137,222704,433
15130901,35.9238,15.1162,472,49640,0.561801,0.27,1,223178,222706,472
15133821,43.9848,33.4232,480,49640,0.56836,0.31,1,223224,222744,480
15136741,35.997,41.8846,470,49640,0.585672,0.31,1,223258,222788,470
15139661,16.7994,35.5769,448,49640,0.589134,0.35,1,223270,222822,448
15142581,9.75988,16.7154,444,49640,0.605827,0.31,1,223278,222834,444
15145501,17.152,9.74308,455,49640,0.625165,0.33,1,223297,222842,455
15148421,5.03039,15.5486,440,49640,0.629033,0.35,1,223299,222859,440
15151341,9.00608,11.1097,440,49640,0.645807,0.37,1,223309,222869,440
15154261,18.6012,18.2219,441,49640,0.665161,0.37,1,223330,222889,441
15157181,5.32024,5.24439,441,49640,0.669032,0.37,1,223332,222891,441
15160101,2.66405,2.64888,441,49640,0.669806,0.39,1,223334,222893,441
15163021,2.13281,2.12978,441,49640,0.669961,0.39,1,223336,222895,441
15165941,50.0266,50.026,441,49640,0.685992,0.51,1,223398,222957,441
15168861,90.0053,84.4052,448,49640,0.849198,0.51,2,223498,223050,448
15171781,19.6011,18.481,448,49640,0.88184,0.53,2,223500,223052,448
15174701,70.3202,70.0962,448,49640,0.920368,0.53,2,223583,223135,448
15177621,15.664,15.6192,448,49640,0.928074,0.57,2,223585,223137,448
15332381,38,59,469,49640,0.79,1,2,225097,224628,469
15335301,49.2,39.8,486,51100,0.758,1,2,225149,224663,486
15338221,22.64,19.16,488,51100,0.7756,1,2,225165,224677,488
15358661,14,14,487,51100,0.86,1,2,225254,224767,487
15513421,14,13,500,62780,0.87,1,2,226679,226179,500
15516341,12.4,12.2,500,62780,0.838,1,2,226691,226191,500
15519261,12.08,17.64,493,62780,0.8076,1,2,226703,226210,493
15522181,14.416,16.328,492,62780,0.73752,1,1,226718,226226,492
15525101,10.8832,13.6656,489,62780,0.667504,1,1,226728,226239,489
15528021,60.5766,76.3331,470,62780,0.509501,1,1,226801,226331,470
15530941,33.7153,29.6666,479,62780,0.4299,1,1,226828,226349,479
15533861,89.1431,82.7333,486,62780,0.34198,1,1,226931,226445,486
15536781,31.4286,16.5467,503,64240,0.300396,1,1,226948,226445,503
15539701,18.2857,13.7093,505,64240,0.292079,1,1,226963,226458,505
15542621,14.8571,13.9419,505,64240,0.298416,1,1,226977,226472,505
15545541,14.9714,13.9884,506,65700,0.243683,1,1,226992,226486,506
15548461,12.5943,13.1977,505,65700,0.216737,1,1,227004,226499,505
15551381,22.5189,13.8395,516,65700,0.179347,1,1,227029,226513,516
15554301,15.7038,37.1679,487,65700,0.171869,1,1,227043,226556,487
15557221,12.7408,20.2336,483,65700,0.170374,1,1,227055,226572,483
15560141,12.9482,17.6467,479,65700,0.122075,1,1,227068,226589,479
15563061,16.9896,17.1293,480,65700,0.224415,0.98,1,227086,226606,480
15565981,18.5979,27.4259,469,67160,0.244883,0.91,1,227105,226636,469
15568901,14.1196,18.2852,466,67160,0.168977,0.91,1,227118,226652,466
15571821,10.0239,3.65703,475,67160,0.105795,0.87,1,227127,226652,475
15574741,11.6048,11.1314,474,67160,0.333159,0.87,1,227139,226665,474
15577661,10.321,13.4263,470,67160,0.634632,0.83,1,227149,226679,470
15580581,9.26419,12.2853,467,68620,0.646926,0.8,1,227158,226691,467
15583501,12.2528,12.0571,468,68620,0.569385,0.72,1,227171,226703,468
15586421,8.05057,14.4114,460,68620,0.521877,0.65,1,227178,226718,460
15589341,53.6101,10.8823,515,68620,0.288375,0.47,1,227243,226728,515
15592261,29.922,60.5765,466,68620,0.113675,0.41,1,227267,226801,466
15595181,86.7844,33.7153,540,70080,0.022735,0.32,1,227368,226828,540
15598101,18.9569,89.1431,439,70080,0.012547,0.29,1,227370,226931,439
15601021,16.5914,31.4286,438,70080,0.442509,0.29,1,227386,226948,438
15603941,15.3183,18.2857,438,70080,0.464502,0.3,1,227401,226963,438
15606861,11.0637,14.8571,434,71540,0.3729,0.3,1,227411,226977,434
15609781,11.8127,2.97143,446,71540,0.37058,0.23,1,227423,226977,446
15612701,10.3625,12.5943,441,71540,0.370116,0.21,1,227433,226992,441
15615621,22.0725,12.1189,454,71540,0.338023,0.17,1,227458,227004,454
15618541,14.8145,22.4238,442,71540,0.331605,0.17,1,227471,227029,442
15621461,10.9629,15.6848,438,73000,0.282321,0.17,1,227481,227043,438
15624381,19.7926,12.737,448,73000,0.480464,0.11,1,227503,227055,448
15627301,15.9585,12.9474,450,73000,0.376093,0.25,1,227518,227068,450
15630221,4.7917,16.9895,434,73000,0.371219,0.25,1,227520,227086,434
15633141,12.1583,18.5979,429,74460,0.418244,0.15,1,227534,227105,429
15636061,9.63167,14.1196,425,74460,0.491649,0.09,1,227543,227118,425
15638981,21.9263,10.0239,441,74460,0.57033,0.39,1,227568,227127,441
15641901,26.7853,11.6048,457,74460,0.698066,0.71,1,227596,227139,457
15644821,10.1571,10.321,453,75920,0.723613,0.71,1,227602,227149,453
15647741,5.23141,2.06419,457,75920,0.696723,0.65,1,227606,227149,457
15650661,7.44628,7.61284,456,75920,0.755345,0.55,2,227614,227158,456
15653581,3.88926,11.9226,446,75920,0.751069,0.51,2,227617,227171,446
15656501,44.7779,7.98451,494,75920,0.814214,0.23,2,227672,227178,494
15659421,21.7556,53.5969,445,77380,0.874843,0.07,2,227688,227243,445
15662341,5.95111,29.9194,423,77380,0.886969,0,2,227690,227267,423
15665261,81.1902,86.7839,422,77380,0.425394,0.01,1,227790,227368,422
15668181,17.838,18.9568,422,78840,0.365079,0.55,1,227792,227370,422
15671101,37.1676,16.5914,448,78840,0.353016,0.47,1,227834,227386,448
15674021,12.2335,15.3183,439,78840,0.366603,0.47,1,227840,227401,439
15676941,10.4467,3.06365,449,80300,0.353321,0.35,1,227850,227401,449
15679861,11.6893,8.61273,451,80300,0.414664,0.37,1,227862,227411,451
15682781,9.53787,11.3225,448,80300,0.394933,0.37,1,227871,227423,448
15685701,21.9076,10.2645,463,80300,0.462987,0.33,1,227896,227433,463
15688621,11.5815,22.0529,447,81760,0.532597,0.33,1,227905,227458,447
15691541,3.9163,14.8106,436,81760,0.562519,0.27,1,227907,227471,436
15694461,26.3833,10.9621,458,81760,0.600504,0.53,1,227939,227481,458
15697381,8.47665,19.7924,440,83220,0.624101,0.35,1,227943,227503,440
15700301,15.2953,15.9585,442,83220,0.64482,0.37,1,227960,227518,442
15703221,4.65907,4.7917,442,83220,0.664964,0.37,1,227962,227520,442
15706141,14.5318,0.958339,459,83220,0.620993,0.43,1,227979,227520,459
15709061,13.3064,11.3917,458,84680,0.676199,0.51,1,227992,227534,458
15711981,25.0613,9.47833,477,84680,0.67124,0.59,1,228020,227543,477
15714901,29.8123,21.8957,483,84680,0.734248,0.73,1,228051,227568,483
15717821,7.56245,26.7791,457,84680,0.74685,0.73,1,228053,227596,457
15720741,8.71249,10.1558,460,86140,0.76537,0.69,2,228062,227602,460
15723661,3.3425,5.23117,458,86140,0.785074,0.77,2,228064,227606,458
15726581,7.8685,7.44623,459,86140,0.773015,0.75,2,228073,227614,459
15729501,3.1737,3.88925,458,86140,0.770603,0.83,2,228075,227617,458
15732421,47.8347,44.7778,462,87600,0.882121,0.83,2,228134,227672,462
15735341,24.7669,8.95557,481,87600,0.920424,0.89,2,228153,227672,481
15738261,6.55339,14.5911,467,87600,0.944085,0.89,2,228155,227688,467
15741181,57.3107,4.51822,535,89060,0.908817,0.31,2,228225,227690,535
15744101,13.0621,80.9036,437,89060,0.901763,0.35,2,228227,227790,437
15747021,4.21243,17.7807,437,89060,0.868353,0.35,2,228229,227792,437
16030261,52,58,474,90520,0.05,0.37,1,229961,229487,474
16040481,78.4,108.4,438,90520,0.314,0.33,1,230046,229608,438
16074061,18.88,27.28,435,90520,0.3828,0.05,1,230050,229615,435
16082821,94.176,104.656,424,66860,0.07656,0.01,1,230163,229739,424
16100661,42.8352,47.3312,421,60800,0.263312,0,1,230193,229772,421
16102741,78.167,67.8662,435,46420,0.0526624,0.05,1,230280,229845,435
16105661,17.2334,23.9732,424,90520,0.0105325,0.02,1,230282,229858,424
16108581,5.04668,4.79465,426,90520,0.0021065,0.02,1,230284,229858,426
16111501,2.60934,0.95893,428,90520,0.000421299,0.02,1,230286,229858,428
16114421,2.12187,0.191786,430,91980,0.0560843,0.02,1,230288,229858,430
16117341,2.02437,0.0383572,432,91980,0.0352169,0.02,1,230290,229858,432
16120261,2.00487,0.00767144,434,91980,0.575043,0.02,1,230292,229858,434
16123181,2.00097,0.00153429,436,91980,0.699009,0.02,1,230294,229858,436
16126101,30.0002,0.000306857,473,91980,0.691802,0.05,1,230331,229858,473
16129021,7.60004,40.8001,424,93440,0.72236,0.05,1,230333,229909,424
16130401,3.12001,8.16001,426,93440,0.728472,0.05,1,230335,229909,426
16133321,39.824,43.232,423,93440,0.489694,0.05,1,230384,229961,423
16136241,9.5648,8.6464,425,94900,0.473939,0.05,1,230386,229961,425
16139161,81.913,1.72928,525,94900,0.374788,0.4,1,230486,229961,525
16142081,21.9826,71.5459,443,94900,0.386958,0.31,1,230493,230050,443
16145001,172.397,128.709,510,94900,0.0773915,0,1,230703,230193,510
16147921,37.6793,95.3418,427,96360,0.0154783,0,1,230707,230280,427
16150841,9.13586,19.0684,429,96360,0.0110957,0,1,230709,230280,429
16153761,3.42717,3.81367,431,97820,0.0422191,0,1,230711,230280,431
16156681,2.28543,0.762735,433,97820,0.0164438,0,1,230713,230280,433
16159601,2.05709,0.152547,435,97820,0.0672888,0,1,230715,230280,435
16162521,2.01142,0.0305094,437,99280,0.0454578,0,1,230717,230280,437
16165441,2.00228,0.00610188,439,99280,0.0650916,0,1,230719,230280,439
16168361,2.00046,0.00122037,441,99280,0.0850183,0,1,230721,230280,441
16171281,2.00009,0.000244075,443,99280,0.0890037,0,1,230723,230280,443
16174201,2.00002,4.8815e-05,445,100740,0.0898007,0,1,230725,230280,445
16177121,2,9.763e-06,447,100740,0.10596,0,1,230727,230280,447
16180041,2,1.9526e-06,449,100740,0.109192,0,1,230729,230280,449
16182961,2,3.9052e-07,451,100740,0.109838,0,1,230731,230280,451
16185881,2,7.8104e-08,453,100740,0.109968,0,1,230733,230280,453
16188801,2,1.56208e-08,455,102200,0.125994,0,1,230735,230280,455
16191721,2,3.12416e-09,457,102200,0.129199,0,1,230737,230280,457
16194641,2,1.6,457,102200,0.12984,0,1,230739,230282,457
16197561,2,0.32,459,102200,0.129968,0,1,230741,230282,459
16200481,2,1.664,459,102200,0.129994,0,1,230743,230284,459
16203401,2,1.9328,459,103660,0.145999,0.07,1,230745,230286,459
16206321,2,1.98656,459,103660,0.1492,0.03,1,230747,230288,459
16209241,2,1.99731,459,103660,0.14984,0.71,1,230749,230290,459
16212161,2,1.99946,459,103660,0.149968,0.73,1,230751,230292,459
16215081,2,1.99989,459,103660,0.149994,0.69,1,230753,230294,459
16218001,26,30,454,105120,0.229999,0.69,1,230785,230331,454
16220921,6.8,6,456,105120,0.214,0.73,1,230787,230331,456
16223841,2.96,2.8,456,105120,0.2108,0.43,1,230789,230333,456
16226761,32.592,41.36,445,105120,0.37016,0.43,1,230829,230384,445
16229681,8.1184,8.272,447,105120,0.434032,0.47,1,230831,230384,447
16232601,76.8237,3.2544,539,105120,0.574806,0.35,1,230925,230386,539
16235521,20.1647,80.6509,445,106580,0.602961,0.39,1,230931,230486,445
16238441,159.233,21.7302,632,106580,0.160592,0,1,231125,230493,632
16241361,34.2466,172.346,425,106580,0.0321184,0,1,231128,230703,425
16244281,10.0493,37.6692,425,106580,0.0144237,0.01,1,231132,230707,425
16247201,3.60986,9.13384,425,108040,0.0108847,0.01,1,231134,230709,425
16250121,2.32197,1.82677,427,108040,0.0261769,0.05,1,231136,230709,427
16253041,2.06439,1.96535,427,108040,0.0292354,0.01,1,231138,230711,427
16255961,2.01288,1.99307,427,108040,0.0298471,0.08,1,231140,230713,427
16258881,2.00258,1.99861,427,108040,0.00596942,0.04,1,231142,230715,427
16261801,2.00052,1.99972,427,109500,0.0651939,0.07,1,231144,230717,427
16264721,2.0001,1.99994,427,109500,0.0770388,0.09,1,231146,230719,427
16267641,2.00002,1.99999,427,109500,0.0714078,0.09,1,231148,230721,427
16270561,2,2,427,109500,0.0702816,0.09,1,231150,230723,427
16273481,2,0.4,429,109500,0.0700563,0.09,1,231152,230723,429
16276401,2,1.68,429,109500,0.0860113,0.11,1,231154,230725,429
16279321,2,1.936,429,110960,0.0892023,0.11,1,231156,230727,429
16282241,2,1.9872,429,110960,0.0898404,0.11,1,231158,230729,429
16285161,2,1.99744,429,110960,0.0899681,0.11,1,231160,230731,429
16288081,2,1.99949,429,110960,0.0899936,0.13,1,231162,230733,429
16291001,2,1.9999,429,110960,0.0899987,0.13,1,231164,230735,429
16293921,2,1.99998,429,110960,0.106,0.13,1,231166,230737,429
16296841,2,2,429,110960,0.1092,0.13,1,231168,230739,429
16299761,2,2,429,112420,0.10984,0.13,1,231170,230741,429
16302681,2,2,429,112420,0.109968,0.13,1,231172,230743,429
16305601,2,0.4,431,112420,0.109994,0.15,1,231174,230743,431
16308521,2,1.68,431,112420,0.109999,0.15,1,231176,230745,431
16311441,2,1.936,431,112420,0.11,0.15,1,231178,230747,431
16314361,2,1.9872,431,112420,0.126,0.15,1,231180,230749,431
16317281,2,1.99744,431,112420,0.1292,0.15,1,231182,230751,431
16320201,2,1.99949,431,112420,0.12984,0.25,1,231184,230753,431
16323121,25.2,25.9999,430,112420,0.177968,0.21,1,231215,230785,430
16326041,6.64,6.79998,430,113880,0.187594,0.21,1,231217,230787,430
16328961,2.928,2.96,430,113880,0.189519,0.41,1,231219,230789,430
16331881,47.7856,32.592,449,113880,0.477904,0.45,1,231278,230829,449
16334801,11.1571,8.1184,449,113880,0.551581,0.61,1,231280,230831,449
16337721,79.8314,76.8237,452,113880,0.614316,0.61,1,231377,230925,452
16340641,21.5663,15.3647,459,113880,0.626863,0.61,1,231384,230925,459
16343561,133.913,7.87295,615,115340,0.805373,0.05,2,231546,230931,615
16346481,29.9827,156.775,425,115340,0.841075,0,2,231550,231125,425
16349401,9.19653,33.7549,426,115340,0.816215,0.01,2,231554,231128,426
16352321,4.23931,9.95098,425,115340,0.827243,0.01,2,231557,231132,425
16355241,2.44786,3.5902,425,115340,0.797449,0.03,2,231559,231134,425
16358161,2.08957,2.31804,425,115340,0.82349,0.03,2,231561,231136,425
16361081,2.01791,2.06361,425,115340,0.796698,0.03,2,231563,231138,425
16364001,2.00358,2.01272,425,115340,0.79134,0,2,231565,231140,425
16366921,2.00072,2.00254,425,116800,0.790268,0,2,231567,231142,425
16369841,2.00014,0.400509,427,116800,0.790054,0.08,2,231569,231142,427
16372761,2.00003,1.6801,427,116800,0.790011,0.08,2,231571,231144,427
16375681,2.00001,1.93602,427,116800,0.790002,0.07,2,231573,231146,427
16378601,2,1.9872,427,116800,0.79,0.07,2,231575,231148,427
16381521,2,1.99744,427,116800,0.806,0.07,2,231577,231150,427
16384441,2,1.99949,427,116800,0.8092,0.09,2,231579,231152,427
16387361,2,1.9999,427,116800,0.80984,0.09,2,231581,231154,427
16390281,2,1.99998,427,116800,0.809968,0.09,2,231583,231156,427
16393201,2,2,427,116800,0.809994,0.09,2,231585,231158,427
16396121,2,2,427,118260,0.809999,0.09,2,231587,231160,427
16399041,2,2,427,118260,0.81,0.09,2,231589,231162,427
16401961,2,2,427,118260,0.81,0.11,2,231591,231164,427
16404881,2,2,427,118260,0.802,0.11,2,231593,231166,427
16407801,2,2,427,118260,0.7684,0.11,2,231595,231168,427
16410721,2,0.4,429,118260,0.80968,0.11,2,231597,231168,429
16413641,2,1.68,429,118260,0.817936,0.11,2,231599,231170,429
16416561,2,1.936,429,118260,0.819587,0.11,2,231601,231172,429
16419481,2,1.9872,429,118260,0.819917,0.11,2,231603,231174,429
16422401,2,1.99744,429,118260,0.811983,0.11,2,231605,231176,429
16425321,2,1.99949,429,118260,0.810397,0.13,2,231607,231178,429
16428241,2,1.9999,429,118260,0.810079,0.13,2,231609,231180,429
16431161,2,1.99998,429,119720,0.810016,0.13,2,231611,231182,429
16434081,26,2,459,119720,0.842003,0.19,2,231643,231184,459
16437001,6.8,25.2,430,119720,0.848401,0.19,2,231645,231215,430
16439921,2.96,6.64,430,119720,0.85768,0.19,2,231647,231217,430
16442841,2.192,2.928,430,119720,0.859536,0.55,2,231649,231219,430
16898961,379,433,428,5840,0.15,0.09,1,234027,233599,428
16910641,2,0,427,94900,0.81,0.15,2,234454,234027,427
16913561,2,0,429,96360,0.81,0.15,2,234456,234027,429
16916481,2,0,431,96360,0.81,0.15,2,234458,234027,431
16919401,2,0,433,96360,0.778,0.15,2,234460,234027,433
16922321,2,0,435,96360,0.7876,0.15,2,234462,234027,435
16925241,2,0,437,96360,0.80552,0.15,2,234464,234027,437
16928161,2,0,439,96360,0.825104,0.15,2,234466,234027,439
16931081,2,0,441,96360,0.829021,0.15,2,234468,234027,441
16934001,2,0,443,96360,0.829804,0.15,2,234470,234027,443
16936921,2,0,445,96360,0.829961,0.15,2,234472,234027,445
16939841,2,0,447,96360,0.829992,0.15,2,234474,234027,447
16942761,2,0,449,96360,0.829998,0.15,2,234476,234027,449
16945681,2,0,451,97820,0.83,0.15,2,234478,234027,451
16948601,2,0,453,97820,0.83,0.15,2,234480,234027,453
16951521,2,0,455,97820,0.83,0.15,2,234482,234027,455
16954441,2,0,457,97820,0.83,0.15,2,234484,234027,457
16957361,2,0,459,97820,0.83,0.15,2,234486,234027,459
16960281,2,0,461,97820,0.846,0.15,2,234488,234027,461
16963201,2,0,463,97820,0.8492,0.15,2,234490,234027,463
16966121,2,0,465,97820,0.84984,0.15,2,234492,234027,465
16969041,2,0,467,99280,0.849968,0.15,2,234494,234027,467
16971961,2,0,469,99280,0.849994,0.15,2,234496,234027,469
16974881,5.2,0,475,99280,0.849999,0.15,2,234502,234027,475
16977801,4.24,0,479,99280,0.866,0.15,2,234506,234027,479
16980721,6.448,0,486,99280,0.8852,0.15,2,234513,234027,486
16983641,6.0896,0,492,99280,0.90504,0.15,2,234519,234027,492
16986561,9.21792,0,502,99280,0.893008,0.15,2,234529,234027,502
17298321,80,97,423,74460,0.33,0.28,1,236480,236057,423
17301241,35.2,28.2,436,75920,0.25,0.19,1,236504,236068,436
17304161,21.44,17.64,439,77380,0.234,0.29,1,236522,236083,439
17307081,14.688,13.128,440,77380,0.2788,0.21,1,236535,236095,440
17308541,169.338,17.8256,629,78840,0.33576,0.04,1,236743,236114,629
17311461,51.4675,162.765,452,78840,0.331152,0.55,1,236765,236313,452
17314381,17.4935,42.953,448,78840,0.34623,0.57,1,236774,236326,448
17317301,15.4987,14.9906,455,78840,0.333246,0.03,1,236789,236334,455
17320221,29.4997,55.7981,422,78840,0.330649,0.03,1,236822,236400,422
17323141,7.49995,11.1596,424,78840,0.33013,0.03,1,236824,236400,424
17326061,3.09999,2.23192,426,80300,0.298026,0.03,1,236826,236400,426
17328981,2.22,0.446385,428,80300,0.259605,0.03,1,236828,236400,428
17331901,2.044,0.089277,430,80300,0.219921,0.03,1,236830,236400,430
17334821,2.0088,0.0178554,432,80300,0.179984,0.03,1,236832,236400,432
17337741,2.00176,0.00357108,434,80300,0.171997,0.03,1,236834,236400,434
17340661,2.00035,0.000714216,436,80300,0.186399,0.03,1,236836,236400,436
17343581,2.00007,0.000142843,438,80300,0.18928,0.03,1,236838,236400,438
17346501,2.00001,2.85686e-05,440,80300,0.189856,0.03,1,236840,236400,440
17349421,2,5.71372e-06,442,80300,0.189971,0.03,1,236842,236400,442
17352341,2,1.14274e-06,444,81760,0.189994,0.03,1,236844,236400,444
17355261,53.2,2.28549e-07,510,81760,0.253999,0.33,1,236910,236400,510
17358181,12.24,64,432,81760,0.2668,0.33,1,236912,236480,432
17361101,4.048,12.8,434,81760,0.26936,0.33,1,236914,236480,434
17364021,2.4096,2.56,436,81760,0.285872,0.33,1,236916,236480,436
17366941,2.08192,0.512,438,81760,0.289174,0.33,1,236918,236480,438
17369861,2.01638,0.1024,440,81760,0.289835,0.33,1,236920,236480,440
17372781,2.00328,0.02048,442,81760,0.289967,0.33,1,236922,236480,442
17375701,10.8007,0.004096,455,81760,0.305993,0.23,1,236935,236480,455
17378621,3.76013,19.2008,433,81760,0.277199,0.23,1,236937,236504,433
17381541,16.752,18.2402,435,81760,0.30344,0.29,1,236957,236522,435
17384461,12.1504,14.048,433,81760,0.292688,0.29,1,236968,236535,433
17385921,163.23,2.80961,634,81760,0.434538,0.35,1,237169,236535,634
17388841,59.046,166.962,459,83220,0.494907,0.33,1,237202,236743,459
17391761,18.2092,50.9924,445,83220,0.522982,0.35,1,237210,236765,445
17394681,14.8418,17.3985,450,83220,0.544596,0.33,1,237224,236774,450
17397601,24.5684,15.4797,462,83220,0.548919,0.33,1,237251,236789,462
17400521,6.51367,29.4959,431,83220,0.549784,0.33,1,237253,236822,431
17403441,2.90273,7.49919,431,83220,0.549957,0.29,1,237255,236824,431
17406361,2.18055,3.09984,431,83220,0.549991,0.25,1,237257,236826,431
17409281,2.03611,2.21997,431,83220,0.549998,0.21,1,237259,236828,431
17412201,2.00722,2.04399,431,83220,0.55,0.17,1,237261,236830,431
17415121,2.00144,2.0088,431,83220,0.55,0.17,1,237263,236832,431
17418041,2.00029,2.00176,431,83220,0.55,0.19,1,237265,236834,431
17420961,2.00006,2.00035,431,84680,0.55,0.19,1,237267,236836,431
17423881,2.00001,2.00007,431,84680,0.55,0.19,1,237269,236838,431
17426801,2,2.00001,431,84680,0.55,0.19,1,237271,236840,431
17429721,2,2,431,84680,0.55,0.19,1,237273,236842,431
17432641,2,0.400001,433,84680,0.55,0.19,1,237275,236842,433
17435561,56.4,1.68,501,84680,0.566,0.27,1,237345,236844,501
17438481,12.88,53.136,437,84680,0.5692,0.27,1,237347,236910,437
17441401,4.176,12.2272,437,84680,0.58584,0.27,1,237349,236912,437
17444321,2.4352,4.04544,437,84680,0.589168,0.29,1,237351,236914,437
17447241,2.08704,2.40909,437,84680,0.589834,0.29,1,237353,236916,437
17450161,2.01741,2.08182,437,84680,0.589967,0.29,1,237355,236918,437
17453081,2.00348,2.01636,437,84680,0.589993,0.29,1,237357,236920,437
17456001,10.0007,2.00327,447,84680,0.589999,0.31,1,237369,236922,447
17458921,3.60014,10.8007,436,84680,0.59,0.27,1,237371,236935,436
17461841,16.72,3.76013,454,86140,0.606,0.31,1,237391,236937,454
17464761,13.744,16.752,447,86140,0.6252,0.29,1,237404,236957,447
17466221,163.549,12.1504,637,86140,0.67704,0.47,1,237605,236968,637
17469141,39.9098,163.23,445,86140,0.719408,0.51,1,237614,237169,445
17472061,37.582,59.046,449,86140,0.743882,0.53,1,237651,237202,449
17474981,13.9164,18.2092,449,86140,0.748776,0.55,1,237659,237210,449
17477901,14.7833,14.8418,450,86140,0.765755,0.55,2,237674,237224,450
17480821,23.7567,24.5684,449,86140,0.817151,0.55,2,237700,237251,449
17483741,6.35133,6.51367,449,86140,0.79543,0.55,2,237702,237253,449
17486661,2.87027,2.90273,449,86140,0.823086,0.55,2,237704,237255,449
17489581,2.17405,2.18055,449,86140,0.796617,0.55,2,237706,237257,449
17492501,2.03481,2.03611,449,86140,0.791323,0.55,2,237708,237259,449
17495421,2.00696,2.00722,449,86140,0.790265,0.55,2,237710,237261,449
17498341,2.00139,2.00144,449,86140,0.790053,0.55,2,237712,237263,449
17501261,2.00028,2.00029,449,86140,0.790011,0.55,2,237714,237265,449
17504181,2.00006,0.400058,451,87600,0.790002,0.55,2,237716,237265,451
17507101,2.00001,1.68001,451,87600,0.79,0.55,2,237718,237267,451
17510021,2,1.936,451,87600,0.79,0.55,2,237720,237269,451
17512941,2,1.9872,451,87600,0.79,0.55,2,237722,237271,451
17515861,2,1.99744,451,87600,0.79,0.55,2,237724,237273,451
17518781,57.2,1.99949,520,87600,0.822,0.57,2,237795,237275,520
17521701,13.04,56.3999,452,87600,0.8284,0.57,2,237797,237345,452
17524621,4.208,12.88,452,87600,0.82968,0.59,2,237799,237347,452
17527541,2.4416,4.176,452,87600,0.829936,0.59,2,237801,237349,452
17530461,2.08832,2.4352,452,87600,0.829987,0.59,2,237803,237351,452
17533381,2.01766,2.08704,452,87600,0.829997,0.59,2,237805,237353,452
17536301,2.00353,2.01741,452,87600,0.829999,0.59,2,237807,237355,452
17539221,10.0007,2.00348,462,87600,0.83,0.59,2,237819,237357,462
17542141,3.60014,10.0007,452,87600,0.83,0.59,2,237821,237369,452
17545061,2.32003,3.60014,452,87600,0.83,0.61,2,237823,237371,452
17547981,16.464,16.72,452,87600,0.83,0.63,2,237843,237391,452
17550901,13.6928,13.744,452,87600,0.846,0.69,2,237856,237404,452
17553821,173.939,163.549,465,87600,0.8812,0.73,2,238070,237605,465
17556741,65.9877,39.9098,495,87600,0.93624,0.75,2,238109,237614,495
17568421,2,26,462,87600,0.93,0.79,2,238162,237700,462
17571341,2,6.8,462,87600,0.93,0.83,2,238164,237702,462
17574261,2,2.96,462,87600,0.93,0.79,2,238166,237704,462
17577181,2,2.192,462,87600,0.93,0.79,2,238168,237706,462
17580101,2,2.0384,462,87600,0.93,0.79,2,238170,237708,462
17583021,2,2.00768,462,87600,0.93,0.79,2,238172,237710,462
17585941,2,2.00154,462,87600,0.93,0.79,2,238174,237712,462
17588861,2,2.00031,462,87600,0.93,0.79,2,238176,237714,462
17591781,2,2.00006,462,89060,0.93,0.79,2,238178,237716,462
17594701,2,2.00001,462,89060,0.93,0.79,2,238180,237718,462
17597621,2,2,462,89060,0.93,0.79,2,238182,237720,462
17600541,2,2,462,89060,0.93,0.79,2,238184,237722,462
17603461,2,2,462,89060,0.93,0.83,2,238186,237724,462
18048761,308,340,459,59380,0.19,0.57,1,241077,240618,459
18057521,153.6,171.2,445,59650,0.35,0.09,1,241192,240747,445
18100841,141.12,159.84,426,52605,0.59,0.07,1,241330,240904,426
18103761,62.624,38.368,461,51822,0.574,0.19,1,241373,240912,461
18106681,38.1248,41.2736,451,50257,0.5868,0.23,1,241405,240954,451
18109601,27.625,23.4547,457,48691,0.62136,0.25,1,241430,240973,457
18112521,15.925,27.0909,442,47126,0.628272,0.23,1,241443,241001,442
18115441,11.985,16.6182,439,45560,0.613654,0.2,1,241454,241015,439
18118361,46.397,13.7236,481,43800,0.434731,0.19,1,241509,241028,481
18121281,10.8794,41.9447,434,43800,0.398946,0.19,1,241511,241077,434
18124201,3.77588,8.38895,436,43800,0.391789,0.19,1,241513,241077,436
18127121,2.35518,1.67779,438,43800,0.390358,0.19,1,241515,241077,438
18130041,2.07104,0.335558,440,43800,0.390072,0.19,1,241517,241077,440
18132961,2.01421,0.0671115,442,43800,0.358014,0.19,1,241519,241077,442
18135881,2.00284,0.0134223,444,43800,0.335603,0.19,1,241521,241077,444
18138801,2.00057,0.00268446,446,43800,0.331121,0.19,1,241523,241077,446
18141721,54.0001,0.000536892,513,43800,0.330224,0.38,1,241590,241077,513
18144641,26,69.6001,445,43800,0.346045,0.39,1,241609,241164,445
18147561,39.6,36.32,460,45260,0.269209,0.43,1,241652,241192,460
18150481,13.52,26.464,443,46720,0.173842,0.69,1,241659,241216,443
18153401,103.504,19.6928,551,48180,0.202768,0.57,1,241785,241234,551
18156321,77.5008,115.139,483,49640,0.272554,0.63,1,241856,241373,483
18159241,45.9002,68.6277,464,49640,0.318511,0.61,1,241894,241430,464
18162161,51.58,32.9255,493,49640,0.375702,0.39,1,241947,241454,493
18165081,11.916,52.1851,438,51100,0.38714,0.39,1,241949,241511,438
18168001,3.9832,12.037,438,51100,0.389428,0.39,1,241951,241513,438
18170921,2.39664,4.0074,438,51100,0.389886,0.39,1,241953,241515,438
18173841,2.07933,2.40148,438,51100,0.389977,0.35,1,241955,241517,438
18176761,2.01587,2.0803,438,51100,0.389995,0.33,1,241957,241519,438
18179681,2.00317,2.01606,438,51100,0.405999,0.33,1,241959,241521,438
18182601,2.00063,2.00321,438,51100,0.4092,0.33,1,241961,241523,438
18185521,54.0001,54.0006,438,51100,0.47384,0.35,1,242028,241590,438
18188441,23.6,26.0001,435,51100,0.534768,0.35,1,242044,241609,435
18191361,32.72,5.20003,470,51100,0.562954,0.25,1,242079,241609,470
18194281,8.144,35.44,429,51100,0.568591,0.15,1,242081,241652,429
18197201,6.4288,12.688,428,51100,0.569718,0.15,1,242087,241659,428
18200121,104.486,2.5376,557,51100,0.697944,0.21,1,242216,241659,557
18203041,22.4972,101.308,433,51100,0.723589,0.29,1,242218,241785,433
18205961,64.4994,77.0615,437,51100,0.808718,0.33,2,242293,241856,437
18208881,45.6999,45.8123,440,51100,0.841744,0.39,2,242334,241894,440
18360721,55,63,470,52560,0.13,1,1,243701,243231,470
18363641,57.4,47.8,484,52560,0.026,1,1,243759,243275,484
18366561,21.08,19.96,483,52560,0.0452,1,1,243771,243288,483
18369481,38.616,44.792,475,52560,0.18504,1,1,243814,243339,475
18372401,14.9232,14.5584,477,52560,0.141008,1,1,243823,243346,477
18375321,6.98464,7.71168,476,52560,0.148202,1,1,243828,243352,476
18378241,15.7969,11.1423,482,52560,0.0696403,1,1,243846,243364,482
18381161,15.1594,15.0285,481,52560,0.0699281,1,1,243861,243380,481
18384081,15.0319,15.8057,480,52560,0.0699856,1,1,243876,243396,480
18387001,16.6064,14.3611,483,52560,0.253997,1,1,243893,243410,483
18389921,12.1213,14.0722,480,52560,0.330799,1,1,243904,243424,480
18392841,16.8243,14.8144,483,52560,0.26616,1,1,243922,243439,483
18395761,8.16485,11.7629,478,52560,0.245232,0.97,1,243928,243450,478
18398681,16.833,19.9526,475,52560,0.185046,1,1,243947,243472,475
18401601,14.5666,14.3905,476,52560,0.157009,1,1,243961,243485,476
18404521,12.5133,14.0781,474,52560,0.135402,0.46,1,243973,243499,474
18407441,76.1027,104.416,439,52560,0.24308,0.36,1,244065,243626,439
18410361,30.4205,36.8831,438,52560,0.136616,0.13,1,244084,243646,438
18413281,40.4841,51.3766,426,52560,0.779323,0,2,244127,243701,426
18416201,52.0968,56.6753,423,52560,0.611865,0.05,1,244182,243759,423
18419121,19.2194,20.9351,422,52560,0.514373,0.22,1,244193,243771,422
18422041,43.8439,38.587,429,52560,0.430875,0.13,1,244243,243814,429
18424961,13.5688,14.9174,426,52560,0.350175,0.15,1,244249,243823,426
18427881,5.91375,6.98348,425,52560,0.350035,0.05,1,244253,243828,425
18430801,15.5828,15.7967,425,52560,0.238007,0.07,1,244271,243846,425
18433721,15.1166,15.1593,425,52560,0.167601,0.07,1,244286,243861,425
18436641,15.0233,15.0319,425,52560,0.20152,0.3,1,244301,243876,425
18439561,27.0047,16.6064,438,52560,0.224304,0.35,1,244331,243893,438
18442481,11.8009,12.1213,435,52560,0.212861,0.25,1,244339,243904,435
18445401,14.3602,16.8243,432,52560,0.210572,0.24,1,244354,243922,432
18448321,6.87204,8.16485,431,52560,0.194114,0.17,1,244359,243928,431
18451241,14.9744,16.833,429,52560,0.110823,0.15,1,244376,243947,429
18454161,13.3949,14.5666,428,52560,0.0221646,0.13,1,244389,243961,428
18457081,10.679,12.5133,426,52560,0.00443291,0.27,1,244399,243973,426
18460001,78.1358,76.1027,429,52560,0.000886583,0.11,1,244494,244065,429
18462921,25.2272,30.4205,422,52560,0.120177,0.94,1,244506,244084,422
18465841,72.2454,40.4841,463,52560,0.192035,0.57,1,244590,244127,463
18468761,44.0491,52.0968,445,52560,0.238407,0.49,1,244627,244182,445
18471681,23.2098,19.2194,452,52560,0.247681,0.41,1,244645,244193,452
18474601,34.242,43.8439,439,52560,0.297536,0.33,1,244682,244243,439
18477521,8.44839,13.5688,435,52560,0.307507,0.35,1,244684,244249,435
18480441,3.28968,5.91375,433,52560,0.309501,0.21,1,244686,244253,433
18483361,12.6579,15.5828,430,52560,0.3099,0.15,1,244701,244271,430
18486281,16.1316,15.1166,432,52560,0.32598,0.21,1,244718,244286,432
18489201,13.6263,15.0233,430,52560,0.361196,0.23,1,244731,244301,430
18492121,28.3253,27.0047,432,52560,0.360239,0.21,1,244763,244331,432
18495041,12.0651,11.8009,432,52560,0.352048,0.21,1,244771,244339,432
18497961,11.213,14.3602,428,52560,0.38241,0.19,1,244782,244354,428
18500881,5.4426,6.87204,427,52560,0.388482,0.09,1,244786,244359,427
18503801,10.6885,14.9744,422,52560,0.373696,0,1,244798,244376,422
18506721,12.5377,13.3949,422,52560,0.322739,0,1,244811,244389,422
18509641,11.3075,10.679,423,52560,0.232548,0,1,244822,244399,423
18512561,81.4615,78.1358,427,52560,0.0545096,0.15,1,244921,244494,427
18515481,26.6923,25.2272,428,52560,0.0509019,0.21,1,244934,244506,428
18518401,74.1385,72.2454,430,52560,0.11418,0.25,1,245020,244590,430
18521321,46.0277,44.0491,432,54020,0.158836,0.25,1,245059,244627,432
18524241,26.0055,23.2098,435,54020,0.167767,0.31,1,245080,244645,435
18527161,34.8011,34.242,435,54020,0.217553,0.31,1,245117,244682,435
18530081,8.56022,8.44839,435,54020,0.243511,0.31,1,245119,244684,435
18533001,3.31204,3.28968,435,54020,0.280702,0.31,1,245121,244686,435
18535921,14.2624,12.6579,437,54020,0.30414,0.33,1,245138,244701,437
18538841,18.0525,16.1316,439,54020,0.340828,0.37,1,245157,244718,439
18541761,13.2105,13.6263,438,54020,0.316166,0.36,1,245169,244731,438
18544681,29.0421,28.3253,439,54020,0.327233,0.35,1,245202,244763,439
18547601,13.0084,12.0651,440,54020,0.345447,0.39,1,245211,244771,440
18550521,10.6017,11.213,439,54020,0.333089,0.39,1,245221,244782,439
18553441,6.12034,5.4426,440,54020,0.362618,0.37,1,245226,244786,440
18556361,9.22407,10.6885,438,54020,0.336524,0.31,1,245236,244798,438
18559281,6.64481,12.5377,431,54020,0.331305,0.21,1,245242,244811,431
18562201,9.32896,11.3075,430,54020,0.330261,0.01,1,245252,244822,430
18565121,75.4658,81.4615,423,54020,0.346052,0.05,1,245344,244921,423
18568041,26.2932,26.6923,424,54020,0.38121,0.13,1,245358,244934,424
18570961,78.0586,74.1385,429,54020,0.500242,0.13,1,245449,245020,429
18573881,46.0117,14.8277,467,55480,0.604048,0.17,1,245487,245020,467
18576801,27.6023,34.1655,451,55480,0.60881,0.17,1,245510,245059,451
18579721,38.3205,23.6331,471,55480,0.625762,0.23,1,245551,245080,471
18582641,9.26409,34.3266,436,55480,0.629152,0.25,1,245553,245117,436
18585561,3.45282,8.46532,436,55480,0.62983,0.29,1,245555,245119,436
18588481,16.6906,3.29306,454,55480,0.629966,0.31,1,245575,245121,454
18591401,17.7381,14.2586,455,55480,0.613993,0.35,1,245593,245138,455
18594321,13.1476,18.0517,448,55480,0.610799,0.31,1,245605,245157,448
18597241,29.8295,13.2103,470,55480,0.64216,0.33,1,245639,245169,470
18600161,13.1659,29.0421,446,56940,0.696432,0.35,1,245648,245202,446
18603081,11.4332,13.0084,448,56940,0.739286,0.33,1,245659,245211,448
18606001,5.48664,10.6017,442,56940,0.747857,0.37,1,245663,245221,442
18608921,9.09733,6.12034,447,56940,0.749571,0.33,1,245673,245226,447
18611841,6.61947,9.22407,443,56940,0.749914,0.33,1,245679,245236,443
18614761,9.32389,6.64481,447,56940,0.749983,0.33,1,245689,245242,447
18617681,76.2648,9.32896,530,56940,0.781997,0.35,2,245782,245252,530
18620601,26.453,75.4658,452,56940,0.788399,0.39,2,245796,245344,452
18623521,85.2906,26.2932,538,56940,0.83768,0.53,2,245896,245358,538
18626441,18.6581,78.0586,449,58400,0.847536,0.63,2,245898,245449,449
18629361,37.3316,46.0117,453,58400,0.929507,0.61,2,245940,245487,453
18632281,25.0663,27.6023,452,58400,0.945901,0.63,2,245962,245510,452
18635201,38.6133,38.3205,453,58400,0.93318,0.63,2,246004,245551,453
18825001,15,11,492,75920,0.81,1,2,247397,246905,492
18827921,15,35.8,465,75920,0.794,1,2,247412,246947,465
18830841,15,15.96,469,75920,0.7588,1,2,247427,246958,469
18833761,14.2,9.592,475,75920,0.71976,1,1,247441,246966,475
18836681,14.04,1.9184,489,77380,0.711952,1,1,247455,246966,489
18839601,21.208,7.58368,503,77380,0.69439,1,1,247478,246975,503
18842521,13.8416,12.7167,501,77380,0.674878,1,1,247490,246989,501
18845441,14.7683,10.5433,506,77380,0.654976,1,1,247505,246999,506
18848361,14.9537,26.9087,490,77380,0.818995,1,2,247520,247030,490
18851281,14.1907,18.1817,488,78840,0.835799,1,2,247534,247046,488
18862961,14,15,492,80300,0.75,1,2,247591,247099,492
18865881,19.6,15.8,497,80300,0.686,1,1,247612,247115,497
18868801,16.72,15.96,497,80300,0.6412,1,1,247628,247131,497
18871721,16.144,15.192,498,80300,0.55224,1,1,247644,247146,498
18874641,21.6288,44.6384,469,81760,0.478448,1,1,247667,247198,469
18877561,24.3258,20.1277,480,81760,0.39969,1,1,247692,247212,480
18880481,61.6652,4.02554,551,81760,0.391938,0.9,1,247763,247212,551
18883401,18.733,64.8051,479,81760,0.566388,0.95,1,247771,247292,479
18886321,15.7466,20.161,485,83220,0.601278,1,1,247786,247301,485
18889241,11.9493,17.6322,479,83220,0.592256,0.99,1,247797,247318,479
18892161,29.5899,14.7264,499,83220,0.782451,0.81,2,247831,247332,499
18895081,7.51797,34.1453,462,83220,0.82049,0.83,2,247833,247371,462
18898001,9.50359,15.6291,461,84680,0.764098,0.81,2,247843,247382,461
18900921,13.9007,15.1258,461,84680,0.70482,0.79,1,247858,247397,461
18903841,13.9801,15.0252,460,84680,0.660964,0.75,1,247872,247412,460
18906761,12.396,15.005,457,86140,0.636193,0.71,1,247884,247427,457
18909681,12.8792,14.201,456,86140,0.535239,0.71,1,247897,247441,456
18912601,12.9758,2.8402,469,86140,0.419048,0.71,1,247910,247441,469
18915521,20.1952,11.768,477,86140,0.26781,0.69,1,247932,247455,477
18918441,12.839,20.7536,465,87600,0.613562,0.67,1,247943,247478,465
18921361,12.9678,13.7507,466,87600,0.594712,0.65,1,247956,247490,466
18933041,10,14,465,89060,0.71,0.86,1,248013,247548,465
18935961,10,14,461,89060,0.718,0.78,1,248023,247562,461
18938881,11.6,14.8,458,90520,0.8556,0.78,2,248035,247577,458
18941801,11.92,2.96,470,90520,0.91512,0.75,2,248047,247577,470
18944721,15.184,11.792,472,90520,0.959024,0.67,2,248063,247591,472
18947641,12.6368,19.1584,463,91980,0.935805,0.63,2,248075,247612,463
19220661,241,334,455,61320,0.03,0.59,1,249839,249384,455
19227521,106.6,130.8,448,83220,0.254,0.55,1,249912,249464,448
19230441,29.32,29.36,454,84680,0.2348,0.55,1,249922,249468,454
19233361,7.464,5.872,456,84680,0.29496,0.55,1,249924,249468,456
19236281,7.0928,1.1744,463,86140,0.274992,0.74,1,249931,249468,463
19239201,11.8186,11.4349,462,86140,0.254998,0.66,1,249944,249482,462
19242121,14.3637,16.687,459,86140,0.379,0.61,1,249959,249500,459
19245041,51.6727,16.9374,503,86140,0.3238,0.11,1,250020,249517,503
19247961,11.9345,68.1875,424,87600,0.31276,0.11,1,250022,249598,424
19250881,3.98691,13.6375,426,87600,0.342552,0.11,1,250024,249598,426
19253801,2.39738,2.7275,428,87600,0.34851,0.11,1,250026,249598,428
19256721,2.07948,0.5455,430,87600,0.349702,0.11,1,250028,249598,430
19259641,2.0159,0.1091,432,87600,0.33394,0.11,1,250030,249598,432
19262561,2.00318,0.02182,434,89060,0.346788,0.11,1,250032,249598,434
19264021,161.201,0.004364,635,89060,0.285358,0.03,1,250233,249598,635
19266941,54.6401,192.801,422,89060,0.145072,0.03,1,250261,249839,422
19269861,12.528,38.5602,424,89060,0.117014,0.03,1,250263,249839,424
19272781,4.1056,7.71203,426,90520,0.0794029,0.03,1,250265,249839,426
19275701,2.42112,1.54241,428,90520,0.0398806,0.03,1,250267,249839,428
19278621,2.08422,0.308481,430,90520,0.00797611,0.03,1,250269,249839,430
19281541,2.01684,0.0616963,432,90520,0.00959522,0.03,1,250271,249839,432
19284461,2.00337,0.0123393,434,91980,0.00991904,0.03,1,250273,249839,434
19287381,2.00067,0.00246785,436,91980,0.0259838,0.03,1,250275,249839,436
19290301,2.00013,0.00049357,438,91980,0.0291968,0.03,1,250277,249839,438
19293221,2.00003,9.8714e-05,440,91980,0.0298394,0.03,1,250279,249839,440
19296141,2.00001,1.97428e-05,442,91980,0.0299679,0.03,1,250281,249839,442
19299061,2,3.94856e-06,444,93440,0.0459936,0.03,1,250283,249839,444
19301981,2,7.89712e-07,446,93440,0.0491987,0.03,1,250285,249839,446
19304901,47.6,1.57942e-07,505,93440,0.0658397,0.31,1,250344,249839,505
19307821,11.12,58.4,434,93440,0.0691679,0.31,1,250346,249912,434
19310741,3.824,11.68,436,93440,0.0698336,0.31,1,250348,249912,436
19313661,6.3648,2.336,443,94900,0.133967,0.23,1,250355,249912,443
19316581,2.87296,8.4672,435,94900,0.146793,0.31,1,250357,249922,435
19319501,2.17459,3.29344,435,94900,0.165359,0.27,1,250359,249924,435
19322421,6.03492,6.25869,435,94900,0.185072,0.25,1,250366,249931,435
19325341,14.007,11.6517,438,94900,0.157014,0.41,1,250382,249944,438
19328261,14.0014,14.3303,437,94900,0.151403,0.31,1,250396,249959,437
19331181,52.4003,51.6661,438,94900,0.134281,0.31,1,250458,250020,438
19334101,12.0801,10.3332,440,96360,0.130856,0.31,1,250460,250020,440
19337021,4.01601,3.66664,440,96360,0.130171,0.35,1,250462,250022,440
19339941,2.4032,2.33333,440,96360,0.162034,0.35,1,250464,250024,440
19342861,2.08064,2.06667,440,96360,0.184407,0.35,1,250466,250026,440
19345781,2.01613,2.01333,440,96360,0.156881,0.33,1,250468,250028,440
19348701,2.00323,2.00267,440,97820,0.167376,0.35,1,250470,250030,440
19351621,2.00065,2.00053,440,97820,0.169475,0.27,1,250472,250032,440
19354541,168.4,161.2,449,97820,0.361895,0.11,1,250682,250233,449
19357461,35.28,54.64,423,97820,0.400379,0.11,1,250684,250261,423
19360381,8.656,12.528,423,97820,0.408076,0.07,1,250686,250263,423
19363301,3.3312,4.1056,423,99280,0.441615,0.03,1,250688,250265,423
19366221,2.26624,2.42112,423,99280,0.416323,0,1,250690,250267,423
19369141,2.05325,2.08422,423,99280,0.411265,0.01,1,250692,250269,423
19372061,2.01065,2.01684,423,99280,0.410253,0.01,1,250694,250271,423
19374981,2.00213,0.403369,425,99280,0.410051,0.01,1,250696,250271,425
19377901,2.00043,1.68067,425,99280,0.42601,0.03,1,250698,250273,425
19380821,2.00009,1.93613,425,99280,0.429202,0.03,1,250700,250275,425
19383741,2.00002,1.98723,425,100740,0.42984,0.03,1,250702,250277,425
19386661,2,1.99745,425,100740,0.429968,0.03,1,250704,250279,425
19389581,2,1.99949,425,100740,0.429994,0.05,1,250706,250281,425
19392501,2,1.9999,425,100740,0.429999,0.05,1,250708,250283,425
19395421,2,1.99998,425,100740,0.43,0.07,1,250710,250285,425
19398341,50,47.6,428,100740,0.414,0.07,1,250772,250344,428
19401261,11.6,11.12,428,102200,0.4108,0.07,1,250774,250346,428
19404181,3.92,3.824,428,102200,0.41016,0.07,1,250776,250348,428
19407101,7.184,0.7648,436,102200,0.394032,0.15,1,250784,250348,436
19410021,3.0368,5.75296,431,102200,0.390806,0.15,1,250786,250355,431
19412941,2.20736,2.75059,431,102200,0.390161,0.17,1,250788,250357,431
19415861,5.24147,2.15012,435,102200,0.390032,0.19,1,250794,250359,435
19418781,13.8483,6.03002,444,102200,0.406006,0.15,1,250810,250366,444
19421701,11.5697,14.006,439,102200,0.425201,0.15,1,250821,250382,439
19424621,54.3139,14.0012,490,102200,0.44504,0.13,1,250886,250396,490
19427541,12.4628,52.4002,430,103660,0.449008,0.13,1,250888,250458,430
19430461,4.09256,12.08,430,103660,0.449802,0.13,1,250890,250460,430
19433381,2.41851,4.01601,430,103660,0.41796,0.17,1,250892,250462,430
19436301,2.0837,2.4032,430,103660,0.411592,0.19,1,250894,250464,430
19439221,2.01674,2.08064,430,103660,0.410318,0.15,1,250896,250466,430
19442141,2.00335,2.01613,430,103660,0.426064,0.15,1,250898,250468,430
19445061,2.00067,0.403226,432,103660,0.429213,0.17,1,250900,250468,432
19447981,2.00013,1.68065,432,105120,0.429843,0.17,1,250902,250470,432
19449441,161.2,1.93613,631,105120,0.637969,0.41,1,251103,250472,631
19452361,49.04,168.387,442,105120,0.695594,0.41,1,251124,250682,442
19455281,11.408,35.2774,442,105120,0.675119,0.41,1,251126,250684,442
19458201,3.8816,8.65549,442,105120,0.671024,0.41,1,251128,250686,442
19461121,2.37632,1.7311,444,105120,0.702205,0.45,1,251130,250686,444
19464041,2.07526,1.94622,444,105120,0.708441,0.41,1,251132,250688,444
19466961,2.01505,1.98924,444,105120,0.677688,0.41,1,251134,250690,444
19469881,2.00301,1.99785,444,105120,0.671538,0.41,1,251136,250692,444
19472801,2.0006,1.99957,444,106580,0.670308,0.41,1,251138,250694,444
19475721,2.00012,1.99991,444,106580,0.670061,0.43,1,251140,250696,444
19478641,2.00002,1.99998,444,106580,0.670012,0.43,1,251142,250698,444
19481561,2,2,444,106580,0.670002,0.43,1,251144,250700,444
19484481,2,2,444,106580,0.670001,0.43,1,251146,250702,444
19487401,2,2,444,106580,0.686,0.43,1,251148,250704,444
19490321,2,2,444,106580,0.6892,0.43,1,251150,250706,444
19493241,2,2,444,106580,0.68984,0.43,1,251152,250708,444
19496161,2,2,444,106580,0.689968,0.41,1,251154,250710,444
19499081,46.8,50,440,106580,0.689994,0.41,1,251212,250772,440
19502001,10.96,10,442,108040,0.721999,0.41,1,251214,250772,442
19504921,3.792,3.6,442,108040,0.7284,0.41,1,251216,250774,442
19507841,7.1584,2.32,448,108040,0.71368,0.39,1,251224,250776,448
19510761,3.03168,6.864,442,108040,0.710736,0.39,1,251226,250784,442
19513681,2.20634,2.9728,442,108040,0.710147,0.39,1,251228,250786,442
19516601,5.24127,2.19456,446,108040,0.710029,0.39,1,251234,250788,446
19519521,14.6483,5.23891,457,108040,0.694006,0.41,1,251251,250794,457
19522441,11.7297,13.8478,452,108040,0.706801,0.43,1,251262,250810,452
19525361,54.3459,11.5696,506,108040,0.72536,0.45,1,251327,250821,506
19528281,12.4692,54.3139,443,108040,0.729072,0.45,1,251329,250886,443
19531201,4.09384,12.4628,443,108040,0.729814,0.45,1,251331,250888,443
19534121,2.41877,4.09256,443,109500,0.729963,0.41,1,251333,250890,443
19537041,2.08375,2.41851,443,109500,0.729993,0.41,1,251335,250892,443
19539961,2.01675,2.0837,443,109500,0.729999,0.41,1,251337,250894,443
19542881,2.00335,2.01674,443,109500,0.73,0.43,1,251339,250896,443
19545801,2.00067,2.00335,443,109500,0.73,0.43,1,251341,250898,443
19548721,2.00013,2.00067,443,109500,0.746,0.43,1,251343,250900,443
19551641,2.00003,0.400134,445,109500,0.7492,0.43,1,251345,250900,445
19553101,161.2,1.68003,644,109500,0.79784,0.69,2,251546,250902,644
19556021,57.84,161.136,475,109500,0.791568,0.71,2,251578,251103,475
19558941,13.168,49.0272,456,109500,0.790314,0.67,2,251580,251124,456
19561861,4.2336,11.4054,456,109500,0.790063,0.67,2,251582,251126,456
19564781,2.44672,3.88109,456,109500,0.790013,0.71,2,251584,251128,456
19567701,2.08934,2.37622,456,109500,0.790003,0.71,2,251586,251130,456
19570621,2.01787,2.07524,456,110960,0.790001,0.67,2,251588,251132,456
19573541,2.00357,2.01505,456,110960,0.79,0.67,2,251590,251134,456
19576461,2.00071,2.00301,456,110960,0.79,0.67,2,251592,251136,456
19579381,2.00014,2.0006,456,110960,0.79,0.67,2,251594,251138,456
19582301,2.00003,2.00012,456,110960,0.79,0.67,2,251596,251140,456
19585221,2.00001,2.00002,456,110960,0.814,0.67,2,251598,251142,456
19588141,2,2,456,110960,0.8108,0.67,2,251600,251144,456
19591061,2,2,456,110960,0.81016,0.69,2,251602,251146,456
19593981,2,2,456,110960,0.810032,0.69,2,251604,251148,456
19596901,2,2,456,110960,0.810006,0.69,2,251606,251150,456
19599821,2,2,456,110960,0.810001,0.69,2,251608,251152,456
19602741,2,2,456,110960,0.81,0.69,2,251610,251154,456
19605661,46.8,46.8,456,110960,0.81,0.69,2,251668,251212,456
19608581,10.96,9.36,458,112420,0.81,0.73,2,251670,251212,458
19611501,3.792,3.472,458,112420,0.81,0.73,2,251672,251214,458
19614421,7.1584,2.2944,464,112420,0.826,0.71,2,251680,251216,464
19617341,3.03168,6.85888,458,112420,0.8292,0.71,2,251682,251224,458
19620261,2.20634,2.97178,458,112420,0.82984,0.71,2,251684,251226,458
19623181,5.24127,2.19436,462,112420,0.829968,0.71,2,251690,251228,462
19626101,13.8483,5.23887,472,112420,0.829994,0.69,2,251706,251234,472
19629021,12.3697,14.6478,467,112420,0.829999,0.71,2,251718,251251,467
19631941,55.2739,11.7296,522,112420,0.83,0.73,2,251784,251262,522
19634861,12.6548,54.3459,459,112420,0.83,0.73,2,251786,251327,459
19637781,4.13096,12.4692,459,112420,0.83,0.73,2,251788,251329,459
19640701,2.42619,4.09384,459,112420,0.83,0.73,2,251790,251331,459
19643621,2.08524,2.41877,459,112420,0.83,0.73,2,251792,251333,459
19646541,2.01705,2.08375,459,112420,0.83,0.73,2,251794,251335,459
19649461,2.00341,2.01675,459,112420,0.83,0.73,2,251796,251337,459
19652381,2.00068,2.00335,459,112420,0.83,0.73,2,251798,251339,459
19655301,2.00014,2.00067,459,112420,0.83,0.75,2,251800,251341,459
19658221,2.00003,2.00013,459,112420,0.83,0.75,2,251802,251343,459
19661141,2.00001,2.00003,459,112420,0.83,0.81,2,251804,251345,459
19826561,2,2,469,115340,0.94,0.96,2,252541,252072,469
19829481,47.6,46.8,470,115340,0.948,0.96,2,252600,252130,470
19832401,11.12,9.36,472,115340,0.9496,1,2,252602,252130,472
19835321,3.824,3.472,472,116800,0.91792,0.97,2,252604,252132,472
19838241,7.1648,2.2944,478,116800,0.911584,0.99,2,252612,252134,478
19841161,3.03296,6.85888,472,116800,0.926317,0.99,2,252614,252142,472
19844081,2.20659,2.97178,472,116800,0.929263,0.99,2,252616,252144,472
19847001,5.24132,2.19436,476,116800,0.929853,0.99,2,252622,252146,476
19849921,13.8483,5.23887,486,116800,0.929971,0.99,2,252638,252152,486
19852841,12.3697,13.8478,482,116800,0.929994,0.99,2,252650,252168,482
20578741,19,18,496,17520,0.9,1,2,259284,258788,496
20581661,18.2,3.6,514,20440,0.876,0.8,2,259302,258788,514
20584581,333.24,370.32,464,23360,0.2792,0.8,1,259714,259250,464
20587501,68.248,74.064,466,26280,0.20784,0.83,1,259716,259250,466
20590421,24.0496,26.8128,464,29200,0.225568,0.83,1,259729,259265,464
20593341,6.40992,5.36256,466,32120,0.229114,0.9,1,259731,259265,466
20596261,14.082,16.2725,463,35040,0.277823,0.9,1,259747,259284,463
20599181,4.4164,3.2545,465,37960,0.287565,0.87,1,259749,259284,465
20602101,12.0833,15.0509,461,40880,0.353513,0.87,1,259763,259302,461
20605021,4.01666,3.01018,463,43800,0.366703,0.13,1,259765,259302,463
20607941,303.203,330.202,429,45260,0.737341,0.13,1,260143,259714,429
20610861,62.2407,66.0404,431,46720,0.811468,0.19,2,260145,259714,431
20613781,14.0481,14.8081,431,48180,0.874294,0.19,2,260147,259716,431
20616701,4.40963,2.96162,433,49640,0.902859,0.23,2,260149,259716,433
20619621,9.68193,10.9923,431,51100,0.948572,0.23,2,260160,259729,431
20897021,148,169,445,49640,0.35,0.31,1,262660,262215,445
20946661,103.2,116.2,434,41089,0.43,0.31,1,262752,262318,434
20949581,27.84,27.24,438,40255,0.478,0.28,1,262761,262323,438
20952501,143.968,16.648,597,38586,0.7516,0.01,2,262934,262337,597
20955421,35.1936,143.33,430,36918,0.78232,0.03,2,262942,262512,430
20958341,38.2387,56.6659,434,35040,0.740464,0.09,1,262981,262547,434
20961261,36.4477,36.1332,439,35040,0.716093,0.11,1,263017,262578,439
20964181,21.6895,19.2266,442,35040,0.727219,0.31,1,263035,262593,442
20967101,14.7379,16.6453,439,35040,0.761444,0.29,2,263048,262609,439
20970021,20.5476,16.1291,445,35040,0.784289,0.33,2,263070,262625,445
20972941,23.3095,21.6258,446,35040,0.852858,0.35,2,263094,262648,446
20975861,7.8619,13.9252,438,35040,0.866571,0.35,2,263098,262660,438
20978781,13.5724,9.18503,445,35040,0.901314,0.39,2,263113,262668,445
21075141,27,54,468,42340,0.55,1,1,264428,263960,468
21078061,16.6,25.2,464,42340,0.486,1,1,264442,263978,464
21080981,27.32,17.04,479,42340,0.3932,1,1,264472,263993,479
21083901,35.864,17.808,499,42340,0.27864,1,1,264510,264011,499
21086821,23.9728,16.3616,504,42340,0.199728,1,1,264531,264027,504
21089741,20.7946,16.0723,508,42340,0.143946,1,1,264551,264043,508
21092661,18.5589,17.6145,508,42340,0.132789,1,1,264569,264061,508
21095581,18.1118,3.52289,526,42340,0.0825578,1,1,264587,264061,526
21098501,18.0224,27.9046,510,42340,0.0485116,1,1,264605,264095,510
21099961,17.2045,17.5809,512,42340,0.0497023,1,1,264622,264110,512
21145221,354.641,426.716,422,29200,0.56994,0,1,265061,264639,422
21148141,219.728,234.143,422,30660,0.121988,0,1,265247,264825,422
21151061,78.3456,69.2286,437,32120,0.0243976,0.03,1,265290,264853,437
21153981,26.8691,37.0457,422,33580,0.0448795,0.01,1,265304,264882,422
21156901,63.7738,29.0091,468,35040,0.0489759,0.25,1,265377,264909,468
21159821,68.7548,45.8018,488,36500,0.113795,1,1,265447,264959,488
21162741,24.951,36.3604,468,37960,0.190759,1,1,265461,264993,468
21165661,15.3902,20.0721,465,37960,0.190152,1,1,265474,265009,465
21168581,21.478,18.4144,470,37960,0.19003,0.75,1,265497,265027,470
21171501,13.8956,16.4829,466,37960,0.222006,0.7,1,265509,265043,466
21174421,11.5791,10.4966,468,37960,0.180401,0.7,1,265520,265052,468
21177341,120.716,9.29932,607,37960,0.0600802,0.01,1,265668,265061,607
21180261,25.7432,150.66,423,39420,0.0360161,0,1,265670,265247,423
21183181,39.5486,64.532,423,39420,0.00720321,0,1,265713,265290,423
21186101,17.5097,12.9064,435,39420,0.00944064,0.05,1,265725,265290,435
21189021,5.10195,13.7813,423,39420,0.00988813,0.05,1,265727,265304,423
21191941,61.0204,61.1563,425,39420,0.0419776,0.05,1,265802,265377,425
21194861,69.8041,12.2313,497,39420,0.0803955,0.13,1,265874,265377,497
21197781,15.5608,58.4462,429,39420,0.0880791,0.21,1,265876,265447,429
21200701,15.1122,22.8892,430,39420,0.105616,0.19,1,265891,265461,430
21203621,13.4224,14.9779,430,39420,0.125123,0.19,1,265904,265474,430
21206541,21.8845,21.3956,431,39420,0.145025,0.23,1,265928,265497,431
21209461,12.3769,13.8791,429,39420,0.117005,0.17,1,265938,265509,429
21212381,8.87538,11.5758,426,39420,0.159401,0.03,1,265946,265520,426
21215301,117.775,120.715,423,39420,0.15188,0.03,1,266091,265668,423
21218221,25.155,24.143,425,40880,0.118376,0.03,1,266093,265668,425
21221141,37.831,6.42861,464,40880,0.0236752,0,1,266134,265670,464
21224061,17.1662,35.6857,433,40880,0.028735,0.01,1,266146,265713,433
21226981,5.03324,16.7371,423,40880,0.029747,0.01,1,266148,265725,423
21229901,62.6067,4.94743,498,40880,0.0459494,0.05,1,266225,265727,498
21232821,71.7213,60.9895,497,40880,0.0811899,0.09,1,266299,265802,497
21235741,15.9443,69.7979,427,40880,0.088238,0.09,1,266301,265874,427
21238661,15.9889,15.5596,441,42340,0.121648,0.11,1,266317,265876,441
21241581,12.7978,15.1119,438,42340,0.12833,0.13,1,266329,265891,438
21244501,22.5596,13.4224,450,42340,0.161666,0.15,1,266354,265904,450
21247421,13.3119,21.8845,437,42340,0.184333,0.11,1,266365,265928,437
21250341,9.06238,12.3769,435,42340,0.156867,0.17,1,266373,265938,435
21253261,116.212,8.87538,570,42340,0.199373,0.15,1,266516,265946,570
21256181,24.8425,117.775,427,42340,0.207875,0.11,1,266518,266091,427
21259101,6.5685,25.155,427,42340,0.209575,0,1,266520,266093,427
21262021,30.9137,37.831,423,42340,0.041915,0.03,1,266557,266134,423
21264941,15.7827,17.1662,423,42340,0.048383,0.03,1,266569,266146,423
21267861,4.75655,5.03324,423,42340,0.0176766,0.05,1,266571,266148,423
21270781,63.3513,62.6067,424,42340,0.0435353,0.09,1,266649,266225,424
21273701,74.2703,71.7213,427,42340,0.0967071,0.09,1,266726,266299,427
21276621,16.4541,15.9443,427,42340,0.107341,0.09,1,266728,266301,427
21279541,16.0908,3.18885,443,42340,0.0934683,0.13,1,266744,266301,443
21282461,12.8182,13.4378,439,42340,0.0906937,0.13,1,266756,266317,439
21285381,24.1636,12.2876,454,42340,0.106139,0.17,1,266783,266329,454
21288301,12.8327,22.4575,439,42340,0.109228,0.19,1,266793,266354,439
21291221,8.96655,13.2915,436,42340,0.109846,0.15,1,266801,266365,436
21294141,118.593,9.0583,574,42340,0.141969,0.21,1,266947,266373,574
21297061,25.3187,116.212,433,42340,0.164394,0.21,1,266949,266516,433
21299981,6.66373,24.8423,433,42340,0.168879,0.21,1,266951,266518,433
21302901,22.9327,6.56847,458,42340,0.169776,0,1,266978,266520,458
21305821,14.1865,30.9137,433,42340,0.105955,0.05,1,266990,266557,433
21308741,4.43731,15.7827,423,42340,0.109191,0.01,1,266992,266569,423
21311661,64.0875,4.75655,500,42340,0.0458382,0.05,1,267071,266571,500
21314581,76.0175,63.3513,501,42340,0.0811676,0.11,1,267150,266649,501
21317501,16.8035,74.2703,426,42340,0.0882335,0.11,1,267152,266726,426
21320421,16.9607,16.4541,441,42340,0.0896467,0.09,1,267169,266728,441
21323341,12.9921,16.0908,437,42340,0.0899293,0.09,1,267181,266744,437
21326261,24.9984,12.8182,453,42340,0.0899859,0.11,1,267209,266756,453
21329181,12.9997,24.1636,436,42340,0.0899972,0.11,1,267219,266783,436
21332101,8.99994,12.8327,434,42340,0.0899994,0.11,1,267227,266793,434
21335021,121.8,8.96655,576,42340,0.138,0.15,1,267377,266801,576
21337941,25.96,118.593,432,42340,0.1476,0.17,1,267379,266947,432
21340861,6.792,25.3187,432,42340,0.14952,0.17,1,267381,266949,432
21343781,18.9584,6.66373,452,42340,0.149904,0.17,1,267403,266951,452
21346701,10.9917,22.9327,434,42340,0.165981,0.09,1,267412,266978,434
21349621,3.79834,14.1865,424,42340,0.169196,0.11,1,267414,266990,424
21352541,63.9597,4.43731,501,42340,0.0418392,0.03,1,267493,266992,501
21355461,78.3919,64.0875,504,42340,0.160368,0.09,1,267575,267071,504
21358381,17.2784,76.0175,427,42340,0.184074,0.09,1,267577,267150,427
21361301,17.0557,16.8035,442,42340,0.188815,0.09,1,267594,267152,442
21364221,13.0111,16.9607,437,42340,0.189763,0.09,1,267606,267169,437
21367141,25.0022,12.9921,453,42340,0.189953,0.09,1,267634,267181,453
21370061,13.0004,24.9984,435,42340,0.189991,0.09,1,267644,267209,435
21372981,9.00009,12.9997,433,42340,0.189998,0.09,1,267652,267219,433
21375901,124.2,8.99994,578,42340,0.286,0.15,1,267805,267227,578
21378821,26.44,121.8,430,42340,0.3052,0.15,1,267807,267377,430
21381741,6.888,25.96,430,42340,0.30904,0.15,1,267809,267379,430
21384661,18.9776,6.792,450,42340,0.309808,0.15,1,267831,267381,450
21387581,11.7955,18.9584,438,42340,0.309962,0.17,1,267841,267403,438
21390501,3.9591,10.9917,431,42340,0.325992,0.17,1,267843,267412,431
21393421,58.3918,3.79834,501,42340,0.433198,0.01,1,267915,267414,501
21396341,83.6784,63.9597,512,42340,0.68664,0.19,1,268005,267493,512
21399261,18.3357,78.3919,432,42340,0.737328,0.19,1,268007,267575,432
21402181,17.2671,17.2784,447,42340,0.779466,0.19,2,268024,267577,447
21405101,13.0534,17.0557,442,42340,0.787893,0.19,2,268036,267594,442
21408021,25.0107,13.0111,458,42340,0.789579,0.19,2,268064,267606,458
21410941,13.0021,25.0022,440,42340,0.789916,0.19,2,268074,267634,440
21413861,9.00043,13.0004,438,42340,0.789983,0.19,2,268082,267644,438
21416781,129,9.00009,589,42340,0.773997,0.31,2,268241,267652,589
21419701,27.4,124.2,438,42340,0.770799,0.31,2,268243,267805,438
21422621,7.08,26.44,438,42340,0.77016,0.31,2,268245,267807,438
21425541,19.816,6.888,459,42340,0.754032,0.31,2,268268,267809,459
21428461,11.9632,18.9776,447,42340,0.750806,0.31,2,268278,267831,447
21431381,3.99264,11.7955,439,42340,0.750161,0.33,2,268280,267841,439
21434301,63.9985,3.9591,516,42340,0.750032,0.46,2,268359,267843,516
21437221,95.9997,58.3918,548,42340,0.782006,0.75,2,268463,267915,548
21440141,20.7999,83.6784,460,42340,0.788401,0.75,2,268465,268005,460
21443061,19.36,18.3357,477,42340,0.81368,0.79,2,268484,268007,477
21445981,13.472,17.2671,472,42340,0.818736,0.79,2,268496,268024,472
21448901,25.0944,13.0534,488,42340,0.827747,0.79,2,268524,268036,488
21451821,13.0189,25.0107,470,42340,0.845549,0.79,2,268534,268064,470
21454741,9.00378,13.0021,468,42340,0.84911,0.79,2,268542,268074,468
21457661,128.201,9.00043,618,42340,0.929822,0.77,2,268700,268082,618
21460581,27.2401,129,461,42340,0.945964,0.77,2,268702,268241,461
21463501,7.04803,27.4,461,42340,0.965193,0.77,2,268704,268243,461
21618261,17,13,489,54020,0.85,1,2,270372,269883,489
21621181,15.4,13.8,490,54020,0.922,1,2,270387,269897,490
21624101,14.28,9.96,495,55480,0.9124,1,2,270401,269906,495
21627021,15.656,11.592,499,55480,0.84648,1,2,270417,269918,499
21629941,15.9312,2.3184,515,55480,0.817296,1,2,270433,269918,515
21632861,13.5862,13.2637,512,55480,0.795459,1,2,270446,269934,512
21635781,9.91725,19.4527,500,55480,0.743092,1,1,270455,269955,500
21638701,109.983,12.6905,624,55480,0.548618,1,1,270590,269966,624
21641621,33.9967,125.738,485,56940,0.557724,1,1,270605,270120,485
21644541,19.5993,37.1476,486,56940,0.567545,1,1,270621,270135,486
21647461,17.5199,19.4295,488,56940,0.521509,1,1,270638,270150,488
21650381,17.104,14.2859,492,56940,0.456302,1,1,270655,270163,492
21653301,14.6208,14.0572,492,56940,0.50726,1,1,270669,270177,492
21656221,14.9242,13.2114,494,58400,0.525452,1,1,270684,270190,494
21659141,20.5848,30.6423,481,58400,0.45709,1,1,270706,270225,481
21662061,15.317,17.3285,481,58400,0.499418,0.89,1,270720,270239,481
21664981,78.2634,87.4657,470,58400,0.395884,0.89,1,270814,270344,470
21667901,23.6527,17.4931,480,58400,0.423177,0.86,1,270824,270344,480
21670821,17.5305,12.2986,485,59860,0.428635,0.85,1,270840,270355,485
21673741,13.1061,16.0597,480,59860,0.381727,0.94,1,270852,270372,480
21676661,4.22122,15.2119,467,59860,0.372345,0.91,1,270854,270387,467
21679581,9.64424,14.2424,464,59860,0.370469,0.83,1,270865,270401,464
21682501,13.9288,15.6485,463,59860,0.562094,0.81,1,270880,270417,463
21685421,13.1858,15.9297,460,61320,0.584419,0.79,1,270893,270433,460
21688341,12.2372,13.5859,459,61320,0.508884,0.73,1,270905,270446,459
21691261,7.24743,9.91719,456,61320,0.445777,0.5,1,270911,270455,456
21694181,103.049,109.983,448,61320,0.113155,0.5,1,271038,270590,448
21697101,32.6099,21.9967,463,62780,0.494631,0.56,1,271053,270590,463
21700021,16.922,16.3993,461,62780,0.538926,0.57,1,271066,270605,461
21702941,15.3844,16.0799,460,62780,0.563785,0.51,1,271081,270621,460
21705861,20.6769,16.816,465,62780,0.424757,0.44,1,271103,270638,465
21708781,13.7354,16.9632,460,64240,0.396951,0.52,1,271115,270655,460
21711701,4.34708,14.5926,448,64240,0.35939,0.53,1,271117,270669,448
21714621,8.86941,14.9185,443,64240,0.319878,0.44,1,271127,270684,443
21717541,20.9739,20.5837,445,64240,0.423976,0.51,1,271151,270706,445
21720461,14.5948,15.3167,444,65700,0.380795,0.37,1,271164,270720,444
21982481,243,289,427,59000,0.81,0.09,2,273050,272623,427
21994161,14,15,429,65700,0.67,0.05,1,273201,272772,429
21997081,13.2,14.2,428,67160,0.718,0.03,1,273214,272786,428
22000001,29.84,14.04,448,67160,0.5836,0,1,273248,272800,448
22002921,7.568,8.408,443,67160,0.52472,0,1,273250,272807,443
22005841,3.1136,1.6816,445,67160,0.512944,0,1,273252,272807,445
22008761,2.22272,0.33632,447,68620,0.478589,0,1,273254,272807,447
22011601,2.04454,0.067264,449,68620,0.487718,0.71,1,273256,272807,449
22014521,45.2089,25.6135,473,68620,0.0975435,1,1,273312,272839,473
22017441,17.0418,14.7227,471,68620,0.0195087,1,1,273322,272851,471
22020361,9.80836,10.1445,470,68620,0.0759017,1,1,273330,272860,470
22023281,45.1617,9.22891,515,68620,0.19918,0.9,1,273384,272869,515
22026201,24.2323,36.2458,491,70080,0.287836,1,1,273403,272912,491
22029121,16.0465,21.6492,487,70080,0.337567,1,1,273417,272930,487
22032041,24.8093,17.9298,497,70080,0.363513,0.99,1,273444,272947,497
22034961,20.9619,36.386,476,70080,0.416703,0.81,1,273464,272988,476
22037881,45.7924,56.8772,466,70080,0.459341,0.81,1,273516,273050,466
22040801,10.7585,11.3754,468,70080,0.467868,0.81,1,273518,273050,468
22043721,3.75169,2.27509,470,71540,0.469574,1,1,273520,273050,470
22046641,27.9503,41.255,453,71540,0.485915,1,1,273554,273101,453
22049561,68.7901,8.251,532,71540,0.617183,0.59,1,273633,273101,532
22052481,15.358,59.2502,462,71540,0.643437,0.57,1,273635,273173,462
22055401,14.2716,23.05,462,71540,0.664687,0.57,1,273649,273187,462
22058321,10.0543,4.61001,471,71540,0.668937,0.67,1,273658,273187,471
22061241,3.61086,12.122,459,73000,0.669788,0.73,1,273660,273201,459
22064161,7.92217,12.8244,455,73000,0.701957,0.55,1,273669,273214,455
22067081,21.5844,29.7649,446,73000,0.692392,0.51,1,273694,273248,446
22070001,5.91689,7.55298,446,73000,0.706478,0.51,1,273696,273250,446
22072921,2.78338,3.1106,446,73000,0.709296,0.51,1,273698,273252,446
22075841,2.15668,0.622119,448,73000,0.709859,0.47,1,273700,273252,448
22078761,2.03134,1.72442,448,73000,0.709972,0.49,1,273702,273254,448
22081681,25.2063,1.94488,477,73000,0.661994,0,1,273733,273256,477
22084601,14.6413,45.189,433,74460,0.588399,0,1,273745,273312,433
22087521,10.9283,17.0378,433,74460,0.62168,0.09,1,273755,273322,433
22090441,50.9856,9.80756,486,74460,0.612336,0.23,1,273816,273330,486
22093361,11.7971,45.1615,434,74460,0.610467,0.31,1,273818,273384,434
22096281,21.5594,24.2323,439,74460,0.690093,0.35,1,273842,273403,439
22099201,16.3119,16.0465,440,74460,0.722019,0.37,1,273857,273417,440
22102121,25.6624,24.8093,441,75920,0.712404,0.43,1,273885,273444,441
22105041,21.1325,20.9619,441,75920,0.742481,0.47,1,273905,273464,441
22107961,47.4265,45.7924,443,75920,0.748496,0.47,1,273959,273516,443
22110881,11.0853,10.7585,443,75920,0.781699,0.47,2,273961,273518,443
22113801,3.81706,2.15169,445,75920,0.78834,0.47,2,273963,273518,445
22116721,29.5634,2.03034,479,75920,0.789668,0.49,2,273999,273520,479
22119641,76.3127,27.6061,533,77380,0.901934,0.65,2,274087,273554,533
22122561,16.8625,68.7212,456,77380,0.924387,0.65,2,274089,273633,456
22373681,10,8,497,86140,0.89,1,2,275566,275069,497
22376601,8.4,5.6,500,86140,0.898,1,2,275574,275074,500
22379521,5.68,4.32,501,86140,0.8596,1,2,275579,275078,501
22382441,7.536,10.464,497,86140,0.85192,1,2,275587,275090,497
22385361,7.9072,6.8928,499,86140,0.834384,1,2,275595,275096,499
22388281,7.98144,6.17856,501,86140,0.846877,1,2,275603,275102,501
22391201,11.1963,4.43571,509,86140,0.833375,1,2,275615,275106,509
22392661,10.2393,7.28714,511,86140,0.766675,1,2,275625,275114,511
22481721,374.048,419.057,454,59080,0.809335,0.82,2,276090,275636,454
22510921,7,91,428,70080,0.45,0.01,1,276403,275975,428
22513841,8.6,29.4,423,70080,0.45,0,1,276412,275989,423
22516761,52.12,15.48,474,70080,0.386,0,1,276475,276001,474
22519681,17.624,12.696,471,70080,0.3732,0.85,1,276484,276013,471
22522241,10.7248,16.1392,463,70080,0.38664,0.83,1,276493,276030,463
22523281,10.145,9.62784,465,71540,0.405328,1,1,276503,276038,465
22526201,52.429,49.1256,469,71540,0.329066,1,1,276566,276097,469
22529121,15.2858,9.82511,475,71540,0.329813,1,1,276572,276097,475
22532041,6.25716,1.96502,479,71540,0.297963,1,1,276576,276097,479
22534961,3.65143,0.393004,482,71540,0.307593,1,1,276579,276097,482
22537881,2.33029,0.0786009,484,71540,0.325518,1,1,276581,276097,484
22540801,2.86606,0.0157202,487,71540,0.345104,0.99,1,276584,276097,487
22543721,3.77321,3.20314,487,71540,0.349021,0.99,1,276588,276101,487
22546641,2.35464,0.640629,489,71540,0.349804,1,1,276590,276101,489
22549561,3.67093,18.5281,470,73000,0.349961,1,1,276594,276124,470
22552481,11.1342,3.70562,483,73000,0.349992,0.77,1,276607,276124,483
22555401,3.82684,23.1411,457,73000,0.365998,1,1,276609,276152,457
22558321,28.7654,22.2282,470,73000,0.4172,1,1,276644,276174,470
22561241,19.3531,4.44564,487,73000,0.37944,1,1,276661,276174,487
22564161,5.47061,15.2891,471,73000,0.339888,0.43,1,276663,276192,471
22567081,15.4941,36.6578,447,73000,0.411978,0.43,1,276681,276234,447
22570001,63.0988,7.33157,522,73000,0.474396,0.97,1,276756,276234,522
22572921,32.6198,51.8663,484,74460,0.518879,0.81,1,276781,276297,484
22575841,54.524,27.1733,523,74460,0.559776,0.55,1,276841,276318,523
22578761,14.1048,67.8347,449,74460,0.535955,0.45,1,276845,276396,449
22581681,8.42096,19.1669,449,74460,0.595191,0.45,1,276852,276403,449
22584601,52.0842,11.0334,503,74460,0.639038,0.37,1,276915,276412,503
22587521,19.2168,52.6067,451,75920,0.679808,0.37,1,276926,276475,451
22590441,10.2434,17.7213,450,75920,0.671962,0.39,1,276934,276484,450
22593361,3.64867,10.7443,443,75920,0.686392,0.41,1,276936,276493,443
22596281,52.7297,10.1489,498,75920,0.689278,0.31,1,277001,276503,498
22599201,17.7459,52.4298,444,75920,0.705856,0.33,1,277010,276566,444
22602121,6.74919,15.286,442,75920,0.709171,0.29,1,277014,276572,442
22605041,2.94984,6.25719,440,75920,0.709834,0.31,1,277016,276576,440
22607961,2.18997,3.65144,439,75920,0.709967,0.33,1,277018,276579,439
22610881,3.63799,2.33029,441,77380,0.709993,0.35,1,277022,276581,441
22613801,3.9276,2.86606,442,77380,0.709999,0.35,1,277026,276584,442
22616721,2.38552,3.77321,440,77380,0.71,0.35,1,277028,276588,440
22619641,2.0771,2.35464,440,77380,0.726,0.35,1,277030,276590,440
22622561,3.61542,3.67093,440,77380,0.7612,0.35,2,277034,276594,440
22625481,11.1231,11.1342,440,77380,0.80024,0.37,2,277047,276607,440
22628401,3.82462,3.82684,440,77380,0.776048,0.43,2,277049,276609,440
22631321,27.9649,28.7654,439,77380,0.80321,0.37,2,277083,276644,439
22634241,19.993,19.3531,440,78840,0.856642,0.33,2,277101,276661,440
22637161,5.5986,5.47061,440,78840,0.867328,0.43,2,277103,276663,440
22640081,17.9197,15.4941,443,78840,0.917466,0.49,2,277124,276681,443
23154741,15,21,501,49640,0.27,1,1,280702,280201,501
23157661,15.8,16.2,502,51100,0.27,1,1,280718,280216,502
23160581,13.56,25.64,487,52560,0.238,1,1,280731,280244,487
23163501,25.112,25.128,490,52560,0.1916,1,1,280759,280269,490
23166421,26.6224,25.0256,492,52560,0.27032,0.99,1,280786,280294,492
23169341,46.1245,55.4051,480,52560,0.054064,0.98,1,280837,280357,480
23172261,41.2249,35.081,490,52560,0.146813,0.87,1,280877,280387,490
23175181,42.645,38.2162,494,54020,0.0533626,0.63,1,280920,280426,494
23178101,27.729,48.4432,467,54020,0.194673,0.47,1,280944,280477,467
23181021,62.3458,67.2886,466,54020,0.0469345,0.33,1,281015,280549,466
23183941,28.4692,44.6577,447,54020,0.0093869,0.31,1,281035,280588,447
23186861,21.6938,24.1315,448,54020,0.0578774,0.37,1,281055,280607,448
23189781,15.5388,17.6263,446,54020,0.0195755,0.35,1,281069,280623,446
23192701,16.7078,17.9253,445,54020,0.0119151,0.27,1,281086,280641,445
23195621,16.1416,18.7851,442,54020,0.362383,0.29,1,281102,280660,442
23198541,17.6283,10.157,452,54020,0.560477,0.27,1,281120,280668,452
23201461,5.12566,17.2314,435,54020,0.600095,0.27,1,281122,280687,435
23204381,13.0251,15.4463,435,54020,0.512019,0.27,1,281137,280702,435
23207301,12.205,3.08926,447,54020,0.718404,0.27,1,281149,280702,447
23210221,4.04101,13.4179,433,54020,0.735681,0.23,1,281151,280718,433
23213141,11.2082,13.0836,433,54020,0.691136,0.18,1,281164,280731,433
23216061,28.6416,25.0167,438,54020,0.674227,0.29,1,281197,280759,438
23218981,21.7283,26.6033,431,54020,0.654845,0,1,281217,280786,431
23221901,45.1457,46.1207,431,54020,0.378969,0.17,1,281268,280837,431
23224821,37.8291,41.2241,427,54020,0.371794,0.17,1,281304,280877,427
23227741,37.9658,8.24483,465,54020,0.258359,0.03,1,281342,280877,465
23230661,32.3932,36.049,453,55480,0.123672,0.23,1,281373,280920,453
23233581,56.8786,26.4098,492,55480,0.0247343,0.01,1,281436,280944,492
23236501,33.7757,62.082,449,55480,0.00494687,0,1,281464,281015,449
23239421,16.3551,28.4164,441,55480,0.0249894,0.07,1,281476,281035,441
23242341,14.471,21.6833,435,55480,0.0449979,0.01,1,281490,281055,435
23245261,21.2942,15.5367,444,55480,0.0489996,0.01,1,281513,281069,444
23248181,29.8588,16.7073,459,55480,0.0977999,0.45,1,281545,281086,459
23251101,22.7718,16.1415,464,55480,0.10756,0.61,1,281566,281102,464
23254021,6.15435,17.6283,448,55480,0.125512,0.61,1,281568,281120,448
23256941,23.6309,5.12566,474,55480,0.113102,0.49,1,281596,281122,474
23259861,11.9262,13.0251,468,55480,0.11062,0.77,1,281605,281137,468
23262781,3.98523,12.205,458,55480,0.150124,0.74,1,281607,281149,458
23265701,11.197,4.04101,469,55480,0.150025,0.68,1,281620,281151,469
23268621,27.0394,11.2082,487,55480,0.102005,0.67,1,281651,281164,487
23271541,15.0079,28.6416,466,55480,0.156401,0.65,1,281663,281197,466
23274461,36.6016,21.7283,488,55480,0.19928,0.31,1,281705,281217,488
23277381,37.7203,45.1457,475,55480,0.255856,0.37,1,281743,281268,475
23280301,31.5441,37.8291,469,55480,0.267171,0.23,1,281773,281304,469
23283221,7.90881,37.9658,433,55480,0.301434,0.09,1,281775,281342,433
23286141,19.1818,32.3932,424,56940,0.308287,0,1,281797,281373,424
23289061,53.4364,56.8786,423,56940,0.0856574,0,1,281859,281436,423
23291981,33.0873,33.7757,423,56940,0.0411315,0.03,1,281887,281464,423
23294901,15.4175,16.3551,422,56940,0.0482263,0.05,1,281898,281476,422
23297821,15.0835,14.471,423,56940,0.0496453,0.05,1,281913,281490,423
23300741,24.6167,21.2942,427,56940,0.0339291,0.11,1,281940,281513,427
23303661,28.9233,29.8588,425,56940,0.126786,0.11,1,281970,281545,425
23306581,24.1847,22.7718,427,56940,0.177357,0.13,1,281993,281566,427
23309501,6.43693,6.15435,427,56940,0.187471,0.11,1,281995,281568,427
23312421,24.4874,23.6309,428,56940,0.221494,0.11,1,282024,281596,428
23315341,12.0975,11.9262,428,56940,0.212299,0.16,1,282033,281605,428
23318261,4.0195,3.98523,428,56940,0.21046,0.15,1,282035,281607,428
23321181,12.0039,11.197,429,56940,0.210092,0.09,1,282049,281620,429
23324101,28.0008,27.0394,430,56940,0.290018,0.17,1,282081,281651,430
23327021,14.4002,15.0079,429,56940,0.322004,0.21,1,282092,281663,429
23329941,38.08,36.6016,431,56940,0.312401,0.27,1,282136,281705,431
23332861,41.216,37.7203,435,56940,0.29448,0.27,1,282178,281743,435
23335781,30.6432,31.5441,433,56940,0.322896,0.31,1,282206,281773,433
23338701,7.72864,7.90881,433,56940,0.328579,0.31,1,282208,281775,433
23341621,19.9457,1.58176,456,56940,0.297716,0.31,1,282231,281775,456
23344541,43.1891,17.9164,483,56940,0.259543,0.03,1,282280,281797,483
23347461,31.8378,53.1833,450,56940,0.0759086,0.03,1,282309,281859,450
23350381,15.1676,33.0367,433,56940,0.0551817,0.05,1,282320,281887,433
23353301,14.2335,15.4073,436,56940,0.0350363,0.05,1,282334,281898,436
23356221,26.0467,15.0815,450,56940,0.0470073,0.03,1,282363,281913,450
23359141,31.6093,24.6163,456,56940,0.0974015,0.15,1,282396,281940,456
23362061,27.9219,28.9233,453,56940,0.10748,0.19,1,282423,281970,453
23364981,7.18437,24.1847,432,56940,0.109496,0.19,1,282425,281993,432
23367901,24.6369,6.43693,459,56940,0.157899,0.23,1,282454,281995,459
23370821,12.9274,24.4874,440,56940,0.16758,0.21,1,282464,282024,440
23373741,4.18547,12.0975,433,56940,0.169516,0.21,1,282466,282033,433
23376661,12.8371,4.0195,446,56940,0.153903,0.21,1,282481,282035,446
23379581,31.3674,12.0039,468,56940,0.134781,0.31,1,282517,282049,468
23382501,15.0735,28.0008,447,56940,0.178956,0.33,1,282528,282081,447
23385421,37.4147,14.4002,479,56940,0.203791,0.31,1,282571,282092,479
23388341,40.2829,38.08,476,56940,0.240758,0.29,1,282612,282136,476
23391261,31.2566,41.216,463,56940,0.232152,0.33,1,282641,282178,463
23394181,7.85132,30.6432,437,56940,0.23043,0.33,1,282643,282206,437
23397101,20.7703,7.72864,459,56940,0.278086,0.29,1,282667,282208,459
23400021,38.5541,19.9457,479,56940,0.303617,0.25,1,282710,282231,479
23402941,24.5108,43.1891,451,56940,0.292723,0.03,1,282731,282280,451
23405861,13.7022,31.8378,433,56940,0.322545,0.05,1,282742,282309,433
23408781,13.9404,15.1676,436,56940,0.296509,0.03,1,282756,282320,436
23411701,27.5881,14.2335,453,56940,0.275302,0.05,1,282787,282334,453
23414621,33.5176,26.0467,459,56940,0.28706,0.11,1,282822,282363,459
23417541,28.3035,31.6093,453,56940,0.305412,0.11,1,282849,282396,453
23420461,7.2607,27.9219,428,56940,0.309082,0.11,1,282851,282423,428
23423381,27.0521,7.18437,458,56940,0.341816,0.17,1,282883,282425,458
23426301,11.8104,24.6369,437,56940,0.348363,0.17,1,282891,282454,437
23429221,3.96209,12.9274,429,56940,0.349673,0.17,1,282893,282464,429
23432141,12.7924,4.18547,442,56940,0.365935,0.15,1,282908,282466,442
23435061,32.9585,12.8371,465,56940,0.353187,0.13,1,282946,282481,465
23437981,16.1917,31.3674,441,56940,0.334637,0.19,1,282958,282517,441
23440901,38.4383,15.0735,474,56940,0.330927,0.21,1,283002,282528,474
23443821,40.4877,37.4147,472,56940,0.394185,0.25,1,283043,282571,472
23446741,32.8975,40.2829,462,56940,0.390837,0.23,1,283074,282612,462
23449661,8.17951,31.2566,435,56940,0.422167,0.23,1,283076,282641,435
23452581,24.0359,7.85132,461,56940,0.428434,0.29,1,283104,282643,461
23455501,38.4072,20.7703,479,56940,0.461687,0.31,1,283146,282667,479
23458421,24.4814,38.5541,457,56940,0.484337,0.29,1,283167,282710,457
23461341,12.8963,24.5108,446,56940,0.504867,0.33,1,283177,282731,446
23464261,13.7793,13.7022,449,56940,0.524974,0.29,1,283191,282742,449
23467181,27.5559,13.9404,466,56940,0.512995,0.27,1,283222,282756,466
23470101,33.5112,27.5881,470,56940,0.526599,0.29,1,283257,282787,470
23473021,29.1022,33.5176,463,56940,0.52932,0.31,1,283285,282822,463
23475941,7.42045,28.3035,438,56940,0.529864,0.31,1,283287,282849,438
23478861,28.6841,7.2607,470,56940,0.577973,0.35,1,283321,282851,470
23481781,12.1368,27.0521,446,56940,0.587595,0.35,1,283329,282883,446
23484701,4.02736,11.8104,440,56940,0.589519,0.35,1,283331,282891,440
23487621,12.0055,3.96209,452,56940,0.589904,0.37,1,283345,282893,452
23490541,32.8011,12.7924,475,56940,0.605981,0.35,1,283383,282908,475
23493461,16.1602,32.9585,449,56940,0.609196,0.33,1,283395,282946,449
23496381,40.032,16.1917,483,56940,0.625839,0.33,1,283441,282958,483
23499301,42.4064,38.4383,482,56940,0.645168,0.41,1,283484,283002,482
23502221,33.2813,40.4877,472,56940,0.649034,0.39,1,283515,283043,472
23505141,8.25626,32.8975,443,56940,0.681807,0.43,1,283517,283074,443
23508061,26.4513,8.17951,472,56940,0.720361,0.43,1,283548,283076,472
23510981,38.8903,24.0359,486,56940,0.760072,0.47,2,283590,283104,486
23513901,26.178,38.4072,467,56940,0.768014,0.49,2,283613,283146,467
23516821,14.0356,24.4814,457,56940,0.833603,0.51,2,283624,283167,457
23519741,14.0071,12.8963,461,56940,0.814721,0.53,2,283638,283177,461
23522661,26.8014,13.7793,477,56940,0.826944,0.51,2,283668,283191,477
23525581,34.1603,27.5559,482,56940,0.829389,0.53,2,283704,283222,482
23528501,30.0321,33.5112,476,56940,0.813878,0.53,2,283733,283257,476
23531421,7.60641,29.1022,450,56940,0.810776,0.53,2,283735,283285,450
23534341,30.3213,7.42045,484,56940,0.842155,0.59,2,283771,283287,484
23537261,12.4643,28.6841,458,56940,0.864431,0.59,2,283779,283321,458
23540181,4.09285,12.1368,452,56940,0.868886,0.59,2,283781,283329,452
23543101,12.8186,4.02736,465,56940,0.885777,0.59,2,283796,283331,465
23546021,32.9637,12.0055,489,56940,0.905155,0.61,2,283834,283345,489
23548941,16.9927,32.8011,464,56940,0.885031,0.61,2,283847,283383,464
23551861,40.1985,16.1602,498,56940,0.889006,0.63,2,283893,283395,498
23554781,44.0397,40.032,497,56940,0.921801,0.65,2,283938,283441,497
23557701,33.6079,42.4064,485,56940,0.92836,0.65,2,283969,283484,485
23724141,17,14,492,64240,0.83,1,2,285285,284793,492
23727061,24.2,38,474,64240,0.742,1,1,285311,284837,474
23729981,50.44,49.2,479,65700,0.6764,1,1,285368,284889,479
23732901,23.688,23.44,479,65700,0.59928,1,1,285385,284906,479
23735821,21.5376,17.488,484,65700,0.575856,1,1,285406,284922,484
23738741,18.7075,21.0976,480,65700,0.555171,1,1,285424,284944,480
23741661,46.1415,49.0195,477,65700,0.311034,1,1,285477,285000,477
23744581,30.8283,9.8039,504,67160,0.214207,1,1,285504,285000,504
23747501,18.9657,21.1608,496,67160,0.178841,1,1,285520,285024,496
23750421,16.5931,14.6322,499,67160,0.147768,1,1,285536,285037,499
23753341,17.7186,12.5264,505,67160,0.133554,1,1,285554,285049,505
23756261,27.5437,16.1053,518,67160,0.0827107,1,1,285584,285066,518
23759181,33.5087,37.6211,510,67160,0.0405421,0.97,1,285619,285109,510
23762101,16.3017,35.5242,487,67160,0.0321084,1,1,285631,285144,487
23765021,16.0603,17.5048,490,67160,0.0144217,1,1,285647,285157,490
23767941,14.4121,16.301,488,67160,0.00288434,1,1,285661,285173,488
23770861,12.4824,14.4602,486,68620,0.0245769,1,1,285673,285187,486
23773781,9.69648,13.292,482,68620,0.0289154,1,1,285682,285200,482
23776701,5.1393,13.0584,473,68620,0.0297831,0.99,1,285686,285213,473
23779621,4.22786,9.01168,469,68620,0.0459566,0.8,1,285690,285221,469
23782541,22.4456,28.2023,463,68620,0.0331913,0.8,1,285717,285254,463
23785461,14.8891,16.8405,462,68620,0.0466383,0.83,1,285730,285268,462
23788381,14.9778,16.9681,460,68620,0.0493276,0.72,1,285745,285285,460
23791301,22.9956,24.1936,459,68620,0.129866,0.72,1,285770,285311,459
23794221,43.7991,4.83872,508,70080,0.113973,0.66,1,285819,285311,508
23797141,20.7598,46.5677,466,70080,0.0947946,0.58,1,285834,285368,466
23800061,16.952,22.9135,465,70080,0.0749589,0.57,1,285850,285385,465
23802981,19.3904,21.3827,464,70080,0.0709918,0.55,1,285870,285406,464
23805901,35.0781,18.6765,485,70080,0.0861984,0.25,1,285909,285424,485
23808821,8.61562,46.1353,434,70080,0.0892397,0.19,1,285911,285477,434
23811741,21.7231,30.8271,432,70080,0.137848,0.17,1,285936,285504,432
23984021,17,12,513,89060,0.89,1,2,287088,286575,513
23986941,17.8,11.2,520,89060,0.842,1,2,287106,286586,520
23989861,17.96,2.24,538,90520,0.7684,1,2,287124,286586,538
23992781,14.792,8.448,542,90520,0.70568,1,1,287138,286596,542
23995701,14.1584,5.6896,551,90520,0.645136,1,1,287152,286601,551
23998621,14.8317,3.53792,563,91980,0.633027,1,1,287167,286604,563
24019061,384.566,473.508,449,63260,0.822605,0.29,2,287644,287195,449
24023441,157.713,188.302,433,63260,0.428521,0.19,1,287745,287312,433
24039501,50.7427,61.6603,427,63260,0.285704,0.05,1,287769,287342,427
24112501,52.5485,58.7321,422,63260,0.113141,0.01,1,287822,287400,422
24115421,27.3097,14.1464,440,65700,0.294628,0.01,1,287843,287403,440
24118341,25.4619,23.6293,439,67160,0.274926,0.03,1,287868,287429,439
24121261,18.6924,26.3259,429,68620,0.254985,0.01,1,287885,287456,429
24124181,24.5385,19.6652,437,70080,0.234997,0.13,1,287911,287474,437
24127101,20.9077,28.733,426,71540,0.230999,0.55,1,287931,287505,426
24129041,50.5815,30.5466,453,73000,0.0461999,0.77,1,287989,287536,453
24131961,125.316,106.109,472,73000,0.01724,0.67,1,288133,287661,472
24134881,36.2633,41.2219,461,73000,0.027448,0.58,1,288147,287686,461
24137801,16.8527,25.0444,452,73000,0.0934896,0.37,1,288159,287707,452
24140721,19.3705,21.8089,451,73000,0.0426979,0.29,1,288179,287728,451
24143641,21.4741,24.3618,448,73000,0.12854,0.23,1,288201,287753,448
24146561,16.2948,25.6724,437,74460,0.177708,0.15,1,288216,287779,437
24149481,16.859,18.7345,437,74460,0.171542,0.11,1,288233,287796,437
24152401,12.1718,17.3469,431,74460,0.202308,0.07,1,288244,287813,431
24155321,4.03436,10.6694,424,74460,0.208462,0.07,1,288246,287822,424
24158241,2.40687,2.13388,426,74460,0.209692,0.07,1,288248,287822,426
24161161,2.08137,0.426775,428,74460,0.177938,0.07,1,288250,287822,428
24164081,2.01627,0.085355,430,75920,0.171588,0.07,1,288252,287822,430
24167001,2.00325,0.017071,432,75920,0.170318,0.07,1,288254,287822,432
24169601,2.00065,0.0034142,434,75920,0.170064,0.28,1,288256,287822,434
24172521,9.20013,8.00068,435,75920,0.202013,0.28,1,288267,287832,435
24175441,3.44003,1.60014,437,75920,0.224403,0.28,1,288269,287832,437
24178361,11.088,0.320027,450,75920,0.212881,0.34,1,288282,287832,450
24181281,3.8176,8.86401,441,75920,0.210576,0.27,1,288284,287843,441
24184201,13.5635,21.7728,432,75920,0.258115,0.27,1,288300,287868,432
24187121,14.7127,4.35456,447,77380,0.251623,0.25,1,288315,287868,447
24190041,4.54254,14.4709,432,77380,0.250325,0.23,1,288317,287885,432
24192961,21.7085,23.6942,432,77380,0.474065,0.23,1,288343,287911,432
24195881,18.7417,4.73884,450,77380,0.534813,0.23,1,288361,287911,450
24198801,5.34834,16.9478,432,77380,0.546963,0,1,288363,287931,432
24201721,41.8697,49.7896,425,77380,0.389392,0.01,1,288414,287989,425
24204641,121.974,125.158,423,77380,0.101879,0.03,1,288556,288133,423
24207561,37.1948,36.2316,425,78840,0.0443757,0.11,1,288572,288147,425
24210481,17.039,16.8463,425,78840,0.0328751,0.03,1,288584,288159,425
24213401,20.2078,19.3693,426,78840,0.046575,0.15,1,288605,288179,426
24216321,24.0416,21.4739,429,78840,0.049315,0.15,1,288630,288201,429
24219241,17.6083,4.29477,445,78840,0.033863,0.19,1,288646,288201,445
24222161,17.1217,12.859,447,80300,0.0307726,0.17,1,288663,288216,447
24225081,11.4243,16.1718,440,80300,0.0781545,0.21,1,288673,288233,440
24228001,3.88487,12.0344,431,80300,0.0876309,0.21,1,288675,288244,431
24230921,2.37697,4.00687,431,80300,0.0895262,0.21,1,288677,288246,431
24233841,2.07539,2.40137,431,80300,0.0899052,0.17,1,288679,288248,431
24236761,2.01508,2.08027,431,80300,0.089981,0.17,1,288681,288250,431
24239681,2.00302,2.01605,431,80300,0.0899962,0.17,1,288683,288252,431
24242601,2.0006,2.00321,431,80300,0.0899992,0.17,1,288685,288254,431
24245521,2.00012,2.00064,431,80300,0.0899998,0.21,1,288687,288256,431
24248441,9.20002,9.20013,431,81760,0.122,0.23,1,288698,288267,431
24251361,3.44,3.44003,431,81760,0.1284,0.21,1,288700,288269,431
24254281,12.688,11.088,433,81760,0.11368,0.21,1,288715,288282,433
24257201,4.1376,3.8176,433,81760,0.110736,0.27,1,288717,288284,433
24260121,14.4275,13.5635,434,81760,0.110147,0.27,1,288734,288300,434
24263041,14.0855,2.7127,448,81760,0.0940294,0.25,1,288748,288300,448
24265961,4.4171,12.5425,435,81760,0.0908059,0.25,1,288750,288315,435
24268881,32.8834,4.10851,473,81760,0.122161,0.53,1,288790,288317,473
24271801,21.7767,21.6217,466,81760,0.192432,0.55,1,288809,288343,466
24274721,5.95534,18.7243,450,83220,0.206486,0.55,1,288811,288361,450
24277641,33.1911,5.34487,488,83220,0.305297,0.35,1,288851,288363,488
24280561,107.438,41.869,563,83220,0.0610595,0.03,1,288977,288414,563
24283481,23.0876,121.974,423,83220,0.0682119,0.03,1,288979,288556,423
24286401,17.4175,37.1948,423,83220,0.0856424,0.03,1,288995,288572,423
24289321,13.8835,17.039,424,83220,0.121128,0.05,1,289008,288584,424
24292241,17.9767,20.2078,422,83220,0.0802257,0.05,1,289027,288605,422
24295161,24.3953,24.0416,423,83220,0.0880451,0.03,1,289053,288630,423
24298081,17.6791,17.6083,423,83220,0.121609,0.03,1,289069,288646,423
24301001,18.7358,3.52166,442,84680,0.136322,0.03,1,289088,288646,442
24303921,11.7472,14.3043,435,84680,0.123264,0.09,1,289098,288663,435
24306841,3.94943,10.8609,427,84680,0.120653,0.09,1,289100,288673,427
24309761,2.38989,3.77217,427,84680,0.120131,0.09,1,289102,288675,427
24312681,2.07798,2.35443,427,84680,0.112026,0.09,1,289104,288677,427
24315601,2.0156,2.07089,427,84680,0.110405,0.09,1,289106,288679,427
24318521,2.00312,2.01418,427,84680,0.126081,0.09,1,289108,288681,427
24321441,2.00062,2.00284,427,86140,0.129216,0.09,1,289110,288683,427
24324361,2.00012,2.00057,427,86140,0.129843,0.09,1,289112,288685,427
24327281,2.00002,2.00011,427,86140,0.129969,0.13,1,289114,288687,427
24330201,8.4,9.20002,426,86140,0.145994,0.13,1,289124,288698,426
24333121,3.28,3.44,426,86140,0.181199,0.11,1,289126,288700,426
24336041,11.856,12.688,425,86140,0.16424,0.11,1,289140,288715,425
24338961,3.9712,4.1376,425,86140,0.168848,0.11,1,289142,288717,425
24341881,15.1942,14.4275,426,86140,0.23377,0.09,1,289160,288734,426
24344801,14.2388,14.0855,426,86140,0.270754,0.09,1,289174,288748,426
24347721,4.44777,4.4171,426,86140,0.278151,0.13,1,289176,288750,426
24350641,35.2896,32.8834,429,86140,0.31963,0.21,1,289219,288790,429
24353561,26.2579,21.7767,434,86140,0.375926,0.21,1,289243,288809,434
24356481,6.85158,4.35534,436,86140,0.355185,0.21,1,289245,288809,436
24359401,35.7703,2.47107,477,86140,0.351037,0.33,1,289288,288811,477
24362321,98.3541,32.4942,551,86140,0.198207,0,1,289402,288851,551
24365241,21.2708,107.299,427,87600,0.135641,0.07,1,289404,288977,427
24368161,17.0542,23.0598,441,87600,0.171128,0.09,1,289420,288979,441
24371081,13.8108,17.412,438,87600,0.122226,0.13,1,289433,288995,438
24374001,17.1622,13.8824,443,87600,0.152445,0.07,1,289451,289008,443
24376921,25.0324,17.9765,451,87600,0.142489,0.09,1,289478,289027,451
24379841,18.6065,24.3953,442,87600,0.132498,0.13,1,289495,289053,442
24382761,5.3213,17.6791,428,87600,0.1865,0.14,1,289497,289069,428
24385681,15.4643,18.7358,427,87600,0.1973,0.12,1,289515,289088,427
24388601,11.8929,11.7472,428,87600,0.23946,0.12,1,289526,289098,428
24391521,3.97857,3.94943,428,87600,0.247892,0.12,1,289528,289100,428
24394441,2.39571,2.38989,428,89060,0.257578,0.11,1,289530,289102,428
24397361,2.07914,2.07798,428,89060,0.259516,0.11,1,289532,289104,428
24400281,2.01583,2.0156,428,89060,0.259903,0.13,1,289534,289106,428
24403201,2.00317,2.00312,428,89060,0.227981,0.13,1,289536,289108,428
24406121,2.00063,0.400624,430,89060,0.229596,0.13,1,289538,289108,430
24409041,2.00013,1.68012,430,89060,0.245919,0.13,1,289540,289110,430
24411961,2.00003,1.93602,430,89060,0.249184,0.13,1,289542,289112,430
24414881,10.8,1.9872,441,89060,0.257837,0.15,1,289555,289114,441
24417801,3.76,8.39744,433,89060,0.259567,0.19,1,289557,289124,433
24420721,11.952,3.27949,445,89060,0.251913,0.16,1,289571,289126,445
24423641,3.9904,11.8559,433,89060,0.290383,0.17,1,289573,289140,433
24426561,18.3981,3.97118,453,89060,0.282077,0.25,1,289595,289142,453
24429481,14.0796,15.1942,448,89060,0.256415,0.28,1,289608,289160,448
24432401,4.41592,14.2388,436,89060,0.251283,0.28,1,289610,289174,436
24435321,33.6832,4.44777,475,89060,0.282257,0.33,1,289651,289176,475
24438241,30.7366,35.2896,462,89060,0.296451,0.39,1,289681,289219,462
24441161,7.74733,26.2579,440,90520,0.29929,0.35,1,289683,289243,440
24444081,37.5495,6.85158,483,90520,0.459858,0.35,1,289728,289245,483
24447001,85.9099,35.7703,538,90520,0.515972,0.16,1,289826,289288,538
24449921,18.782,98.3541,426,90520,0.535194,0.12,1,289828,289402,426
24452841,5.3564,21.2708,426,90520,0.563039,0.18,1,289830,289404,426
24455761,15.4713,17.0542,428,90520,0.536608,0.11,1,289848,289420,428
24458681,12.6943,13.8108,427,90520,0.611322,0.16,1,289860,289433,427
24461601,19.3389,17.1622,430,90520,0.626264,0.14,1,289881,289451,430
24464521,23.0678,25.0324,427,90520,0.557253,0.13,1,289905,289478,427
24467441,22.2136,18.6065,432,90520,0.567451,0.2,1,289927,289495,432
24470361,6.04271,5.3213,432,90520,0.56949,0.2,1,289929,289497,432
24473281,17.2085,15.4643,434,90520,0.593898,0.25,1,289949,289515,434
24476201,11.4417,11.8929,433,90520,0.58278,0.25,1,289959,289526,433
24479121,3.88834,3.97857,433,90520,0.612556,0.25,1,289961,289528,433
24482041,2.37767,0.795714,435,90520,0.618511,0.26,1,289963,289528,435
24484961,2.07553,1.75914,435,90520,0.627702,0.26,1,289965,289530,435
24487881,3.61511,1.95183,437,90520,0.59754,0.26,1,289969,289532,437
24490801,2.32302,1.99037,437,90520,0.591508,0.22,1,289971,289534,437
24493721,2.0646,1.99807,437,90520,0.590302,0.23,1,289973,289536,437
24496641,2.01292,1.99961,437,90520,0.59806,0.25,1,289975,289538,437
24499561,2.00258,1.99992,437,90520,0.599612,0.25,1,289977,289540,437
24502481,9.20052,1.99998,446,90520,0.583922,0.26,1,289988,289542,446
24505401,3.4401,10.8,435,90520,0.588784,0.26,1,289990,289555,435
24508321,13.488,3.76,449,90520,0.597757,0.25,1,290006,289557,449
24511241,4.2976,11.952,437,90520,0.567551,0.3,1,290008,289571,437
24514161,18.4595,3.9904,457,90520,0.59351,0.28,1,290030,289573,457
24517081,13.2919,18.3981,447,90520,0.574702,0.25,1,290042,289595,447
24520001,5.85838,14.0796,438,90520,0.57094,0.25,1,290046,289608,438
24522921,31.5717,4.41592,474,90520,0.594188,0.29,1,290084,289610,474
24525841,39.1143,33.6832,474,90520,0.686838,0.3,1,290125,289651,474
24528761,9.42287,30.7366,446,91980,0.737367,0.3,1,290127,289681,446
24531681,3.48457,7.74733,446,91980,0.835474,0.5,2,290129,289683,446
24534601,38.2969,37.5495,448,91980,0.919095,0.53,2,290176,289728,448
24889381,20,22,483,67160,0.11,0.99,1,292039,291556,483
24892301,88.8,26.8,561,68620,0.158,0.71,1,292145,291584,561
24895221,32.96,94.16,469,70080,0.1996,0.67,1,292164,291695,469
24898141,20.992,38.032,463,71540,0.22392,0.55,1,292182,291719,463
24901061,22.5984,26.8064,462,73000,0.372784,0.51,1,292205,291743,462
24903981,17.3197,24.5613,454,74460,0.874557,0.4,2,292221,291767,454
24928201,2,0,426,80300,0.83,0.01,2,292405,291979,426
24931121,2,0,428,80300,0.83,0.01,2,292407,291979,428
24934041,2,0,430,80300,0.798,0.01,2,292409,291979,430
24936961,2,0,432,80300,0.7516,0.01,2,292411,291979,432
24939881,2,0,434,80300,0.77432,0.01,2,292413,291979,434
24942801,2,0,436,80300,0.794864,0.01,2,292415,291979,436
24945721,2,0,438,80300,0.814973,0.01,2,292417,291979,438
25252481,15,23,491,43800,0.87,1,2,294571,294080,491
25255401,12.6,4.6,503,43800,0.822,1,2,294583,294080,503
25258321,12.12,0.92,515,42700,0.7484,1,1,294595,294080,515
25261241,13.624,0.184,529,42700,0.68568,1,1,294609,294080,529
25306861,377.925,437.637,451,41240,0.241136,0.6,1,295078,294627,451
25309781,85.185,92.3274,457,45260,0.208227,0.59,1,295090,294633,457
25312701,28.237,29.6655,457,46720,0.193645,0.6,1,295104,294647,457
25315621,16.8474,16.3331,458,48180,0.174729,0.67,1,295118,294660,458
25318541,14.5695,12.0666,461,48180,0.154946,0.67,1,295132,294671,461
25321461,12.5139,12.8133,460,48180,0.0869892,0.71,1,295144,294684,460
25324381,41.7028,10.5627,499,48180,0.0253978,0.59,1,295193,294694,499
25327301,27.5406,51.7125,461,48180,0.46908,0.41,1,295217,294756,461
25330221,130.308,33.5425,588,49640,0.773816,0.19,2,295373,294785,588
25347741,10,9,430,49640,0.81,0.13,2,295498,295068,430
25350661,9.2,9.8,429,49640,0.802,0.13,2,295507,295078,429
25353581,10.64,1.96,440,49640,0.7604,0.2,2,295518,295078,440
25356501,3.728,9.992,430,49640,0.75208,0.19,2,295520,295090,430
25359421,11.1456,13.1984,429,49640,0.758416,0.19,2,295533,295104,429
25362341,12.6291,2.63968,442,49640,0.743683,0.17,1,295546,295104,442
25365261,9.72582,11.7279,437,49640,0.708737,0.15,1,295555,295118,437
25368181,10.7452,13.5456,434,49640,0.661747,0.07,1,295566,295132,434
25371101,40.549,12.3091,470,49640,0.460349,0.01,1,295614,295144,470
25374021,45.7098,41.6618,468,49640,0.46807,0.58,1,295661,295193,468
25376941,10.742,27.5324,446,49640,0.469614,0.85,1,295663,295217,446
25379861,140.548,130.306,463,51100,0.485923,1,1,295836,295373,463
25382781,84.9097,76.4613,471,51100,0.553185,1,1,295907,295436,471
25385701,37.7819,36.0923,471,51100,0.614637,0.88,1,295933,295462,471
25388621,12.3564,13.6185,469,51100,0.626927,0.83,1,295939,295470,469
25391541,7.27128,9.12369,467,51100,0.629385,0.81,1,295945,295478,467
25394461,7.85426,9.82474,465,51100,0.629877,0.81,1,295953,295488,465
25397381,7.97085,9.96495,463,51100,0.629975,0.8,1,295961,295498,463
25400301,4.79417,9.19299,458,51100,0.629995,0.75,1,295965,295507,458
25403221,10.5588,10.6386,459,51100,0.629999,0.75,1,295977,295518,459
25406141,3.71177,3.72772,459,51100,0.598,0.76,1,295979,295520,459
25409061,10.3424,11.1455,458,51100,0.6156,0.74,1,295991,295533,458
25411981,10.8685,12.6291,456,51100,0.60312,0.7,1,296002,295546,456
25414901,6.97369,9.72582,453,51100,0.616624,0.65,1,296008,295555,453
25417821,8.59474,10.7452,451,51100,0.603325,0.41,1,296017,295566,451
25420741,32.9189,40.549,442,51100,0.640665,0.47,1,296056,295614,442
25423661,47.3838,45.7098,446,51100,0.696133,0.47,1,296107,295661,446
25426581,11.0768,10.742,446,51100,0.707227,0.47,1,296109,295663,446
25429501,139.015,2.14839,617,51100,0.469445,0.49,1,296280,295663,617
25432421,91.0031,138.83,523,52560,0.701889,0.57,1,296359,295836,523
25435341,37.4006,84.5659,476,52560,0.756378,0.63,2,296383,295907,476
25438261,12.2801,37.7132,456,52560,0.767276,0.63,2,296389,295933,456
25441181,7.25602,12.3426,456,52560,0.769455,0.63,2,296395,295939,456
25444101,7.8512,7.26853,458,52560,0.769891,0.63,2,296403,295945,458
25447021,7.97024,7.85371,458,52560,0.769978,0.63,2,296411,295953,458
25449941,4.79405,7.97074,454,52560,0.769996,0.63,2,296415,295961,454
25452861,8.95881,4.79415,460,52560,0.769999,0.63,2,296425,295965,460
25455781,4.19176,10.5588,451,52560,0.786,0.59,2,296428,295977,451
25458701,11.2384,3.71177,462,52560,0.7412,0.62,1,296441,295979,462
25461621,11.0477,10.3424,461,52560,0.76424,0.6,2,296452,295991,461
25464541,7.00953,10.8685,456,52560,0.792848,0.62,2,296458,296002,456
25467461,9.40191,6.97369,460,52560,0.79857,0.6,2,296468,296008,460
25470381,34.6804,8.59474,492,52560,0.807714,0.65,2,296509,296017,492
25473301,48.5361,32.9189,505,52560,0.857543,0.71,2,296561,296056,505
25476221,11.3072,47.3838,456,52560,0.867509,0.71,2,296563,296107,456
25479141,135.061,11.0768,620,52560,0.829502,0.41,2,296729,296109,620
25482061,28.6123,139.015,451,52560,0.7899,0.76,2,296731,296280,451
25750701,39,84,504,56940,0.9,1,2,299216,298712,504
25753621,28.6,45.6,494,56940,0.932,1,2,299242,298748,494
25756541,18.52,21.12,495,56940,0.9304,1,2,299258,298763,495
25759461,18.104,16.224,498,56940,0.93008,1,2,299276,298778,498
25762381,18.0208,15.2448,501,58400,0.922016,1,2,299294,298793,501
25765301,16.4042,15.849,501,58400,0.848403,1,2,299310,298809,501
25768221,16.0808,12.7698,505,58400,0.849681,1,2,299326,298821,505
25771141,14.4162,9.75396,510,58400,0.769936,1,2,299340,298830,510
25774061,12.4832,7.55079,515,58400,0.705987,1,1,299352,298837,515
25776981,13.6966,6.31016,523,58400,0.669197,1,1,299366,298843,523
25975541,9,15,492,56940,0.78,0.97,2,301240,300748,492
25978461,12.2,12.6,493,56940,0.82,1,2,301253,300760,493
25981381,12.84,12.92,493,56940,0.828,1,2,301266,300773,493
25984301,26.568,11.384,512,56940,0.6856,1,1,301296,300784,512
25987221,17.3136,35.8768,485,56940,0.62512,1,1,301311,300826,485
25990141,20.2627,21.5754,488,56940,0.501024,1,1,301332,300844,488
25993061,20.0525,20.3151,488,56940,0.460205,1,1,301352,300864,488
25995981,20.0105,20.063,488,56940,0.388041,1,1,301372,300884,488
25998901,43.2021,47.2126,483,56940,0.261608,1,1,301421,300938,483
26191621,45,40,486,58400,0.71,1,1,303059,302573,486
26194541,23.4,22.4,486,58400,0.67,1,1,303077,302591,486
26197461,18.28,18.08,486,58400,0.622,1,1,303094,302608,486
26200381,14.856,14.816,486,58400,0.6124,1,1,303108,302622,486
26203301,14.1712,14.1632,486,58400,0.55448,1,1,303122,302636,486
26206221,22.0342,14.0326,496,58400,0.510896,1,1,303146,302650,496
26209141,15.6068,30.0065,476,58400,0.438179,1,1,303160,302684,476
26212061,19.1214,25.2013,472,58400,0.335636,1,1,303180,302708,472
26214981,16.6243,19.4403,470,58400,0.315127,1,1,303196,302726,470
26217901,24.1249,17.4881,479,58400,0.279025,1,1,303222,302743,479
26220821,28.825,16.2976,493,58400,0.239805,1,1,303252,302759,493
26223741,16.165,14.4595,492,58400,0.231961,1,1,303265,302773,492
26226661,14.433,11.6919,495,58400,0.230392,1,1,303279,302784,495
26229581,18.8866,35.9384,473,58400,0.190078,1,1,303299,302826,473
26232501,28.5773,23.1877,484,58400,0.494016,0.9,1,303330,302846,484
26235421,30.5155,35.8375,476,58400,0.618803,0.96,1,303361,302885,476
26238341,17.3031,19.9675,474,58400,0.611761,1,1,303375,302901,474
26241261,43.4606,47.9935,469,58400,0.642352,0.86,1,303425,302956,469
26244181,27.0921,29.5987,467,58400,0.68047,0.83,1,303448,302981,467
26247101,27.8184,32.3197,462,58400,0.784094,0.71,2,303476,303014,462
26250021,35.9637,42.4639,455,58400,0.772819,0.66,2,303514,303059,455
26252941,19.1927,22.8928,452,58400,0.818564,0.61,2,303529,303077,452
26302581,22,23,455,59860,0.57,0.81,1,303903,303448,455
26305501,31.6,27,461,59860,0.586,0.77,1,303937,303476,461
26308421,39.12,35.8,464,59860,0.6692,0.83,1,303978,303514,464
26311341,29.424,19.16,476,59860,0.70184,1,1,304005,303529,476
26314261,21.0848,16.632,479,59860,0.692368,1,1,304024,303545,479
26317181,16.217,12.9264,482,59860,0.706474,1,1,304039,303557,482
26320101,12.8434,12.1853,482,59860,0.709295,1,1,304051,303569,482
26323021,24.1687,19.2371,488,59860,0.693859,1,1,304078,303590,488
26325941,28.8337,14.2474,505,59860,0.706772,1,1,304108,303603,505
26328861,18.5667,15.6495,505,59860,0.725354,1,1,304124,303619,505
26331781,15.7133,13.5299,507,59860,0.745071,1,1,304139,303632,507
26334701,14.3427,20.306,499,59860,0.749014,1,1,304153,303654,499
26337621,14.0685,28.8612,482,59860,0.749803,1,1,304167,303685,482
26340541,13.2137,14.5722,484,59860,0.781961,1,2,304180,303696,484
26343461,17.8427,14.9144,488,59860,0.804392,0.95,2,304199,303711,488
26346381,15.5685,18.1829,484,59860,0.792878,1,2,304214,303730,484
26349301,25.5137,40.4366,466,59860,0.806576,1,2,304242,303776,466
26352221,41.9027,36.8873,476,61320,0.873315,0.93,2,304288,303812,476
26355141,13.1805,18.5775,468,61320,0.854663,0.63,2,304294,303826,468
26358061,31.4361,47.7155,449,61320,0.850933,0.63,2,304330,303881,449
26360981,24.6872,9.5431,472,61320,0.850187,0.57,2,304353,303881,472
26363901,32.9374,19.5086,485,61320,0.866037,0.59,2,304388,303903,485
26366821,41.7875,31.1017,495,61320,0.917207,0.69,2,304432,303937,495
26565381,32,35,478,74460,0.87,1,2,305880,305402,478
26568301,33.6,24.6,490,74460,0.87,1,2,305914,305424,490
26571221,18.72,16.92,490,74460,0.902,1,2,305929,305439,490
26574141,14.144,12.984,491,75920,0.9244,1,2,305942,305451,491
26577061,9.2288,17.7968,480,75920,0.88088,1,2,305950,305470,480
26579981,8.24576,8.35936,482,75920,0.872176,1,2,305958,305476,482
26582901,31.2492,35.2719,477,75920,0.918435,1,2,305995,305518,477
26585821,19.8498,7.05437,494,75920,0.943687,0.99,2,306012,305518,494
26588741,15.17,15.0109,491,75920,0.932737,1,2,306026,305535,491
26591661,14.234,16.6022,488,77380,0.930547,1,2,306040,305552,488
26594581,14.0468,14.5204,488,77380,0.946109,1,2,306054,305566,488
26597501,12.4094,13.3041,487,77380,0.933222,1,2,306066,305579,487
26600421,20.8819,12.2608,498,77380,0.914644,1,2,306089,305591,498
26603341,20.9764,22.4522,494,78840,0.926929,1,2,306110,305616,494
26829641,27,18,488,70080,0.15,0.89,1,307762,307274,488
26839861,118.2,135.6,464,69320,0.134,0.67,1,307903,307439,464
26855921,61.24,76.72,449,69660,0.2268,0.39,1,307950,307501,449
26861761,49.048,60.944,438,70080,0.13336,0.25,1,307996,307558,438
26904801,25.0096,33.7888,430,70080,0.098672,0.16,1,308015,307585,430
26907721,81.8019,75.5578,440,71540,0.107734,0.19,1,308111,307671,440
26910641,33.9604,31.1116,442,73000,0.421547,0.23,1,308133,307691,442
26913561,21.1921,21.4223,441,74460,0.732309,0.2,1,308151,307710,441
26916481,15.4384,17.8845,438,75920,0.802462,0.15,2,308165,307727,438
26919401,23.8877,31.5769,429,77380,0.712492,0.06,1,308191,307762,429
26922321,43.1775,39.9154,435,77380,0.454498,0.05,1,308239,307804,435
26925241,32.6355,28.7831,439,77380,0.3549,0.11,1,308269,307830,439
26928161,30.5271,31.3566,437,77380,0.30298,0.17,1,308299,307862,437
26931081,22.1054,24.6713,434,77380,0.308596,0.13,1,308319,307885,434
26934001,10.8211,19.3343,424,78840,0.213719,0.13,1,308327,307903,424
26936921,3.76422,3.86685,426,78840,0.194744,0.13,1,308329,307903,426
26939841,43.1528,0.77337,479,78840,0.190949,0.25,1,308382,307903,479
26942761,10.2306,37.7547,434,78840,0.19019,0.25,1,308384,307950,434
26945681,3.64611,7.55093,436,80300,0.158038,0.25,1,308386,307950,436
26948601,2.32922,1.51019,438,80300,0.151608,0.11,1,308388,307950,438
26951521,27.6658,37.102,426,80300,0.246322,0.11,1,308422,307996,426
26954441,18.3332,7.42041,442,80300,0.265264,0.09,1,308438,307996,442
26957361,5.26663,16.6841,425,80300,0.269053,0.09,1,308440,308015,425
26960281,2.65333,3.33682,427,80300,0.269811,0.09,1,308442,308015,427
26963201,2.13067,0.667363,429,81760,0.269962,0.09,1,308444,308015,429
26966121,2.02613,0.133473,431,81760,0.269992,0.09,1,308446,308015,431
26969041,2.00523,0.0266945,433,81760,0.285998,0.09,1,308448,308015,433
26971961,2.00105,0.0053389,435,81760,0.2892,0.09,1,308450,308015,435
26974881,2.00021,0.00106778,437,81760,0.28984,0.09,1,308452,308015,437
26977801,67.6,0.000213556,521,81760,0.257968,0.11,1,308536,308015,521
26980721,15.12,76.8,427,83220,0.251594,0.5,1,308538,308111,427
26983641,47.024,32.96,460,83220,0.298319,0.5,1,308593,308133,460
26986561,23.8048,6.592,478,83220,0.371664,0.81,1,308611,308133,478
26989481,6.36096,15.7184,462,83220,0.386333,0.82,1,308613,308151,462
26992401,11.6722,14.3437,461,83220,0.421267,0.82,1,308626,308165,461
26995321,15.9344,2.86874,478,84680,0.412253,0.69,1,308643,308165,478
26998241,33.5869,21.3737,490,84680,0.474451,0.39,1,308681,308191,490
27001161,28.3174,42.6748,469,84680,0.50289,0.33,1,308708,308239,469
27004081,26.4635,32.5349,465,84680,0.524578,0.29,1,308734,308269,465
27007001,17.2927,30.507,450,84680,0.560916,0.31,1,308749,308299,450
27009921,5.05854,22.1014,432,86140,0.536183,0.19,1,308751,308319,432
27012841,5.81171,10.8203,430,86140,0.563237,0.19,1,308757,308327,430
27015761,2.76234,3.76406,430,86140,0.568647,0.19,1,308759,308329,430
27018681,42.1525,43.1528,429,86140,0.633729,0.19,1,308811,308382,429
27021601,10.0305,10.2306,429,86140,0.646746,0.19,1,308813,308384,429
27024521,3.6061,2.04611,431,86140,0.617349,0.15,1,308815,308384,431
27027441,2.32122,2.00922,431,86140,0.64347,0.15,1,308817,308386,431
27030361,30.8642,2.00184,467,87600,0.664694,0.27,1,308855,308388,467
27033281,20.5728,27.6004,451,87600,0.716939,0.27,1,308873,308422,451
27036201,5.71457,18.3201,437,87600,0.695388,0.27,1,308875,308438,437
27039121,2.74291,5.26401,437,87600,0.691078,0.27,1,308877,308440,437
27042041,2.14858,2.6528,437,87600,0.690216,0.27,1,308879,308442,437
27044961,2.02972,2.13056,437,87600,0.722043,0.27,1,308881,308444,437
27047881,2.00594,2.02611,437,87600,0.744409,0.29,1,308883,308446,437
27050801,2.00119,2.00522,437,87600,0.748882,0.29,1,308885,308448,437
27053721,2.00024,2.00104,437,89060,0.749776,0.29,1,308887,308450,437
27056641,2.00005,2.00021,437,89060,0.749955,0.25,1,308889,308452,437
27059561,66,67.6,435,89060,0.781991,0.25,2,308971,308536,435
27062481,14.8,13.52,437,89060,0.788398,0.25,2,308973,308536,437
27065401,49.36,4.304,493,89060,0.80568,0.31,2,309031,308538,493
27068321,26.672,44.8608,459,89060,0.873136,0.39,2,309052,308593,459
27071241,6.9344,23.3722,443,89060,0.854627,0.39,2,309054,308611,443
27074161,10.9869,6.27443,453,90520,0.882926,0.43,2,309066,308613,453
27077081,3.79738,11.6549,442,90520,0.888585,0.41,2,309068,308626,442
27080001,16.7595,15.931,445,90520,0.905717,0.49,2,309088,308643,445
27322361,7,13,515,99280,0.93,1,2,310360,309845,515
27323821,15.8,11.4,522,99280,0.962,1,2,310378,309856,522
27426021,385.56,428.68,467,67320,0.6964,0.65,1,310856,310389,467
27462681,2,0,449,77380,0.81,0.57,2,311315,310866,449
27465601,2,0,451,77380,0.826,0.57,2,311317,310866,451
27468521,2,0,453,77380,0.8132,0.57,2,311319,310866,453
27471441,2,0,455,77380,0.76264,0.57,2,311321,310866,455
27474361,2,0,457,77380,0.816528,0.57,2,311323,310866,457
27477281,2,0,459,77380,0.843306,0.57,2,311325,310866,459
27480201,2,0,461,77380,0.864661,0.57,2,311327,310866,461
27483121,2,0,463,77380,0.868932,0.57,2,311329,310866,463
27486041,2,0,465,77380,0.885786,0.57,2,311331,310866,465
27488961,2,0,467,77380,0.897157,0.57,2,311333,310866,467
27491881,2,0,469,77380,0.915431,0.57,2,311335,310866,469
27970881,4,4,531,77380,0.92,1,2,314765,314234,531
27973801,5.6,5.6,531,77380,0.88,1,2,314771,314240,531
27975261,13.92,5.92,541,78840,0.936,1,2,314787,314246,541
27995701,384.384,446.784,461,52740,0.8352,0.34,2,315264,314803,461
28080381,19,22,440,58400,0.27,0.24,1,315597,315157,440
28083301,19.8,23.6,436,59860,0.142,0.21,1,315617,315181,436
28086221,30.36,17.52,453,59860,0.1004,0.73,1,315650,315197,453
28089141,22.872,16.304,458,59860,0.10808,0.75,1,315671,315213,458
28092061,13.3744,10.4608,460,59860,0.125616,0.73,1,315682,315222,460
28094981,10.6749,7.69216,463,59860,0.0971232,0.77,1,315692,315229,463
28097901,5.33498,4.73843,463,59860,0.123425,0.83,1,315696,315233,463
28100821,4.267,4.94769,462,59860,0.128685,0.83,1,315700,315238,462
28103741,12.0534,2.58954,474,59860,0.097737,0.79,1,315714,315240,474
28103921,6.41068,11.7179,465,59860,0.107547,0.76,1,315719,315254,465
28106841,30.8821,24.7436,474,59860,0.173509,0.96,1,315756,315282,474
28109761,22.9764,21.7487,474,59860,0.202702,0.95,1,315777,315303,474
28112681,13.3953,17.9497,468,61320,0.25654,0.87,1,315788,315320,468
28115601,18.6791,15.5899,473,61320,0.331308,1,1,315808,315335,473
28118521,14.1358,13.518,473,61320,0.346262,1,1,315821,315348,473
28121441,15.6272,17.1036,471,61320,0.317252,1,1,315837,315366,471
28124361,6.32543,4.22072,474,61320,0.35945,1,1,315841,315367,474
28127281,125.265,0.844144,629,61320,0.44789,0.23,1,315996,315367,629
28130201,28.253,156.169,438,61320,0.465578,0.35,1,316000,315562,438
28133121,16.0506,44.0338,435,61320,0.453116,0.35,1,316013,315578,435
28136041,15.2101,8.80675,450,61320,0.450623,0.27,1,316028,315578,450
28138961,4.64202,16.9614,433,61320,0.418125,0.11,1,316030,315597,433
28141881,8.9284,19.3923,423,61320,0.443625,0.09,1,316040,315617,423
28144801,28.9857,30.2785,424,62780,0.496725,0.11,1,316074,315650,424
28147721,24.9971,22.8557,427,62780,0.491345,0.13,1,316098,315671,427
28150641,12.9994,13.3711,426,62780,0.490269,0.09,1,316108,315682,426
28153561,10.5999,10.6742,426,62780,0.506054,0.13,1,316118,315692,426
28156481,5.31998,5.33485,426,62780,0.557211,0.13,1,316122,315696,426
28159401,4.264,4.26697,426,62780,0.567442,0.09,1,316126,315700,426
28162321,13.6528,12.0534,428,62780,0.537488,0.11,1,316142,315714,428
28165241,37.9306,6.41068,467,62780,0.531498,0.19,1,316186,315719,467
28168161,25.9861,30.8821,453,62780,0.5623,0.21,1,316209,315756,453
28171081,6.79722,22.9764,434,62780,0.56846,0.27,1,316211,315777,434
28174001,11.7594,13.3953,436,62780,0.585692,0.35,1,316224,315788,436
28176921,19.1519,18.6791,437,62780,0.645138,0.35,1,316245,315808,437
28179841,14.2304,14.1358,437,62780,0.649028,0.31,1,316258,315821,437
28182761,16.4461,15.6272,438,62780,0.633806,0.37,1,316275,315837,438
28185681,6.48922,6.32543,438,62780,0.630761,0.47,1,316279,315841,438
28188601,129.298,125.265,443,62780,0.694152,0.47,1,316439,315996,443
28191521,29.0596,28.253,443,64240,0.70683,0.45,1,316443,316000,443
28194441,16.2119,16.0506,443,64240,0.709366,0.45,1,316456,316013,443
28197361,16.0424,15.2101,444,64240,0.741873,0.41,1,316472,316028,444
28200281,4.80848,4.64202,444,64240,0.764375,0.45,2,316474,316030,444
28203201,8.1617,8.9284,443,64240,0.752875,0.45,2,316483,316040,443
28206121,30.4323,1.78568,479,64240,0.766575,0.51,2,316519,316040,479
28209041,25.2865,27.5571,469,64240,0.785315,0.49,2,316543,316074,469
28211961,13.8573,24.7114,456,64240,0.805063,0.49,2,316554,316098,456
28214881,11.5715,12.9423,457,64240,0.841013,0.51,2,316565,316108,457
28217801,5.51429,10.5885,451,64240,0.816203,0.57,2,316569,316118,451
28220721,4.30286,5.31769,451,64240,0.827241,0.57,2,316573,316122,451
28223641,13.6606,4.26354,463,64240,0.829448,0.53,2,316589,316126,463
28226561,37.9321,13.6527,491,64240,0.86189,0.53,2,316633,316142,491
28229481,27.5864,37.9305,472,64240,0.884378,0.57,2,316658,316186,472
28232401,7.11728,25.9861,451,64240,0.888876,0.57,2,316660,316209,451
28235321,12.6235,6.79722,463,64240,0.905775,0.59,2,316674,316211,463
28836841,19,14,476,54020,0.79,1,2,321056,320580,476
29076281,37,19,439,49640,0.17,0.01,1,322990,322551,439
29079201,70.6,30.2,485,51100,0.042,0.1,1,323069,322584,485
29082121,34.92,70.04,431,52560,0.0324,0.03,1,323095,322664,431
29085041,32.584,28.408,445,52560,0.00648,0.01,1,323127,322682,445
29087961,24.9168,28.0816,440,52560,0.009296,0.01,1,323150,322710,440
29090881,16.9834,27.2163,428,52560,0.0018592,0.01,1,323165,322737,428
29093801,18.5967,13.4433,437,52560,0.00037184,0.03,1,323184,322747,437
29096721,17.3193,22.6887,429,54020,0.296074,0,1,323201,322772,429
29099641,18.6639,15.7377,434,54020,0.259215,0.01,1,323220,322786,434
29102561,22.1328,16.7475,440,54020,0.051843,0.21,1,323243,322803,440
29105481,25.2266,16.1495,450,54020,0.0663686,0.19,1,323269,322819,450
29108401,18.6453,20.8299,445,54020,0.0372737,0.27,1,323286,322841,445
29111321,24.5291,20.966,450,54020,0.0154547,0.38,1,323312,322862,450
29114241,19.3058,20.1932,448,54020,0.0270909,0.37,1,323330,322882,448
29117161,19.0612,18.4386,449,54020,0.0294182,0.25,1,323349,322900,449
29120081,17.4122,24.4877,440,54020,0.0298836,0.05,1,323366,322926,440
29123001,14.6824,26.4975,427,54020,0.0139767,0.17,1,323380,322953,427
29125921,31.7365,34.8995,426,54020,0.0107953,0.17,1,323416,322990,426
29128841,65.5473,6.9799,500,55480,0.0421591,0.01,1,323490,322990,500
29131761,14.7095,64.596,423,55480,0.0164318,0.03,1,323492,323069,423
29134681,22.9419,33.7192,422,55480,0.0112864,0,1,323517,323095,422
29137601,30.9884,32.3438,423,55480,0.0102573,0.01,1,323550,323127,423
29140521,24.5977,24.8688,423,55480,0.00205145,0,1,323573,323150,423
29143441,16.9195,16.9738,423,55480,0.000410291,0,1,323588,323165,423
29146361,18.5839,18.5948,423,55480,8.20582e-05,0,1,323607,323184,423
29149281,29.3168,3.71895,455,55480,0.0560164,0.37,1,323639,323184,455
29152201,10.6634,14.3438,444,55480,0.0512033,0.25,1,323645,323201,444
29155121,19.7327,18.0688,447,55480,0.0182407,0,1,323667,323220,447
29158041,22.3465,22.0138,447,55480,0.123648,0.07,1,323690,323243,447
29160961,18.8693,25.2028,439,55480,0.0967296,0.03,1,323708,323269,439
29163881,24.5739,18.6406,448,55480,0.0273459,0.01,1,323734,323286,448
29166801,18.5148,24.5281,439,56940,0.0294692,0.03,1,323751,323312,439
29169721,20.503,19.3056,442,56940,0.00589384,0.03,1,323772,323330,442
29172641,17.7006,19.0611,440,56940,0.0411788,0.03,1,323789,323349,440
29175561,13.1401,17.4122,435,56940,0.0162358,0.01,1,323801,323366,435
29178481,31.428,14.6824,457,56940,0.0432472,0.01,1,323837,323380,457
29181401,7.8856,31.7365,423,56940,0.0166494,0.05,1,323839,323416,423
29184321,59.9771,65.5473,422,56940,0.0273299,0.01,1,323912,323490,422
29187241,13.5954,14.7095,422,56940,0.00546598,0.01,1,323914,323492,422
29190161,22.7191,22.9419,422,56940,0.0410932,0.01,1,323939,323517,422
29193081,30.9438,30.9884,422,56940,0.0162186,0,1,323972,323550,422
29196001,24.5888,24.5977,422,56940,0.00324373,0,1,323995,323573,422
29198921,17.7178,16.9195,423,56940,0.000648745,0,1,324011,323588,423
29201841,17.9436,18.5839,422,56940,0.000129749,0.07,1,324029,323607,422
29204761,30.7887,29.3168,424,56940,0.024026,0.05,1,324063,323639,424
29207681,10.9577,10.6634,424,56940,0.0768052,0.01,1,324069,323645,424
29210601,19.7915,19.7327,424,56940,0.023361,0.15,1,324091,323667,424
29213521,25.5583,22.3465,428,56940,0.0446722,0.09,1,324118,323690,428
29216441,17.9117,18.8693,426,56940,0.0969344,0.01,1,324134,323708,426
29219361,21.9823,24.5739,423,56940,0.123387,0.01,1,324157,323734,423
29222281,17.1965,4.91477,439,58400,0.112677,0.03,1,324173,323734,439
29225201,19.4393,14.583,442,58400,0.0785355,0,1,324193,323751,442
29228121,17.4879,19.7166,438,58400,0.0397071,0.05,1,324210,323772,438
29231041,13.0976,17.5433,433,58400,0.0319414,0.01,1,324222,323789,433
29233961,32.2195,13.1087,458,58400,0.0303883,0.05,1,324259,323801,458
29236881,8.0439,31.4217,424,58400,0.00607766,0.01,1,324261,323837,424
29239801,59.2088,7.88435,494,58400,0.0252155,0.03,1,324333,323839,494
29242721,13.4418,59.9769,423,58400,0.00504311,0,1,324335,323912,423
29245641,22.6884,13.5954,446,58400,0.0570086,0.05,1,324360,323914,446
29248561,30.9377,22.7191,454,58400,0.0354017,0.01,1,324393,323939,454
29251481,24.5875,30.9438,444,58400,0.00708034,0,1,324416,323972,444
29254401,17.7175,24.5888,437,58400,0.00141607,0,1,324432,323995,437
29257321,17.9435,17.7178,439,58400,0.000283214,0,1,324450,324011,439
29260241,32.3887,17.9436,457,58400,0.0400566,0.03,1,324486,324029,457
29263161,11.2777,30.7887,429,58400,0.0480113,0.09,1,324492,324063,429
29266081,19.0555,10.9577,444,58400,0.0336023,0.01,1,324513,324069,444
29269001,28.6111,19.7915,453,58400,0.0627204,0.05,1,324544,324091,453
29271921,18.5222,25.5583,442,58400,0.100544,0.11,1,324560,324118,442
29274841,21.3044,17.9117,448,58400,0.108109,0.13,1,324582,324134,448
29277761,5.86089,21.9823,427,58400,0.109622,0.11,1,324584,324157,427
29280681,13.9722,17.1965,427,58400,0.109924,0.07,1,324600,324173,427
29283601,15.5944,19.4393,423,58400,0.109985,0.03,1,324616,324193,423
29286521,16.7189,17.4879,423,58400,0.093997,0.03,1,324633,324210,423
29289441,12.9438,13.0976,423,58400,0.106799,0.03,1,324645,324222,423
29292361,31.3888,32.2195,422,58400,0.0773599,0,1,324681,324259,422
29295281,7.87775,8.0439,422,58400,0.039472,0.03,1,324683,324261,422
29298201,59.1756,59.2088,422,58400,0.0318944,0,1,324755,324333,422
29301121,13.4351,13.4418,422,58400,0.00637888,0.07,1,324757,324335,422
29304041,22.687,22.6884,422,58400,0.00927578,0.03,1,324782,324360,422
29306961,30.9374,30.9377,422,58400,0.0258552,0,1,324815,324393,422
29309881,25.3875,24.5875,423,58400,0.029171,0,1,324839,324416,423
29312801,18.6775,17.7175,424,58400,0.00583421,0,1,324856,324432,424
29315721,17.3355,17.9435,423,58400,0.0251668,0.05,1,324873,324450,423
29318641,33.0671,32.3887,424,58400,0.0770334,0.05,1,324910,324486,424
29321561,11.4134,11.2777,424,58400,0.0554067,0.03,1,324916,324492,424
29324481,18.2827,19.0555,423,58400,0.0830813,0.07,1,324936,324513,423
29327401,31.6565,28.6111,427,58400,0.0886163,0.11,1,324971,324544,427
29330321,19.1313,18.5222,427,58400,0.153723,0.11,1,324987,324560,427
29333241,21.4263,21.3044,427,58400,0.182745,0.11,1,325009,324582,427
29336161,5.88525,5.86089,427,58400,0.188549,0.11,1,325011,324584,427
29339081,13.9771,13.9722,427,58400,0.18971,0.11,1,325027,324600,427
29342001,15.5954,15.5944,427,58400,0.189942,0.09,1,325043,324616,427
29344921,16.7191,16.7189,427,58400,0.173988,0.11,1,325060,324633,427
29347841,14.5438,12.9438,429,58400,0.138798,0.07,1,325074,324645,429
29350761,26.1088,31.3888,422,58400,0.21176,0.03,1,325103,324681,422
29353681,6.82175,7.87775,422,58400,0.226352,0.03,1,325105,324683,422
29356601,58.9644,59.1756,422,58400,0.0852704,0,1,325177,324755,422
29359521,13.3929,13.4351,422,58400,0.0570541,0.01,1,325179,324757,422
29362441,22.6786,22.687,422,58400,0.0354108,0.03,1,325204,324782,422
29365361,30.9357,30.9374,422,58400,0.0470822,0.03,1,325237,324815,422
29368281,25.3871,25.3875,422,58400,0.0334164,0,1,325261,324839,422
29371201,18.6774,18.6775,422,58400,0.00668329,0.03,1,325278,324856,422
29374121,17.3355,17.3355,422,58400,0.00933666,0.09,1,325295,324873,422
29377041,34.6671,33.0671,424,58400,0.0258673,0.05,1,325334,324910,424
29379961,11.7334,11.4134,424,58400,0.00517347,0.09,1,325340,324916,424
29382881,18.3467,18.2827,424,58400,0.0410347,0.09,1,325360,324936,424
29385801,34.8693,31.6565,428,58400,0.0482069,0.17,1,325399,324971,428
29388721,20.5739,19.1313,429,58400,0.193641,0.19,1,325416,324987,429
29391641,21.7148,21.4263,429,58400,0.254728,0.19,1,325438,325009,429
29394561,5.94295,5.88525,429,58400,0.266946,0.19,1,325440,325011,429
29397481,13.9886,13.9771,429,58400,0.237389,0.19,1,325456,325027,429
29400401,15.5977,15.5954,429,58400,0.263478,0.17,1,325472,325043,429
29403321,17.5195,16.7191,430,58400,0.236696,0.13,1,325490,325060,430
29406241,16.3039,14.5438,432,58400,0.263339,0.23,1,325506,325074,432
29409161,25.6608,26.1088,431,58400,0.300668,0.23,1,325534,325103,431
29412081,6.73216,6.82175,431,58400,0.308134,0.05,1,325536,325105,431
29415001,51.7464,58.9644,422,58400,0.293627,0.05,1,325599,325177,422
29417921,11.9493,13.3929,422,58400,0.290725,0.03,1,325601,325179,422
29420841,22.3899,22.6786,422,58400,0.210145,0.05,1,325626,325204,422
29423761,30.878,30.9357,422,58400,0.050029,0.03,1,325659,325237,422
29426681,25.3756,25.3871,422,58400,0.0340058,0,1,325683,325261,422
29429601,18.6751,18.6774,422,58400,0.0308012,0.01,1,325700,325278,422
29432521,17.335,17.3355,422,58400,0.00616023,0.03,1,325717,325295,422
29435441,34.667,34.6671,422,58400,0.025232,0,1,325756,325334,422
29438361,11.7334,11.7334,422,58400,0.00504641,0.05,1,325762,325340,422
29441281,19.1467,18.3467,423,58400,0.0250093,0.05,1,325783,325360,423
29444201,42.2293,34.8693,432,58400,0.125002,0.23,1,325831,325399,432
29447121,22.8459,20.5739,433,58400,0.209,0.27,1,325849,325416,433
29450041,22.1692,21.7148,433,58400,0.2578,0.27,1,325871,325438,433
29452961,6.03383,5.94295,433,58400,0.26756,0.23,1,325873,325440,433
29455881,14.0068,13.9886,433,58400,0.237512,0.27,1,325889,325456,433
29458801,15.6014,15.5977,433,58400,0.263502,0.23,1,325905,325472,433
29461721,17.5203,17.5195,433,58400,0.2367,0.27,1,325923,325490,433
29464641,19.5041,16.3039,437,58400,0.32734,0.31,1,325943,325506,437
29467561,26.3008,25.6608,437,58400,0.377468,0.31,1,325971,325534,437
29470481,6.86016,6.73216,437,58400,0.387494,0.29,1,325973,325536,437
29473401,47.772,51.7464,432,58400,0.389499,0.29,1,326031,325599,432
29476321,11.1544,11.9493,432,58400,0.3899,0.19,1,326033,325601,432
29479241,16.6309,22.3899,425,58400,0.42198,0.01,1,326051,325626,425
29482161,27.3262,30.878,422,58400,0.396396,0.03,1,326081,325659,422
29485081,24.6652,25.3756,422,58400,0.199279,0.03,1,326105,325683,422
29488001,18.533,18.6751,422,58400,0.0478558,0,1,326122,325700,422
29490921,17.3066,17.335,422,58400,0.00957117,0.03,1,326139,325717,422
29493841,34.6613,34.667,422,58400,0.0739142,0,1,326178,325756,422
29496761,11.7323,11.7334,422,58400,0.0547828,0.03,1,326184,325762,422
29499681,20.7465,19.1467,424,58400,0.0669566,0.15,1,326207,325783,424
29502601,49.7493,42.2293,433,58400,0.0693913,0.23,1,326264,325831,433
29505521,24.3499,22.8459,433,58400,0.0698783,0.27,1,326282,325849,433
29508441,22.47,22.1692,433,58400,0.0699757,0.27,1,326304,325871,433
29511361,6.09399,6.03383,433,58400,0.0699951,0.23,1,326306,325873,433
29514281,14.0188,14.0068,433,58400,0.037999,0.27,1,326322,325889,433
29517201,15.6038,15.6014,433,58400,0.0635998,0.23,1,326338,325905,433
29520121,17.5208,17.5203,433,58400,0.08472,0.35,1,326356,325923,433
29523041,25.9041,19.5041,441,58400,0.280944,0.39,1,326384,325943,441
29525961,27.5808,26.3008,441,58400,0.368189,0.39,1,326412,325971,441
29528881,7.11617,6.86016,441,58400,0.385638,0.39,1,326414,325973,441
29531801,47.8232,47.772,441,58400,0.421128,0.39,1,326472,326031,441
29534721,11.1646,11.1544,441,58400,0.428226,0.43,1,326474,326033,441
29537641,16.6329,16.6309,441,58400,0.461645,0.39,1,326492,326051,441
29540561,22.5266,27.3262,435,59860,0.452329,0.15,1,326516,326081,435
29543481,14.1053,24.6652,423,59860,0.450466,0.01,1,326528,326105,423
29546401,15.6211,18.533,422,59860,0.418093,0,1,326544,326122,422
29549321,16.7242,17.3066,422,59860,0.331619,0.09,1,326561,326139,422
29552241,36.1448,34.6613,424,59860,0.234324,0.05,1,326602,326178,424
29555161,12.029,11.7323,424,59860,0.182865,0.07,1,326608,326184,424
29558081,20.0058,20.7465,423,59860,0.204573,0.07,1,326630,326207,423
29561001,49.6012,49.7493,423,59860,0.224915,0.07,1,326687,326264,423
29563921,24.3202,24.3499,423,59860,0.244983,0.07,1,326705,326282,423
29566841,22.464,22.47,423,59860,0.248997,0.07,1,326727,326304,423
29569761,6.09281,6.09399,423,59860,0.249799,0.03,1,326729,326306,423
29572681,14.0186,14.0188,423,59860,0.21796,0.07,1,326745,326322,423
29575601,15.6037,15.6038,423,59860,0.259592,0.09,1,326761,326338,423
29578521,18.3207,17.5208,424,59860,0.251918,0.33,1,326780,326356,424
29581441,38.8641,25.9041,440,59860,0.266384,0.39,1,326824,326384,440
29584361,30.9728,27.5808,441,59860,0.301277,0.39,1,326853,326412,441
29587281,7.79457,7.11617,441,61320,0.308255,0.43,1,326855,326414,441
29590201,49.5589,47.8232,443,61320,0.341651,0.43,1,326915,326472,443
29593121,11.5118,11.1646,443,61320,0.34833,0.47,1,326917,326474,443
29596041,16.7024,16.6329,443,61320,0.397666,0.47,1,326935,326492,443
29598961,22.5405,3.32659,467,61320,0.375533,0.45,1,326959,326492,467
29601881,14.1081,19.8653,455,61320,0.371107,0.45,1,326971,326516,455
29604801,10.8216,13.5731,453,61320,0.370221,0.41,1,326981,326528,453
29607721,11.7643,15.5146,449,61320,0.370044,0.31,1,326993,326544,449
29610641,32.7529,16.7029,470,61320,0.402009,0.21,1,327031,326561,470
29613561,11.3506,36.1406,435,61320,0.424402,0.17,1,327037,326602,435
29616481,19.8701,12.0281,451,61320,0.44488,0.21,1,327059,326608,451
29619401,50.374,20.0056,487,61320,0.512976,0.23,1,327117,326630,487
29622321,25.2748,49.6011,449,62780,0.590595,0.25,1,327136,326687,449
29625241,22.655,24.3202,453,62780,0.606119,0.25,1,327158,326705,453
29628161,6.13099,22.464,433,62780,0.609224,0.25,1,327160,326727,433
29631081,14.0262,6.09281,447,62780,0.609845,0.21,1,327176,326729,447
29634001,16.4052,14.0186,448,62780,0.609969,0.27,1,327193,326745,448
29636921,17.681,15.6037,450,62780,0.609994,0.25,1,327211,326761,450
29639841,41.1362,18.3207,478,62780,0.625999,0.27,1,327258,326780,478
29642761,33.0272,38.8641,465,62780,0.6452,0.31,1,327289,326824,465
29645681,8.20545,30.9728,438,64240,0.64904,0.31,1,327291,326853,438
29648601,3.24109,7.79457,438,64240,0.649808,0.35,1,327293,326855,438
29651521,49.4482,49.5589,439,64240,0.665962,0.35,1,327354,326915,439
29654441,11.4896,11.5118,439,64240,0.669192,0.41,1,327356,326917,439
29657361,17.4979,16.7024,440,64240,0.669838,0.37,1,327375,326935,440
29660281,22.6996,22.5405,440,64240,0.669968,0.37,1,327399,326959,440
29663201,14.1399,14.1081,440,64240,0.701994,0.37,1,327411,326971,440
29666121,10.828,10.8216,440,64240,0.708399,0.37,1,327421,326981,440
29669041,13.3656,11.7643,442,64240,0.74168,0.41,1,327435,326993,442
29671961,33.8731,32.7529,443,64240,0.780336,0.43,2,327474,327031,443
29674881,11.5746,11.3506,443,65700,0.820067,0.45,2,327480,327037,443
29677801,20.7149,19.8701,444,65700,0.828013,0.53,2,327503,327059,444
29680721,54.543,50.374,449,65700,0.845603,0.53,2,327566,327117,449
29683641,27.7086,10.0748,470,65700,0.881121,0.61,2,327587,327117,470
29686561,23.1417,17.215,473,65700,0.920224,0.61,2,327609,327136,473
29689481,6.22834,21.043,453,67160,0.928045,0.61,2,327611,327158,453
29692401,14.0457,5.8086,467,67160,0.945609,0.61,2,327627,327160,467
30005881,15,14,430,39420,0,0.15,1,329825,329395,430
30008801,4.6,2.8,432,39420,0.136,0.15,1,329827,329395,432
30011721,2.52,0.56,434,39420,0.1632,0.13,1,329829,329395,434
30014641,34.104,5.712,469,39420,0.07264,0.13,1,329871,329402,469
30043841,67,56,444,45260,0.51,0,1,330254,329810,444
30046761,15,23.2,431,45260,0.542,0.17,1,330256,329825,431
30049681,4.6,6.24,431,45260,0.5164,0.17,1,330258,329827,431
30052601,29.72,2.848,465,45260,0.31928,0.05,1,330294,329829,465
30055521,7.544,34.1696,425,45260,0.279856,0.96,1,330296,329871,425
30058441,94.3088,60.4339,474,45260,0.383971,0.96,1,330412,329938,474
30061361,26.8618,12.0868,484,45260,0.436794,1,1,330422,329938,484
30064281,16.5724,20.8174,475,45260,0.519359,1,1,330436,329961,475
30067201,29.7145,41.7635,461,45260,0.607872,1,1,330469,330008,461
30070121,61.9429,25.1527,510,45260,0.689574,1,1,330539,330029,510
30073041,26.7886,5.03054,528,45260,0.769915,1,2,330557,330029,528
30075961,19.7577,31.4061,508,46720,0.785983,1,2,330575,330067,508
30078881,23.1515,26.2812,507,46720,0.741197,1,1,330599,330092,507
30081801,40.6303,33.2562,517,46720,0.796239,0.85,2,330644,330127,517
30084721,16.1261,41.8512,483,46720,0.839248,0.92,2,330654,330171,483
30087641,37.6252,21.1702,510,46720,0.87985,0.51,2,330697,330187,510
30090561,9.12504,57.8341,445,46720,0.88797,0.55,2,330699,330254,445
30093481,3.42501,13.1668,445,46720,0.889594,0.51,2,330701,330256,445
30096401,19.885,4.23336,467,46720,0.905919,0.27,2,330725,330258,467
30099321,5.577,29.6467,433,46720,0.909184,0.27,2,330727,330294,433
30233641,13,13,505,48180,0.83,1,2,332143,331638,505
30236561,15.4,12.2,509,48180,0.798,1,2,332159,331650,509
30239481,15.08,11.24,513,48180,0.6956,1,1,332174,331661,513
30242401,72.616,11.848,588,48180,0.27512,1,1,332261,331673,588
30245321,46.5232,109.57,494,48180,0.063024,1,1,332301,331807,494
30248241,37.3046,36.3139,511,48180,0.0366048,1,1,332336,331825,511
30251161,20.2609,22.4628,508,48180,0.367321,1,1,332352,331844,508
30254081,44.8522,18.0926,542,48180,0.241464,1,1,332403,331861,542
30257001,36.9704,62.8185,503,48180,0.472293,1,1,332438,331935,503
30259921,24.9941,25.3637,509,48180,0.422459,0.98,1,332460,331951,509
30262841,24.1988,27.4727,505,48180,0.364492,1,1,332484,331979,505
30265761,18.4398,31.8945,489,48180,0.320898,1,1,332501,332012,489
30268681,15.688,19.1789,488,48180,0.28018,1,1,332516,332028,488
30271601,15.9376,18.2358,486,48180,0.608036,1,1,332532,332046,486
30274521,39.9875,17.2472,515,48180,0.481607,0.84,1,332578,332063,515
30277441,18.3975,45.0494,476,48180,0.472321,0.87,1,332591,332115,476
30280361,14.0795,21.0099,474,48180,0.438464,0.83,1,332604,332130,474
30283281,10.8159,14.602,471,48180,0.407693,0.79,1,332614,332143,471
30286201,11.7632,15.7204,467,48180,0.401539,0.67,1,332626,332159,467
30289121,51.9526,15.1441,514,48180,0.720308,0.17,1,332688,332174,514
30292041,37.5905,72.6288,461,48180,0.552062,0.01,1,332722,332261,461
30294961,37.1181,46.5258,458,48180,0.110412,0.03,1,332759,332301,458
30306641,18,35,461,48180,0.19,0.41,1,332899,332438,461
30309561,21.2,24.6,461,48180,0.11,0.35,1,332921,332460,461
30312481,15.44,24.12,451,48180,0.062,0.31,1,332935,332484,451
30315401,12.688,18.424,446,48180,0.0844,0.27,1,332947,332501,446
30318321,30.5376,15.6848,466,48180,0.05688,0.69,1,332982,332516,466
30321241,37.3075,15.937,489,48180,0.067376,0.45,1,333021,332532,489
30324161,16.2615,39.9874,454,48180,0.0854752,0.47,1,333032,332578,454
30327081,12.8523,18.3975,453,48180,0.089095,0.43,1,333044,332591,453
30330001,10.5705,14.0795,450,48180,0.121819,0.4,1,333054,332604,450
30332921,13.3141,10.8159,454,48180,0.0963638,0.4,1,333068,332614,454
30335841,61.8628,11.7632,516,48180,0.203273,0.8,1,333142,332626,516
30338761,25.1726,51.9526,470,48180,0.240655,0.51,1,333158,332688,470
30341681,61.0345,37.5905,506,48180,0.184131,0,1,333228,332722,506
30344601,18.6069,37.1181,477,48180,0.172826,0.59,1,333236,332759,477
30347521,55.7214,33.8236,509,48180,0.202565,0.55,1,333301,332792,509
30350441,20.7443,59.5647,455,49640,0.192513,0.31,1,333313,332858,455
30353361,12.9489,30.3129,443,49640,0.254503,0.19,1,333324,332881,443
30356281,17.7898,20.4626,444,49640,0.234901,0.09,1,333343,332899,444
30359201,17.158,21.6925,439,49640,0.21498,0.05,1,333360,332921,439
30362121,10.6316,15.5385,434,49640,0.242996,0.09,1,333369,332935,434
30365041,30.9263,12.7077,458,49640,0.280599,0.05,1,333405,332947,458
30367961,38.1853,30.5415,463,49640,0.35212,0.07,1,333445,332982,463
30370881,17.2371,37.3083,436,49640,0.366424,0.09,1,333457,333021,436
30373801,14.6474,16.2617,439,49640,0.369285,0.09,1,333471,333032,439
30376721,9.32948,12.8523,435,49640,0.369857,0.13,1,333479,333044,435
30379641,13.8659,10.5705,440,49640,0.353971,0.09,1,333494,333054,440
30382561,66.7732,13.3141,506,49640,0.430794,0.23,1,333574,333068,506
30385481,26.1546,61.8628,448,49640,0.446159,0.25,1,333590,333142,448
30388401,58.8309,25.1726,499,49640,0.465232,0.17,1,333657,333158,499
30391321,18.1662,61.0345,437,51100,0.501046,0.17,1,333665,333228,437
30394241,55.6332,18.6069,494,51100,0.540209,0.21,1,333730,333236,494
30397161,12.7266,55.7214,431,51100,0.548042,0.19,1,333732,333301,431
30400081,14.5453,20.7443,434,51100,0.565608,0.27,1,333747,333313,434
30403001,11.7091,12.9489,434,51100,0.601122,0.23,1,333758,333324,434
30405921,16.7418,17.7898,433,51100,0.624224,0.21,1,333776,333343,433
30408841,18.5484,17.158,435,51100,0.612845,0.25,1,333795,333360,435
30411761,10.9097,10.6316,435,51100,0.642569,0.29,1,333804,333369,435
30414681,31.7819,30.9263,436,51100,0.664514,0.37,1,333841,333405,436
30417601,41.5564,38.1853,440,51100,0.700903,0.37,1,333885,333445,440
30420521,17.9113,17.2371,440,52560,0.772181,0.37,2,333897,333457,440
30423441,14.7823,14.6474,440,52560,0.770436,0.37,2,333911,333471,440
30426361,9.35645,9.32948,440,52560,0.802087,0.35,2,333919,333479,440
30429281,13.0713,13.8659,439,52560,0.776417,0.45,2,333933,333494,439
30432201,70.6143,66.7732,444,52560,0.851283,0.45,2,334018,333574,444
30435121,26.1229,26.1546,443,52560,0.882257,0.47,2,334033,333590,443
30438041,62.0246,58.8309,447,52560,0.936451,0.47,2,334104,333657,447
30440961,18.8049,11.7662,455,54020,0.94729,0.51,2,334112,333657,455
30940281,119,126,461,77380,0.71,0.85,1,337956,337495,461
30947581,33.4,31.6,465,77380,0.774,0.89,2,337968,337503,465
30999281,12.28,14.32,462,77380,0.7548,1,2,337975,337513,462
31002201,152.856,134.864,485,78840,0.72696,1,1,338163,337678,485
31005121,40.1712,40.5728,480,80300,0.673392,0.91,1,338175,337695,480
31168861,20,27,475,65980,0,1,1,339593,339118,475
31198061,20,23.8,472,65980,0.008,0.51,1,339613,339141,472
31203901,116.8,140.76,443,65980,0.2656,0.27,1,339754,339311,443
31271061,40.96,56.152,430,65980,0.54912,0.19,1,339776,339346,430
31271761,17.792,16.8304,435,68620,0.837824,0.07,2,339788,339353,435
31272801,17.9584,22.5661,429,70080,0.887565,0.03,2,339806,339377,429
31275721,123.592,126.113,427,70080,0.233513,0.01,1,339956,339529,427
31278641,39.9183,37.2226,431,71540,0.102703,0.01,1,339975,339544,431
31281561,23.1837,23.4445,430,73000,0.0445405,0.01,1,339994,339564,430
31284481,20.6367,15.8889,436,73000,0.0089081,0.01,1,340014,339578,436
31287401,20.1273,20.7778,434,73000,0.00178162,0.01,1,340034,339600,434
31290321,16.0255,18.5556,431,73000,0.0403563,0,1,340049,339618,431
31293241,24.8051,22.1111,435,73000,0.0320713,0.03,1,340076,339641,435
31296161,24.961,22.8222,437,73000,0.0304143,0.03,1,340101,339664,437
31299081,30.5922,24.5644,444,73000,0.00608285,0.19,1,340133,339689,444
31302001,20.5184,23.3129,439,74460,0.0412166,0.17,1,340151,339712,439
31304921,26.5037,23.0626,444,74460,0.0162433,0.33,1,340179,339735,444
31307841,26.9007,19.8125,452,74460,0.0272487,0.62,1,340206,339754,452
31310761,20.5801,21.5625,449,74460,0.0294497,0.62,1,340225,339776,449
31313681,5.71603,4.3125,451,74460,0.0298899,0.62,1,340227,339776,451
31316601,2.74321,0.8625,453,74460,0.029978,0.62,1,340229,339776,453
31319521,2.14864,0.1725,455,74460,0.0619956,0.62,1,340231,339776,455
31322441,2.02973,0.0345,457,74460,0.0683991,0.62,1,340233,339776,457
31325361,2.00595,0.0069,459,74460,0.0376798,0.62,1,340235,339776,459
31328281,2.00119,0.00138,461,74460,0.031536,0.62,1,340237,339776,461
31331201,2.00024,0.000276,463,74460,0.0303072,0.62,1,340239,339776,463
31334121,2.00005,5.52e-05,465,74460,0.0300614,0.62,1,340241,339776,465
31335621,10,1.104e-05,477,74460,0.0620123,0.91,1,340253,339776,477
31338541,3.6,9.6,467,75920,0.0684025,0.91,1,340255,339788,467
31341461,2.32,1.92,469,75920,0.0696805,0.07,1,340257,339788,469
31344381,98.064,134.784,423,75920,0.149936,0.07,1,340379,339956,423
31347301,34.0128,26.9568,441,75920,0.133987,0.07,1,340397,339956,441
31350221,8.40256,20.5914,424,75920,0.130797,0.03,1,340399,339975,424
31353141,17.6805,19.3183,425,75920,0.16216,0,1,340419,339994,425
31356061,18.7361,19.8637,424,75920,0.104432,0,1,340438,340014,424
31358981,19.7472,19.9727,424,75920,0.0208864,0.05,1,340458,340034,424
31361901,15.1494,15.9945,423,75920,0.0441773,0.03,1,340472,340049,423
31364821,24.6299,24.7989,423,75920,0.00883545,0.03,1,340499,340076,423
31367741,24.926,24.9598,423,75920,0.0417671,0,1,340524,340101,423
31370661,32.1852,30.592,425,75920,0.0163534,0,1,340558,340133,425
31373581,19.237,6.11839,441,75920,0.0432707,0.05,1,340574,340133,441
31376501,25.4474,15.6237,450,77380,0.0166541,0.01,1,340601,340151,450
31379421,25.8895,25.5247,448,77380,0.00333083,0.03,1,340627,340179,448
31382341,21.1779,26.7049,441,77380,0.0246662,0.03,1,340647,340206,441
31385261,5.83558,20.541,424,77380,0.0289332,0.03,1,340649,340225,424
31388181,2.76712,5.7082,424,77380,0.0297866,0.03,1,340651,340227,424
31391101,2.15342,2.74164,424,77380,0.0299573,0.07,1,340653,340229,424
31394021,2.03068,2.14833,424,77380,0.0299915,0.07,1,340655,340231,424
31396941,2.00614,2.02967,424,77380,0.0299983,0.03,1,340657,340233,424
31399861,2.00123,2.00593,424,77380,0.0299997,0.03,1,340659,340235,424
31402781,2.00025,2.00119,424,78840,0.0299999,0.03,1,340661,340237,424
31405701,2.00005,2.00024,424,78840,0.03,0.03,1,340663,340239,424
31408621,12.4,2.00005,437,78840,0.03,0.07,1,340678,340241,437
31411541,4.08,10,427,78840,0.03,0.07,1,340680,340253,427
31414461,2.416,3.6,427,78840,0.03,0.07,1,340682,340255,427
31417381,2.0832,2.32,427,78840,0.062,0.17,1,340684,340257,427
31420301,100.417,98.064,430,78840,0.0844,0.13,1,340809,340379,430
31423221,33.6833,34.0128,429,78840,0.12088,0.13,1,340826,340397,429
31426141,8.33667,8.40256,429,78840,0.128176,0.17,1,340828,340399,429
31429061,17.6673,17.6805,429,78840,0.161635,0.09,1,340848,340419,429
31431981,16.3335,18.7361,426,78840,0.168327,0,1,340864,340438,426
31434901,16.0667,19.7472,422,78840,0.169665,0.05,1,340880,340458,422
31437821,14.4133,15.1494,422,78840,0.137933,0,1,340894,340472,422
31440741,24.4827,24.6299,422,78840,0.0275866,0.05,1,340921,340499,422
31443661,25.6965,24.926,423,80300,0.0295173,0.01,1,340947,340524,423
31446581,33.1393,32.1852,424,80300,0.0299035,0.05,1,340982,340558,424
31449501,18.6279,19.237,423,80300,0.0619807,0.05,1,340997,340574,423
31452421,24.5256,3.84741,449,80300,0.0123961,0.01,1,341023,340574,449
31455341,27.3051,22.3695,450,80300,0.0104792,0,1,341051,340601,450
31458261,19.861,25.2739,442,80300,0.0420958,0.03,1,341069,340627,442
31461181,5.5722,21.0548,424,80300,0.0484192,0.03,1,341071,340647,424
31464101,2.71444,5.81096,424,80300,0.0496838,0.03,1,341073,340649,424
31467021,2.14289,2.76219,424,80300,0.0499368,0.03,1,341075,340651,424
31469941,2.02858,2.15244,424,80300,0.0499874,0.03,1,341077,340653,424
31472861,2.00572,2.03049,424,80300,0.0499975,0.03,1,341079,340655,424
31475781,2.00114,2.0061,424,80300,0.0499995,0.03,1,341081,340657,424
31478701,2.00023,2.00122,424,80300,0.0499999,0.03,1,341083,340659,424
31481621,2.00005,2.00024,424,80300,0.05,0.03,1,341085,340661,424
31484541,2.00001,2.00005,424,80300,0.05,0.03,1,341087,340663,424
31487461,13.2,12.4,425,80300,0.082,0.03,1,341103,340678,425
31490381,4.24,4.08,425,80300,0.0564,0.03,1,341105,340680,425
31493301,2.448,2.416,425,80300,0.05128,0.07,1,341107,340682,425
31496221,2.0896,2.0832,425,80300,0.050256,0.09,1,341109,340684,425
31499141,102.018,100.417,427,80300,0.0980512,0.13,1,341236,340809,427
31502061,34.0036,33.6833,427,80300,0.12361,0.13,1,341253,340826,427
31504981,8.40072,8.33667,427,80300,0.128722,0.17,1,341255,340828,427
31507901,20.0801,17.6673,430,80300,0.145744,0.17,1,341278,340848,430
31510821,16.816,16.3335,430,80300,0.117149,0.17,1,341294,340864,430
31513741,12.9632,16.0667,426,80300,0.11143,0.13,1,341306,340880,426
31516661,13.7926,14.4133,426,80300,0.110286,0,1,341320,340894,426
31519581,21.1585,24.4827,422,80300,0.126057,0,1,341343,340921,422
31522501,25.0317,4.89653,448,81760,0.113211,0.03,1,341369,340921,448
31525421,33.8063,21.7793,458,81760,0.142642,0.03,1,341405,340947,458
31528341,17.9613,32.3559,437,81760,0.148528,0.07,1,341419,340982,437
31531261,24.3923,18.4712,448,81760,0.0857057,0,1,341445,340997,448
31534181,28.0785,24.4942,451,81760,0.0571411,0.01,1,341474,341023,451
31537101,20.0157,27.2988,441,81760,0.0514282,0.05,1,341492,341051,441
31540021,5.60314,19.8598,425,81760,0.0502856,0.05,1,341494,341069,425
31542941,2.72063,5.57195,425,81760,0.0500571,0.05,1,341496,341071,425
31545861,2.14413,2.71439,425,81760,0.0660114,0.05,1,341498,341073,425
31548781,2.02883,2.14288,425,81760,0.0692023,0.05,1,341500,341075,425
31551701,2.00577,2.02858,425,81760,0.0698405,0.05,1,341502,341077,425
31554621,2.00115,2.00572,425,81760,0.0699681,0.05,1,341504,341079,425
31557541,2.00023,2.00114,425,81760,0.0699936,0.05,1,341506,341081,425
31560461,2.00005,2.00023,425,81760,0.0699987,0.05,1,341508,341083,425
31563381,2.00001,2.00005,425,81760,0.0699997,0.05,1,341510,341085,425
31566301,13.2,2.00001,439,81760,0.0699999,0.09,1,341526,341087,439
31569221,4.24,13.2,425,81760,0.07,0.05,1,341528,341103,425
31572141,2.448,4.24,425,81760,0.07,0.05,1,341530,341105,425
31575061,2.0896,2.448,425,81760,0.07,0.05,1,341532,341107,425
31577981,103.618,2.0896,552,81760,0.102,0.11,1,341661,341109,552
31580901,35.1236,102.018,443,81760,0.1084,0.13,1,341679,341236,443
31583821,8.62472,34.0036,428,81760,0.10968,0.13,1,341681,341253,428
31586741,20.1249,8.40072,449,81760,0.109936,0.15,1,341704,341255,449
31589661,16.825,20.0801,442,81760,0.109987,0.11,1,341720,341278,442
31592581,12.965,16.816,438,81760,0.109997,0.11,1,341732,341294,438
31595501,14.593,12.9632,441,81760,0.125999,0.11,1,341747,341306,441
31598421,19.7186,13.7926,448,81760,0.1132,0.13,1,341768,341320,448
31601341,5.54372,21.1585,427,81760,0.11064,0.11,1,341770,341343,427
31604261,21.9087,25.0317,427,81760,0.142128,0.15,1,341796,341369,427
31607181,34.7817,33.8063,429,81760,0.212426,0.15,1,341834,341405,429
31610101,18.1563,17.9613,429,81760,0.226485,0.07,1,341848,341419,429
31613021,19.6313,24.3923,423,81760,0.245297,0.05,1,341868,341445,423
31615941,27.9263,28.0785,424,81760,0.153059,0.05,1,341898,341474,424
31618861,20.7853,20.0157,425,81760,0.150612,0.05,1,341917,341492,425
31621781,5.75705,5.60314,425,81760,0.150122,0.05,1,341919,341494,425
31624701,2.75141,2.72063,425,81760,0.166024,0.07,1,341921,341496,425
31627621,2.15028,2.14413,425,81760,0.169205,0.07,1,341923,341498,425
31630541,2.03006,2.02883,425,81760,0.169841,0.07,1,341925,341500,425
31633461,2.00601,2.00577,425,81760,0.169968,0.07,1,341927,341502,425
31636381,2.0012,2.00115,425,81760,0.169994,0.07,1,341929,341504,425
31639301,2.00024,2.00023,425,81760,0.169999,0.07,1,341931,341506,425
31642221,2.00005,2.00005,425,81760,0.17,0.07,1,341933,341508,425
31645141,2.00001,2.00001,425,81760,0.17,0.07,1,341935,341510,425
31648061,13.2,13.2,425,81760,0.202,0.07,1,341951,341526,425
31650981,4.24,4.24,425,81760,0.1764,0.07,1,341953,341528,425
31653901,2.448,2.448,425,81760,0.18728,0.07,1,341955,341530,425
31656821,2.0896,2.0896,425,81760,0.189456,0.11,1,341957,341532,425
31659741,106.818,103.618,429,81760,0.237891,0.11,1,342090,341661,429
31662661,34.1636,35.1236,427,81760,0.247578,0.11,1,342106,341679,427
31665581,8.43272,8.62472,427,81760,0.217516,0.11,1,342108,341681,427
31668501,20.0865,20.1249,427,81760,0.259503,0.11,1,342131,341704,427
31671421,16.8173,16.825,427,81760,0.267901,0.11,1,342147,341720,427
31674341,12.9635,12.965,427,81760,0.23758,0.13,1,342159,341732,427
31677261,13.7927,14.593,426,81760,0.263516,0.11,1,342173,341747,426
31680181,20.3585,19.7186,427,81760,0.268703,0.11,1,342195,341768,427
31683101,5.67171,5.54372,427,81760,0.237741,0.15,1,342197,341770,427
31686021,21.9343,21.9087,427,81760,0.279548,0.23,1,342223,341796,427
31688941,37.9869,34.7817,431,81760,0.43191,0.23,1,342265,341834,431
31691861,19.5974,18.1563,432,81760,0.446382,0.25,1,342280,341848,432
31694781,16.7195,19.6313,428,81760,0.417276,0.13,1,342296,341868,428
31697701,27.3439,27.9263,428,81760,0.443455,0.15,1,342326,341898,428
31700621,22.2688,20.7853,430,81760,0.432691,0.15,1,342347,341917,430
31703541,6.05376,5.75705,430,81760,0.430538,0.17,1,342349,341919,430
31706461,2.81075,2.75141,430,81760,0.430108,0.17,1,342351,341921,430
31709381,2.16215,2.15028,430,81760,0.398022,0.17,1,342353,341923,430
31712301,2.03243,2.03006,430,81760,0.391604,0.17,1,342355,341925,430
31715221,2.00649,2.00601,430,81760,0.390321,0.17,1,342357,341927,430
31718141,2.0013,2.0012,430,81760,0.390064,0.17,1,342359,341929,430
31721061,2.00026,2.00024,430,81760,0.390013,0.17,1,342361,341931,430
31723981,2.00005,2.00005,430,81760,0.390003,0.17,1,342363,341933,430
31726901,2.00001,2.00001,430,81760,0.390001,0.21,1,342365,341935,430
31729821,14,13.2,431,81760,0.406,0.17,1,342382,341951,431
31732741,4.4,4.24,431,81760,0.4252,0.19,1,342384,341953,431
31735661,2.48,2.448,431,81760,0.46104,0.19,1,342386,341955,431
31738581,2.096,2.0896,431,81760,0.468208,0.25,1,342388,341957,431
31741501,107.619,106.818,432,81760,0.501642,0.25,1,342522,342090,432
31744421,34.3238,34.1636,432,81760,0.508328,0.21,1,342538,342106,432
31747341,8.46477,8.43272,432,81760,0.541666,0.27,1,342540,342108,432
31750261,20.893,20.0865,433,81760,0.564333,0.27,1,342564,342131,433
31753181,16.9786,16.8173,433,81760,0.536867,0.23,1,342580,342147,433
31756101,12.9957,12.9635,433,81760,0.531373,0.27,1,342592,342159,433
31759021,13.7991,13.7927,433,81760,0.562275,0.27,1,342606,342173,433
31761941,20.3598,20.3585,433,81760,0.568455,0.23,1,342628,342195,433
31764861,5.67197,5.67171,433,81760,0.537691,0.29,1,342630,342197,433
31767781,23.5344,21.9343,435,81760,0.547538,0.47,1,342658,342223,435
31770701,44.7069,37.9869,443,81760,0.757508,0.45,2,342708,342265,443
31773621,20.1414,19.5974,442,81760,0.799502,0.41,2,342722,342280,442
31776541,16.8283,16.7195,442,81760,0.8079,0.45,2,342738,342296,442
31779461,27.3657,27.3439,442,81760,0.77758,0.43,2,342768,342326,442
31782381,21.4731,22.2688,441,81760,0.803516,0.43,2,342788,342347,441
31785301,5.89463,6.05376,441,81760,0.808703,0.43,2,342790,342349,441
31788221,2.77893,2.81075,441,81760,0.809741,0.39,2,342792,342351,441
31791141,2.15579,2.16215,441,81760,0.777948,0.39,2,342794,342353,441
31794061,2.03116,2.03243,441,81760,0.77159,0.39,2,342796,342355,441
31796981,2.00623,2.00649,441,81760,0.770318,0.39,2,342798,342357,441
31799901,2.00125,2.0013,441,81760,0.770064,0.39,2,342800,342359,441
31802821,2.00025,2.00026,441,81760,0.770013,0.39,2,342802,342361,441
31805741,2.00005,2.00005,441,81760,0.770003,0.39,2,342804,342363,441
31808661,2.00001,2.00001,441,81760,0.770001,0.41,2,342806,342365,441
31811581,15.6,14,443,81760,0.802,0.43,2,342825,342382,443
31814501,4.72,4.4,443,81760,0.8084,0.47,2,342827,342384,443
31817421,2.544,2.48,443,81760,0.84168,0.47,2,342829,342386,443
31820341,2.1088,2.096,443,81760,0.848336,0.51,2,342831,342388,443
31823261,110.822,107.619,447,81760,0.849667,0.51,2,342969,342522,447
31826181,34.9644,34.3238,447,81760,0.849933,0.55,2,342985,342538,447
31829101,8.59287,8.46477,447,81760,0.897987,0.57,2,342987,342540,447
31832021,21.7186,20.893,448,81760,0.891597,0.53,2,343012,342564,448
31834941,17.1437,16.9786,448,81760,0.89032,0.53,2,343028,342580,448
31837861,13.0287,12.9957,448,81760,0.890064,0.57,2,343040,342592,448
31840781,13.8057,13.7991,448,81760,0.890013,0.57,2,343054,342606,448
31843701,21.1611,20.3598,449,81760,0.874003,0.53,2,343077,342628,449
31846621,5.83223,5.67197,449,81760,0.8708,0.55,2,343079,342630,449
31849541,21.9664,23.5344,447,81760,0.91816,0.81,2,343105,342658,447
32172201,45,60,427,62320,0.09,0.01,1,345380,344953,427
32180961,45.8,53.6,421,62320,0.018,0.01,1,345426,345005,421
32246661,49.16,50.72,421,62320,0.1716,0.03,1,345476,345055,421
32249581,41.832,15.744,454,64240,0.18632,0.01,1,345516,345062,454
32252501,36.3664,32.7488,452,65700,0.061264,0.05,1,345551,345099,452
32255421,19.2733,36.1498,430,67160,0.0842528,0.01,1,345566,345136,430
32258341,16.6547,18.43,432,68620,0.0408506,0.03,1,345582,345150,432
32260801,23.3309,17.286,440,70080,0.0641701,0.15,1,345607,345167,440
32263721,87.0662,83.4572,443,71540,0.036834,0.25,1,345710,345267,443
32266641,29.4132,31.0914,440,73000,0.0953668,0.21,1,345725,345285,440
32269561,22.6826,18.2183,446,74460,0.107073,0.21,1,345746,345300,446
32272481,19.7365,20.4437,444,74460,0.0614147,0.17,1,345765,345321,444
32275401,15.9473,20.8887,438,75920,0.132283,0.13,1,345780,345342,438
32278321,17.5895,20.1777,436,75920,0.178457,0.09,1,345798,345362,436
32281241,21.9179,18.4355,441,75920,0.171691,0.13,1,345821,345380,441
32284161,17.1836,20.4871,436,75920,0.138338,0,1,345837,345401,436
32287081,23.4367,24.0974,436,75920,0.0676676,0,1,345862,345426,436
32290001,36.6873,22.4195,454,75920,0.0375335,0.21,1,345902,345448,454
32292921,8.93747,26.8839,428,75920,0.0315067,0.21,1,345904,345476,428
32295841,3.38749,5.37678,430,75920,0.0303013,0.21,1,345906,345476,430
32298761,2.2775,1.07536,432,75920,0.0620603,0.21,1,345908,345476,432
32301681,2.0555,0.215071,434,75920,0.0684121,0.21,1,345910,345476,434
32304601,2.0111,0.0430142,436,75920,0.0376824,0.21,1,345912,345476,436
32307521,2.00222,0.00860284,438,77380,0.0315365,0.21,1,345914,345476,438
32310441,2.00044,0.00172057,440,77380,0.0303073,0.19,1,345916,345476,440
32313361,21.2001,32.0003,426,77380,0.142061,0.19,1,345942,345516,426
32316281,29.84,6.40007,458,77380,0.116412,0.03,1,345974,345516,458
32319201,7.568,29.28,425,77380,0.0792825,0.09,1,345976,345551,425
32322121,11.9136,17.856,423,77380,0.0718565,0.09,1,345989,345566,423
32325041,15.1827,3.5712,439,77380,0.0543713,0.03,1,346005,345566,439
32327961,4.63654,13.5142,425,77380,0.0508743,0.07,1,346007,345582,425
32330881,21.7273,22.7028,426,77380,0.0501749,0.07,1,346033,345607,426
32333801,82.7455,4.54057,524,77380,0.010035,0.03,1,346131,345607,524
32336721,18.1491,83.3081,423,78840,0.010007,0.11,1,346133,345710,423
32339641,16.4298,28.6616,424,78840,0.0900014,0.11,1,346149,345725,424
32342561,20.086,5.73232,445,78840,0.0740003,0.11,1,346170,345725,445
32345481,19.2172,17.9465,443,78840,0.0868001,0.05,1,346189,345746,443
32348401,5.44344,18.7893,426,78840,0.08936,0.15,1,346191,345765,426
32351321,15.4887,15.7579,429,78840,0.121872,0.19,1,346209,345780,429
32354241,19.0977,17.5516,431,78840,0.128374,0.17,1,346229,345798,431
32357161,21.4195,21.9103,430,78840,0.129675,0.13,1,346251,345821,430
32360081,13.8839,17.1821,426,80300,0.161935,0.05,1,346263,345837,426
32363001,21.1768,23.4364,424,80300,0.216387,0.03,1,346286,345862,424
32365921,35.4354,36.6873,423,80300,0.147277,0.03,1,346325,345902,423
32368841,8.68707,8.93746,423,80300,0.133455,0.03,1,346327,345904,423
32371761,3.33741,3.38749,423,80300,0.130691,0.07,1,346329,345906,423
32374681,2.26748,2.2775,423,80300,0.130138,0.07,1,346331,345908,423
32377601,2.0535,2.0555,423,80300,0.0980276,0.03,1,346333,345910,423
32380521,2.0107,2.0111,423,80300,0.0916055,0.03,1,346335,345912,423
32383441,2.00214,0.40222,425,80300,0.0903211,0.03,1,346337,345912,425
32386361,2.00043,1.68044,425,80300,0.0900642,0.03,1,346339,345914,425
32389281,24.4001,1.93609,453,80300,0.122013,0.17,1,346369,345916,453
32392201,27.28,21.1872,455,81760,0.112403,0.11,1,346397,345942,455
32395121,7.056,29.8374,425,81760,0.142481,0.07,1,346399,345974,425
32398041,13.4112,7.56749,438,81760,0.180496,0.07,1,346414,345976,438
32400961,15.4822,11.9135,441,81760,0.204099,0.05,1,346430,345989,441
32403881,4.69645,15.1827,427,81760,0.20882,0.05,1,346432,346005,427
32406801,20.1393,4.63654,449,81760,0.257764,0.05,1,346456,346007,449
32409721,81.6279,21.7273,520,81760,0.0755528,0,1,346553,346033,520
32412641,17.9256,82.7455,424,83220,0.0151106,0.01,1,346555,346131,424
32415561,5.18511,18.1491,424,83220,0.0270221,0.11,1,346557,346133,424
32418481,15.437,16.4298,426,83220,0.0774044,0.07,1,346575,346149,426
32421401,19.8874,20.086,426,83220,0.119481,0.09,1,346596,346170,426
32424321,19.1775,19.2172,426,83220,0.111896,0.09,1,346615,346189,426
32427241,5.4355,5.44344,426,83220,0.126379,0.13,1,346617,346191,426
32430161,15.4871,15.4887,426,83220,0.145276,0.13,1,346635,346209,426
32433081,19.0974,19.0977,426,83220,0.149055,0.13,1,346655,346229,426
32436001,22.2195,21.4195,427,83220,0.165811,0.13,1,346678,346251,427
32438921,14.0439,4.28391,439,83220,0.185162,0.17,1,346690,346251,439
32441841,24.4088,10.4568,454,83220,0.205032,0.23,1,346717,346263,454
32444761,31.2818,20.4914,464,83220,0.241006,0.13,1,346750,346286,464
32447681,7.85635,35.2983,427,84680,0.248201,0.13,1,346752,346325,427
32450601,3.17127,8.65965,427,84680,0.24964,0.13,1,346754,346327,427
32453521,2.23425,3.33193,427,84680,0.249928,0.13,1,346756,346329,427
32456441,2.04685,2.26639,427,84680,0.249986,0.09,1,346758,346331,427
32459361,2.00937,2.05328,427,84680,0.265997,0.09,1,346760,346333,427
32462281,2.00187,2.01066,427,84680,0.285199,0.09,1,346762,346335,427
32465201,2.00037,2.00213,427,84680,0.28904,0.09,1,346764,346337,427
32468121,26.0001,2.00043,457,84680,0.337808,0.13,1,346796,346339,457
32471041,6.80001,24.4001,429,84680,0.347562,0.11,1,346798,346369,429
32473961,24.56,27.28,430,84680,0.381512,0.15,1,346827,346397,430
32476881,6.512,7.056,430,84680,0.388302,0.19,1,346829,346399,430
32479801,14.9024,13.4112,432,84680,0.38966,0.21,1,346846,346414,432
32482721,17.3805,15.4822,434,86140,0.373932,0.21,1,346864,346430,434
32485641,5.0761,4.69645,434,86140,0.402786,0.27,1,346866,346432,434
32488561,21.8152,20.1393,436,86140,0.424557,0.03,1,346892,346456,436
32491481,71.563,81.6279,423,86140,0.364911,0.03,1,346976,346553,423
32494401,15.9126,16.3256,425,86140,0.320982,0,1,346978,346553,425
32497321,4.78252,4.86511,425,86140,0.312196,0.03,1,346980,346555,425
32500241,17.7565,2.57302,444,86140,0.342439,0.09,1,347001,346557,444
32503161,19.5513,14.9146,446,86140,0.348488,0.13,1,347021,346575,446
32506081,19.1103,19.7829,444,86140,0.365698,0.11,1,347040,346596,444
32509001,5.42205,19.1566,427,86140,0.33714,0.13,1,347042,346615,427
32511921,16.2844,5.43132,444,86140,0.331428,0.15,1,347061,346617,444
32514841,20.0569,15.4863,447,86140,0.346286,0.15,1,347082,346635,447
32517761,24.8114,19.0973,453,86140,0.365257,0.17,1,347108,346655,453
32520681,14.5623,22.2194,442,86140,0.329051,0.19,1,347120,346678,442
32523601,26.1125,14.0439,459,87600,0.41781,0.21,1,347149,346690,459
32526521,33.2225,24.4088,467,87600,0.483562,0.25,1,347184,346717,467
32529441,8.2445,31.2818,436,87600,0.496712,0.25,1,347186,346750,436
32532361,3.2489,7.85635,436,87600,0.499342,0.25,1,347188,346752,436
32535281,2.24978,3.17127,436,87600,0.499869,0.25,1,347190,346754,436
32538201,2.04996,2.23425,436,87600,0.515974,0.25,1,347192,346756,436
32541121,2.00999,2.04685,436,87600,0.487195,0.27,1,347194,346758,436
32544041,2.002,2.00937,436,87600,0.481439,0.29,1,347196,346760,436
32546961,2.0004,2.00187,436,87600,0.512288,0.29,1,347198,346762,436
32549881,2.00008,2.00037,436,87600,0.518458,0.35,1,347200,346764,436
32552801,29.2,26.0001,440,87600,0.567692,0.35,1,347236,346796,440
32555721,7.44,6.80001,440,87600,0.553538,0.39,1,347238,346798,440
32558641,24.688,24.56,440,87600,0.598708,0.39,1,347267,346827,440
32561561,6.5376,6.512,440,87600,0.575742,0.39,1,347269,346829,440
32564481,14.1075,14.9024,439,87600,0.619148,0.39,1,347285,346846,439
32567401,17.2215,2.98048,457,87600,0.59583,0.37,1,347303,346846,457
32570321,5.0443,14.9961,441,87600,0.591166,0.41,1,347305,346864,441
32573241,22.6089,4.59922,466,87600,0.590233,0.43,1,347332,346866,466
32576161,68.5218,21.7198,520,89060,0.774047,0.35,2,347412,346892,520
32579081,15.3044,71.544,438,89060,0.826809,0.31,2,347414,346976,438
32582001,4.66087,15.9088,438,89060,0.837362,0.31,2,347416,346978,438
32584921,18.5322,4.78176,458,89060,0.743472,0.35,1,347438,346980,458
32587841,20.5064,17.7564,458,89060,0.844694,0.35,2,347459,347001,458
32590761,18.5013,19.5513,456,89060,0.832939,0.37,2,347477,347021,456
32593681,5.30026,19.1103,439,89060,0.870588,0.33,2,347479,347040,439
32596601,16.2601,5.42205,456,89060,0.822118,0.33,2,347498,347042,456
32599521,19.252,16.2844,457,89060,0.804424,0.35,2,347518,347061,457
32602441,24.6504,20.0569,462,89060,0.800885,0.37,2,347544,347082,462
32605361,18.5301,24.8114,453,89060,0.872177,0.32,2,347561,347108,453
32608281,5.30602,14.5623,443,89060,0.854435,0.44,2,347563,347120,443
32611201,25.8612,26.1125,445,89060,0.834887,0.5,2,347594,347149,445
32614121,33.1722,33.2225,445,89060,0.862977,0.5,2,347629,347184,445
32617041,9.83445,8.2445,447,89060,0.860595,0.5,2,347633,347186,447
32619961,3.56689,3.2489,447,89060,0.860119,0.5,2,347635,347188,447
32622881,2.31338,2.24978,447,89060,0.860024,0.52,2,347637,347190,447
32625801,2.06268,2.04996,447,89060,0.820005,0.48,2,347639,347192,447
32628721,2.01254,2.00999,447,89060,0.812001,0.48,2,347641,347194,447
32631641,2.00251,2.002,447,89060,0.7784,0.52,2,347643,347196,447
32634561,2.0005,2.0004,447,89060,0.77168,0.52,2,347645,347198,447
32637481,2.0001,2.00008,447,89060,0.770336,0.58,2,347647,347200,447
32640401,30.8,29.2,449,89060,0.850067,0.55,2,347685,347236,449
32643321,7.76,7.44,449,89060,0.866013,0.61,2,347687,347238,449
32646241,21.552,24.688,445,89060,0.829203,0.57,2,347712,347267,445
32649161,10.7104,6.5376,451,89060,0.837841,0.63,2,347720,347269,451
32652081,13.3421,14.1075,449,89060,0.807568,0.59,2,347734,347285,449
32655001,18.6684,17.2215,451,89060,0.777514,0.59,2,347754,347303,451
32657921,5.33368,5.0443,451,90520,0.803503,0.59,2,347756,347305,451
32660841,21.8667,22.6089,450,90520,0.872701,0.59,2,347782,347332,450
32956361,35,25,445,64240,0.27,0.41,1,349625,349180,445
32959281,14.2,12.2,445,65700,0.206,0.39,1,349634,349189,445
32962201,72.44,10.44,522,67160,0.0492,0.01,1,349721,349199,522
32965121,34.488,88.488,439,68620,0.03384,0,1,349746,349307,439
32968041,21.2976,39.2976,430,70080,0.190768,0.01,1,349764,349334,430
32970961,19.4595,22.2595,431,71540,0.126154,0.03,1,349783,349352,431
32973881,39.8919,18.8519,458,73000,0.0492307,0.01,1,349828,349370,458
32976801,23.9784,38.1704,435,74460,0.0818461,0.03,1,349848,349413,435
32979721,20.7957,22.8341,436,75920,0.0403692,0.11,1,349868,349432,436
32982641,17.7591,18.9668,435,75920,0.128074,0.03,1,349885,349450,435
32985561,18.7518,21.3934,432,75920,0.113615,0,1,349904,349472,432
32988481,21.3504,20.2787,434,75920,0.022723,0.27,1,349926,349492,434
32991401,80.2701,82.4557,431,75920,0.0605446,0.27,1,350021,349590,431
32994321,17.654,16.4911,433,75920,0.0681089,0.27,1,350023,349590,433
32997241,5.1308,3.29823,435,75920,0.0696218,0.27,1,350025,349590,435
33000161,2.62616,0.659646,437,75920,0.0379244,0.27,1,350027,349590,437
33003081,2.12523,0.131929,439,77380,0.0475849,0.27,1,350029,349590,439
33006001,2.02505,0.0263858,441,77380,0.049517,0.27,1,350031,349590,441
33008921,2.00501,0.00527717,443,77380,0.0499034,0.27,1,350033,349590,443
33011841,2.001,0.00105543,445,77380,0.0499807,0.27,1,350035,349590,445
33014761,2.0002,0.000211087,447,77380,0.0499961,0.27,1,350037,349590,447
33017681,2.00004,4.22173e-05,449,77380,0.0659992,0.27,1,350039,349590,449
33020601,13.2,28,430,77380,0.0851998,0.27,1,350055,349625,430
33023521,8.24,5.6,437,77380,0.10504,0.19,1,350062,349625,437
33026441,3.248,8.32,430,77380,0.109008,0.01,1,350064,349634,430
33029361,63.8496,71.264,422,77380,0.189802,0.01,1,350143,349721,422
33032281,41.5699,14.2528,458,77380,0.0619603,0.03,1,350179,349721,458
33035201,9.91398,22.8506,435,77380,0.0363921,0.23,1,350181,349746,435
33038121,8.3828,18.9701,425,77380,0.0312784,0.23,1,350189,349764,425
33041041,13.6766,3.79402,440,78840,0.0782557,0.11,1,350204,349764,440
33043961,4.33531,15.9588,423,78840,0.0556511,0.03,1,350206,349783,423
33046881,36.8671,39.1918,423,78840,0.0111302,0.03,1,350251,349828,423
33049801,23.3734,7.83835,443,78840,0.026226,0.09,1,350271,349828,443
33052721,6.27468,17.5677,425,78840,0.0292452,0.03,1,350273,349848,425
33055641,20.4549,19.5135,429,78840,0.029849,0.15,1,350297,349868,429
33058561,18.491,17.5027,430,78840,0.0939698,0.11,1,350315,349885,430
33061481,14.0982,18.7005,424,78840,0.090794,0,1,350328,349904,424
33064401,22.0196,21.3401,426,78840,0.0261588,0.07,1,350352,349926,426
33067321,78.8039,80.268,424,80300,0.0612318,0.07,1,350445,350021,424
33070241,17.3608,17.6536,424,80300,0.0682463,0.07,1,350447,350023,424
33073161,5.07216,5.13072,424,80300,0.0696493,0.03,1,350449,350025,424
33076081,2.61443,2.62614,424,80300,0.0699299,0.03,1,350451,350027,424
33079001,2.12289,0.525229,426,80300,0.101986,0.05,1,350453,350027,426
33081921,2.02458,1.70505,426,80300,0.0763972,0.05,1,350455,350029,426
33084841,2.00492,1.94101,426,80300,0.0712794,0.05,1,350457,350031,426
33087761,2.00098,1.9882,426,80300,0.0702559,0.05,1,350459,350033,426
33090681,2.0002,1.99764,426,80300,0.0700512,0.05,1,350461,350035,426
33093601,2.00004,1.99953,426,80300,0.0700102,0.07,1,350463,350037,426
33096521,14,1.99991,441,80300,0.054002,0.09,1,350480,350039,441
33099441,7.6,13.2,431,81760,0.0668004,0.11,1,350486,350055,431
33102361,3.12,8.24,426,81760,0.0693601,0.11,1,350488,350062,426
33105281,64.624,3.248,504,81760,0.117872,0.21,1,350568,350064,504
33108201,39.3248,63.8496,458,81760,0.0635744,0.03,1,350601,350143,458
33111121,9.46496,41.5699,424,81760,0.0527149,0.03,1,350603,350179,424
33114041,9.09299,9.91398,431,81760,0.066543,0.03,1,350612,350181,431
33116961,3.4186,8.3828,425,81760,0.0693086,0.09,1,350614,350189,425
33119881,11.8837,13.6766,424,81760,0.0698617,0.05,1,350628,350204,424
33122801,3.97674,4.33531,424,81760,0.0699723,0,1,350630,350206,424
33125721,35.1954,36.8671,422,81760,0.0859945,0.03,1,350673,350251,422
33128641,23.8391,23.3734,423,83220,0.105199,0.03,1,350694,350271,423
33131561,6.36781,6.27468,423,83220,0.0770398,0.03,1,350696,350273,423
33134481,20.4736,20.4549,423,83220,0.103408,0.11,1,350720,350297,423
33137401,20.0947,18.491,425,83220,0.108682,0.09,1,350740,350315,425
33140321,13.6189,14.0982,424,83220,0.0937363,0.01,1,350752,350328,424
33143241,21.1238,22.0196,423,83220,0.106747,0.01,1,350775,350352,423
33146161,79.4248,4.40393,517,83220,0.0933495,0.07,1,350869,350352,517
33149081,17.485,75.2808,426,84680,0.0906699,0.07,1,350871,350445,426
33152001,5.09699,16.6562,426,84680,0.090134,0.07,1,350873,350447,426
33154921,2.6194,4.93123,426,84680,0.0900268,0.07,1,350875,350449,426
33157841,2.12388,2.58625,426,84680,0.0900054,0.11,1,350877,350451,426
33160761,2.02478,2.11725,426,84680,0.0900011,0.07,1,350879,350453,426
33163681,2.00496,2.02345,426,84680,0.106,0.07,1,350881,350455,426
33166601,2.00099,2.00469,426,84680,0.1252,0.07,1,350883,350457,426
33169521,2.0002,2.00094,426,84680,0.12904,0.07,1,350885,350459,426
33172441,2.00004,2.00019,426,84680,0.129808,0.07,1,350887,350461,426
33175361,14,2.00004,441,84680,0.113962,0.05,1,350904,350463,441
33178281,4.4,14,426,84680,0.110792,0.07,1,350906,350480,426
33181201,6.48,7.6,427,84680,0.0941585,0.07,1,350913,350486,427
33184121,2.896,3.12,427,84680,0.122832,0.13,1,350915,350488,427
33187041,65.3792,64.624,428,84680,0.112566,0.05,1,350996,350568,428
33189961,36.2758,39.3248,424,86140,0.142513,0.05,1,351025,350601,424
33192881,8.85517,9.46496,424,86140,0.148503,0.07,1,351027,350603,424
33195801,9.77103,9.09299,425,86140,0.117701,0.07,1,351037,350612,425
33198721,3.55421,3.4186,425,86140,0.11154,0.07,1,351039,350614,425
33201641,11.9108,11.8837,425,86140,0.110308,0.07,1,351053,350628,425
33204561,3.98217,3.97674,425,86140,0.142062,0.09,1,351055,350630,425
33207481,34.3964,35.1954,424,86140,0.212412,0.09,1,351097,350673,424
33210401,23.6793,7.03907,445,86140,0.258482,0.11,1,351118,350673,445
33213321,6.33586,18.2078,426,86140,0.267696,0.07,1,351120,350694,426
33216241,20.4672,5.24156,448,86140,0.269539,0.11,1,351144,350696,448
33219161,20.8934,20.2483,445,86140,0.253908,0.11,1,351165,350720,445
33222081,13.7787,20.0497,437,86140,0.282782,0.09,1,351177,350740,437
33225001,23.5557,13.6099,451,86140,0.320556,0.11,1,351203,350752,451
33227921,77.5112,21.122,519,86140,0.264111,0.09,1,351294,350775,519
33230841,17.1022,79.4244,427,86140,0.252822,0.09,1,351296,350869,427
33233761,5.82045,17.4849,428,87600,0.266564,0.09,1,351299,350871,428
33236681,2.76409,5.09698,428,87600,0.269313,0.09,1,351301,350873,428
33239601,2.15282,2.6194,428,87600,0.237863,0.09,1,351303,350875,428
33242521,2.03056,2.12388,428,87600,0.263573,0.09,1,351305,350877,428
33245441,2.00611,2.02478,428,87600,0.284715,0.11,1,351307,350879,428
33248361,2.00122,2.00496,428,87600,0.256943,0.13,1,351309,350881,428
33251281,2.00024,2.00099,428,87600,0.251389,0.13,1,351311,350883,428
33254201,2.00005,2.0002,428,87600,0.250278,0.13,1,351313,350885,428
33257121,2.00001,2.00004,428,87600,0.250056,0.11,1,351315,350887,428
33260041,13.2,14,427,87600,0.282011,0.11,1,351331,350904,427
33262961,4.24,4.4,427,87600,0.288402,0.09,1,351333,350906,427
33265881,5.648,6.48,426,87600,0.28968,0.13,1,351339,350913,426
33268801,2.7296,2.896,426,87600,0.257936,0.11,1,351341,350915,426
33271721,66.1459,65.3792,427,87600,0.315587,0.11,1,351423,350996,427
33274641,35.6292,13.0758,455,87600,0.359117,0.15,1,351451,350996,455
33277561,8.72584,25.8152,428,89060,0.367823,0.15,1,351453,351025,428
33280481,9.74517,6.76303,436,89060,0.401565,0.11,1,351463,351027,436
33283401,3.54903,9.35261,428,89060,0.408313,0.11,1,351465,351037,428
33286321,11.9098,3.47052,440,89060,0.409663,0.11,1,351479,351039,440
33289241,3.98196,11.8941,428,89060,0.409933,0.15,1,351481,351053,428
33292161,39.1964,3.97882,474,89060,0.409986,0.23,1,351529,351055,474
33295081,27.0393,34.3958,456,89060,0.409997,0.27,1,351553,351097,456
33298001,7.00786,23.6792,437,89060,0.409999,0.27,1,351555,351118,437
33300921,19.8016,6.33583,458,89060,0.458,0.27,1,351578,351120,458
33303841,21.5603,20.4672,456,89060,0.4676,0.25,1,351600,351144,456
33306761,14.7121,20.8934,448,89060,0.48552,0.29,1,351613,351165,448
33309681,26.1424,13.7787,465,89060,0.457104,0.33,1,351642,351177,465
33312601,73.2285,23.5557,524,89060,0.563421,0.25,1,351727,351203,524
33315521,16.2457,77.5112,435,89060,0.600684,0.25,1,351729,351294,435
33318441,4.84914,17.1022,435,89060,0.608137,0.27,1,351731,351296,435
33321361,2.56983,5.82045,434,89060,0.609627,0.27,1,351733,351299,434
33324281,2.11397,2.76409,434,89060,0.609925,0.23,1,351735,351301,434
33327201,2.02279,2.15282,434,89060,0.609985,0.27,1,351737,351303,434
33330121,2.00456,2.03056,434,89060,0.625997,0.29,1,351739,351305,434
33333041,2.00091,2.00611,434,89060,0.629199,0.25,1,351741,351307,434
33335961,2.00018,2.00122,434,89060,0.62984,0.25,1,351743,351309,434
33338881,2.00004,2.00024,434,89060,0.629968,0.25,1,351745,351311,434
33341801,2.00001,2.00005,434,89060,0.629994,0.25,1,351747,351313,434
33344721,2,2.00001,434,89060,0.629999,0.29,1,351749,351315,434
33347641,13.2,13.2,434,89060,0.63,0.29,1,351765,351331,434
33350561,5.04,4.24,435,89060,0.662,0.29,1,351768,351333,435
33353481,7.408,5.648,437,89060,0.6684,0.25,1,351776,351339,437
33356401,3.0816,2.7296,437,89060,0.63768,0.33,1,351778,351341,437
33359321,67.8163,66.1459,439,89060,0.663536,0.37,1,351862,351423,439
33362241,37.5633,35.6292,441,89060,0.684707,0.37,1,351892,351451,441
33365161,9.11265,7.12584,443,90520,0.688941,0.37,1,351894,351451,443
33368081,9.82253,3.02517,451,90520,0.673788,0.41,1,351904,351453,451
33371001,3.56451,8.60503,443,90520,0.670758,0.41,1,351906,351463,443
33373921,11.9129,3.32101,455,90520,0.670152,0.41,1,351920,351465,455
33376841,3.98258,11.8642,443,90520,0.67003,0.41,1,351922,351479,443
33379761,39.1965,3.97284,489,90520,0.686006,0.41,1,351970,351481,489
33382681,27.8393,39.1946,466,90520,0.689201,0.41,1,351995,351529,466
33385601,7.16786,27.0389,444,90520,0.72184,0.41,1,351997,351553,444
33388521,21.4336,7.00778,467,90520,0.760368,0.47,2,352022,351555,467
33391441,21.8867,19.8016,466,90520,0.768074,0.47,2,352044,351578,466
33394361,13.9773,21.5603,456,90520,0.769615,0.49,2,352056,351600,456
33397281,29.1955,14.7121,476,90520,0.785923,0.45,2,352089,351613,476
33747801,53,39,464,64240,0.13,0.72,1,354266,353802,464
33750721,22.6,20.6,463,65700,0.146,0.67,1,354281,353818,463
33753641,14.12,16.92,459,67160,0.1652,0.55,1,354293,353834,459
33756561,8.424,13.784,453,68620,0.13704,0.59,1,354300,353847,453
33759481,17.6848,15.5568,457,70080,0.715408,0.52,1,354320,353863,457
33762401,12.337,13.5114,455,71540,0.911082,0.5,2,354331,353876,455
33788681,2,0,429,77380,0.94,0,2,354642,354213,429
33791601,2,0,431,77380,0.948,0,2,354644,354213,431
33806201,2,0,441,77380,0.95,0,2,354654,354213,441
34104521,42,46,433,61320,0.81,0.19,2,356694,356261,433
34107441,14,15.6,432,62780,0.89,0.13,2,356701,356269,432
34127881,58,41,456,64240,0.81,0.23,2,356871,356415,456
34130801,82,93.8,437,64240,0.634,0.09,1,356959,356522,437
34133721,44.4,54.76,427,64240,0.5668,0.05,1,356994,356567,427
34136641,24.88,26.952,427,64240,0.52136,0.03,1,357014,356587,427
34139561,25.776,18.1904,437,65700,0.496272,0.31,1,357040,356603,437
34142481,55.5552,42.8381,451,65700,0.491254,0.31,1,357103,356652,451
34145401,12.711,8.56762,453,65700,0.490251,0.31,1,357105,356652,453
34148321,4.14221,1.71352,455,65700,0.50605,0.31,1,357107,356652,455
34151241,2.42844,0.342705,457,65700,0.50921,0.31,1,357109,356652,457
34154161,2.08569,0.0685409,459,65700,0.509842,0.31,1,357111,356652,459
34157081,2.01714,0.0137082,461,65700,0.493968,0.31,1,357113,356652,461
34160001,2.00343,0.00274164,463,65700,0.490794,0.31,1,357115,356652,463
34162921,2.00069,0.000548327,465,67160,0.490159,0.81,1,357117,356652,465
34165841,39.6001,33.6001,472,67160,0.506032,0.81,1,357166,356694,472
34168761,11.12,6.72002,476,67160,0.509206,0.91,1,357170,356694,476
34171681,7.02401,6.944,475,67160,0.477841,1,1,357176,356701,475
34174601,10.2048,6.1888,480,67160,0.487568,0.97,1,357187,356707,480
34177521,5.24096,9.23776,474,67160,0.505514,1,1,357191,356717,474
34180441,2.64819,6.64755,470,67160,0.509103,0.97,1,357193,356723,470
34183361,6.92964,8.52951,469,67160,0.557821,0.88,1,357201,356732,469
34186281,17.3859,19.3059,467,67160,0.551564,0.89,1,357221,356754,467
34189201,49.0772,51.0612,465,67160,0.582313,0.81,1,357278,356813,465
34192121,54.6154,56.6122,463,67160,0.588463,0.59,1,357334,356871,463
34195041,70.9231,81.7224,450,68620,0.685693,0.55,1,357409,356959,450
34197961,40.5846,44.3445,448,68620,0.753138,0.51,2,357442,356994,448
34200881,20.1169,24.8689,443,68620,0.782628,0.51,2,357457,357014,443
34203801,24.8234,4.97378,469,68620,0.804526,0.49,2,357483,357014,469
34206721,56.9647,21.7948,508,68620,0.872905,0.49,2,357548,357040,508
34209641,12.9929,54.759,447,68620,0.886581,0.49,2,357550,357103,447
34212561,4.19859,12.5518,447,68620,0.889316,0.51,2,357552,357105,447
34215481,2.43972,4.11036,447,68620,0.889863,0.51,2,357554,357107,447
34218401,2.08794,2.42207,447,68620,0.905973,0.51,2,357556,357109,447
34221321,2.01759,2.08441,447,68620,0.941195,0.49,2,357558,357111,447
34238841,6,6,445,70080,0.91,0.49,2,357621,357176,445
34241761,14,10,450,70080,0.942,0.51,2,357637,357187,450
34244681,6,5.2,450,70080,0.9484,0.51,2,357641,357191,450
34466601,57,60,528,54020,0.5,1,1,359206,358678,528
34469521,81,120,480,55480,0.428,1,1,359293,358813,480
34472441,56.2,51.2,496,56940,0.3496,0.92,1,359343,358847,496
34475361,28.04,31.04,491,58400,0.45392,1,1,359364,358873,491
34478281,56.808,66.208,480,59860,0.842784,1,2,359428,358948,480
34481201,18.5616,22.8416,477,61320,0.888557,0.91,2,359437,358960,477
34484121,10.1123,11.7683,476,61320,0.905711,0.92,2,359445,358969,476
34487041,8.42246,8.75366,476,62780,0.901142,0.92,2,359453,358977,476
34489961,16.0845,11.3507,482,62780,0.868228,0.91,2,359471,358989,482
34492881,24.8169,15.0701,493,62780,0.837646,0.95,2,359498,359005,493
34495801,20.1634,28.614,480,62780,0.831529,0.91,2,359517,359037,480
34498721,14.4327,24.9228,469,62780,0.862306,0.89,2,359530,359061,469
34560041,17,19,479,65700,0.79,0.87,2,359996,359517,479
34562961,15.4,14.2,481,65700,0.838,1,2,360011,359530,481
34565881,13.48,14.84,479,65700,0.8156,1,2,360024,359545,479
34568801,10.696,10.168,480,67160,0.87512,1,2,360034,359554,480
34571721,8.5392,5.2336,484,67160,0.903024,1,2,360042,359558,484
34574641,7.30784,6.64672,484,67160,0.892605,1,2,360049,359565,484
34577561,10.2616,4.52934,491,67160,0.906521,1,2,360060,359569,491
34764441,13,9,493,73000,0.92,1,2,361415,360922,493
34767361,15.4,15.4,492,73000,0.92,1,2,361431,360939,492
34770281,16.68,15.08,494,73000,0.912,1,2,361448,360954,494
34773201,13.736,14.216,493,73000,0.8784,1,2,361461,360968,493
34776121,12.3472,10.0432,496,73000,0.87168,1,2,361473,360977,496
34779041,12.0694,8.40864,500,73000,0.870336,1,2,361485,360985,500
34796561,68,13,549,73000,0.65,1,1,361633,361084,549
34799481,48.8,57.8,524,73000,0.578,1,1,361677,361153,524
34802401,24.16,58.76,483,73000,0.5796,1,1,361695,361212,483
34805321,17.632,21.352,487,73000,0.61192,1,1,361711,361224,487
34808241,33.9264,34.6704,487,73000,0.578384,1,1,361749,361262,487
34811161,39.5853,42.9341,483,73000,0.523677,1,1,361790,361307,483
34814081,17.5171,17.3868,484,73000,0.496735,1,1,361802,361318,484
34817001,11.5034,11.4774,484,73000,0.459347,1,1,361812,361328,484
34819921,4.70068,9.49547,478,73000,0.451869,1,1,361815,361337,478
34822841,10.5401,13.0991,476,73000,0.450374,1,1,361827,361351,476
34825761,9.30803,12.2198,473,73000,0.418075,1,1,361836,361363,473
34828681,11.4616,13.644,471,73000,0.411615,0.92,1,361848,361377,471
34831601,12.6923,13.9288,470,73000,0.394323,0.94,1,361861,361391,470
34834521,11.3385,11.5858,470,73000,0.342865,0.92,1,361872,361402,470
34837441,7.86769,12.7172,464,73000,0.300573,0.92,1,361879,361415,464
34840361,14.3735,15.3434,464,73000,0.244115,0.91,1,361895,361431,464
34843281,17.2747,16.6687,465,73000,0.184823,0.87,1,361913,361448,465
34846201,13.8549,13.7337,465,73000,0.692965,0.87,1,361926,361461,465
34860801,15,14,468,73000,0.67,0.85,1,361988,361520,468
34863721,27,28.4,466,73000,0.59,0.89,1,362018,361552,466
34866641,15,16.08,465,73000,0.606,0.65,1,362030,361565,465
34878321,16,16,450,73000,0.93,0.57,2,362161,361711,450
34881241,32.8,33.6,449,73000,0.738,0.51,1,362198,361749,449
34884161,36.16,39.52,445,73000,0.7476,0.49,1,362235,361790,445
34887081,16.032,17.504,444,73000,0.73352,0.45,1,362246,361802,444
34890001,11.2064,11.5008,444,73000,0.698704,0.45,1,362256,361812,444
34892921,3.84128,4.70016,443,73000,0.723741,0.45,1,362258,361815,443
34895841,8.76826,10.54,441,73000,0.760748,0.41,2,362268,361827,441
34898761,8.15365,9.30801,440,73000,0.76815,0.41,2,362276,361836,440
34901681,11.2307,11.4616,440,73000,0.81763,0.39,2,362288,361848,440
34904601,10.2461,12.6923,437,73000,0.811526,0.33,2,362298,361861,437
34907521,8.44923,11.3385,434,73000,0.810305,0.29,2,362306,361872,434
34910441,4.88985,7.86769,431,73000,0.810061,0.23,2,362310,361879,431
34913361,12.178,14.3735,429,73000,0.842012,0.17,2,362324,361895,429
34916281,28.8356,17.2747,444,73000,0.880402,0.82,2,362357,361913,444
34919201,38.5671,13.8549,472,73000,0.92008,1,2,362398,361926,472
34922121,16.5134,11.571,472,73000,0.928016,1,2,362409,361937,472
34925041,10.5027,15.9142,464,73000,0.929603,0.86,2,362418,361954,464
34927961,6.10054,10.3828,460,73000,0.913921,0.77,2,362423,361963,460
34930881,7.62011,10.0766,458,73000,0.910784,0.67,2,362431,361973,458
34933801,9.52402,14.0153,453,73000,0.910157,0.57,2,362441,361988,453
34945481,36,45,464,73000,0.85,0.85,2,362593,362129,464
34948401,21.6,21.8,466,73000,0.818,0.93,2,362611,362145,466
34951321,17.92,17.16,467,73000,0.8436,0.69,2,362628,362161,467
34954241,21.984,33.032,453,73000,0.91272,0.75,2,362651,362198,453
35167401,20,39,493,77380,0.81,1,2,364024,363531,493
35170321,16.8,31,480,77380,0.794,1,2,364040,363560,480
35173241,44.96,19.8,515,77380,0.8148,1,2,364092,363577,515
35176161,26.592,18.36,519,77380,0.83496,1,2,364114,363595,519
35179081,18.1184,43.672,485,77380,0.830992,1,2,364130,363645,485
35182001,16.4237,17.5344,490,77380,0.798198,1,2,364146,363656,490
35202441,13,12,521,78840,0.91,1,2,364275,363754,521
35205361,9,7.2,523,78840,0.846,1,2,364283,363760,523
35208281,8.2,7.04,524,78840,0.8492,1,2,364291,363767,524
35211201,5.64,13.408,514,78840,0.81784,1,2,364296,363782,514
35214121,4.328,17.8816,499,78840,0.795568,1,2,364300,363801,499
35217041,7.2656,13.1763,495,78840,0.791114,0.99,2,364308,363813,495
35219961,14.2531,21.0353,488,78840,0.710223,1,1,364324,363836,488
35222881,11.6506,14.6071,486,78840,0.654045,1,1,364335,363849,486
35225801,18.3301,20.5214,484,78840,0.498809,1,1,364355,363871,484
35228721,18.866,20.9043,482,80300,0.443762,1,1,364374,363892,482
35231641,15.7732,20.1809,477,80300,0.432752,1,1,364389,363912,477
35234561,20.7546,19.2362,480,80300,0.39855,0.88,1,364411,363931,480
35237481,38.5509,48.6472,467,80300,0.42371,0.83,1,364454,363987,467
35240401,18.1102,23.3294,463,80300,0.428742,0.83,1,364467,364004,463
35243321,18.022,4.66589,481,80300,0.525748,0.81,1,364485,364004,481
35246241,16.4044,16.9332,477,80300,0.54515,0.79,1,364501,364024,477
35249161,42.4809,16.1866,510,81760,0.54903,0.82,1,364550,364040,510
35252081,29.2962,44.8373,484,81760,0.357806,0.84,1,364576,364092,484
35255001,16.2592,26.5675,475,81760,0.559561,0.83,1,364589,364114,475
35257921,15.2518,18.1135,474,81760,0.583912,0.79,1,364604,364130,474
35260841,23.0504,16.4227,483,81760,0.556782,1,1,364629,364146,483
35263761,36.6101,15.2845,508,81760,0.567356,1,1,364669,364161,508
35266681,8.92201,33.4569,472,81760,0.537471,1,1,364671,364199,472
35269601,13.7844,18.6914,472,81760,0.563494,0.98,1,364686,364214,472
35272521,12.3569,14.9383,470,83220,0.552699,0.92,1,364698,364228,470
35275441,14.4714,16.5877,468,83220,0.55054,0.93,1,364713,364245,468
35278361,15.6943,16.9175,467,83220,0.534108,0.91,1,364729,364262,467
35281281,11.1389,13.7835,464,83220,0.498822,0.83,1,364739,364275,464
35284201,7.82777,9.1567,463,83220,0.475764,0.85,1,364746,364283,463
35287121,6.36555,8.23134,461,83220,0.503153,0.81,1,364752,364291,461
35290041,5.27311,5.64627,461,83220,0.460631,0.79,1,364757,364296,461
35292961,3.45462,4.32925,460,83220,0.468126,0.79,1,364760,364300,460
35295881,3.89092,7.26585,456,83220,0.437625,0.69,1,364764,364308,456
35298801,11.1782,14.2532,453,83220,0.447525,0.64,1,364777,364324,453
35301721,8.63564,11.6506,450,83220,0.433505,0.46,1,364785,364335,450
35304641,16.1271,18.3301,448,83220,0.414701,0.46,1,364803,364355,448
35307561,14.4254,3.66603,462,83220,0.41094,0.43,1,364817,364355,462
35310481,14.0851,15.9332,457,83220,0.426188,0.43,1,364831,364374,457
35313401,18.017,15.1866,461,83220,0.397238,0.39,1,364850,364389,461
35316321,39.6034,20.6373,484,83220,0.311448,0.43,1,364895,364411,484
35319241,25.5207,38.5275,463,84680,0.262289,0.43,1,364917,364454,463
35322161,19.5041,18.1055,468,84680,0.220458,0.55,1,364935,364467,468
35325081,13.5008,18.0211,462,84680,0.228092,0.55,1,364947,364485,462
35328001,4.30017,16.4042,448,84680,0.229618,0.55,1,364949,364501,448
35330921,36.06,42.4808,443,84680,0.229924,0.31,1,364993,364550,443
35333841,36.012,29.2962,453,84680,0.293985,0.61,1,365029,364576,453
35336761,16.0024,16.2592,451,84680,0.306797,0.59,1,365040,364589,451
35339681,12.8005,15.2518,448,84680,0.325359,0.55,1,365052,364604,448
35342601,24.9601,23.0504,451,84680,0.345072,0.57,1,365080,364629,451
35345521,33.792,36.6101,447,86140,0.413014,0.53,1,365116,364669,447
35348441,9.1584,8.92201,448,86140,0.410603,0.57,1,365119,364671,448
35351361,13.8317,13.7844,448,86140,0.410121,0.57,1,365134,364686,448
35354281,11.5663,2.75688,459,86140,0.426024,0.55,1,365145,364686,459
35357201,13.5133,10.1514,461,86140,0.413205,0.55,1,365159,364698,461
35360121,14.7027,14.0303,461,86140,0.426641,0.53,1,365174,364713,461
35363041,10.1405,15.6061,454,86140,0.413328,0.49,1,365183,364729,454
35365961,6.02811,11.1212,449,86140,0.426666,0.47,1,365188,364739,449
35368881,6.00562,7.82424,448,87600,0.429333,0.51,1,365194,364746,448
35371801,4.40112,6.36485,446,87600,0.397867,0.45,1,365198,364752,446
35374721,2.48022,5.27297,443,87600,0.407573,0.47,1,365200,364757,443
35377641,5.29605,3.45459,446,87600,0.425515,0.43,1,365206,364760,446
35380561,9.85921,3.89092,453,87600,0.445103,0.45,1,365217,364764,453
35383481,8.37184,11.1782,448,87600,0.449021,0.43,1,365225,364777,448
35386401,16.8744,8.63564,459,87600,0.449804,0.41,1,365244,364785,459
35389321,13.7749,16.1271,454,87600,0.449961,0.41,1,365257,364803,454
35392241,13.955,14.4254,454,87600,0.481992,0.43,1,365271,364817,454
35395161,16.391,14.0851,457,87600,0.520398,0.39,1,365288,364831,457
35398081,34.4782,18.017,477,89060,0.60808,0.29,1,365327,364850,477
35401001,8.49564,39.6034,434,89060,0.593616,0.25,1,365329,364895,434
35403921,19.2991,25.5207,434,89060,0.638723,0.21,1,365351,364917,434
35406841,17.4598,19.5041,433,89060,0.695745,0.23,1,365368,364935,433
35409761,13.092,13.5008,433,89060,0.707149,0.23,1,365380,364947,433
35412681,4.21839,4.30017,433,89060,0.67743,0.23,1,365382,364949,433
35415601,36.8437,36.06,434,89060,0.703486,0.31,1,365427,364993,434
35418521,37.7687,36.012,436,89060,0.756697,0.31,2,365465,365029,436
35421441,17.9537,16.0024,438,90520,0.815339,0.33,2,365478,365040,438
35424361,13.1907,12.8005,438,90520,0.827068,0.35,2,365490,365052,438
35427281,25.8382,24.9601,439,90520,0.845414,0.35,2,365519,365080,439
35430201,35.5676,4.99202,477,90520,0.881083,0.43,2,365557,365080,477
35433121,8.71353,29.7984,443,91980,0.888217,0.41,2,365559,365116,443
35436041,14.5427,8.35968,456,91980,0.921643,0.41,2,365575,365119,456
35438961,10.9085,13.6719,451,91980,0.912329,0.43,2,365585,365134,451
35441881,14.1817,11.5344,455,91980,0.942466,0.41,2,365600,365145,455
35792861,438,629,438,2920,0.35,0,1,369176,368738,438
35842501,19,15,509,52560,0.03,1,1,371087,370578,509
35845421,18.2,3,527,55480,0.03,1,1,371105,370578,527
35848341,16.44,11.8,529,55480,0.014,1,1,371121,370592,529
35851261,13.688,2.36,542,55480,0.0268,1,1,371134,370592,542
35854181,9.9376,11.672,537,55480,0.01336,1,1,371143,370606,537
35857101,9.98752,2.3344,547,55480,0.010672,1,1,371153,370606,547
36051281,14,31,493,54020,0.79,1,2,373059,372566,493
36054201,16.4,15,499,54020,0.726,1,1,373076,372577,499
36057121,17.68,15.8,501,54020,0.6572,1,1,373094,372593,501
36060041,13.136,13.56,500,54020,0.59544,1,1,373106,372606,500
36062961,13.0272,13.112,500,54020,0.591088,1,1,373119,372619,500
36065881,15.4054,11.4224,505,54020,0.510218,1,1,373135,372630,505
36068801,16.6811,10.2845,512,54020,0.462043,1,1,373152,372640,512
36071721,112.136,126.057,493,54020,0.196409,1,1,373288,372795,493
36074641,107.227,110.811,492,54020,0.0792817,1,1,373394,372902,492
36077561,35.8454,40.5623,487,54020,0.0238563,1,1,373412,372925,487
36080481,16.7691,19.3125,485,54020,0.0447713,1,1,373424,372939,485
36083401,12.1538,15.0625,482,54020,0.0809543,1,1,373435,372953,482
36086321,9.63076,12.6125,479,54020,0.0721909,1,1,373444,372965,479
36089241,11.5262,2.5225,491,54020,0.0704382,1,1,373456,372965,491
36092161,7.90523,11.7045,484,55480,0.0140876,1,1,373463,372979,484
36095081,9.58105,11.1409,483,55480,0.0268175,1,1,373473,372990,483
36098001,13.1162,11.0282,486,55480,0.0053635,0.91,1,373487,373001,486
36100921,16.2232,12.6056,490,55480,0.0010727,0.84,1,373504,373014,490
36103841,12.0446,27.3211,470,55480,0.0402145,0.79,1,373515,373045,470
36106761,13.6089,16.6642,470,55480,0.0480429,0.71,1,373529,373059,470
36109681,13.9218,16.9328,467,55480,0.0496086,0.64,1,373543,373076,467
36112601,11.5844,17.7866,460,55480,0.0339217,0.58,1,373554,373094,460
36115521,10.3169,13.1573,458,55480,0.0147843,0.59,1,373564,373106,458
36118441,12.4634,13.0315,458,55480,0.0109569,0.49,1,373577,373119,458
36130121,19,106,441,55480,0.23,0.01,1,373835,373394,441
36133041,14.2,35.6,436,55480,0.23,0.05,1,373848,373412,436
36135961,13.24,16.72,437,55480,0.246,0.09,1,373861,373424,437
36138881,7.448,12.144,432,55480,0.2492,0.07,1,373867,373435,432
36141801,10.2896,9.6288,434,55480,0.26584,0.07,1,373878,373444,434
36144721,3.65792,11.5258,424,55480,0.237168,0,1,373880,373456,424
36147641,5.53158,7.90515,423,55480,0.215434,0.03,1,373886,373463,423
36150561,8.30632,9.58103,422,55480,0.227087,0,1,373895,373473,422
36153481,12.8613,13.1162,422,55480,0.133417,0,1,373909,373487,422
36156401,16.9723,16.2232,423,55480,0.0506835,0.05,1,373927,373504,423
36159321,12.1945,12.0446,423,55480,0.0341367,0.05,1,373938,373515,423
36162241,13.6389,13.6089,423,55480,0.0468273,0.05,1,373952,373529,423
36165161,13.1278,13.9218,422,55480,0.0333655,0.03,1,373965,373543,422
36168081,11.4256,11.5844,422,55480,0.0466731,0.01,1,373976,373554,422
36171001,10.2851,10.3169,422,55480,0.0173346,0.01,1,373986,373564,422
36173921,52.457,12.4634,472,55480,0.139467,0.98,1,374049,373577,472
36176841,23.2914,15.2927,472,55480,0.163893,0.83,1,374065,373593,472
36179761,91.0583,99.0585,460,55480,0.272779,0.29,1,374173,373713,460
36182681,79.0117,102.212,433,55480,0.286556,0.23,1,374249,373816,433
36185601,29.4023,35.6423,431,55480,0.321311,0.23,1,374266,373835,431
36188521,17.0805,17.5285,432,55480,0.328262,0.25,1,374280,373848,432
36191441,15.4161,13.9057,434,55480,0.281652,0.25,1,374295,373861,434
36194361,7.88322,7.58114,434,55480,0.27233,0.27,1,374301,373867,434
36197281,8.77664,10.3162,432,55480,0.286466,0.23,1,374310,373878,432
36200201,3.35533,3.66325,432,55480,0.289293,0.21,1,374312,373880,432
36203121,5.47107,5.53265,432,55480,0.305859,0.23,1,374318,373886,432
36206041,5.89421,8.30653,429,55480,0.341172,0.11,1,374324,373895,429
36208961,8.37884,12.8613,424,55480,0.332234,0.03,1,374333,373909,424
36211881,14.4758,16.9723,422,55480,0.314447,0.03,1,374349,373927,422
36214801,11.6952,12.1945,422,55480,0.198889,0.05,1,374360,373938,422
36217721,13.539,13.6389,422,55480,0.143778,0.03,1,374374,373952,422
36220641,13.9078,13.1278,423,55480,0.0687556,0.05,1,374388,373965,423
36223561,10.7816,11.4256,422,55480,0.0537511,0.01,1,374398,373976,422
36226481,10.1563,10.2851,422,55480,0.0187502,0.17,1,374408,373986,422
36229401,58.0313,52.457,429,55480,0.05975,0.17,1,374478,374049,429
36232321,26.0063,23.2914,431,55480,0.06795,0.3,1,374496,374065,431
36235241,94.0013,91.0583,434,55480,0.03759,0.29,1,374607,374173,434
36238161,82.0003,79.0117,437,55480,0.079518,0.33,1,374686,374249,437
36241081,29.2,29.4023,436,55480,0.103904,0.33,1,374702,374266,436
36244001,17.04,17.0805,436,55480,0.108781,0.27,1,374716,374280,436
36246921,14.608,15.4161,435,55480,0.109756,0.27,1,374730,374295,435
36249841,7.7216,7.88322,435,55480,0.109951,0.29,1,374736,374301,435
36252761,10.3443,8.77664,437,55480,0.12599,0.29,1,374747,374310,437
36255681,3.66886,3.35533,437,55480,0.129198,0.31,1,374749,374312,437
36258601,5.53377,5.47107,437,55480,0.0978396,0.35,1,374755,374318,437
36261521,5.90675,5.89421,437,55480,0.123568,0.33,1,374761,374324,437
36264441,9.98135,8.37884,439,55480,0.112714,0.31,1,374772,374333,439
36267361,6.79627,14.4758,429,55480,0.110543,0.17,1,374778,374349,429
36270281,7.75925,11.6952,426,55480,0.110109,0.13,1,374786,374360,426
36273201,11.1519,13.539,424,55480,0.110022,0.05,1,374798,374374,424
36276121,13.4304,13.9078,424,55480,0.142004,0.05,1,374812,374388,424
36279041,9.08607,10.7816,422,55480,0.132401,0.01,1,374820,374398,422
36281961,9.81721,10.1563,422,55480,0.11448,0.07,1,374830,374408,422
36284881,59.5634,58.0313,424,55480,0.078896,0.07,1,374902,374478,424
36287801,27.1127,26.0063,425,55480,0.0557792,0.03,1,374921,374496,425
36290721,92.6225,94.0013,423,55480,0.0351558,0.09,1,375030,374607,423
36293641,84.9245,82.0003,427,55480,0.0790312,0.11,1,375113,374686,427
36296561,29.7849,29.2,427,55480,0.0878062,0.11,1,375129,374702,427
36299481,17.157,17.04,427,55480,0.0895613,0.11,1,375143,374716,427
36302401,14.6314,14.608,427,55480,0.0579122,0.11,1,375157,374730,427
36305321,7.72628,7.7216,427,55480,0.0515825,0.13,1,375163,374736,427
36308241,9.54526,10.3443,426,55480,0.0503165,0.13,1,375173,374747,426
36311161,3.50905,3.66886,426,55480,0.0820633,0.09,1,375175,374749,426
36314081,5.50181,5.53377,426,55480,0.0564127,0.13,1,375181,374755,426
36317001,5.90036,5.90675,426,55480,0.0832825,0.11,1,375187,374761,426
36319921,10.7801,9.98135,427,55480,0.0886565,0.11,1,375199,374772,427
36322841,6.95601,6.79627,427,55480,0.0577313,0.11,1,375205,374778,427
36325761,7.7912,7.75925,427,55480,0.0515463,0.11,1,375213,374786,427
36328681,11.1582,11.1519,427,55480,0.0503093,0.15,1,375225,374798,427
36331601,14.2316,13.4304,428,55480,0.0820619,0.13,1,375240,374812,428
36334521,8.44633,9.08607,427,55480,0.104412,0.11,1,375247,374820,427
36337441,6.48927,9.81721,423,55480,0.108882,0.07,1,375253,374830,423
36340361,58.8979,59.5634,423,55480,0.181776,0.05,1,375325,374902,423
36343281,26.1796,27.1127,422,55480,0.172355,0.03,1,375343,374921,422
36346201,94.0359,92.6225,424,55480,0.122471,0.09,1,375454,375030,424
36349121,85.2072,84.9245,424,55480,0.0964942,0.09,1,375537,375113,424
36352041,29.8414,29.7849,424,55480,0.0912988,0.09,1,375553,375129,424
36354961,17.1683,17.157,424,55480,0.0902598,0.05,1,375567,375143,424
36357881,14.6337,14.6314,424,55480,0.058052,0.05,1,375581,375157,424
36360801,7.72673,7.72628,424,55480,0.0516104,0.05,1,375587,375163,424
36363721,9.54535,9.54526,424,55480,0.0503221,0.09,1,375597,375173,424
36366641,3.50907,3.50905,424,55480,0.0820644,0.05,1,375599,375175,424
36369561,5.50181,5.50181,424,55480,0.0564129,0.09,1,375605,375181,424
36372481,5.90036,5.90036,424,55480,0.0832826,0.09,1,375611,375187,424
36375401,10.7801,10.7801,424,55480,0.0886565,0.05,1,375623,375199,424
36378321,6.95601,6.95601,424,55480,0.0897313,0.05,1,375629,375205,424
36381241,7.7912,7.7912,424,55480,0.0579463,0.05,1,375637,375213,424
36384161,11.1582,11.1582,424,56940,0.0995893,0.09,1,375649,375225,424
36387081,15.8316,14.2316,426,56940,0.123918,0.11,1,375666,375240,426
36390001,9.56633,8.44633,427,56940,0.128784,0.11,1,375674,375247,427
36392921,6.71327,6.48927,427,56940,0.0977567,0.2,1,375680,375253,427
36395841,60.5427,58.8979,429,56940,0.203551,0.17,1,375754,375325,429
36398761,27.3085,26.1796,430,56940,0.24071,0.11,1,375773,375343,430
36401681,90.2617,94.0359,425,56940,0.264142,0.09,1,375879,375454,425
36404601,83.6523,85.2072,424,56940,0.284828,0.09,1,375961,375537,424
36407521,29.5305,29.8414,424,56940,0.320966,0.09,1,375977,375553,424
36410441,17.1061,17.1683,424,56940,0.328193,0.05,1,375991,375567,424
36413361,14.6212,14.6337,424,58400,0.313639,0.05,1,376005,375581,424
36416281,7.72424,7.72673,424,58400,0.310728,0.05,1,376011,375587,424
36419201,9.54485,9.54535,424,58400,0.310146,0.09,1,376021,375597,424
36422121,3.50897,3.50907,424,58400,0.342029,0.05,1,376023,375599,424
36425041,5.50179,5.50181,424,58400,0.316406,0.09,1,376029,375605,424
36427961,5.90036,5.90036,424,58400,0.311281,0.09,1,376035,375611,424
36430881,10.7801,10.7801,424,58400,0.310256,0.09,1,376047,375623,424
36433801,6.95601,6.95601,424,58400,0.310051,0.05,1,376053,375629,424
36436721,7.7912,7.7912,424,58400,0.31001,0.05,1,376061,375637,424
36439641,11.1582,1.55824,436,58400,0.310002,0.11,1,376073,375637,436
36442561,16.6316,9.91165,442,58400,0.31,0.13,1,376091,375649,442
36445481,9.72633,15.5823,433,58400,0.31,0.13,1,376099,375666,433
36448401,7.54527,9.51647,432,58400,0.326,0.09,1,376106,375674,432
36451321,63.9091,6.70329,504,58400,0.3692,0.23,1,376184,375680,504
36454241,28.7818,60.5407,450,58400,0.40184,0.25,1,376204,375754,450
36457161,92.9564,27.3081,540,58400,0.424368,0.27,1,376313,375773,540
36460081,84.9913,90.2616,517,59860,0.492874,0.29,1,376396,375879,517
36463001,29.7983,83.6523,451,59860,0.506575,0.33,1,376412,375961,451
36465921,17.1597,29.5305,449,59860,0.525315,0.33,1,376426,375977,449
36468841,5.03193,17.1061,437,59860,0.529063,0.31,1,376428,375991,437
36471761,12.2064,14.6212,437,59860,0.561813,0.31,1,376442,376005,437
36474681,7.24128,7.72424,437,61320,0.584363,0.31,1,376448,376011,437
36477601,9.44826,9.54485,437,61320,0.572873,0.35,1,376458,376021,437
36480521,3.48965,3.50897,437,61320,0.570575,0.31,1,376460,376023,437
36483441,5.49793,5.50179,437,61320,0.602115,0.31,1,376466,376029,437
36486361,5.89959,5.90036,437,61320,0.576423,0.31,1,376472,376035,437
36489281,10.7799,10.7801,437,61320,0.571285,0.31,1,376484,376047,437
36492201,6.95598,6.95601,437,61320,0.570257,0.31,1,376490,376053,437
36495121,7.7912,7.7912,437,61320,0.602051,0.31,1,376498,376061,437
36498041,11.1582,11.1582,437,61320,0.57641,0.31,1,376510,376073,437
36500961,16.6316,16.6316,437,61320,0.571282,0.31,1,376528,376091,437
36503881,9.72633,9.72633,437,61320,0.602256,0.33,1,376536,376099,437
36506801,6.74527,7.54527,436,61320,0.576451,0.38,1,376542,376106,436
36509721,67.7491,63.9091,441,61320,0.69929,0.41,1,376625,376184,441
36512641,31.1498,28.7818,443,62780,0.787858,0.43,2,376647,376204,443
36515561,94.23,92.9564,444,62780,0.837572,0.43,2,376757,376313,444
36518481,86.846,18.5913,529,64240,0.927514,0.51,2,376842,376313,529
36521401,30.9692,70.1183,463,64240,0.929503,0.51,2,376859,376396,463
36524321,17.3938,26.8237,461,64240,0.929901,0.53,2,376873,376412,461
36527241,5.07877,16.5647,449,65700,0.92998,0.53,2,376875,376426,449
36530161,13.0158,4.91295,462,65700,0.929996,0.57,2,376890,376428,462
36533081,4.20315,12.1826,450,65700,0.929999,0.59,2,376892,376442,450
36536001,5.64063,7.23652,450,65700,0.93,0.57,2,376898,376448,450
36814961,69,84,435,48343,0.25,0.45,1,378928,378493,435
36817881,37,32.8,444,41686,0.122,0.37,1,378957,378513,444
36820801,29.8,21.76,453,40051,0.0244,0.05,1,378985,378532,453
36823721,96.36,112.352,431,37960,0.33288,0.03,1,379098,378667,431
36826641,54.472,43.2704,449,37960,0.402576,0.07,1,379142,378693,449
36829561,54.0944,61.4541,437,37960,0.600515,0.19,1,379196,378759,437
36832481,30.0189,33.0908,435,37960,0.656103,0.1,1,379220,378785,435
36835401,12.4038,21.8182,424,37960,0.635221,0.03,1,379228,378804,424
36838321,20.8808,14.7636,434,37960,0.631044,0.19,1,379251,378817,434
36841241,8.97615,13.3527,427,37960,0.630209,0.11,1,379257,378830,427
36844161,17.7952,9.87055,438,37960,0.678042,0.17,1,379277,378839,438
36847081,22.759,17.9741,442,37960,0.751608,0.17,2,379301,378859,442
36850001,10.1518,3.59482,449,37960,0.750322,0.43,2,379308,378859,449
36852921,10.8304,10.319,448,37960,0.798064,0.33,2,379319,378871,448
36855841,26.9661,29.2638,445,39420,0.855613,0.25,2,379350,378905,445
36858761,30.1932,24.2528,453,39420,0.867123,0,2,379381,378928,453
36993081,21,19,506,46720,0.03,1,1,381004,380498,506
36996001,55.4,32.6,534,46720,0.014,1,1,381068,380534,534
36998921,34.28,53.72,504,46720,0.0268,1,1,381097,380593,504
37001841,16.456,31.544,490,46720,0.07736,1,1,381109,380619,490
37004761,12.8912,15.9088,490,46720,0.055472,1,1,381121,380631,490
37007681,15.3782,12.7818,494,46720,0.0670944,1,1,381137,380643,494
37010601,17.4756,12.1564,500,46720,0.0374189,1,1,381155,380655,500
37013521,13.8951,22.4313,488,46720,0.0154838,1,1,381168,380680,488
37016441,13.979,19.6863,483,46720,0.0430968,1,1,381182,380699,483
37019361,17.1958,17.5373,484,46720,0.0406194,0.97,1,381200,380716,484
37022281,19.4392,17.1075,487,46720,0.0401239,1,1,381220,380733,487
37025201,19.8878,26.6215,478,46720,0.0960248,1,1,381240,380762,478
37028121,14.3776,17.3243,476,46720,0.139205,1,1,381253,380777,476
37031041,14.0755,18.6649,471,46720,0.123841,0.21,1,381267,380796,471
37033961,95.6151,129.333,430,46720,0.480768,0.05,1,381383,380953,430
37036881,38.323,49.8666,424,46720,0.656154,0.03,1,381407,380983,424
37039801,22.8646,26.7733,422,46720,0.859231,0.01,2,381426,381004,422
37042721,55.7729,56.5547,422,46720,0.627846,0.03,1,381490,381068,422
37045641,35.9546,34.5109,424,46720,0.533569,0.09,1,381521,381097,424
37048561,15.1909,16.5022,422,46720,0.466714,0.05,1,381531,381109,422
37051481,15.8382,12.9004,426,46720,0.453343,0.07,1,381547,381121,426
37054401,12.7676,15.3801,422,46720,0.386669,0.03,1,381559,381137,422
37057321,16.9535,17.476,422,46720,0.341334,0.01,1,381577,381155,422
37060241,14.5907,13.8952,423,46720,0.364267,0.05,1,381591,381168,423
37063161,14.1181,13.979,423,46720,0.352853,0.04,1,381605,381182,423
37066081,17.2236,17.1958,423,46720,0.366571,0.04,1,381623,381200,423
37069001,19.4447,19.4392,423,46720,0.337314,0.11,1,381643,381220,423
37071921,23.0889,19.8878,427,46720,0.235463,0.15,1,381667,381240,427
37074841,14.2178,14.3776,426,46720,0.183093,0.12,1,381679,381253,426
37077761,14.8436,14.0755,427,46720,0.124619,0.57,1,381694,381267,427
37080681,118.169,95.6151,455,46720,0.176924,0.7,1,381838,381383,455
37083601,40.4337,38.323,452,46720,0.203385,0.91,1,381859,381407,452
37086521,32.0867,22.8646,463,46720,0.128677,0.57,1,381889,381426,463
37089441,48.0174,55.7729,451,46720,0.145735,0.51,1,381941,381490,451
37092361,28.8035,35.9546,444,46720,0.165147,0.45,1,381965,381521,444
37095281,15.3607,15.1909,446,46720,0.169029,0.45,1,381977,381531,446
37098201,11.0721,15.8382,440,46720,0.201806,0.37,1,381987,381547,440
37101121,9.41443,12.7676,437,46720,0.240361,0.33,1,381996,381559,437
37104041,18.6829,16.9535,440,46720,0.296072,0.37,1,382017,381577,440
37106961,12.5366,14.5907,437,46720,0.307214,0.35,1,382028,381591,437
37109881,14.5073,14.1181,438,46720,0.293443,0.37,1,382043,381605,438
37112801,17.3015,17.2236,438,46720,0.258689,0.33,1,382061,381623,438
37115721,16.2603,19.4447,434,46720,0.283738,0.21,1,382077,381643,434
37118641,19.2521,23.0889,430,46720,0.272748,0.17,1,382097,381667,430
37121561,10.2504,14.2178,426,46720,0.28655,0.11,1,382105,381679,426
37124481,11.6501,14.8436,423,46720,0.28931,0.19,1,382117,381694,423
37127401,122.33,118.169,429,46720,0.257862,0.21,1,382267,381838,429
37130321,42.066,40.4337,430,46720,0.251572,0.11,1,382289,381859,430
37133241,26.8132,32.0867,423,46720,0.282314,0.15,1,382312,381889,423
37136161,52.5626,48.0174,430,46720,0.288463,0.17,1,382371,381941,430
37139081,29.7125,28.8035,430,46720,0.305693,0.17,1,382395,381965,430
37142001,17.1425,15.3607,432,46720,0.309139,0.21,1,382409,381977,432
37144921,12.2285,11.0721,433,46720,0.341828,0.25,1,382420,381987,433
37147841,10.4457,9.41443,434,46720,0.316366,0.31,1,382430,381996,434
37150761,20.4891,18.6829,436,46720,0.359273,0.31,1,382453,382017,436
37153681,12.0978,12.5366,435,46720,0.351855,0.29,1,382463,382028,435
37156601,13.6196,14.5073,434,46720,0.382371,0.25,1,382477,382043,434
37159521,17.1239,17.3015,434,46720,0.388474,0.29,1,382495,382061,434
37162441,16.2248,16.2603,434,46720,0.373695,0.27,1,382511,382077,434
37165361,20.845,19.2521,436,46720,0.386739,0.29,1,382533,382097,436
37168281,10.569,10.2504,436,46720,0.421348,0.29,1,382541,382105,436
37171201,11.7138,11.6501,436,46720,0.39627,0.25,1,382553,382117,436
37174121,120.743,122.33,434,46720,0.471254,0.25,1,382701,382267,434
37177041,41.7486,42.066,434,46720,0.486251,0.29,1,382723,382289,434
37179961,28.3497,26.8132,436,48180,0.56925,0.29,1,382748,382312,436
37182881,53.6699,52.5626,437,48180,0.55385,0.31,1,382808,382371,437
37185801,29.934,29.7125,437,48180,0.58277,0.31,1,382832,382395,437
37188721,17.9868,17.1425,438,48180,0.604554,0.35,1,382847,382409,438
37191641,11.5974,12.2285,437,48180,0.576911,0.31,1,382857,382420,437
37194561,11.1195,10.4457,438,48180,0.587382,0.37,1,382868,382430,438
37197481,21.4239,20.4891,439,48180,0.621476,0.35,1,382892,382453,439
37200401,12.2848,12.0978,439,48180,0.596295,0.39,1,382902,382463,439
37203321,13.657,13.6196,439,48180,0.623259,0.39,1,382916,382477,439
37206241,17.9314,17.1239,440,48180,0.612652,0.37,1,382935,382495,440
37209161,16.3863,16.2248,440,48180,0.61053,0.39,1,382951,382511,440
37212081,21.6773,20.845,441,48180,0.626106,0.43,1,382974,382533,441
37215001,10.7355,10.569,441,48180,0.629221,0.39,1,382982,382541,441
37217921,11.7471,11.7138,441,48180,0.613844,0.49,1,382994,382553,441
37220841,124.749,120.743,446,48180,0.658769,0.49,1,383147,382701,446
37223761,42.5499,41.7486,446,49640,0.683754,0.49,1,383169,382723,446
37226681,30.11,8.34971,473,49640,0.640751,0.59,1,383196,382723,473
37229601,55.622,21.6699,510,49640,0.64815,0.55,1,383258,382748,510
37232521,30.3244,52.334,474,49640,0.64963,0.59,1,383282,382808,474
37235441,17.2649,29.6668,464,49640,0.649926,0.61,1,383296,382832,464
37238361,11.453,17.9334,459,49640,0.649985,0.57,1,383306,382847,459
37241281,12.6906,11.5867,462,49640,0.633997,0.59,1,383319,382857,462
37244201,20.9381,11.1173,474,49640,0.678799,0.63,1,383342,382868,474
37247121,12.1876,21.4235,460,51100,0.68776,0.59,1,383352,382892,460
37250041,13.6375,12.2847,464,51100,0.705552,0.63,1,383366,382902,464
37252961,17.1275,13.6569,468,51100,0.70911,0.61,1,383384,382916,468
37255881,16.2255,17.9314,465,51100,0.709822,0.61,1,383400,382935,465
37258801,22.4451,16.3863,473,51100,0.709964,0.63,1,383424,382951,473
37261721,11.689,21.6773,459,51100,0.725993,0.63,1,383433,382974,459
37264641,11.9378,10.7355,463,51100,0.745199,0.61,1,383445,382982,463
37267561,125.588,11.7471,605,51100,0.74904,0.67,1,383599,382994,605
37270481,26.7175,124.749,454,52560,0.749808,0.69,1,383601,383147,454
37273401,22.9435,42.5499,454,52560,0.781962,0.63,2,383623,383169,454
37276321,25.3887,30.11,453,52560,0.788392,0.65,2,383649,383196,453
37279241,55.4777,55.622,454,52560,0.805678,0.65,2,383712,383258,454
37282161,30.2955,30.3244,454,54020,0.825136,0.65,2,383736,383282,454
37285081,17.2591,17.2649,454,54020,0.797027,0.65,2,383750,383296,454
37288001,11.4518,11.453,454,54020,0.791405,0.63,2,383760,383306,454
37290921,12.6904,12.6906,454,54020,0.806281,0.69,2,383773,383319,454
37293841,22.5381,20.9381,456,54020,0.793256,0.69,2,383798,383342,456
37296761,12.5076,4.18762,466,54020,0.758651,0.69,2,383808,383342,466
37299681,13.7015,8.83752,470,54020,0.75173,0.71,2,383822,383352,470
37302601,17.1403,12.9675,474,54020,0.750346,0.71,2,383840,383366,474
37305521,16.2281,16.9935,472,55480,0.782069,0.71,2,383856,383384,472
37308441,22.4456,16.1987,480,55480,0.788414,0.71,2,383880,383400,480
37311361,13.2891,22.4397,467,55480,0.805683,0.73,2,383891,383424,467
37314281,12.2578,11.6879,470,55480,0.825137,0.75,2,383903,383433,470
37317201,126.452,11.9376,613,55480,0.829027,0.75,2,384058,383445,613
37320121,26.8903,125.588,461,56940,0.829805,0.75,2,384060,383599,461
37323041,6.97806,26.7175,461,56940,0.829961,0.79,2,384062,383601,461
37325961,18.9956,22.9435,461,56940,0.877992,0.79,2,384084,383623,461
37328881,24.5991,25.3887,461,56940,0.887599,0.81,2,384110,383649,461
37331801,54.5198,55.4777,460,56940,0.92152,0.81,2,384172,383712,460
37334721,30.104,11.0955,484,56940,0.896304,0.83,2,384196,383712,484
37337641,17.2208,21.4191,474,56940,0.891261,0.79,2,384210,383736,474
37340561,11.4442,15.4838,470,56940,0.890252,0.79,2,384220,383750,470
37343481,11.8888,11.0968,472,56940,0.906051,0.81,2,384232,383760,472
37346401,21.5778,12.6194,483,56940,0.90921,0.79,2,384256,383773,483
37349321,12.3156,22.5239,468,58400,0.909842,0.75,2,384266,383798,468
37352241,13.6631,12.5048,472,58400,0.925968,0.75,2,384280,383808,472
37355161,17.1326,13.701,476,58400,0.929194,0.75,2,384298,383822,476
37358081,5.02652,17.1402,460,58400,0.929839,0.79,2,384300,383840,460
37361001,14.6053,16.228,461,58400,0.913968,0.79,2,384317,383856,461
37363921,22.1211,22.4456,461,58400,0.910794,0.81,2,384341,383880,461
37366841,14.8242,13.2891,463,58400,0.926159,0.83,2,384354,383891,463
37369761,12.5648,12.2578,463,58400,0.945232,0.83,2,384366,383903,463
37689601,67,77,421,58500,0.25,0.01,1,386760,386339,421
37692521,77.4,57.8,448,61320,0.362,0.01,1,386840,386392,448
37695441,34.68,37.96,439,62780,0.3044,0.07,1,386864,386425,439
37698361,22.136,26.792,434,64240,0.37288,0.07,1,386883,386449,434
37701281,18.0272,17.3584,436,65700,0.354576,0.13,1,386900,386464,436
37704201,22.0054,17.8717,441,65700,0.366915,0.09,1,386923,386482,441
37707121,29.2011,24.3743,446,67160,0.305383,0.11,1,386954,386508,446
37710041,17.0402,23.2749,437,67160,0.277077,0.09,1,386968,386531,437
37712961,20.208,21.455,437,67160,0.399415,0.09,1,386989,386552,437
37715881,22.4416,22.691,437,67160,0.439883,0.07,1,387012,386575,437
37718801,22.8883,19.7382,441,67160,0.543977,0.09,1,387035,386594,441
37721721,24.5777,24.7476,440,67160,0.580795,0.11,1,387060,386620,440
37724641,24.1155,22.5495,442,68620,0.588159,0.07,1,387084,386642,442
37727561,16.8231,19.7099,438,68620,0.669632,0.19,1,387099,386661,438
37730481,29.7646,15.942,456,68620,0.685926,0.33,1,387132,386676,456
37733401,7.55292,16.7884,441,68620,0.737185,0.33,1,387134,386693,441
37736321,3.11058,3.35768,443,68620,0.747437,0.33,1,387136,386693,443
37739241,2.22212,0.671536,445,70080,0.717487,0.33,1,387138,386693,445
37742161,2.04442,0.134307,447,70080,0.727497,0.39,1,387140,386693,447
37745081,40.4089,6.42686,489,70080,0.7935,0.25,2,387190,386701,489
37748001,9.68178,48.4854,432,70080,0.8067,0.25,2,387192,386760,432
37750921,3.53636,9.69707,434,70080,0.80934,0.39,2,387194,386760,434
38000581,90,111,430,54560,0.15,0.19,1,388916,388486,430
38003501,48.4,30.2,458,56940,0.134,0.01,1,388954,388496,458
38006421,33.68,41.24,444,58400,0.1948,0.05,1,388984,388540,444
38009341,33.136,32.248,447,59860,0.77496,0.01,2,389017,388570,447
38012261,21.8272,34.4496,431,59860,0.826992,0.05,2,389036,388605,431
38015181,11.5654,15.6899,429,59860,0.757398,0.03,2,389045,388616,429
38018101,10.3131,10.338,430,59860,0.68748,0.07,1,389055,388625,430
38021021,7.66262,11.6676,425,61320,0.625496,0.03,1,389062,388637,425
38023941,11.1325,8.73352,429,61320,0.597099,0.01,1,389074,388645,429
38024481,5.4265,7.3467,426,61320,0.55942,0.03,1,389078,388652,426
38027401,72.2853,55.0693,448,61320,0.183884,0.03,1,389167,388719,448
38030321,32.0571,37.4139,437,61320,0.0607768,0.01,1,389189,388752,437
38033241,22.4114,26.6828,433,61320,0.0361554,0.01,1,389209,388776,433
38036161,26.0823,22.9366,438,61320,0.0312311,0.11,1,389236,388798,438
38039081,26.0165,18.9873,446,61320,0.0462462,0.31,1,389262,388816,446
38042001,22.0033,18.9975,448,61320,0.0652492,0.27,1,389283,388835,448
38044921,20.4007,19.7995,448,62780,0.11705,0.25,1,389303,388855,448
38047841,16.8801,24.7599,438,62780,0.12741,0.21,1,389319,388881,438
38050761,22.576,21.752,441,62780,0.129482,0.15,1,389343,388902,441
38053681,6.11521,15.5504,429,62780,0.0978964,0.15,1,389345,388916,429
38056601,2.82304,3.11008,431,62780,0.0595793,0.13,1,389347,388916,431
38059521,34.9646,31.022,436,62780,0.147916,0.13,1,389390,388954,436
38062441,39.7929,6.2044,477,62780,0.181583,0.21,1,389431,388954,477
38065361,9.55858,25.2409,449,62780,0.188317,0.92,1,389433,388984,449
38068281,41.9117,31.4482,466,62780,0.285663,0.84,1,389483,389017,466
38071201,16.3823,21.4896,457,62780,0.273133,0.74,1,389493,389036,457
38074121,8.87647,11.4979,455,62780,0.286627,0.67,1,389500,389045,455
38077041,4.97529,10.2996,449,64240,0.289325,0.67,1,389504,389055,449
38079961,7.39506,2.05992,457,64240,0.305865,0.61,1,389512,389055,457
38082881,6.27901,6.01198,456,64240,0.309173,0.59,1,389518,389062,456
38085801,6.8558,10.8024,451,64240,0.309835,0.09,1,389525,389074,451
38088721,52.5712,76.5605,422,64240,0.341967,0.03,1,389589,389167,422
38091641,28.1142,32.9121,422,64240,0.316393,0.03,1,389611,389189,422
38094561,22.4228,22.5824,423,64240,0.279279,0.03,1,389632,389209,423
38097481,28.4846,26.1165,426,64240,0.143856,0.05,1,389662,389236,426
38100401,26.4969,26.0233,426,64240,0.164771,0.07,1,389688,389262,426
38103321,22.0994,22.0047,426,64240,0.152954,0.07,1,389709,389283,426
38106241,19.6199,4.40093,445,64240,0.150591,0.13,1,389728,389283,445
38109161,16.724,16.8802,441,64240,0.182118,0.13,1,389744,389303,441
38112081,22.5448,16.176,449,64240,0.204424,0.13,1,389768,389319,449
38115001,6.10896,22.4352,427,64240,0.208885,0.09,1,389770,389343,427
38117921,2.82179,6.08704,427,64240,0.209777,0.05,1,389772,389345,427
38120841,38.9644,2.81741,473,64240,0.241955,0.17,1,389820,389347,473
38123761,41.3929,34.9635,472,64240,0.248391,0.19,1,389862,389390,472
38126681,9.87857,39.7927,433,65700,0.265678,0.19,1,389864,389431,433
38129601,44.3757,9.55854,484,65700,0.285136,0.31,1,389917,389433,484
38132521,16.8751,41.9117,444,65700,0.289027,0.27,1,389927,389483,444
38135441,9.77503,16.3823,442,65700,0.321805,0.29,1,389935,389493,442
38138361,3.55501,8.87647,437,65700,0.328361,0.29,1,389937,389500,437
38141281,3.911,4.97529,437,65700,0.329672,0.31,1,389941,389504,437
38144201,5.5822,7.39506,435,65700,0.329934,0.31,1,389947,389512,435
38147121,6.71644,6.27901,436,65700,0.345987,0.31,1,389954,389518,436
38150041,8.54329,6.8558,438,65700,0.365197,0.35,1,389963,389525,438
38152961,53.7087,52.5712,439,65700,0.401039,0.31,1,390028,389589,439
38155881,25.9417,28.1142,436,65700,0.424208,0.27,1,390047,389611,436
38158801,19.5883,22.4228,433,65700,0.412842,0.11,1,390065,389632,433
38161721,23.1177,28.4846,427,65700,0.458568,0.17,1,390089,389662,427
38164641,26.2235,26.4969,428,65700,0.467714,0.15,1,390116,389688,428
38167561,23.6447,22.0994,430,65700,0.517543,0.15,1,390139,389709,430
38170481,19.9289,19.6199,430,65700,0.543509,0.19,1,390158,389728,430
38173401,17.5858,16.724,431,67160,0.532702,0.21,1,390175,389744,431
38176321,23.5172,22.5448,432,67160,0.61054,0.21,1,390200,389768,432
38179241,6.30343,6.10896,432,67160,0.594108,0.21,1,390202,389770,432
38182161,2.86069,2.82179,432,67160,0.590822,0.25,1,390204,389772,432
38185081,40.5721,38.9644,434,67160,0.590164,0.25,1,390254,389820,434
38188001,42.5144,41.3929,435,67160,0.622033,0.25,1,390297,389862,435
38190921,10.1029,8.27857,437,67160,0.628407,0.27,1,390299,389862,437
38193841,44.4206,3.25571,488,67160,0.581681,0.29,1,390352,389864,488
38196761,18.4841,43.0511,447,67160,0.572336,0.29,1,390364,389917,447
38199681,10.0968,16.6102,445,67160,0.538467,0.33,1,390372,389927,445
38202601,3.61936,9.72205,439,67160,0.531693,0.33,1,390374,389935,439
38205521,3.92387,3.54441,441,67160,0.530339,0.33,1,390378,389937,441
38208441,5.58477,3.90888,443,67160,0.530068,0.33,1,390384,389941,443
38211361,7.51695,5.58178,445,67160,0.530014,0.35,1,390392,389947,445
38214281,10.3034,6.71636,449,67160,0.546003,0.37,1,390403,389954,449
38217201,54.8607,8.54327,506,67160,0.565201,0.41,1,390469,389963,506
38220121,26.1721,53.7087,460,67160,0.58504,0.43,1,390488,390028,460
38223041,19.6344,25.9417,459,67160,0.557008,0.41,1,390506,390047,459
38225961,23.9269,19.5883,466,67160,0.583402,0.47,1,390531,390065,466
38228881,28.7854,23.1177,472,67160,0.60468,0.47,1,390561,390089,472
38231801,25.7571,26.2235,470,67160,0.640936,0.53,1,390586,390116,470
38234721,20.3514,23.6447,466,67160,0.648187,0.55,1,390605,390139,466
38237641,5.67028,19.9289,449,67160,0.649637,0.53,1,390607,390158,449
38240561,15.5341,17.5858,450,67160,0.713927,0.63,1,390625,390175,450
38243481,23.9068,23.5172,451,67160,0.726785,0.59,1,390651,390200,451
38246401,6.38136,6.30343,451,67160,0.729357,0.59,1,390653,390202,451
38249321,2.87627,2.86069,451,67160,0.729871,0.59,1,390655,390204,451
38252241,40.5753,40.5721,451,67160,0.729974,0.63,1,390705,390254,451
38255161,42.5151,42.5144,451,67160,0.713995,0.63,1,390748,390297,451
38258081,10.103,10.1029,451,67160,0.710799,0.57,1,390750,390299,451
38261001,43.6206,44.4206,450,67160,0.72616,0.57,1,390802,390352,450
38263921,16.7241,18.4841,448,67160,0.729232,0.53,1,390812,390364,448
38266841,9.74482,10.0968,448,67160,0.729846,0.53,1,390820,390372,448
38269761,3.54896,3.61936,448,67160,0.729969,0.53,1,390822,390374,448
38272681,3.90979,3.92387,448,67160,0.761994,0.53,2,390826,390378,448
38275601,5.58196,5.58477,448,67160,0.736399,0.53,1,390832,390384,448
38278521,7.51639,7.51695,448,67160,0.73128,0.55,1,390840,390392,448
38281441,11.9033,10.3034,450,67160,0.746256,0.57,1,390853,390403,450
38284361,55.1807,54.8607,450,67160,0.717251,0.59,1,390919,390469,450
38287281,25.4361,26.1721,449,67160,0.72745,0.55,1,390937,390488,449
38290201,19.4872,19.6344,449,67160,0.72949,0.59,1,390955,390506,449
38293121,25.4974,23.9269,451,67160,0.777898,0.61,2,390982,390531,451
38296041,29.8995,28.7854,452,67160,0.80358,0.65,2,391013,390561,452
38298961,28.3799,25.7571,455,67160,0.808716,0.65,2,391041,390586,455
38301881,21.676,20.3514,456,67160,0.777743,0.65,2,391061,390605,456
38304801,5.9352,5.67028,456,67160,0.771549,0.73,2,391063,390607,456
38307721,17.187,15.5341,458,67160,0.80231,0.73,2,391083,390625,458
38310641,24.2374,23.9068,458,67160,0.792462,0.73,2,391109,390651,458
38313561,6.44748,6.38136,458,67160,0.822492,0.73,2,391111,390653,458
38316481,2.8895,2.87627,458,67160,0.828498,0.73,2,391113,390655,458
38319401,40.5779,40.5753,458,67160,0.7977,0.71,2,391163,390705,458
38322321,42.5156,42.5151,458,67160,0.82354,0.71,2,391206,390748,458
38325241,10.1031,10.103,458,67160,0.828708,0.73,2,391208,390750,458
38328161,43.6206,43.6206,458,67160,0.829742,0.73,2,391260,390802,458
38331081,16.7241,16.7241,458,67160,0.797948,0.73,2,391270,390812,458
38334001,9.74482,9.74482,458,67160,0.82359,0.73,2,391278,390820,458
38336921,3.54896,3.54896,458,67160,0.796718,0.77,2,391280,390822,458
38339841,3.90979,3.90979,458,67160,0.791344,0.73,2,391284,390826,458
38342761,5.58196,5.58196,458,67160,0.790269,0.73,2,391290,390832,458
38345681,7.51639,7.51639,458,67160,0.822054,0.75,2,391298,390840,458
38348601,11.1033,11.9033,457,67160,0.796411,0.71,2,391310,390853,457
38351521,55.8207,55.1807,458,67160,0.823282,0.73,2,391377,390919,458
38354441,25.5641,25.4361,458,67160,0.828656,0.73,2,391395,390937,458
38357361,19.5128,19.4872,458,67160,0.829731,0.79,2,391413,390955,458
38360281,27.9026,25.4974,461,67160,0.877946,0.81,2,391443,390982,461
38363201,31.1805,29.8995,462,67160,0.871589,0.81,2,391475,391013,462
38366121,27.0361,28.3799,460,67160,0.870318,0.77,2,391501,391041,460
38369041,21.4072,21.676,460,67160,0.870064,0.77,2,391521,391061,460
38371961,5.88144,5.9352,460,67160,0.902013,0.81,2,391523,391063,460
38374881,17.9763,17.187,461,67160,0.908403,0.79,2,391544,391083,461
38377801,24.3953,24.2374,461,67160,0.877681,0.83,2,391570,391109,461
38380721,6.47905,6.44748,461,67160,0.903536,0.83,2,391572,391111,461
38383641,2.89581,2.8895,461,67160,0.876707,0.79,2,391574,391113,461
38386561,40.5792,40.5779,461,67160,0.903341,0.83,2,391624,391163,461
38389481,42.5158,42.5156,461,67160,0.860668,0.83,2,391667,391206,461
38392401,10.1032,10.1031,461,67160,0.852134,0.83,2,391669,391208,461
38395321,43.6206,43.6206,461,67160,0.914427,0.79,2,391721,391260,461
38398241,16.7241,16.7241,461,67160,0.894885,0.83,2,391731,391270,461
38401161,9.74483,9.74482,461,67160,0.922977,0.79,2,391739,391278,461
38404081,3.54896,3.54896,461,67160,0.896595,0.79,2,391741,391280,461
38407001,3.90979,3.90979,461,67160,0.923319,0.79,2,391745,391284,461
38409921,5.58196,5.58196,461,67160,0.896664,0.83,2,391751,391290,461
38412841,7.51639,7.51639,461,67160,0.891333,0.79,2,391759,391298,461
38415761,11.1033,11.1033,461,67160,0.922267,0.83,2,391771,391310,461
38418681,57.4207,55.8207,463,67160,0.928453,0.83,2,391840,391377,463
38736961,18,58,480,54020,0.07,0.92,1,394102,393622,480
38739881,14,26.8,474,55480,0.406,0.9,1,394115,393641,474
38742801,11.6,17.36,470,56940,0.4572,0.83,1,394126,393656,470
38745721,16.72,14.672,474,58400,0.45144,0.77,1,394144,393670,474
38748641,24.144,22.9344,475,59860,0.418288,0.69,1,394170,393695,475
38751561,23.2288,26.9869,470,61320,0.579658,0.65,1,394193,393723,470
38754481,19.8458,26.9974,462,61320,0.587932,0.47,1,394212,393750,462
38757401,51.1692,38.1995,480,61320,0.685586,0.31,1,394271,393791,480
38760321,28.6338,49.2399,451,62780,0.817117,0.17,2,394294,393843,451
38763241,20.1268,33.848,439,62780,0.907423,0.04,2,394312,393873,439
38774921,15,18,429,64240,0.83,0.01,2,394396,393967,429
38777841,15,14.8,430,64240,0.782,0.03,2,394411,393981,430
38780761,27.8,16.56,444,64240,0.8924,0.07,2,394442,393998,444
38783681,8.76,24.112,422,64240,0.91448,0.11,2,394446,394024,422
38976401,16,9,520,71540,0.87,1,2,395867,395347,520
38977861,16.8,9,528,71540,0.87,1,2,395884,395356,528
39008521,381.76,437.8,456,49640,0.422,0.01,1,396357,395901,456
39069841,221.152,260.36,421,49640,0.3164,0.05,1,396538,396117,421
39072761,68.2304,68.072,431,51100,0.07128,0.01,1,396568,396137,431
39075681,35.2461,36.0144,430,52560,0.014256,0,1,396595,396165,430
39078601,35.0492,34.4029,431,54020,0.122851,0.01,1,396630,396199,431
39081521,35.0098,36.4806,429,54020,0.0325702,0.01,1,396665,396236,429
39084441,53.402,40.0961,446,55480,0.030514,0.05,1,396723,396277,446
39087361,20.2804,21.6192,441,55480,0.0781028,0.18,1,396735,396294,441
39090281,12.8561,14.7238,439,55480,0.0396206,0.17,1,396746,396307,439
39093201,14.5712,11.7448,443,55480,0.0639241,0.15,1,396761,396318,443
39096121,10.9142,14.349,438,55480,0.132785,0.17,1,396771,396333,438
39099041,16.5828,11.6698,445,55480,0.082557,0.31,1,396789,396344,445
39101961,32.1166,12.734,468,55480,0.0405114,0.19,1,396825,396357,468
39104881,20.0233,44.9468,432,55480,0.0641023,0.1,1,396842,396410,432
39107801,21.6047,24.1894,435,55480,0.0208205,0.11,1,396864,396429,435
39110721,30.7209,22.4379,446,55480,0.00416409,0.43,1,396897,396451,446
39113641,18.1442,22.8876,438,55480,0.0888328,0.11,1,396912,396474,438
39116561,29.2288,23.7775,446,55480,0.0737666,0.23,1,396944,396498,446
39119481,23.4458,28.7555,438,55480,0.0387533,0.29,1,396966,396528,438
39122401,23.0892,13.7511,451,55480,0.00775066,0.01,1,396989,396538,451
39125321,6.21783,26.7502,423,55480,0.00155013,0,1,396991,396568,423
39128241,22.0436,26.95,422,55480,0.000310026,0,1,397017,396595,422
39131161,31.6087,5.39001,456,56940,0.024062,0.15,1,397051,396595,456
39134081,46.3217,29.078,471,56940,0.0448124,0.01,1,397101,396630,471
39137001,10.8643,33.8156,438,56940,0.0649625,0.03,1,397103,396665,438
39139921,38.9729,53.1631,426,56940,0.0689925,0.09,1,397149,396723,426
39142841,14.1946,20.2326,422,56940,0.133798,0.03,1,397157,396735,422
39145761,14.8389,12.8465,426,56940,0.16276,0.07,1,397172,396746,426
39148681,17.3678,14.5693,429,56940,0.152552,0.15,1,397190,396761,429
39151601,8.27356,10.9139,425,56940,0.15051,0.07,1,397196,396771,425
39154521,19.2547,16.5828,429,56940,0.118102,0.03,1,397218,396789,429
39157441,27.0509,32.1166,422,56940,0.0956204,0.07,1,397247,396825,422
39160361,19.8102,20.0233,423,56940,0.107124,0.01,1,397265,396842,423
39163281,21.562,21.6047,423,56940,0.0774248,0,1,397287,396864,423
39166201,30.7124,30.7209,423,56940,0.039485,0.11,1,397320,396897,423
39169121,20.5425,18.1442,426,58400,0.063897,0.07,1,397338,396912,426
39172041,30.5085,29.2288,427,58400,0.100779,0.03,1,397371,396944,427
39174961,20.5017,23.4458,423,58400,0.0761559,0,1,397389,396966,423
39177881,23.3003,23.0892,424,58400,0.0152312,0,1,397413,396989,424
39180801,6.26007,6.21783,424,58400,0.00304623,0,1,397415,396991,424
39183721,21.252,22.0436,423,58400,0.000609247,0,1,397440,397017,423
39186641,30.6504,4.40871,456,58400,0.0401218,0.03,1,397473,397017,456
39189561,47.7301,28.0817,474,58400,0.0480244,0.05,1,397525,397051,474
39192481,11.146,45.6163,426,58400,0.0496049,0.07,1,397527,397101,426
39195401,42.2292,10.7233,474,58400,0.049921,0.07,1,397577,397103,474
39198321,14.8458,38.9447,436,58400,0.0179842,0.15,1,397585,397149,436
39201241,12.5692,14.1889,440,58400,0.0275968,0.17,1,397597,397157,440
39204161,17.7138,14.8378,444,58400,0.0775194,0.15,1,397616,397172,444
39207081,8.34277,17.3676,432,58400,0.0875039,0.15,1,397622,397190,432
39210001,19.2686,8.27351,448,58400,0.0895008,0.11,1,397644,397196,448
39212921,25.4537,19.2547,453,58400,0.1219,0.09,1,397671,397218,453
39215841,20.2907,27.0509,443,58400,0.16038,0.11,1,397690,397247,443
39218761,18.4581,19.8102,443,58400,0.136076,0.07,1,397708,397265,443
39221681,30.0916,21.562,454,58400,0.0512152,0.03,1,397741,397287,454
39224601,7.61833,30.7124,423,58400,0.034243,0.07,1,397743,397320,423
39227521,17.5237,20.5425,425,59860,0.0788486,0.11,1,397763,397338,425
39230441,29.9047,30.5085,425,59860,0.10377,0.07,1,397796,397371,425
39233361,19.5809,20.5017,424,59860,0.0927539,0,1,397813,397389,424
39236281,21.5162,23.3003,422,59860,0.0425508,0,1,397835,397413,422
39239201,5.90324,6.26007,422,59860,0.00851016,0,1,397837,397415,422
39242121,21.1806,21.252,422,59860,0.00170203,0.05,1,397862,397440,422
39245041,32.2361,30.6504,424,59860,0.0243404,0.05,1,397897,397473,424
39247961,48.0472,47.7301,424,59860,0.0928681,0.05,1,397949,397525,424
39250881,11.2094,11.146,424,59860,0.122574,0.05,1,397951,397527,424
39253801,41.4419,42.2292,423,59860,0.128515,0.01,1,398000,397577,423
39256721,14.6884,14.8458,423,59860,0.097703,0.03,1,398008,397585,423
39259641,13.3377,12.5692,424,59860,0.107541,0.09,1,398021,397597,424
39262561,19.4675,17.7138,426,59860,0.0935081,0.09,1,398042,397616,426
39265481,8.69351,8.34277,426,59860,0.0907016,0.09,1,398048,397622,426
39268401,19.3387,19.2686,426,59860,0.0901403,0.13,1,398070,397644,426
39271321,27.0677,25.4537,428,59860,0.154028,0.17,1,398099,397671,428
39274241,20.6135,20.2907,428,59860,0.118806,0.13,1,398118,397690,428
39277161,15.3227,18.4581,424,59860,0.111761,0.03,1,398132,397708,424
39280081,28.6645,30.0916,423,59860,0.110352,0.03,1,398164,397741,423
39283001,7.33291,7.61833,423,59860,0.14207,0.03,1,398166,397743,423
39285921,17.4666,1.52367,443,59860,0.148414,0.09,1,398186,397743,443
39288841,30.6933,16.3047,457,59860,0.149683,0.11,1,398220,397763,457
39291761,19.7387,29.6609,441,59860,0.133937,0.09,1,398237,397796,441
39294681,19.1477,19.5322,443,59860,0.130787,0.03,1,398256,397813,443
39297601,5.42955,21.5064,423,59860,0.130157,0,1,398258,397835,423
39300521,21.0859,5.90129,446,59860,0.0820315,0,1,398283,397837,446
39303441,33.0172,21.1803,457,59860,0.0564063,0.03,1,398319,397862,457
39306361,50.6034,32.2361,477,59860,0.0192813,0.11,1,398374,397897,477
39309281,11.7207,48.0472,427,59860,0.0118563,0.13,1,398376,397949,427
39312201,41.5441,11.2094,474,59860,0.0423713,0.13,1,398425,397951,474
39315121,14.7088,41.4419,433,59860,0.0484742,0.09,1,398433,398000,433
39318041,12.5418,14.6884,437,59860,0.0496948,0.11,1,398445,398008,437
39320961,20.1084,13.3377,446,59860,0.065939,0.09,1,398467,398021,446
39323881,8.82167,19.4675,431,59860,0.0691878,0.09,1,398473,398042,431
39326801,19.3643,8.69351,447,59860,0.0698376,0.09,1,398495,398048,447
39329721,28.6729,19.3387,456,59860,0.0859675,0.17,1,398526,398070,456
39332641,20.1346,27.0677,445,59860,0.0891935,0.11,1,398544,398099,445
39335561,15.2269,20.6135,440,59860,0.0898387,0.11,1,398558,398118,440
39338481,30.2454,15.3227,460,59860,0.0899678,0.11,1,398592,398132,460
39341401,7.64908,28.6645,430,59860,0.0899936,0.15,1,398594,398164,430
39344321,17.5298,7.33291,448,59860,0.153999,0.15,1,398614,398166,448
39347241,30.706,17.4666,462,59860,0.1668,0.15,1,398648,398186,462
39350161,19.7412,30.6933,445,59860,0.18536,0.13,1,398665,398220,445
39353081,18.3482,19.7387,446,59860,0.189072,0.13,1,398683,398237,446
39356001,5.26965,19.1477,429,59860,0.189814,0.13,1,398685,398256,429
39358921,17.0539,5.42955,447,59860,0.189963,0.07,1,398705,398258,447
39361841,33.0108,21.0859,459,59860,0.141993,0.05,1,398742,398283,459
39364761,49.8022,33.0172,477,59860,0.132399,0.01,1,398796,398319,477
39367681,11.5604,50.6034,424,59860,0.13048,0.01,1,398798,398374,424
39370601,42.3121,11.7207,472,59860,0.0980959,0.05,1,398848,398376,472
39373521,14.8624,41.5441,431,59860,0.0916192,0.05,1,398856,398425,431
39376441,12.5725,14.7088,435,59860,0.0903238,0.05,1,398868,398433,435
39379361,20.9145,12.5418,446,59860,0.106065,0.07,1,398891,398445,446
39382281,8.9829,20.1084,430,59860,0.109213,0.07,1,398897,398467,430
39385201,19.3966,8.82167,446,59860,0.109843,0.07,1,398919,398473,446
39388121,29.4793,19.3643,456,59860,0.109969,0.09,1,398951,398495,456
39391041,20.2959,28.6729,443,59860,0.109994,0.09,1,398969,398526,443
