#Ack,ack_ewma(ms),send_ewma(ms),rtt_ratio,cwnd (Bytes),Last Router Ocupation Ack Arriaval(Packets),Last Router Ocupation Packet Sent(Packets),Network Situation,AckArrival(ms),TSInsideAck(ms),RTTAck(ms)
4381,4,0,434,16060,0,0.02,1,60859,60425,434
7301,4,0,438,17520,0.144,0.02,1,60863,60425,438
10221,2.4,0,440,18980,0.1408,0.02,1,60865,60425,440
13141,2.08,0,442,20440,0.16416,0.02,1,60867,60425,442
14601,161.216,0,643,21900,0.032832,0.08,1,61068,60425,643
17521,204.243,344,428,23360,0.0865664,0,1,61283,60855,428
20441,44.0486,72,428,24820,0.0733133,0,1,61287,60859,428
23361,10.4097,14.4,430,26280,0.0306627,0.18,1,61289,60859,430
26281,3.68195,6.08,428,27740,0.00613253,0.14,1,61291,60863,428
29201,3.93639,2.816,430,29200,0.113227,0.14,1,61295,60865,430
32121,5.58728,0.5632,436,30660,0.126645,0.17,1,61301,60865,436
35041,2.71746,1.71264,436,32120,0.145329,0,1,61303,60867,436
37961,156.543,161.143,430,33580,0.0290658,0.1,1,61498,61068,430
40881,200.909,204.229,427,35040,0.109813,0.1,1,61710,61283,427
43801,41.7817,40.8457,429,36500,0.0859626,0.07,1,61712,61283,429
46721,9.95635,11.3691,427,37960,0.0491925,0.02,1,61714,61287,427
49641,3.59127,3.87383,427,39420,0.0818385,0.02,1,61716,61289,427
52561,2.31825,0.774766,429,40880,0.0643677,0,1,61718,61289,429
55481,2.06365,1.75495,429,42340,0.0288735,0.14,1,61720,61291,429
58401,5.21273,3.55099,431,43800,0.197775,0.14,1,61726,61295,431
61321,2.64255,0.710198,433,45260,0.247555,0.13,1,61728,61295,433
64241,2.12851,4.94204,429,46720,0.273511,0.15,1,61730,61301,429
67161,7.6257,2.58841,436,48180,0.286702,0.15,1,61739,61303,436
70081,151.925,0.517682,624,49640,0.0573404,0,1,61927,61303,624
73001,31.985,156.104,431,51100,0.0114681,0.13,1,61929,61498,431
75921,169.597,200.821,423,52560,0.106294,0.13,1,62133,61710,423
78841,35.5194,40.1641,425,54020,0.0852587,0.08,1,62135,61710,425
81761,8.70388,9.63283,425,55480,0.0490517,0.04,1,62137,61712,425
84681,9.74078,3.52657,433,56940,0.25781,0.04,1,62147,61714,433
87601,3.54816,0.705313,435,58400,0.315562,0.09,1,62149,61714,435
90521,2.30963,1.74106,435,59860,0.295112,0.06,1,62151,61716,435
93441,2.06193,1.94821,435,61320,0.267022,0.06,1,62153,61718,435
96361,2.01239,0.389642,437,62780,0.229405,0.02,1,62155,61718,437
99281,2.00248,1.67793,437,64240,0.189881,0.24,1,62157,61720,437
102201,2.0005,5.13559,433,65700,0.197976,0.24,1,62159,61726,433
105121,2.0001,1.02712,435,67160,0.223595,0.26,1,62161,61726,435
108041,2.00002,1.80542,435,68620,0.244719,0.28,1,62163,61728,435
110961,2,1.96108,435,70080,0.384944,0.28,1,62165,61730,435
113881,6,0.392217,442,71540,0.492989,0.29,1,62172,61730,442
116801,2.8,7.27844,435,73000,0.530598,0,1,62174,61739,435
119721,147.76,151.856,431,74460,0.10612,0,1,62358,61927,431
122641,31.152,30.3711,433,75920,0.0212239,0,1,62360,61927,433
125561,7.8304,7.67423,433,77380,0.00424478,0.13,1,62362,61929,433
128481,162.366,164.735,430,78840,0.000848956,0.13,1,62563,62133,430
131401,38.8732,32.947,438,80300,0.11217,0.08,1,62571,62133,438
134321,9.37464,8.18939,438,81760,0.102434,0.04,1,62573,62135,438
137241,3.47493,3.23788,438,83220,0.116487,0.04,1,62575,62137,438
140161,2.29499,0.647576,440,84680,0.207297,0.31,1,62577,62137,440
143081,2.059,8.12952,432,86140,0.201459,0.33,1,62579,62147,432
146001,2.0118,3.2259,432,87600,0.240292,0.33,1,62581,62149,432
148921,2.00236,0.645181,434,89060,0.264058,0.29,1,62583,62149,434
151841,2.00047,1.72904,434,90520,0.284812,0.26,1,62585,62151,434
154761,3.60009,1.94581,436,91980,0.312962,0.26,1,62589,62153,436
157681,6.32002,0.389161,443,93440,0.390592,0.22,1,62596,62153,443
160601,2.864,1.67783,443,94900,0.374119,0.18,1,62598,62155,443
163521,2.1728,1.93557,443,96360,0.386824,0.18,1,62600,62157,443
166441,2.03456,0.387113,445,97820,0.357365,0.2,1,62602,62157,445
169361,2.00691,1.67742,445,99280,0.319473,0.23,1,62604,62159,445
172281,2.00138,1.93548,445,100740,0.279895,0.23,1,62606,62161,445
175201,2.00028,0.387097,447,102200,0.287979,0.25,1,62608,62161,447
178121,2.00006,1.67742,447,103660,0.305596,0.42,1,62610,62163,447
181041,2.00001,1.93548,447,105120,0.445119,0.42,1,62612,62165,447
183961,2,0.387097,449,106580,0.489024,0.52,1,62614,62165,449
186881,2,5.67742,444,108040,0.513805,0.54,1,62616,62172,444
189801,2,2.73548,444,109500,0.534761,0.54,1,62618,62174,444
192721,136.4,0.547097,614,110960,0.106952,0,1,62788,62174,614
195641,28.88,147.309,432,112420,0.0213904,0,1,62790,62358,432
198561,7.376,31.0619,432,113880,0.00427809,0,1,62792,62360,432
201481,3.0752,6.21238,434,115340,0.000855617,0,1,62794,62360,434
204401,2.21504,2.84248,434,116800,0.000171123,0,1,62796,62362,434
207321,155.643,161.368,427,118260,0.0960342,0,1,62990,62563,427
210241,41.5286,32.2737,440,119720,0.0592068,0.14,1,63003,62563,440
213161,9.90572,12.8547,434,121180,0.0198414,0.1,1,63005,62571,434
216081,3.58114,4.17095,434,122640,0.115968,0.1,1,63007,62573,434
219001,2.31623,0.834189,436,124100,0.103194,0.12,1,63009,62573,436
221921,2.06325,1.76684,436,125560,0.0686387,0.23,1,63011,62575,436
224841,2.01265,1.95337,436,127020,0.0297277,0.23,1,63013,62577,436
227761,2.00253,0.390673,438,128480,0.0459455,0.2,1,63015,62577,438
230681,2.00051,1.67813,438,129940,0.201189,0.25,1,63017,62579,438
233601,2.0001,1.93563,438,131400,0.240238,0.25,1,63019,62581,438
236521,2.00002,0.387125,440,132860,0.280048,0.27,1,63021,62581,440
239441,2,1.67743,440,134320,0.30401,0.29,1,63023,62583,440
242361,2,1.93549,440,135780,0.284802,0.29,1,63025,62585,440
245281,2,0.387097,442,137240,0.24896,0.32,1,63027,62585,442
248201,2,3.27742,440,138700,0.329792,0.41,1,63029,62589,440
251121,2,6.25548,435,140160,0.321958,0.41,1,63031,62596,435
254041,2,1.2511,437,141620,0.280392,0.37,1,63033,62596,437
256961,2,1.85022,437,143080,0.240078,0.39,1,63035,62598,437
259881,2,1.97004,437,144540,0.200016,0.39,1,63037,62600,437
262801,7.6,0.394009,446,146000,0.288003,0.35,1,63046,62600,446
265721,3.12,1.6788,446,147460,0.281601,0.31,1,63048,62602,446
268641,2.224,1.93576,446,148920,0.24832,0.31,1,63050,62604,446
271561,2.0448,0.387152,448,150380,0.209664,0.27,1,63052,62604,448
274481,2.00896,1.67743,448,151840,0.257933,0.29,1,63054,62606,448
277401,2.00179,1.93549,448,153300,0.235587,0.29,1,63056,62608,448
280321,2.00036,0.387097,450,154760,0.319117,0.31,1,63058,62608,450
283241,2.00007,1.67742,450,156220,0.303823,0.48,1,63060,62610,450
286161,2.00001,1.93548,450,157680,0.260765,0.48,1,63062,62612,450
289081,2,0.387097,452,159140,0.220153,0.5,1,63064,62612,452
292001,2,1.67742,452,160600,0.180031,0.52,1,63066,62614,452
294921,2,1.93548,452,162060,0.300006,0.52,1,63068,62616,452
297841,2,0.387097,454,163520,0.292001,0.54,1,63070,62616,454
300761,2,1.67742,454,164980,0.3624,0,1,63072,62618,454
303681,110.8,136.335,422,166440,0.07248,0,1,63210,62788,422
306601,23.76,27.2671,424,167900,0.014496,0,1,63212,62788,424
309521,6.352,7.05342,424,169360,0.0028992,0,1,63214,62790,424
312441,2.8704,3.01068,424,170820,0.00057984,0,1,63216,62792,424
315361,2.97408,0.602137,427,172280,0.000115968,0,1,63219,62792,427
318281,3.79482,1.72043,429,173740,2.31936e-05,0,1,63223,62794,429
320321,7.15896,1.94409,435,175200,0.0800046,0.09,1,63231,62796,435
323241,147.032,5.98882,610,176660,0.0160009,0.12,1,63413,62803,610
326161,31.0064,150.798,425,178120,0.0672002,0.05,1,63415,62990,425
329081,15.0013,40.5596,423,179580,0.18144,0.05,1,63426,63003,423
332001,4.60025,8.11191,425,181040,0.172288,0.01,1,63428,63003,425
334921,2.52005,3.22238,425,182500,0.138458,0.14,1,63430,63005,425
337841,9.30401,2.24448,434,183960,0.147692,0.14,1,63441,63007,434
339461,2.6608,0.448895,435,185420,0.229538,0.08,1,63442,63007,435
342381,2.13216,2.48978,434,186880,0.213908,0.08,1,63444,63010,434
345301,2.02643,0.497956,436,188340,0.178782,0.06,1,63446,63010,436
348221,2.00529,0.899591,437,189800,0.139756,0.02,1,63448,63011,437
350901,2.00106,1.77992,437,191260,0.107951,0.27,1,63450,63013,437
353821,2.00021,4.35598,434,192720,0.18959,0.27,1,63452,63018,434
356741,2.00004,0.871197,436,194180,0.173918,0.27,1,63454,63018,436
359661,2.00001,0.174239,438,195640,0.146784,0.27,1,63456,63018,438
362341,2,0.0348479,440,197100,0.109357,0.27,1,63458,63018,440
365261,2,12.007,427,198560,0.189871,0.27,1,63460,63033,427
368181,2,2.40139,429,200020,0.173974,0.27,1,63462,63033,429
371101,2,0.480279,431,201480,0.146795,0.27,1,63464,63033,431
374021,2,0.0960557,433,202940,0.109359,0.27,1,63466,63033,433
376941,2,0.0192111,435,204400,0.189872,0.27,1,63468,63033,435
379861,2,0.00384223,437,205860,0.173974,0.27,1,63470,63033,437
381681,1.2,0.000768446,438,207320,0.146795,0.37,1,63471,63033,438
384601,1.84,8.00015,430,208780,0.109359,0.37,1,63473,63043,430
387521,1.968,1.60003,432,210240,0.0698718,0.37,1,63475,63043,432
390001,1.9936,0.320006,434,211700,0.0299744,0.23,1,63477,63043,434
392921,7.59872,10.464,430,213160,0.0699949,0.23,1,63486,63056,430
395841,3.11974,2.0928,432,214620,0.045999,0.23,1,63488,63056,432
398761,2.22395,0.41856,434,216080,0.1932,0.23,1,63490,63056,434
401681,2.04479,0.083712,436,217540,0.19864,0.23,1,63492,63056,436
404561,2.00896,0.0167424,438,219000,0.167728,0.28,1,63494,63056,438
407481,2.00179,4.00335,435,220460,0.129546,0.28,1,63496,63061,435
410401,2.00036,0.80067,437,221920,0.0899091,0.28,1,63498,63061,437
413321,2.00007,0.160134,439,223380,0.169982,0.28,1,63500,63061,439
415381,2.00001,0.0320268,441,224840,0.153996,0.38,1,63502,63061,441
418301,2,8.80641,432,226300,0.126799,0.38,1,63504,63072,432
421221,2,1.76128,434,227760,0.24936,0.38,1,63506,63072,434
424141,2,0.352256,436,229220,0.241872,0.38,1,63508,63072,436
427061,2,0.0704512,438,230680,0.200374,0.38,1,63510,63072,438
429941,2.8,0.0140902,441,232140,0.144075,0.34,1,63513,63072,441
431601,2.16,8.80282,432,233600,0.100815,0,1,63515,63083,432
434521,100.432,109.761,422,235060,0.068163,0,1,63640,63218,422
437441,21.6864,21.9521,424,236520,0.0536326,0,1,63642,63218,424
440361,5.93728,4.39042,426,237980,0.0267265,0,1,63644,63218,426
443041,2.78746,0.878084,428,239440,0.0053453,0,1,63646,63218,428
445961,5.35749,7.37562,425,240900,0.00106906,0,1,63652,63227,425
448881,2.6715,1.47512,427,242360,0.000213812,0,1,63654,63227,427
450741,4.5343,0.295025,432,243820,0.0960428,0.02,1,63659,63227,432
452821,150.507,6.45901,611,245280,0.115209,0.08,1,63846,63235,611
454901,33.3014,145.292,435,246740,0.0550417,0.21,1,63850,63415,435
456561,7.46027,37.8584,425,248200,0.0270083,0.14,1,63851,63426,425
459481,8.69205,11.5717,429,249660,0.0374017,0.14,1,63860,63431,429
462401,3.33841,2.31433,431,251120,0.00748033,0.14,1,63862,63431,431
465321,2.26768,0.462867,433,252580,0.0654961,0.14,1,63864,63431,433
467381,8.45354,0.0925734,443,254040,0.0530992,0.13,1,63874,63431,443
470301,3.29071,13.6185,428,255500,0.0106198,0.13,1,63876,63448,428
473221,2.25814,2.7237,430,256960,0.066124,0.13,1,63878,63448,430
476141,2.05163,0.544741,432,258420,0.0452248,0.13,1,63880,63448,432
477781,1.21033,0.108948,433,259880,0.025045,0.14,1,63881,63448,433
480701,1.84207,6.42179,427,261340,0.00500899,0.14,1,63883,63456,427
483621,1.96841,1.28436,429,262800,0.0010018,0.14,1,63885,63456,429
486541,1.99368,0.256872,431,264260,0.1202,0.14,1,63887,63456,431
489221,1.99874,0.0513743,433,265720,0.12004,0.21,1,63889,63456,433
492141,1.99975,9.61028,423,267180,0.088008,0.21,1,63891,63468,423
495061,1.99995,1.92205,425,268640,0.0496016,0.21,1,63893,63468,425
497981,1.99999,0.384411,427,270100,0.16192,0.21,1,63895,63468,427
500901,2,0.0768822,429,271560,0.160384,0.21,1,63897,63468,429
503821,2,0.0153764,431,273020,0.128077,0.21,1,63899,63468,431
505861,2,0.00307529,433,274480,0.145615,0.23,1,63901,63468,433
508781,2,8.00062,425,275940,0.117123,0.23,1,63903,63478,425
511701,2,1.60012,427,277400,0.175425,0.23,1,63905,63478,427
514621,2,0.320025,429,278860,0.155085,0.23,1,63907,63478,429
517541,2,0.0640049,431,280320,0.183017,0.23,1,63909,63478,431
520461,2,0.012801,433,281780,0.156603,0.23,1,63911,63478,433
522501,7.6,0.0025602,442,283240,0.175321,0.16,1,63920,63478,442
525421,3.12,12.8005,428,284700,0.147064,0.16,1,63922,63494,428
528341,2.224,2.5601,430,286160,0.109413,0.16,1,63924,63494,430
531261,2.0448,0.51202,432,287620,0.0698826,0.16,1,63926,63494,432
533941,2.00896,0.102404,434,289080,0.0299765,0.14,1,63928,63494,434
535601,1.20179,0.820481,434,290540,0.0059953,0.3,1,63929,63495,434
538521,1.84036,8.1641,426,292000,0.00119906,0.3,1,63931,63505,426
541441,1.96807,1.63282,428,293460,0.0962398,0.3,1,63933,63505,428
544361,1.99361,0.326564,430,294920,0.203248,0.3,1,63935,63505,430
547281,1.99872,0.0653128,432,296380,0.19265,0.3,1,63937,63505,432
549121,1.19974,0.0130626,433,297840,0.17453,0.24,1,63938,63505,433
552041,1.83995,2.40261,432,299300,0.218906,0.24,1,63940,63508,432
553701,4.36799,0.480522,437,300760,0.219781,0.17,1,63945,63508,437
556621,3.2736,12.0961,425,302220,0.179956,0.17,1,63948,63523,425
559541,2.25472,2.41922,427,303680,0.139991,0.17,1,63950,63523,427
562461,2.05094,0.483844,429,305140,0.0999983,0.17,1,63952,63523,429
564101,93.2102,0.0967688,545,306600,0.212,0,1,64068,63523,545
567021,20.242,99.2194,423,308060,0.2024,0,1,64070,63647,423
569941,5.64841,19.8439,425,309520,0.16848,0,1,64072,63647,425
572861,2.72968,3.96877,427,310980,0.129696,0,1,64074,63647,427
575541,8.54594,0.793755,437,312440,0.0259392,0.12,1,64084,63647,437
578461,3.30919,9.75875,427,313900,0.00518784,0.12,1,64086,63659,427
580741,7.86184,1.95175,436,315360,0.0650376,0.15,1,64095,63659,436
582821,144.772,8.39035,605,316820,0.141008,0.08,1,64274,63669,605
585741,30.5545,148.878,423,318280,0.132202,0.08,1,64276,63853,423
587601,6.91089,29.7756,424,319740,0.11444,0.04,1,64277,63853,424
590521,10.1822,16.3551,422,321200,0.142888,0.04,1,64288,63866,422
593441,3.63644,3.27102,424,322660,0.116578,0.04,1,64290,63866,424
595921,2.32729,0.654205,426,324120,0.0873155,0.02,1,64292,63866,426
598001,4.46546,7.33084,422,325580,0.0174631,0,1,64297,63875,422
600921,8.89309,8.66617,423,327040,0.171493,0,1,64307,63884,423
603841,3.37862,1.73323,425,328500,0.170299,0,1,64309,63884,425
606761,2.27572,0.346647,427,329960,0.13806,0,1,64311,63884,427
609681,2.05514,0.0693293,429,331420,0.107612,0,1,64313,63884,429
611521,1.21103,0.0138659,430,332880,0.0855224,0.12,1,64314,63884,430
614441,1.84221,4.00277,427,334340,0.0491045,0.12,1,64316,63889,427
616721,1.96844,0.800555,429,335800,0.129821,0.21,1,64318,63889,429
619641,1.99369,4.16011,426,337260,0.161964,0.21,1,64320,63894,426
622561,1.99874,0.832022,428,338720,0.136393,0.21,1,64322,63894,428
625481,1.99975,0.166404,430,340180,0.0992786,0.21,1,64324,63894,430
627541,1.99995,0.0332809,432,341640,0.0598557,0.14,1,64326,63894,432
630461,1.99999,3.20666,430,343100,0.0279711,0.14,1,64328,63898,430
632741,2,0.641331,432,344560,0.00559423,0.19,1,64330,63898,432
635661,2,8.92827,423,346020,0.00111885,0.19,1,64332,63909,423
638581,2,1.78565,425,347480,0.176224,0.19,1,64334,63909,425
641501,2,0.357131,427,348940,0.179245,0.19,1,64336,63909,427
644421,2,0.0714261,429,350400,0.147849,0.19,1,64338,63909,429
646261,9.2,0.0142852,440,351860,0.15757,0.1,1,64349,63909,440
649181,3.44,12.0029,427,353320,0.127514,0.1,1,64351,63924,427
652101,2.288,2.40057,429,354780,0.0895028,0.1,1,64353,63924,429
655021,2.0576,0.480114,431,356240,0.0499006,0.1,1,64355,63924,431
657701,2.01152,0.0960228,433,357700,0.0979801,0,1,64357,63924,433
660621,2.0023,4.0192,430,359160,0.083596,0,1,64359,63929,430
663541,2.00046,0.803841,432,360620,0.168719,0,1,64361,63929,432
666021,2.00009,0.160768,434,362080,0.153744,0.25,1,64363,63929,434
668941,2.00002,4.03215,431,363540,0.126749,0.25,1,64365,63934,431
671841,2,0.806431,433,365000,0.0893498,0.19,1,64367,63934,433
674761,2,10.5613,422,366460,0.16987,0.19,1,64369,63947,422
677681,2,2.11226,424,367920,0.145974,0.19,1,64371,63947,424
680601,2,0.422451,426,369380,0.109195,0.19,1,64373,63947,426
683521,2,0.0844903,428,370840,0.069839,0.19,1,64375,63947,428
685781,4.4,0.0168981,433,372300,0.189968,0.17,1,64380,63947,433
688701,4.88,8.00338,428,373760,0.157994,0.17,1,64385,63957,428
691621,3.376,1.60068,431,375220,0.103599,0.17,1,64388,63957,431
694101,91.8752,0.320135,545,376680,0.0687197,0.02,1,64502,63957,545
697021,19.975,99.264,423,378140,0.0297439,0.02,1,64504,64081,423
699941,5.59501,19.8528,425,379600,0.0379488,0.02,1,64506,64081,425
702861,2.719,3.97056,427,381060,0.00758976,0.02,1,64508,64081,427
704501,1.3438,0.794112,428,382520,0.00151795,0,1,64509,64081,428
707421,1.86876,4.95882,424,383980,0.00030359,0,1,64511,64087,424
709281,1.17375,0.991764,425,385440,6.07181e-05,0.19,1,64512,64087,425
711361,13.0348,9.79835,429,386900,0.0480121,0.15,1,64528,64099,429
714281,148.207,153.16,422,388360,0.0976024,0.15,1,64710,64288,422
717201,31.2414,30.6319,424,389820,0.0835205,0.15,1,64712,64288,424
720101,15.0483,6.12639,435,391280,0.160704,0,1,64723,64288,435
723021,4.60966,7.62528,429,392740,0.144141,0,1,64725,64296,429
725941,2.52193,1.52506,431,394200,0.204828,0,1,64727,64296,431
728421,8.50439,0.305011,441,395660,0.144966,0.17,1,64737,64296,441
731121,3.30088,10.461,430,397120,0.180993,0.13,1,64739,64309,430
734041,4.66018,12.4922,422,398580,0.108199,0.13,1,64744,64322,422
736961,2.53204,2.49844,424,400040,0.15764,0.13,1,64746,64322,424
739881,2.10641,0.499688,426,401500,0.135528,0.13,1,64748,64322,426
742801,2.02128,0.0999376,428,402960,0.147106,0.13,1,64750,64322,428
745721,2.00426,0.0199875,430,404420,0.117421,0.13,1,64752,64322,430
748641,2.00085,0.0039975,432,405880,0.0794842,0.13,1,64754,64322,432
751301,2.00017,0.000799501,434,407340,0.159897,0.24,1,64756,64322,434
754221,2.00003,8.80016,425,408800,0.143979,0.24,1,64758,64333,425
757141,2.00001,1.76003,427,410260,0.116796,0.24,1,64760,64333,427
760061,2,0.352006,429,411720,0.0713592,0.24,1,64762,64333,429
762981,2,0.0704013,431,413180,0.0302718,0.24,1,64764,64333,431
765901,2,0.0140803,433,414640,0.00605437,0.24,1,64766,64333,433
767941,2,0.00281605,435,416100,0.161211,0.23,1,64768,64333,435
770861,2,9.60056,425,417560,0.160242,0.23,1,64770,64345,425
773781,2,1.92011,427,419020,0.128048,0.23,1,64772,64345,427
776261,7.6,0.384022,436,420480,0.13761,0.11,1,64781,64345,436
779181,3.12,9.6768,426,421940,0.195522,0.11,1,64783,64357,426
782101,2.224,1.93536,428,423400,0.175104,0.11,1,64785,64357,428
785021,2.0448,0.387072,430,424860,0.139021,0.11,1,64787,64357,430
786661,2.00896,0.0774144,432,426320,0.107804,0.21,1,64789,64357,432
789581,2.00179,8.81548,423,427780,0.157561,0.21,1,64791,64368,423
792501,2.00036,1.7631,425,429240,0.135512,0.21,1,64793,64368,425
795421,2.00007,0.352619,427,430700,0.163102,0.21,1,64795,64368,427
798341,2.00001,0.0705239,429,432160,0.13662,0.21,1,64797,64368,429
801261,2,0.0141048,431,433620,0.123324,0.21,1,64799,64368,431
802881,1.2,0.00282095,432,435080,0.104665,0.17,1,64800,64368,432
804961,1.84,1.60056,432,436540,0.076933,0.24,1,64802,64370,432
807881,1.968,6.72011,426,438000,0.0393866,0.24,1,64804,64378,426
810801,1.9936,1.34402,428,439460,0.191877,0.24,1,64806,64378,428
813721,1.99872,0.268804,430,440920,0.198375,0.24,1,64808,64378,430
815781,6.79974,0.0537609,438,442380,0.0716751,0.13,1,64816,64378,438
818701,2.95995,11.2108,426,443840,0.014335,0.13,1,64818,64392,426
821621,2.19199,2.24215,428,445300,0.178867,0.13,1,64820,64392,428
824101,88.4384,0.44843,538,446760,0.251773,0,1,64930,64392,538
827021,19.2877,93.6897,423,448220,0.226355,0,1,64932,64509,423
829941,5.45754,18.7379,425,449680,0.189271,0,1,64934,64509,425
832861,2.69151,3.74759,427,451140,0.149854,0,1,64936,64509,427
834501,1.3383,0.749517,428,452600,0.125971,0,1,64937,64509,428
837421,1.86766,4.1499,425,454060,0.0891942,0,1,64939,64514,425
840321,1.97353,0.829981,427,455520,0.0498388,0.14,1,64941,64514,427
842401,14.7947,18.566,422,456980,0.145968,0,1,64959,64537,422
845321,152.559,146.913,430,458440,0.0691936,0,1,65146,64716,430
847601,32.1118,29.3826,432,459900,0.0298387,0.22,1,65148,64716,432
850521,12.8224,14.6765,429,461360,0.0859677,0.22,1,65156,64727,429
853441,4.16447,2.93531,431,462820,0.0651935,0.22,1,65158,64727,431
855301,6.43289,0.587061,438,464280,0.0770387,0.2,1,65165,64727,438
858221,2.88658,8.91741,429,465740,0.103408,0.2,1,65167,64738,429
860501,2.17732,1.78348,431,467200,0.0766815,0.09,1,65169,64738,431
862161,1.23546,5.1567,426,468660,0.0633363,0.18,1,65170,64744,426
865081,6.64709,10.6313,422,470120,0.132667,0.18,1,65178,64756,422
868001,2.92942,2.12627,424,471580,0.122533,0.18,1,65180,64756,424
870921,2.18588,0.425254,426,473040,0.0885067,0.18,1,65182,64756,426
873841,2.03718,0.0850507,428,474500,0.0497013,0.18,1,65184,64756,428
876761,2.00744,0.0170101,430,475960,0.11394,0.18,1,65186,64756,430
878801,2.00149,0.00340203,432,477420,0.174788,0,1,65188,64756,432
881721,2.0003,7.20068,425,478880,0.154958,0,1,65190,64765,425
884641,2.00006,1.44014,427,480340,0.118992,0,1,65192,64765,427
887561,2.00001,0.288027,429,481800,0.0877983,0,1,65194,64765,429
890481,2,0.0576054,431,483260,0.16956,0,1,65196,64765,431
893361,2,0.0115211,433,484720,0.153912,0.14,1,65198,64765,433
896281,2,4.8023,429,486180,0.126782,0.14,1,65200,64771,429
899201,2,0.960461,431,487640,0.0893565,0.14,1,65202,64771,431
901681,2,0.192092,433,489100,0.121871,0.21,1,65204,64771,433
904601,6.8,9.63842,429,490560,0.168374,0.21,1,65212,64783,429
906881,2.96,1.92768,431,492020,0.145675,0.17,1,65214,64783,431
909801,3.792,9.98554,423,493480,0.077135,0.17,1,65218,64795,423
912721,2.3584,1.99711,425,494940,0.103427,0.17,1,65220,64795,425
915641,2.07168,0.399421,427,496400,0.0846854,0.17,1,65222,64795,427
918561,2.01434,0.0798843,429,497860,0.136937,0.17,1,65224,64795,429
921481,2.00287,0.0159769,431,499320,0.107387,0.17,1,65226,64795,431
923521,2.00057,0.00319537,433,500780,0.0694775,0.2,1,65228,64795,433
926441,2.00011,10.4006,422,502240,0.0858955,0.2,1,65230,64808,422
929361,2.00002,2.08013,424,503700,0.0651791,0.2,1,65232,64808,424
932281,2,0.416026,426,505160,0.0290358,0.2,1,65234,64808,426
935201,2,0.0832051,428,506620,0.0218072,0.2,1,65236,64808,428
938121,2,0.016641,430,508080,0.00436143,0.2,1,65238,64808,430
941041,2,0.0033282,432,509540,0.176872,0.2,1,65240,64808,432
942661,1.2,0.000665641,433,511000,0.195374,0.04,1,65241,64808,433
944321,1.04,6.40013,426,512460,0.183075,0.15,1,65242,64816,426
947241,8.208,9.28003,426,513920,0.116615,0.15,1,65252,64826,426
950161,4.8416,1.85601,430,515380,0.175323,0.15,1,65256,64826,430
952641,2.56832,0.371201,432,516840,0.163065,0.25,1,65258,64826,432
954721,78.1137,84.0742,424,518300,0.0326129,0.02,1,65355,64931,424
957641,24.4227,27.2148,422,519760,0.102523,0.02,1,65366,64944,422
960561,6.48455,5.44297,424,521220,0.0845045,0.02,1,65368,64944,424
963481,2.89691,1.08859,426,522680,0.0489009,0.02,1,65370,64944,426
966401,2.17938,0.217719,428,524140,0.0337802,0.02,1,65372,64944,428
969321,2.03588,0.0435437,430,525600,0.00675604,0.02,1,65374,64944,430
971361,2.00718,0.00870875,432,527060,0.00135121,0.15,1,65376,64944,432
973441,20.4014,21.6017,430,528520,0.0962702,0.12,1,65401,64971,430
976361,148.08,151.52,426,529980,0.0832541,0.12,1,65581,65155,426
978641,31.2161,30.3041,428,531440,0.0486508,0.1,1,65583,65155,428
981561,8.64321,13.2608,422,532900,0.0577302,0.1,1,65586,65164,422
983841,3.32864,2.65216,424,534360,0.027546,0.06,1,65588,65164,424
986761,8.66573,8.53043,424,535820,0.0375092,0.06,1,65598,65174,424
989681,3.33315,1.70609,426,537280,0.127502,0.06,1,65600,65174,426
992601,2.26663,0.341217,428,538740,0.1215,0.06,1,65602,65174,428
994661,6.05333,0.0682434,435,540200,0.0243001,0.15,1,65609,65174,435
997581,2.81067,8.81365,426,541660,0.11686,0.15,1,65611,65185,426
1000501,2.16213,1.76273,428,543120,0.159372,0.15,1,65613,65185,428
1003421,2.03243,0.352546,430,544580,0.135874,0.15,1,65615,65185,430
1006101,2.00649,0.0705092,432,546040,0.0991749,0.11,1,65617,65185,432
1009021,2.0013,5.6141,427,547500,0.051835,0.11,1,65619,65192,427
1011921,2.00026,1.12282,429,548960,0.010367,0.1,1,65621,65192,429
1014841,2.00005,7.42456,422,550420,0.0340734,0.1,1,65623,65201,422
1017761,2.00001,1.48491,424,551880,0.110815,0.1,1,65625,65201,424
1020681,2,0.296983,426,553340,0.102163,0.1,1,65627,65201,426
1023601,2,0.0593965,428,554800,0.0684326,0.1,1,65629,65201,428
1026481,2,0.0118793,430,556260,0.149687,0.04,1,65631,65201,430
1029401,2,6.40238,424,557720,0.141937,0.04,1,65633,65209,424
1032321,2,1.28048,426,559180,0.108387,0.04,1,65635,65209,426
1034181,6,0.256095,433,560640,0.0216775,0.06,1,65642,65209,433
1037101,2.8,7.25122,426,562100,0.228335,0.06,1,65644,65218,426
1039381,5.36,1.45024,432,563560,0.173667,0.11,1,65650,65218,432
1042301,2.672,9.09005,423,565020,0.130733,0.11,1,65652,65229,423
1045221,2.1344,1.81801,425,566480,0.162147,0.11,1,65654,65229,425
1048141,2.02688,0.363602,427,567940,0.224429,0.11,1,65656,65229,427
1051061,2.00538,0.0727204,429,569400,0.196886,0.11,1,65658,65229,429
1053981,2.00108,0.0145441,431,570860,0.183377,0.11,1,65660,65229,431
1056021,2.00022,0.00290881,433,572320,0.148675,0.02,1,65662,65229,433
1058941,2.00004,5.60058,428,573780,0.117735,0.02,1,65664,65236,428
1061861,2.00001,1.12012,430,575240,0.079547,0.02,1,65666,65236,430
1064341,2,0.224023,432,576700,0.159909,0.16,1,65668,65236,432
1067261,2,5.6448,427,578160,0.151982,0.16,1,65670,65243,427
1070181,2,1.12896,429,579620,0.126396,0.16,1,65672,65243,429
1073101,2,0.225792,431,581080,0.0892793,0.16,1,65674,65243,431
1075361,2,0.0451584,433,582540,0.0498559,0.23,1,65676,65243,433
1077441,2,8.80903,424,584000,0.193971,0.14,1,65678,65254,424
1080361,8.4,5.76181,429,585460,0.0707942,0.14,1,65688,65259,429
1083281,4.88,1.15236,433,586920,0.142159,0.14,1,65692,65259,433
1085141,75.376,0.230472,526,588380,0.0284318,0.17,1,65785,65259,526
1087221,19.8752,84.0461,427,589840,0.0856863,0.04,1,65791,65364,427
1090141,5.57504,21.6092,423,591300,0.0651373,0.04,1,65793,65370,423
1092421,8.31501,4.32184,432,592760,0.101027,0.06,1,65802,65370,432
1095341,3.263,9.66437,423,594220,0.0762055,0.06,1,65804,65381,423
1098261,2.2526,1.93287,425,595680,0.0312411,0.06,1,65806,65381,425
1101181,2.05052,0.386575,427,597140,0.00624822,0.06,1,65808,65381,427
1103861,22.8101,0.0773149,455,598600,0.0172496,0.08,1,65836,65381,455
1105941,144.562,26.4155,597,600060,0.0754499,0,1,66011,65414,597
1108861,30.5124,145.283,424,601520,0.04709,0,1,66013,65589,424
1111781,7.70248,29.0566,426,602980,0.161418,0,1,66015,65589,426
1114701,3.1405,5.81132,428,604440,0.160284,0,1,66017,65589,428
1116341,9.4281,1.16226,439,605900,0.0320567,0.12,1,66028,65589,439
1119261,3.48562,10.6325,428,607360,0.182411,0.12,1,66030,65602,428
1121541,2.29712,2.12649,430,608820,0.180482,0.14,1,66032,65602,430
1124461,2.05942,7.6253,423,610280,0.148096,0.14,1,66034,65611,423
1126741,7.61189,1.52506,432,611740,0.0296193,0.04,1,66043,65611,432
1129661,3.12238,6.70501,426,613200,0.00592386,0.04,1,66045,65619,426
1132581,2.22448,1.341,428,614660,0.225185,0.04,1,66047,65619,428
1135501,2.0449,0.2682,430,616120,0.237037,0.04,1,66049,65619,430
1138181,4.40898,0.0536401,435,617580,0.151407,0.14,1,66054,65619,435
1141101,2.4818,11.2107,423,619040,0.102281,0.14,1,66056,65633,423
1144021,2.09636,2.24215,425,620500,0.204456,0.14,1,66058,65633,425
1146941,2.01927,0.448429,427,621960,0.176891,0.14,1,66060,65633,427
1149861,2.00385,0.0896858,429,623420,0.139378,0.14,1,66062,65633,429
1152781,2.00077,0.0179372,431,624880,0.0998757,0.14,1,66064,65633,431
1155701,2.00015,0.00358743,433,626340,0.0679751,0.14,1,66066,65633,433
1157521,1.20003,0.000717486,434,627800,0.045595,0.28,1,66067,65633,434
1160441,1.84001,8.00014,426,629260,0.129119,0.28,1,66069,65643,426
1163361,1.968,1.60003,428,630720,0.161824,0.28,1,66071,65643,428
1166261,8.3936,0.320006,438,632180,0.0963648,0.24,1,66081,65643,438
1169181,3.27872,10.464,427,633640,0.051273,0.24,1,66083,65656,427
1172101,2.25574,2.0928,429,635100,0.0102546,0.24,1,66085,65656,429
1175021,2.05115,0.41856,431,636560,0.0980509,0.24,1,66087,65656,431
1177701,2.01023,0.083712,433,638020,0.0836102,0.2,1,66089,65656,433
1180621,2.00205,8.81674,424,639480,0.048722,0.2,1,66091,65667,424
1183541,2.00041,1.76335,426,640940,0.121744,0.2,1,66093,65667,426
1186461,2.00008,0.35267,428,642400,0.176349,0.2,1,66095,65667,428
1189381,2.00002,0.0705339,430,643860,0.15527,0.2,1,66097,65667,430
1192301,2,0.0141068,432,645320,0.119054,0.2,1,66099,65667,432
1194341,2,0.00282136,434,646780,0.0718108,0.23,1,66101,65667,434
1197261,2,8.80056,425,648240,0.0303622,0.23,1,66103,65678,425
1200181,2,1.76011,427,649700,0.150072,0.23,1,66105,65678,427
1203101,2,0.352023,429,651160,0.142014,0.23,1,66107,65678,429
1206021,2,0.0704045,431,652620,0.108403,0.23,1,66109,65678,431
1207861,6.8,0.0140809,439,654080,0.125681,0.16,1,66117,65678,439
1210561,3.76,11.2028,428,655540,0.0811361,0.09,1,66120,65692,428
1213481,7.152,8.64056,428,657000,0.0482272,0.09,1,66128,65700,428
1215141,75.8304,1.72811,521,658460,0.0896454,0.17,1,66221,65700,521
1218061,16.7661,79.5456,424,659920,0.0659291,0.17,1,66223,65799,424
1220961,4.95322,15.9091,426,661380,0.0291858,0.02,1,66225,65799,426
1223881,9.79064,15.1818,422,662840,0.0778372,0.02,1,66236,65814,422
1226801,3.55813,3.03636,424,664300,0.0555674,0.02,1,66238,65814,424
1229721,2.31163,0.607273,426,665760,0.139113,0.02,1,66240,65814,426
1231361,1.26233,0.121455,427,667220,0.139823,0.25,1,66241,65814,427
1234281,23.4525,23.2243,427,668680,0.0279645,0.25,1,66270,65843,427
1235941,140.69,4.64486,597,670140,0.149593,0.17,1,66440,65843,597
1238861,31.3381,140.929,426,671600,0.109919,0.17,1,66444,66018,426
1241781,8.66762,28.1858,429,673060,0.173984,0.17,1,66447,66018,429
1244701,3.33352,5.63716,431,674520,0.154797,0.17,1,66449,66018,431
1246341,7.0667,1.12743,439,675980,0.142959,0.11,1,66457,66018,439
1249261,4.61334,13.8255,426,677440,0.0765919,0.11,1,66461,66035,426
1252181,4.12267,2.7651,430,678900,0.0153184,0.11,1,66465,66035,430
1255101,4.02453,0.553019,434,680360,0.107064,0.11,1,66469,66035,434
1256741,6.40491,0.110604,441,681820,0.0934127,0.28,1,66476,66035,441
1259661,2.88098,9.62212,431,683280,0.0666825,0.28,1,66478,66047,431
1261941,2.1762,1.92442,433,684740,0.0293365,0.23,1,66480,66047,433
1264861,2.03524,9.18488,424,686200,0.0058673,0.23,1,66482,66058,424
1267781,2.00705,1.83698,426,687660,0.0971735,0.23,1,66484,66058,426
1270701,2.00141,0.367395,428,689120,0.0834347,0.23,1,66486,66058,428
1273381,2.00028,0.0734791,430,690580,0.104687,0.17,1,66488,66058,430
1275041,1.20006,1.6147,429,692040,0.0929374,0.07,1,66489,66060,429
1277961,1.84001,4.32294,426,693500,0.106587,0.07,1,66491,66065,426
1280881,1.968,0.864588,428,694960,0.0773175,0.07,1,66493,66065,428
1283361,1.9936,0.172918,430,696420,0.119464,0.2,1,66495,66065,430
1286281,1.99872,8.03458,422,697880,0.0958927,0.2,1,66497,66075,422
1289201,1.99974,1.60692,424,699340,0.0671785,0.2,1,66499,66075,424
1292121,1.99995,0.321383,426,700800,0.0294357,0.2,1,66501,66075,426
1293761,1.19999,0.0642767,427,702260,0.00588714,0.02,1,66502,66075,427
1296681,7.44,7.21286,427,703720,0.0811774,0.02,1,66511,66084,427
1299601,3.088,1.44257,429,705180,0.0642355,0.02,1,66513,66084,429
1301461,2.2176,0.288514,431,706640,0.212847,0.21,1,66515,66084,431
1304381,2.04352,8.0577,423,708100,0.202569,0.21,1,66517,66094,423
1307301,2.0087,1.61154,425,709560,0.168514,0.21,1,66519,66094,425
1310221,2.00174,0.322308,427,711020,0.129703,0.21,1,66521,66094,427
1313141,2.00035,0.0644616,429,712480,0.209941,0.21,1,66523,66094,429
1316021,2.00007,0.0128923,431,713940,0.193988,0.08,1,66525,66094,431
1318941,2.00001,4.80258,427,715400,0.214798,0.08,1,66527,66100,427
1321861,2,0.960516,429,716860,0.19496,0.08,1,66529,66100,429
1324341,2,0.192103,431,718320,0.158992,0.18,1,66531,66100,431
1327261,2,3.23842,429,719780,0.119798,0.18,1,66533,66104,429
1329541,2,0.647684,431,721240,0.19196,0.15,1,66535,66104,431
1332461,2,6.52954,425,722700,0.174392,0.15,1,66537,66112,425
1335381,2,1.30591,427,724160,0.146878,0.15,1,66539,66112,427
1337861,2,0.261181,429,725620,0.213376,0.11,1,66541,66112,429
1339941,10,4.85224,435,727080,0.122675,0.1,1,66553,66118,435
1342861,3.6,10.5704,425,728540,0.072535,0.1,1,66555,66130,425
1345141,79.92,2.11409,524,730000,0.102507,0.2,1,66654,66130,524
1348061,17.584,79.6228,427,731460,0.0845014,0.2,1,66656,66229,427
1350981,5.1168,15.9246,429,732920,0.0489003,0.2,1,66658,66229,429
1353461,8.22336,3.18491,438,734380,0.12178,0.06,1,66667,66229,438
1356381,3.24467,14.237,423,735840,0.104356,0.06,1,66669,66246,423
1359301,2.24893,2.8474,425,737300,0.180871,0.06,1,66671,66246,425
1362221,2.04979,0.569479,427,738760,0.188174,0.06,1,66673,66246,427
1363861,26.01,0.113896,459,740220,0.0376348,0.18,1,66705,66246,459
1365941,143.602,27.2228,598,741680,0.119527,0.17,1,66878,66280,598
1368861,31.1204,146.245,425,743140,0.255905,0.17,1,66881,66456,425
1371781,7.82408,29.2489,427,744600,0.251181,0.17,1,66883,66456,427
1374701,3.16482,5.84978,429,746060,0.218236,0.17,1,66885,66456,429
1376341,3.03296,1.16996,432,747520,0.171647,0,1,66888,66456,432
1379261,2.20659,6.63399,426,748980,0.130329,0,1,66890,66464,426
1381541,8.44132,1.3268,436,750440,0.162066,0.09,1,66900,66464,436
1384461,3.28826,9.86536,426,751900,0.168413,0.09,1,66902,66476,426
1386741,2.25765,1.97307,428,753360,0.193683,0.02,1,66904,66476,428
1389661,2.05153,3.59461,426,754820,0.166737,0.02,1,66906,66480,426
1391941,6.81031,0.718923,434,756280,0.121347,0.07,1,66914,66480,434
1394861,2.96206,10.5438,423,757740,0.0882695,0.07,1,66916,66493,423
1397781,2.19241,2.10876,425,759200,0.169654,0.07,1,66918,66493,425
1400701,2.03848,0.421751,427,760660,0.153931,0.07,1,66920,66493,427
1403621,2.0077,0.0843503,429,762120,0.166786,0.07,1,66922,66493,429
1406541,2.00154,0.0168701,431,763580,0.193357,0.07,1,66924,66493,431
1408161,1.20031,0.00337401,432,765040,0.182671,0.24,1,66925,66493,432
1411081,1.84006,8.00067,424,766500,0.148534,0.24,1,66927,66503,424
1414001,1.96801,1.60013,426,767960,0.101707,0.24,1,66929,66503,426
1416921,1.9936,0.320027,428,769420,0.0683414,0.24,1,66931,66503,428
1419841,1.99872,0.0640054,430,770880,0.0296683,0.24,1,66933,66503,430
1422761,1.99974,0.0128011,432,772340,0.00593365,0.24,1,66935,66503,432
1424801,1.99995,0.00256022,434,773800,0.161187,0.25,1,66937,66503,434
1427721,7.59999,9.60051,431,775260,0.0482373,0.25,1,66946,66515,431
1430001,3.12,1.9201,433,776720,0.00964747,0.23,1,66948,66515,433
1432921,2.224,6.78402,427,778180,0.00192949,0.23,1,66950,66523,427
1435841,2.0448,1.3568,429,779640,0.192386,0.23,1,66952,66523,429
1438761,2.00896,0.271361,431,781100,0.198477,0.23,1,66954,66523,431
1440401,1.20179,0.0542722,432,782560,0.183695,0.19,1,66955,66523,432
1443321,1.84036,4.81085,428,784020,0.148739,0.19,1,66957,66529,428
1446241,1.96807,0.962171,430,785480,0.109748,0.19,1,66959,66529,430
1449161,1.99361,0.192434,432,786940,0.0699496,0.19,1,66961,66529,432
1451221,1.99872,0.0384868,434,788400,0.0299899,0.21,1,66963,66529,434
1454141,1.99974,4.8077,430,789860,0.237998,0.21,1,66965,66535,430
1457061,1.99995,0.961539,432,791320,0.2476,0.21,1,66967,66535,432
1459541,2.79999,0.192308,435,792780,0.26552,0.17,1,66970,66535,435
1462461,2.16,11.2385,423,794240,0.237104,0.17,1,66972,66549,423
1465381,2.032,2.24769,425,795700,0.199421,0.17,1,66974,66549,425
1468301,2.0064,0.449538,427,797160,0.159884,0.17,1,66976,66549,427
1469941,6.00128,0.0899077,434,798620,0.175977,0.14,1,66983,66549,434
1472861,2.80026,8.01798,426,800080,0.147195,0.14,1,66985,66559,426
1475141,81.3601,1.6036,527,801540,0.165439,0,1,67086,66559,527
1478061,18.672,81.1207,429,803000,0.121088,0,1,67089,66660,429
1480981,5.3344,16.2241,431,804460,0.160218,0,1,67091,66660,431
1483461,4.26688,3.24483,435,805920,0.112044,0.2,1,67095,66660,435
1486381,2.45338,9.44897,426,807380,0.0704087,0.2,1,67097,66671,426
1488661,3.69068,1.88979,430,808840,0.0140817,0.07,1,67101,66671,430
1491581,2.33814,7.57796,423,810300,0.0828163,0.07,1,67103,66680,423
1493861,27.6676,1.51559,457,811760,0.0165633,0.14,1,67137,66680,457
1495941,145.534,28.3031,597,813220,0.00331265,0.16,1,67312,66715,597
1498861,30.7067,144.061,426,814680,0.176663,0.16,1,67314,66888,426
1501781,7.74134,28.8121,428,816140,0.179333,0.16,1,67316,66888,428
1504701,3.14827,5.76242,430,817600,0.147867,0.16,1,67318,66888,430
1506341,3.02965,1.15248,433,819060,0.0935733,0.15,1,67321,66888,433
1509261,2.20593,4.2305,430,820520,0.0507147,0.15,1,67323,66893,430
1511541,6.84119,0.846099,438,821980,0.0741429,0.14,1,67331,66893,438
1514461,2.96824,11.3692,426,823440,0.0708286,0.14,1,67333,66907,426
1517381,2.19365,2.27384,428,824900,0.174166,0.14,1,67335,66907,428
1520301,2.03873,0.454769,430,826360,0.170833,0.14,1,67337,66907,430
1521941,7.60775,0.0909537,439,827820,0.162167,0.18,1,67346,66907,439
1524861,3.12155,14.4182,423,829280,0.224433,0.18,1,67348,66925,423
1527781,2.22431,2.88364,425,830740,0.196887,0.18,1,67350,66925,425
1530701,2.04486,0.576728,427,832200,0.183377,0.18,1,67352,66925,427
1533621,2.00897,0.115346,429,833660,0.148675,0.18,1,67354,66925,429
1536541,2.00179,0.0230691,431,835120,0.117735,0.18,1,67356,66925,431
1538581,5.20036,0.00461382,437,836580,0.167547,0.12,1,67362,66925,437
1541501,2.64007,12.8009,423,838040,0.153509,0.12,1,67364,66941,423
1544421,2.12801,2.56018,425,839500,0.118702,0.12,1,67366,66941,425
1547341,2.0256,0.512037,427,840960,0.0717404,0.12,1,67368,66941,427
1550261,2.00512,0.102407,429,842420,0.0303481,0.12,1,67370,66941,429
1553181,2.00102,0.0204815,431,843880,0.11807,0.12,1,67372,66941,431
1555841,2.0002,0.00409629,433,845340,0.127614,0.2,1,67374,66941,433
1558761,3.60004,10.4008,424,846800,0.0655228,0.2,1,67378,66954,424
1561681,3.92001,2.08016,428,848260,0.0931046,0.2,1,67382,66954,428
1564601,3.984,0.416033,432,849720,0.0346209,0.2,1,67386,66954,432
1566241,2.3968,0.0832065,434,851180,0.00692418,0.14,1,67388,66954,434
1569161,2.07936,2.41664,433,852640,0.00138484,0.14,1,67390,66957,433
1571441,2.01587,0.483328,435,854100,0.096277,0.28,1,67392,66957,435
1574361,2.00317,7.29667,428,855560,0.0832554,0.28,1,67394,66966,428
1577281,2.00063,1.45933,430,857020,0.0886511,0.28,1,67396,66966,430
1580201,2.00013,0.291867,432,858480,0.0577302,0.28,1,67398,66966,432
1583121,2.00003,0.0583733,434,859940,0.027546,0.28,1,67400,66966,434
1584961,1.20001,0.0116747,435,861400,0.00550921,0.31,1,67401,66966,435
1587881,1.84,8.80234,426,862860,0.0651018,0.31,1,67403,66977,426
1590801,1.968,1.76047,428,864320,0.16502,0.31,1,67405,66977,428
1593721,1.9936,0.352093,430,865780,0.153004,0.31,1,67407,66977,430
1596641,1.99872,0.0704187,432,867240,0.126601,0.31,1,67409,66977,432
1598481,1.19974,0.0140837,433,868700,0.10532,0.26,1,67410,66977,433
1601401,6.63995,10.4028,428,870160,0.149064,0.26,1,67418,66990,428
1603681,2.92799,2.08056,430,871620,0.125813,0.06,1,67420,66990,430
1606601,80.5856,86.0161,423,873080,0.169163,0.06,1,67520,67097,423
1609521,17.7171,17.2032,425,874540,0.145833,0.06,1,67522,67097,425
1612441,5.14342,3.44064,427,876000,0.109166,0.06,1,67524,67097,427
1614081,1.82868,0.688129,428,877460,0.0858333,0.14,1,67525,67097,428
1617001,5.16574,9.73763,422,878920,0.145167,0.14,1,67531,67109,422
1619921,2.63315,1.94753,424,880380,0.165033,0.14,1,67533,67109,424
1622401,2.12663,0.389505,426,881840,0.137007,0.08,1,67535,67109,426
1624481,22.0253,24.8779,422,883300,0.155401,0.04,1,67562,67140,422
1627401,154.005,151.376,426,884760,0.19108,0.04,1,67749,67323,426
1630321,32.401,30.2751,428,886220,0.166216,0.04,1,67751,67323,428
1633241,8.0802,6.05502,430,887680,0.129243,0.04,1,67753,67323,430
1636161,3.21604,1.211,432,889140,0.0898486,0.04,1,67755,67323,432
1638421,2.24321,0.242201,434,890600,0.0499697,0.08,1,67757,67323,434
1640081,1.24864,6.44844,427,892060,0.0259939,0.17,1,67758,67331,427
1643001,6.64973,6.08969,429,893520,0.221199,0.17,1,67766,67337,429
1645921,2.92995,1.21794,431,894980,0.22824,0.17,1,67768,67337,431
1648401,2.18599,0.243587,433,896440,0.197648,0.19,1,67770,67337,433
1651321,6.8372,10.4487,428,897900,0.14353,0.19,1,67778,67350,428
1654241,2.96744,2.08974,430,899360,0.244706,0.19,1,67780,67350,430
1657141,2.19349,0.417949,432,900820,0.240941,0.21,1,67782,67350,432
1660061,2.0387,8.08359,424,902280,0.208188,0.21,1,67784,67360,424
1662981,2.00774,1.61672,426,903740,0.177638,0.21,1,67786,67360,426
1665901,2.00155,0.323344,428,905200,0.179528,0.21,1,67788,67360,428
1668581,2.00031,0.0646687,430,906660,0.219906,0.17,1,67790,67360,430
1670661,2.00006,2.41293,429,908120,0.195981,0.04,1,67792,67363,429
1673581,2.00001,5.28259,425,909580,0.167196,0.04,1,67794,67369,425
1676501,2,1.05652,427,911040,0.137439,0.04,1,67796,67369,427
1678981,4.4,0.211303,432,912500,0.195488,0.13,1,67801,67369,432
1681901,2.48,8.84226,423,913960,0.183098,0.13,1,67803,67380,423
1684821,2.096,1.76845,425,915420,0.14862,0.13,1,67805,67380,425
1687741,2.0192,0.35369,427,916880,0.109724,0.13,1,67807,67380,427
1690421,2.00384,0.0707381,429,918340,0.0699448,0.04,1,67809,67380,429
1692081,1.20077,4.01415,425,919800,0.197989,0.12,1,67810,67385,425
1695001,3.44015,6.40283,422,921260,0.167598,0.12,1,67814,67392,422
1697921,2.28803,1.28057,424,922720,0.18552,0.12,1,67816,67392,424
1700821,7.65761,0.256113,433,924180,0.0371039,0.08,1,67825,67392,433
1703741,3.13152,8.05122,425,925640,0.135421,0.08,1,67827,67402,425
1706661,2.2263,1.61024,427,927100,0.123084,0.08,1,67829,67402,427
1709581,2.04526,0.322049,429,928560,0.0886168,0.08,1,67831,67402,429
1712501,2.00905,0.0644098,431,930020,0.0497234,0.08,1,67833,67402,431
1715421,2.00181,0.012882,433,931480,0.00994467,0.08,1,67835,67402,433
1717461,2.80036,0.00257639,436,932940,0.00198893,0.22,1,67838,67402,436
1720381,3.76007,10.4005,427,934400,0.184398,0.22,1,67842,67415,427
1723301,2.35201,2.0801,429,935860,0.18888,0.22,1,67844,67415,429
1726221,2.0704,0.416021,431,937320,0.157776,0.22,1,67846,67415,431
1729141,2.01408,0.0832041,433,938780,0.127555,0.22,1,67848,67415,433
1730981,1.20282,0.0166408,434,940240,0.105511,0.06,1,67849,67415,434
1733901,1.84056,6.40333,428,941700,0.0691022,0.06,1,67851,67423,428
1736181,84.3681,1.28067,533,943160,0.19782,0.13,1,67956,67423,533
1739101,18.4736,89.8561,423,944620,0.191564,0.13,1,67958,67535,423
1742021,5.29472,17.9712,425,946080,0.158313,0.13,1,67960,67535,425
1744941,2.65894,3.59424,427,947540,0.127663,0.13,1,67962,67535,427
1747861,2.13179,0.718849,429,949000,0.0895325,0.13,1,67964,67535,429
1750321,2.02636,0.14377,431,950460,0.0499065,0,1,67966,67535,431
1753241,5.20527,6.42875,429,951920,0.161981,0,1,67972,67543,429
1754901,19.4411,1.28575,452,953380,0.160396,0.17,1,67995,67543,452
1756981,155.888,22.6571,614,954840,0.0800793,0.08,1,68185,67571,614
1759901,32.7776,151.731,432,956300,0.0320158,0.08,1,68187,67755,432
1762821,8.15553,30.3463,434,957760,0.0704032,0.08,1,68189,67755,434
1765301,3.23111,6.06926,436,959220,0.0460806,0.2,1,68191,67755,436
1768221,2.24622,8.41385,429,960680,0.00921613,0.2,1,68193,67764,429
1771121,2.04924,1.68277,431,962140,0.0818432,0.21,1,68195,67764,431
1774041,3.60985,4.33655,430,963600,0.0323686,0.21,1,68199,67769,430
1776321,3.92197,0.867311,434,965060,0.00647373,0.15,1,68203,67769,434
1779241,3.98439,6.57346,430,966520,0.0652948,0.15,1,68207,67777,430
1780901,5.59688,1.31469,436,967980,0.0770589,0.18,1,68213,67777,436
1783821,2.71938,9.06294,427,969440,0.0474118,0.18,1,68215,67788,427
1786741,2.14388,1.81259,429,970900,0.00948236,0.18,1,68217,67788,429
1789661,2.02878,0.362518,431,972360,0.00189647,0.18,1,68219,67788,431
1792581,2.00576,0.0725035,433,973820,0.136379,0.18,1,68221,67788,433
1795461,2.00115,0.0145007,435,975280,0.131276,0.25,1,68223,67788,435
1798381,2.00023,8.8029,426,976740,0.0982552,0.25,1,68225,67799,426
1801301,2.00005,1.76058,428,978200,0.067651,0.25,1,68227,67799,428
1804221,2.00001,0.352116,430,979660,0.0295302,0.25,1,68229,67799,430
1807141,2,0.0704232,432,981120,0.00590604,0.25,1,68231,67799,432
1808981,1.2,0.0140846,433,982580,0.00118121,0.14,1,68232,67799,433
1811901,1.84,4.80282,429,984040,0.144236,0.14,1,68234,67805,429
1814181,2.768,0.960563,432,985500,0.180847,0.19,1,68237,67805,432
1817101,2.1536,8.99211,423,986960,0.156169,0.19,1,68239,67816,423
1820021,2.03072,1.79842,425,988420,0.119234,0.19,1,68241,67816,425
1822941,2.00614,0.359684,427,989880,0.223847,0.19,1,68243,67816,427
1825201,2.00123,0.0719369,429,991340,0.212769,0.12,1,68245,67816,429
1828121,5.20025,10.4144,422,992800,0.242554,0.12,1,68251,67829,422
1831041,2.64005,2.08288,424,994260,0.216511,0.12,1,68253,67829,424
1833961,2.12801,0.416575,426,995720,0.179302,0.12,1,68255,67829,426
1836021,7.6256,0.0833151,435,997180,0.14786,0.23,1,68264,67829,435
1838941,3.12512,10.4167,424,998640,0.109572,0.23,1,68266,67842,424
1841861,2.22502,2.08333,426,1000100,0.0699144,0.23,1,68268,67842,426
1844781,2.045,0.416666,428,1001560,0.0299829,0.23,1,68270,67842,428
1847701,2.009,0.0833333,430,1003020,0.00599658,0.23,1,68272,67842,430
1849541,2.8018,0.0166667,433,1004480,0.113199,0.23,1,68275,67842,433
1852461,2.16036,8.00333,425,1005940,0.10264,0.23,1,68277,67852,425
1855381,2.03207,1.60067,427,1007400,0.188528,0.23,1,68279,67852,427
1858301,2.00641,0.320133,429,1008860,0.173706,0.23,1,68281,67852,429
1861221,2.00128,0.0640267,431,1010320,0.130741,0.23,1,68283,67852,431
1864141,2.00026,0.0128053,433,1011780,0.0901482,0.23,1,68285,67852,433
1866181,81.2001,0.00256107,534,1013240,0.12203,0.14,1,68386,67852,534
1869101,17.84,87.2005,427,1014700,0.216406,0.14,1,68388,67961,427
1872021,5.168,17.4401,429,1016160,0.211281,0.14,1,68390,67961,429
1874501,2.6336,3.48802,431,1017620,0.178256,0.21,1,68392,67961,431
1877421,2.12672,8.6976,423,1019080,0.131651,0.21,1,68394,67971,423
1880341,2.02534,1.73952,425,1020540,0.0903303,0.21,1,68396,67971,425
1882821,14.0051,0.347904,442,1022000,0.146066,0.02,1,68413,67971,442
1884901,19.601,12.0696,448,1023460,0.173213,0.14,1,68434,67986,448
1886981,147.92,21.6139,604,1024920,0.226643,0,1,68614,68010,604
1889901,31.184,150.723,423,1026380,0.205329,0,1,68616,68193,423
1892821,7.83681,30.1446,425,1027840,0.169066,0,1,68618,68193,425
1895741,3.16736,6.02891,427,1029300,0.217813,0,1,68620,68193,427
1897381,3.03347,1.20578,430,1030760,0.179563,0.04,1,68623,68193,430
1900301,2.20669,4.24116,427,1032220,0.139913,0.04,1,68625,68198,427
1902161,1.24134,0.848231,428,1033680,0.107983,0.14,1,68626,68198,428
1905081,9.04827,9.76965,427,1035140,0.0215965,0.14,1,68637,68210,427
1908001,3.40965,1.95393,429,1036600,0.0203193,0.14,1,68639,68210,429
1910901,4.68193,0.390786,434,1038060,0.148064,0.13,1,68644,68210,434
1913821,2.53639,10.4782,423,1039520,0.197613,0.13,1,68646,68223,423
1916741,2.10728,2.09563,425,1040980,0.215523,0.13,1,68648,68223,425
1919661,2.02146,0.419126,427,1042440,0.187105,0.13,1,68650,68223,427
1922581,2.00429,0.0838252,429,1043900,0.205421,0.13,1,68652,68223,429
1924421,4.40086,0.016765,434,1045360,0.129084,0,1,68657,68223,434
1927341,2.48017,7.20335,427,1046820,0.0738168,0,1,68659,68232,427
1930261,2.09603,1.44067,429,1048280,0.134763,0,1,68661,68232,429
1933181,2.01921,0.288134,431,1049740,0.122953,0,1,68663,68232,431
1936101,2.00384,0.0576268,433,1051200,0.0885905,0,1,68665,68232,433
1938981,2.00077,0.0115254,435,1052660,0.0497181,0.13,1,68667,68232,435
1941901,2.00015,6.40231,429,1054120,0.0659436,0.13,1,68669,68240,429
1944821,2.00003,1.28046,431,1055580,0.101189,0.13,1,68671,68240,431
1947741,2.00001,0.256092,433,1057040,0.0762377,0.13,1,68673,68240,433
1949381,1.2,0.0512184,434,1058500,0.151248,0.21,1,68674,68240,434
1952301,1.84,10.4102,423,1059960,0.13425,0.21,1,68676,68253,423
1955221,1.968,2.08205,425,1061420,0.10685,0.21,1,68678,68253,425
1958141,1.9936,0.41641,427,1062880,0.15737,0.21,1,68680,68253,427
1959781,9.99872,0.0832819,439,1064340,0.079474,0.06,1,68692,68253,439
1962701,3.59974,12.0167,426,1065800,0.0318948,0.06,1,68694,68268,426
1965621,2.31995,2.40333,428,1067260,0.00637896,0.06,1,68696,68268,428
1968541,2.06399,0.480666,430,1068720,0.00127579,0.06,1,68698,68268,430
1971221,2.8128,0.0961332,433,1070180,0.0802552,0.12,1,68701,68268,433
1974141,2.96256,6.41923,428,1071640,0.168051,0.12,1,68704,68276,428
1977061,2.19251,1.28385,430,1073100,0.14561,0.12,1,68706,68276,430
1979981,2.0385,0.256769,432,1074560,0.109122,0.12,1,68708,68276,432
1981621,3.6077,0.0513538,436,1076020,0.125824,0.16,1,68712,68276,436
1984541,2.32154,12.0103,423,1077480,0.0891649,0.16,1,68714,68291,423
1987461,2.06431,2.40205,425,1078940,0.049833,0.16,1,68716,68291,425
1990381,2.01286,0.480411,427,1080400,0.00996659,0.16,1,68718,68291,427
1993301,2.00257,0.0960821,429,1081860,0.145993,0.16,1,68720,68291,429
1996181,80.4005,0.0192164,529,1083320,0.157199,0.21,1,68820,68291,529
1999101,17.6801,86.4038,423,1084780,0.12744,0.21,1,68822,68399,423
2002021,5.13602,17.2808,425,1086240,0.0894879,0.21,1,68824,68399,425
2004941,2.6272,3.45615,427,1087700,0.201898,0.21,1,68826,68399,427
2007861,2.12544,0.691231,429,1089160,0.19238,0.21,1,68828,68399,429
2010781,2.02509,0.138246,431,1090620,0.166476,0.21,1,68830,68399,431
2012821,13.205,0.0276492,447,1092080,0.225295,0.17,1,68846,68399,447
2014901,19.441,18.4055,445,1093540,0.173059,0.06,1,68867,68422,445
2016981,151.088,18.0811,611,1095000,0.0346118,0.07,1,69051,68440,611
2019901,31.8176,155.616,423,1096460,0.00692236,0.07,1,69053,68630,423
2022821,7.96353,31.1232,425,1097920,0.00138447,0.07,1,69055,68630,425
2025741,3.19271,6.22465,427,1099380,0.176277,0.07,1,69057,68630,427
2028661,2.23854,1.24493,429,1100840,0.179255,0.07,1,69059,68630,429
2031581,2.04771,0.248986,431,1102300,0.147851,0.07,1,69061,68630,431
2033201,1.20954,0.0497972,432,1103760,0.12557,0.25,1,69062,68630,432
2036121,6.64191,8.00996,430,1105220,0.025114,0.25,1,69070,68640,430
2038401,2.92838,1.60199,432,1106680,0.00502281,0.18,1,69072,68640,432
2041321,2.18568,8.3204,424,1108140,0.161005,0.18,1,69074,68650,424
2044241,2.03714,1.66408,426,1109600,0.160201,0.18,1,69076,68650,426
2047161,2.00743,0.332816,428,1111060,0.20804,0.18,1,69078,68650,428
2049221,2.00149,0.0665632,430,1112520,0.185608,0.11,1,69080,68650,430
2052141,2.0003,5.61331,425,1113980,0.149122,0.11,1,69082,68657,425
2054421,5.20006,1.12266,431,1115440,0.157824,0.12,1,69088,68657,431
2057341,2.64001,5.02453,427,1116900,0.127565,0.12,1,69090,68663,427
2060261,2.128,1.00491,429,1118360,0.185513,0.12,1,69092,68663,429
2062741,2.0256,0.200981,431,1119820,0.165103,0.09,1,69094,68663,431
2065661,2.00512,4.0402,428,1121280,0.193021,0.09,1,69096,68668,428
2068581,2.00102,0.808039,430,1122740,0.174604,0.09,1,69098,68668,430
2071061,2.0002,0.161608,432,1124200,0.138921,0.17,1,69100,68668,432
2073981,2.00004,4.83232,428,1125660,0.0997842,0.17,1,69102,68674,428
2076901,2.00001,0.966464,430,1127120,0.0679568,0.17,1,69104,68674,430
2079381,4.4,0.193293,435,1128580,0.165591,0.13,1,69109,68674,435
2082301,2.48,11.2387,423,1130040,0.153118,0.13,1,69111,68688,423
2085221,2.096,2.24773,425,1131500,0.118624,0.13,1,69113,68688,425
2088141,2.0192,0.449546,427,1132960,0.0717247,0.13,1,69115,68688,427
2089781,6.80384,0.0899093,435,1134420,0.094345,0,1,69123,68688,435
2092701,2.96077,8.01798,427,1135880,0.066869,0,1,69125,68698,427
2095621,2.19215,1.6036,429,1137340,0.0293738,0,1,69127,68698,429
2098101,2.83843,0.320719,432,1138800,0.117875,0.19,1,69130,68698,432
2101021,2.16769,8.86414,423,1140260,0.103575,0.19,1,69132,68709,423
2103941,2.03354,1.77283,425,1141720,0.068715,0.19,1,69134,68709,425
2106861,2.00671,0.354566,427,1143180,0.173743,0.19,1,69136,68709,427
2109781,2.00134,0.0709131,429,1144640,0.154749,0.19,1,69138,68709,429
2111621,2.80027,0.0141826,432,1146100,0.17495,0.18,1,69141,68709,432
2114541,2.16005,8.80284,423,1147560,0.14699,0.18,1,69143,68720,423
2117461,2.03201,1.76057,425,1149020,0.101398,0.18,1,69145,68720,425
2120381,2.0064,0.352113,427,1150480,0.0682796,0.18,1,69147,68720,427
2122021,4.40128,0.0704227,432,1151940,0.157656,0.14,1,69152,68720,432
2123681,1.68026,8.81408,422,1153400,0.159531,0.17,1,69153,68731,422
2126601,83.5361,84.9628,422,1154860,0.151906,0.17,1,69257,68835,422
2129521,18.3072,16.9926,424,1156320,0.118381,0.17,1,69259,68835,424
2132441,5.26144,3.39851,426,1157780,0.0796762,0.17,1,69261,68835,426
2135361,2.65229,0.679702,428,1159240,0.0479352,0.17,1,69263,68835,428
2138281,2.13046,0.13594,430,1160700,0.00958705,0.17,1,69265,68835,430
2141201,2.02609,0.0271881,432,1162160,0.193917,0.17,1,69267,68835,432
2142821,6.00522,0.00543762,439,1163620,0.118783,0.21,1,69274,68835,439
2144901,26.801,11.2011,457,1165080,0.159757,0.27,1,69306,68849,457
2146981,146.96,26.2402,604,1166540,0.0479513,0.12,1,69483,68879,604
2149901,30.992,151.648,423,1168000,0.00959027,0.12,1,69485,69062,423
2152821,7.79841,30.3296,425,1169460,0.00191805,0.12,1,69487,69062,425
2155741,3.15968,6.06592,427,1170920,0.000383611,0.12,1,69489,69062,427
2158661,2.23194,1.21318,429,1172380,0.0960767,0.12,1,69491,69062,429
2161581,2.04639,0.242637,431,1173840,0.0832153,0.12,1,69493,69062,431
2163621,2.00928,0.0485274,433,1175300,0.0486431,0.07,1,69495,69062,433
2165701,5.20186,3.20971,435,1176760,0.0257286,0.21,1,69501,69066,435
2168621,2.64037,6.24194,430,1178220,0.00514572,0.21,1,69503,69073,430
2170901,4.52807,1.24839,435,1179680,0.0810291,0.18,1,69508,69073,435
2173821,2.50561,5.84968,430,1181140,0.0882058,0.18,1,69510,69080,430
2176741,2.10112,1.16994,432,1182600,0.0576412,0.18,1,69512,69080,432
2179221,2.02022,0.233987,434,1184060,0.123528,0.17,1,69514,69080,434
2182141,2.00404,3.2468,432,1185520,0.120706,0.17,1,69516,69084,432
2184421,2.00081,0.649359,434,1186980,0.0881411,0.2,1,69518,69084,434
2187341,2.00016,9.72987,424,1188440,0.0336282,0.2,1,69520,69096,424
2190261,2.00003,1.94597,426,1189900,0.00672564,0.2,1,69522,69096,426
2193181,2.00001,0.389195,428,1191360,0.153345,0.2,1,69524,69096,428
2194821,4.4,0.077839,433,1192820,0.110669,0.04,1,69529,69096,433
2197741,2.48,7.21557,426,1194280,0.0701338,0.04,1,69531,69105,426
2200661,2.096,1.44311,428,1195740,0.150027,0.04,1,69533,69105,428
2203581,2.0192,0.288623,430,1197200,0.142005,0.04,1,69535,69105,430
2206501,2.00384,0.0577245,432,1198660,0.108401,0.04,1,69537,69105,432
2209381,2.80077,0.0115449,435,1200120,0.10968,0.18,1,69540,69105,435
2212301,2.16015,11.2023,423,1201580,0.069936,0.18,1,69542,69119,423
2215221,2.03203,2.24046,425,1203040,0.0299872,0.18,1,69544,69119,425
2218141,2.00641,0.448092,427,1204500,0.00599744,0.18,1,69546,69119,427
2219781,6.80128,0.0896185,435,1205960,0.113199,0.06,1,69554,69119,435
2221861,2.96026,4.81792,431,1207420,0.11064,0.14,1,69556,69125,431
2224781,2.19205,4.16358,429,1208880,0.078128,0.14,1,69558,69129,429
2226641,1.23841,0.832717,430,1210340,0.0476256,0.18,1,69559,69129,430
2229561,3.44768,9.76654,422,1211800,0.121525,0.18,1,69563,69141,422
2232481,2.28954,1.95331,424,1213260,0.192305,0.18,1,69565,69141,424
2235401,2.05791,0.390662,426,1214720,0.174461,0.18,1,69567,69141,426
2238321,2.01158,0.0781323,428,1216180,0.138892,0.18,1,69569,69141,428
2240161,1.20232,0.0156265,429,1217640,0.115778,0.18,1,69570,69141,429
2243081,4.24046,8.80313,423,1219100,0.143156,0.18,1,69575,69152,423
2246001,2.44809,1.76062,425,1220560,0.124631,0.18,1,69577,69152,425
2248921,2.08962,0.352125,427,1222020,0.200926,0.18,1,69579,69152,427
2250561,1.21792,0.070425,428,1223480,0.200185,0.1,1,69580,69152,428
2253481,6.64358,11.2141,422,1224940,0.168037,0.1,1,69588,69166,422
2256181,82.1287,2.24282,523,1226400,0.177607,0.24,1,69689,69166,523
2259101,18.0257,81.2486,424,1227860,0.147521,0.24,1,69691,69267,424
2262021,5.20515,16.2497,426,1229320,0.109504,0.24,1,69693,69267,426
2264941,2.64103,3.24994,428,1230780,0.0699009,0.24,1,69695,69267,428
2267861,2.12821,0.649988,430,1232240,0.18198,0.24,1,69697,69267,430
2270741,3.62564,0.129998,434,1233700,0.148396,0.12,1,69701,69267,434
2272821,6.32513,4.826,435,1235160,0.0776792,0.16,1,69708,69273,435
2274901,25.265,8.9652,455,1236620,0.199536,0.21,1,69738,69283,455
2276981,145.853,25.793,601,1238080,0.0399072,0.08,1,69914,69313,601
2279901,30.7706,149.159,423,1239540,0.00798143,0.08,1,69916,69493,423
2282821,7.75412,29.8317,425,1241000,0.0975963,0.08,1,69918,69493,425
2285741,3.15082,5.96634,427,1242460,0.0835193,0.08,1,69920,69493,427
2288661,2.23016,1.19327,429,1243920,0.0487039,0.08,1,69922,69493,429
2290501,3.64603,0.238654,433,1245380,0.0737408,0,1,69926,69493,433
2293421,3.12921,8.04773,426,1246840,0.0307482,0,1,69929,69503,426
2296321,2.22584,1.60955,428,1248300,0.00614963,0.16,1,69931,69503,428
2299241,6.04517,8.32191,425,1249760,0.00122993,0.16,1,69938,69513,425
2302161,2.80903,1.66438,427,1251220,0.144246,0.16,1,69940,69513,427
2305081,2.16181,0.332876,429,1252680,0.140849,0.16,1,69942,69513,429
2307761,2.03236,0.0665753,431,1254140,0.10817,0,1,69944,69513,431
2310681,2.00647,7.21332,424,1255600,0.141634,0,1,69946,69522,424
2313601,2.00129,1.44266,426,1257060,0.116327,0,1,69948,69522,426
2316521,2.00026,0.288533,428,1258520,0.0872654,0,1,69950,69522,428
2318161,1.20005,0.0577065,429,1259980,0.169453,0.14,1,69951,69522,429
2321081,1.84001,4.01154,426,1261440,0.153891,0.14,1,69953,69527,426
2323361,1.968,0.802308,428,1262900,0.198778,0.1,1,69955,69527,428
2326281,5.1936,8.16046,424,1264360,0.119756,0.1,1,69961,69537,424
2329201,4.23872,1.63209,428,1265820,0.191951,0.1,1,69965,69537,428
2332121,2.44774,0.326418,430,1267280,0.18239,0.1,1,69967,69537,430
2333761,1.28955,0.0652837,431,1268740,0.164478,0.11,1,69968,69537,431
2336681,1.85791,2.41306,430,1270200,0.128896,0.11,1,69970,69540,430
2338341,2.77158,0.482611,433,1271660,0.129779,0.18,1,69973,69540,433
2341261,2.15432,9.69652,423,1273120,0.0979558,0.18,1,69975,69552,423
2344181,2.03086,1.9393,425,1274580,0.0515912,0.18,1,69977,69552,425
2347101,2.00617,0.387861,427,1276040,0.0103182,0.18,1,69979,69552,427
2349781,6.80123,0.0775722,435,1277500,0.0900636,0.02,1,69987,69552,435
2352701,2.96025,6.41551,429,1278960,0.162013,0.02,1,69989,69560,429
2355621,2.19205,1.2831,431,1280420,0.136403,0.02,1,69991,69560,431
2357681,2.03841,0.256621,433,1281880,0.107281,0.15,1,69993,69560,433
2360601,3.60768,6.45132,429,1283340,0.0614561,0.15,1,69997,69568,429
2363521,2.32154,1.29026,431,1284800,0.0282912,0.15,1,69999,69568,431
2366001,2.06431,0.258053,433,1286260,0.00565824,0.15,1,70001,69568,433
2368921,3.61286,5.65161,430,1287720,0.153132,0.15,1,70005,69575,430
2371201,2.32257,1.13032,432,1289180,0.150626,0.14,1,70007,69575,432
2374121,2.06451,6.62606,426,1290640,0.158125,0.14,1,70009,69583,426
2377041,2.0129,1.32521,428,1292100,0.167625,0.14,1,70011,69583,428
2379961,2.00258,0.265043,430,1293560,0.137525,0.14,1,70013,69583,430
2381601,1.20052,0.0530085,431,1295020,0.115505,0.15,1,70014,69583,431
2383681,4.2401,11.2106,422,1296480,0.167101,0.16,1,70019,69597,422
2386601,84.048,84.6421,423,1297940,0.0654202,0.16,1,70123,69700,423
2389521,18.4096,16.9284,425,1299400,0.213084,0.16,1,70125,69700,425
2392441,5.28192,3.38568,427,1300860,0.218617,0.16,1,70127,69700,427
2395361,2.65638,0.677137,429,1302320,0.187723,0.16,1,70129,69700,429
2398241,2.13128,0.135427,431,1303780,0.149545,0.14,1,70131,69700,431
2401161,5.22626,11.2271,423,1305240,0.197909,0.14,1,70137,69714,423
2403441,2.64525,2.24542,425,1306700,0.167582,0.19,1,70139,69714,425
2405521,33.329,30.0491,429,1308160,0.225516,0.04,1,70180,69751,429
2408441,142.666,147.61,422,1309620,0.0451033,0.04,1,70350,69928,422
2411361,30.1332,29.522,424,1311080,0.00902065,0.04,1,70352,69928,424
2414281,7.62663,5.90439,426,1312540,0.129804,0.04,1,70354,69928,426
2417201,3.12533,1.18088,428,1314000,0.121961,0.04,1,70356,69928,428
2420121,2.22507,0.236176,430,1315460,0.0883922,0.04,1,70358,69928,430
2422581,2.04501,0.0472351,432,1316920,0.0496784,0,1,70360,69928,432
2425501,2.009,5.60945,427,1318380,0.00993569,0,1,70362,69935,427
2427361,1.2018,1.12189,428,1319840,0.00198714,0.1,1,70363,69935,428
2430281,7.44036,7.42438,428,1321300,0.000397427,0.1,1,70372,69944,428
2433201,3.08807,1.48488,430,1322760,7.94855e-05,0.1,1,70374,69944,430
2435681,2.21761,0.296975,432,1324220,0.128016,0.17,1,70376,69944,432
2438601,2.04352,6.4594,426,1325680,0.121603,0.17,1,70378,69952,426
2441521,2.0087,1.29188,428,1327140,0.0883206,0.17,1,70380,69952,428
2444441,2.00174,0.258376,430,1328600,0.0496641,0.17,1,70382,69952,430
2447361,2.00035,0.0516752,432,1330060,0.00993283,0.17,1,70384,69952,432
2449201,1.20007,0.010335,433,1331520,0.00198656,0.11,1,70385,69952,433
2452121,1.84001,6.40207,427,1332980,0.000397313,0.11,1,70387,69960,427
2454401,1.968,1.28041,429,1334440,0.0640795,0.12,1,70389,69960,429
2457321,5.1936,8.25608,425,1335900,0.180816,0.12,1,70395,69970,425
2460241,2.63872,1.65122,427,1337360,0.172163,0.12,1,70397,69970,427
2463161,2.12774,0.330243,429,1338820,0.138433,0.12,1,70399,69970,429
2464801,1.22555,0.0660486,430,1340280,0.115687,0.13,1,70400,69970,430
2466881,1.84511,2.41321,429,1341740,0.0711373,0.02,1,70402,69973,429
2469801,1.96902,4.48264,426,1343200,0.0302275,0.02,1,70404,69978,426
2472721,1.9938,0.896528,428,1344660,0.118045,0.02,1,70406,69978,428
2475201,1.99876,0.179306,430,1346120,0.103609,0.15,1,70408,69978,430
2477281,1.99975,5.63586,425,1347580,0.0687218,0.11,1,70410,69985,425
2480201,3.59995,6.72717,422,1349040,0.181744,0.11,1,70414,69992,422
2483121,2.31999,1.34543,424,1350500,0.172349,0.11,1,70416,69992,424
2486041,2.064,0.269087,426,1351960,0.14647,0.11,1,70418,69992,426
2488101,6.8128,0.0538174,434,1353420,0.141294,0.03,1,70426,69992,434
2490801,2.96256,4.81076,430,1354880,0.108259,0.18,1,70428,69998,430
2493721,3.79251,8.96215,424,1356340,0.125652,0.18,1,70432,70008,424
2496641,2.3585,1.79243,426,1357800,0.0891304,0.18,1,70434,70008,426
2499561,2.0717,0.358486,428,1359260,0.137826,0.18,1,70436,70008,428
2502241,2.01434,0.0716972,430,1360720,0.115565,0.06,1,70438,70008,430
2505161,3.60287,7.21434,425,1362180,0.247113,0.06,1,70442,70017,425
2508081,2.32057,1.44287,427,1363640,0.241423,0.06,1,70444,70017,427
2511001,2.06411,0.288574,429,1365100,0.272285,0.06,1,70446,70017,429
2512641,1.21282,0.0577147,430,1366560,0.262457,0.15,1,70447,70017,430
2514721,4.24256,10.4115,422,1368020,0.220491,0.29,1,70452,70030,422
2517641,85.6485,84.4823,425,1369480,0.0920983,0.29,1,70558,70133,425
2520561,18.7297,16.8965,427,1370940,0.0344197,0.29,1,70560,70133,427
2523481,5.34594,3.37929,429,1372400,0.182884,0.29,1,70562,70133,429
2526401,2.66919,0.675858,431,1373860,0.180577,0.29,1,70564,70133,431
2529281,2.13384,0.135172,433,1375320,0.148115,0.24,1,70566,70133,433
2532201,6.02677,10.427,427,1376780,0.0296231,0.24,1,70573,70146,427
2534481,2.80535,2.08541,429,1378240,0.101925,0.12,1,70575,70146,429
2536561,37.3611,38.8171,427,1379700,0.0683849,0.14,1,70621,70194,427
2539481,132.272,136.563,422,1381160,0.029677,0.14,1,70777,70355,422
2542401,28.0544,27.3127,424,1382620,0.0059354,0.14,1,70779,70355,424
2544881,7.21089,5.46254,426,1384080,0.0651871,0,1,70781,70355,426
2547801,5.44218,8.29251,422,1385540,0.0290374,0,1,70786,70364,422
2550721,2.68844,1.6585,424,1387000,0.00580748,0,1,70788,70364,424
2553641,2.13769,0.3317,426,1388460,0.0011615,0,1,70790,70364,426
2556561,2.02754,0.06634,428,1389920,0.0322323,0,1,70792,70364,428
2558401,1.20551,0.013268,429,1391380,0.0224465,0.1,1,70793,70364,429
2561321,9.8411,12.0027,426,1392840,0.0844893,0.1,1,70805,70379,426
2564241,3.56822,2.40053,428,1394300,0.0648979,0.1,1,70807,70379,428
2567161,2.31364,0.480106,430,1395760,0.0289796,0.1,1,70809,70379,430
2568801,1.26273,0.0960212,431,1397220,0.00579591,0,1,70810,70379,431
2571721,1.85255,4.0192,428,1398680,0.00115918,0,1,70812,70384,428
2574641,1.97051,0.803841,430,1400140,0.0642318,0,1,70814,70384,430
2576501,1.9941,0.160768,432,1401600,0.0448464,0.21,1,70816,70384,432
2579421,1.99882,8.83215,423,1403060,0.00896927,0.21,1,70818,70395,423
2582341,1.99976,1.76643,425,1404520,0.0817939,0.21,1,70820,70395,425
2585261,1.99995,0.353286,427,1405980,0.152359,0.21,1,70822,70395,427
2586901,4.39999,0.0706572,432,1407440,0.0944718,0.04,1,70827,70395,432
2589821,2.48,6.41413,426,1408900,0.154894,0.04,1,70829,70403,426
2592741,2.096,1.28283,428,1410360,0.134979,0.04,1,70831,70403,428
2595661,2.0192,0.256565,430,1411820,0.106996,0.04,1,70833,70403,430
2597921,2.00384,0.051313,432,1413280,0.0693992,0.04,1,70835,70403,432
2600841,2.00077,6.41026,426,1414740,0.0298798,0.04,1,70837,70411,426
2603761,2.00015,1.28205,428,1416200,0.00597597,0.04,1,70839,70411,428
2606681,2.00003,0.25641,430,1417660,0.0971952,0.04,1,70841,70411,430
2608321,1.20001,0.0512821,431,1419120,0.099439,0.23,1,70842,70411,431
2611241,1.84,8.01026,423,1420580,0.0678878,0.23,1,70844,70421,423
2614161,1.968,1.60205,425,1422040,0.0855776,0.23,1,70846,70421,425
2616641,1.9936,0.32041,427,1423500,0.169115,0.1,1,70848,70421,427
2618721,6.79872,5.66408,428,1424960,0.0658231,0.08,1,70856,70428,428
2621641,10.9597,5.93282,434,1426420,0.197165,0.08,1,70868,70434,434
2623921,3.79195,1.18656,436,1427880,0.239433,0.26,1,70870,70434,436
2626841,4.75839,7.43731,432,1429340,0.295887,0.26,1,70875,70443,432
2629761,2.55168,1.48746,434,1430800,0.307177,0.26,1,70877,70443,434
2632681,2.11034,0.297492,436,1432260,0.285435,0.26,1,70879,70443,436
2635361,2.02207,0.0594985,438,1433720,0.249087,0.32,1,70881,70443,438
2638281,2.80441,8.8119,430,1435180,0.193817,0.32,1,70884,70454,430
2641201,2.16088,1.76238,432,1436640,0.214763,0.32,1,70886,70454,432
2644121,2.03218,0.352476,434,1438100,0.186953,0.32,1,70888,70454,434
2645761,1.20644,0.0704952,435,1439560,0.173391,0.08,1,70889,70454,435
2648681,83.4413,92.0141,424,1441020,0.0986781,0.08,1,70993,70569,424
2651601,18.2883,18.4028,426,1442480,0.0517356,0.08,1,70995,70569,426
2654521,5.25765,3.68056,428,1443940,0.0103471,0.08,1,70997,70569,428
2657441,2.65153,0.736113,430,1445400,0.00206942,0.08,1,70999,70569,430
2660321,2.13031,0.147223,432,1446860,0.000413885,0.14,1,71001,70569,432
2663241,7.62606,12.0294,426,1448320,0.168083,0.14,1,71010,70584,426
2665521,3.92521,2.40589,429,1449780,0.265617,0.08,1,71013,70584,429
2667601,35.985,38.8812,425,1451240,0.237123,0,1,71057,70632,425
2670521,131.197,134.176,422,1452700,0.0794247,0,1,71212,70790,422
2673441,27.8394,26.8352,424,1454160,0.0318849,0,1,71214,70790,424
2676361,7.16788,5.36705,426,1455620,0.00637699,0,1,71216,70790,426
2679281,3.03358,1.07341,428,1457080,0.0172754,0,1,71218,70790,428
2681121,1.40672,0.214682,429,1458540,0.00345508,0.16,1,71219,70790,429
2684041,4.28134,9.64294,422,1460000,0.000691016,0.16,1,71224,70802,422
2686961,2.45627,1.92859,424,1461460,0.000138203,0.16,1,71226,70802,424
2689441,2.09125,0.385717,426,1462920,2.76406e-05,0,1,71228,70802,426
2692361,7.61825,6.47714,427,1464380,0.0720055,0,1,71237,70810,427
2695281,3.12365,1.29543,429,1465840,0.0544011,0,1,71239,70810,429
2697761,2.22473,0.259086,431,1467300,0.0108802,0.02,1,71241,70810,431
2700681,2.04495,5.65182,426,1468760,0.00217604,0.02,1,71243,70817,426
2703601,2.00899,1.13036,428,1470220,0.000435209,0.02,1,71245,70817,428
2706521,2.0018,0.226073,430,1471680,8.70417e-05,0.02,1,71247,70817,430
2708581,2.80036,0.0452145,433,1473140,0.120017,0.17,1,71250,70817,433
2711501,2.16007,9.60904,423,1474600,0.112003,0.17,1,71252,70829,423
2714421,2.03201,1.92181,425,1476060,0.0784007,0.17,1,71254,70829,425
2717341,2.0064,0.384362,427,1477520,0.0316801,0.17,1,71256,70829,427
2718981,4.40128,0.0768723,432,1478980,0.166336,0.02,1,71261,70829,432
2721901,2.48026,6.41537,426,1480440,0.161267,0.02,1,71263,70837,426
2724821,2.09605,1.28307,428,1481900,0.128253,0.02,1,71265,70837,428
2727741,2.01921,0.256615,430,1483360,0.0896507,0.02,1,71267,70837,430
2730421,2.00384,0.051323,432,1484820,0.0499301,0.09,1,71269,70837,432
2733341,2.00077,7.21026,425,1486280,0.065986,0.09,1,71271,70846,425
2736261,2.00015,1.44205,427,1487740,0.0451972,0.09,1,71273,70846,427
2739181,2.00003,0.288411,429,1489200,0.145039,0.09,1,71275,70846,429
2741441,2.00001,0.0576821,431,1490660,0.141008,0.04,1,71277,70846,431
2744361,3.6,8.01154,425,1492120,0.164202,0.04,1,71281,70856,425
2747281,3.92,1.60231,429,1493580,0.11284,0.04,1,71285,70856,429
2749141,10.384,0.320461,441,1495040,0.0865681,0.08,1,71297,70856,441
2751221,8.4768,5.66409,442,1496500,0.265314,0.32,1,71305,70863,442
2754141,3.29536,9.93282,433,1497960,0.317063,0.32,1,71307,70874,433
2756421,2.25907,1.98656,435,1499420,0.303413,0.24,1,71309,70874,435
2759341,2.05181,9.19731,426,1500880,0.316683,0.24,1,71311,70885,426
2762261,2.01036,1.83946,428,1502340,0.335337,0.24,1,71313,70885,428
2765181,2.00207,0.367892,430,1503800,0.379067,0.24,1,71315,70885,430
2768101,2.00041,0.0735785,432,1505260,0.363813,0.24,1,71317,70885,432
2769941,2.80008,0.0147157,435,1506720,0.320763,0.21,1,71320,70885,435
2772861,2.16002,11.2029,423,1508180,0.352153,0.21,1,71322,70899,423
2775781,2.032,2.24059,425,1509640,0.32643,0.21,1,71324,70899,425
2778261,82.0064,0.448118,527,1511100,0.289286,0,1,71426,70899,527
2781181,18.0013,79.2896,430,1512560,0.305857,0,1,71428,70998,430
2784101,5.20026,15.8579,432,1514020,0.277171,0,1,71430,70998,432
2786581,3.44005,3.17158,435,1515480,0.335434,0.25,1,71433,70998,435
2789501,3.08801,3.83432,434,1516940,0.307087,0.25,1,71436,71002,434
2791361,1.4176,0.766863,435,1518400,0.285417,0.25,1,71437,71002,435
2794281,6.68352,10.5534,430,1519860,0.217083,0.25,1,71445,71015,430
2796561,2.9367,2.11067,432,1521320,0.179417,0.23,1,71447,71015,432
2798641,38.9873,44.4221,425,1522780,0.339883,0,1,71495,71070,425
2801561,125.397,128.884,422,1524240,0.0679767,0,1,71642,71220,422
2804481,26.6795,25.7769,424,1525700,0.0135953,0,1,71644,71220,424
2807401,6.9359,5.15538,426,1527160,0.114719,0,1,71646,71220,426
2810321,2.98718,1.03108,428,1528620,0.102944,0,1,71648,71220,428
2812161,1.39744,0.206215,429,1530080,0.0845888,0,1,71649,71220,429
2814241,1.87949,4.04124,426,1531540,0.0489178,0.09,1,71651,71225,426
2817161,8.3759,10.4082,424,1533000,0.00978355,0.09,1,71661,71237,424
2820081,4.87518,2.08165,428,1534460,0.0979567,0.09,1,71665,71237,428
2821941,4.97504,0.41633,433,1535920,0.0355913,0.18,1,71670,71237,433
2824861,2.59501,9.68327,423,1537380,0.0231183,0.18,1,71672,71249,423
2827781,2.119,1.93665,425,1538840,0.00462365,0.18,1,71674,71249,425
2830701,2.0238,0.387331,427,1540300,0.000924731,0.18,1,71676,71249,427
2833621,2.00476,0.0774661,429,1541760,0.000184946,0.18,1,71678,71249,429
2836541,2.00095,0.0154932,431,1543220,0.048037,0.18,1,71680,71249,431
2838581,5.20019,0.00309864,437,1544680,0.145607,0.16,1,71686,71249,437
2841501,2.64004,11.2006,425,1546140,0.133121,0.16,1,71688,71263,425
2844421,2.12801,2.24012,427,1547600,0.106624,0.16,1,71690,71263,427
2847341,2.0256,0.448025,429,1549060,0.0693249,0.16,1,71692,71263,429
2849601,2.00512,0.0896049,431,1550520,0.117865,0.06,1,71694,71263,431
2852521,2.00102,4.01792,428,1551980,0.103573,0.06,1,71696,71268,428
2855441,2.0002,0.803584,430,1553440,0.0687146,0.06,1,71698,71268,430
2857921,2.00004,0.160717,432,1554900,0.0857429,0.17,1,71700,71268,432
2860841,2.80001,10.4321,422,1556360,0.0491486,0.17,1,71703,71281,422
2863761,2.16,2.08643,424,1557820,0.00982972,0.17,1,71705,71281,424
2866681,2.032,0.417286,426,1559280,0.145966,0.17,1,71707,71281,426
2869601,2.0064,0.0834571,428,1560740,0.141193,0.17,1,71709,71281,428
2872481,2.00128,0.0166914,430,1562200,0.164239,0.02,1,71711,71281,430
2875401,9.20026,6.40334,433,1563660,0.160848,0.02,1,71722,71289,433
2877681,4.24005,1.28067,436,1565120,0.11217,0.33,1,71725,71289,436
2879761,16.848,12.2561,441,1566580,0.238434,0.35,1,71745,71304,441
2882681,5.7696,7.25123,438,1568040,0.303687,0.35,1,71748,71310,438
2885601,2.75392,1.45025,440,1569500,0.340737,0.35,1,71750,71310,440
2888501,2.15078,0.290049,442,1570960,0.364147,0.38,1,71752,71310,442
2891421,2.03016,8.85801,433,1572420,0.384829,0.38,1,71754,71321,433
2894341,2.00603,1.7716,435,1573880,0.356966,0.38,1,71756,71321,435
2897261,2.00121,0.35432,437,1575340,0.319393,0.38,1,71758,71321,437
2900181,2.00024,0.0708641,439,1576800,0.279879,0.38,1,71760,71321,439
2902021,2.80005,0.0141728,442,1578260,0.215976,0.3,1,71763,71321,442
2904941,2.16001,12.8028,428,1579720,0.291195,0.3,1,71765,71337,428
2906801,1.232,2.56057,429,1581180,0.290239,0.28,1,71766,71337,429
2909721,81.8464,80.5121,431,1582640,0.138048,0.28,1,71868,71437,431
2912641,17.9693,16.1024,433,1584100,0.22761,0.28,1,71870,71437,433
2915561,5.19386,3.22048,435,1585560,0.213522,0.28,1,71872,71437,435
2918481,2.63877,0.644097,437,1587020,0.186704,0.28,1,71874,71437,437
2920321,1.32775,0.128819,438,1588480,0.165341,0.17,1,71875,71437,438
2923241,7.46555,8.02576,437,1589940,0.129068,0.17,1,71884,71447,437
2925941,5.49311,1.60515,442,1591400,0.0418136,0.34,1,71889,71447,442
2927601,1.89862,7.52103,434,1592860,0.160363,0.4,1,71890,71456,434
2929681,37.9797,40.7042,432,1594320,0.296073,0.04,1,71937,71505,432
2932601,116.396,124.941,422,1595780,0.107215,0.04,1,72073,71651,422
2935521,24.8792,24.9882,424,1597240,0.157443,0.04,1,72075,71651,424
2938441,6.57584,4.99763,426,1598700,0.127489,0.04,1,72077,71651,426
2941361,2.91517,0.999527,428,1600160,0.0894977,0.04,1,72079,71651,428
2943201,1.38303,0.199905,429,1601620,0.0658995,0,1,72080,71651,429
2945281,2.67661,8.03998,422,1603080,0.0131799,0.04,1,72083,71661,422
2948201,6.93532,8.008,422,1604540,0.066636,0.04,1,72091,71669,422
2950481,2.98706,1.6016,424,1606000,0.0453272,0,1,72093,71669,424
2953401,6.99741,5.12032,426,1607460,0.00906544,0,1,72101,71675,426
2956321,2.99948,1.02406,428,1608920,0.0498131,0,1,72103,71675,428
2958801,2.1999,0.204813,430,1610380,0.0259626,0.13,1,72105,71675,430
2961721,2.03998,5.64096,425,1611840,0.00519252,0.13,1,72107,71682,425
2964641,2.008,1.12819,427,1613300,0.0490385,0.13,1,72109,71682,427
2967121,2.0016,0.225638,429,1614760,0.0258077,0.1,1,72111,71682,429
2970041,6.00032,11.2451,422,1616220,0.00516154,0.1,1,72118,71696,422
2972961,2.80006,2.24903,424,1617680,0.00103231,0.1,1,72120,71696,424
2975881,2.16001,0.449805,426,1619140,0.144206,0.1,1,72122,71696,426
2978801,2.032,0.089961,428,1620600,0.140841,0.1,1,72124,71696,428
2980641,1.2064,0.0179922,429,1622060,0.148168,0.11,1,72125,71696,429
2983561,1.84128,2.4036,428,1623520,0.117634,0.11,1,72127,71699,428
2985841,1.96826,0.48072,430,1624980,0.0795267,0.19,1,72129,71699,430
2988761,2.79365,8.89614,422,1626440,0.111905,0.19,1,72132,71710,422
2991681,2.15873,1.77923,424,1627900,0.102381,0.19,1,72134,71710,424
2994601,2.03175,0.355846,426,1629360,0.0684762,0.19,1,72136,71710,426
2997521,2.00635,0.0711691,428,1630820,0.0136952,0.19,1,72138,71710,428
3000401,2.00127,0.0142338,430,1632280,0.00273905,0.18,1,72140,71710,430
3003321,2.00025,8.00285,422,1633740,0.00054781,0.18,1,72142,71720,422
3004981,8.40005,1.60057,432,1635200,0.12011,0.1,1,72152,71720,432
3007061,15.28,4.32011,444,1636660,0.256022,0.15,1,72169,71725,444
3008721,3.856,8.86402,435,1638120,0.299204,0.39,1,72170,71735,435
3011641,12.7712,16.9728,431,1639580,0.435841,0.39,1,72185,71754,431
3014561,4.15424,3.39456,433,1641040,0.487168,0.39,1,72187,71754,433
3017481,2.43085,0.678912,435,1642500,0.497434,0.39,1,72189,71754,435
3019121,1.28617,0.135782,436,1643960,0.531487,0.29,1,72190,71754,436
3022041,1.85723,4.02716,433,1645420,0.554297,0.29,1,72192,71759,433
3024961,1.97145,0.805431,435,1646880,0.574859,0.29,1,72194,71759,435
3027441,1.99429,0.161086,437,1648340,0.546972,0.25,1,72196,71759,437
3030361,6.79886,12.0322,430,1649800,0.517394,0.25,1,72204,71774,430
3033281,2.95977,2.40644,432,1651260,0.479479,0.25,1,72206,71774,432
3036201,2.19195,0.481289,434,1652720,0.439896,0.25,1,72208,71774,434
3037841,1.23839,0.0962577,435,1654180,0.415979,0.23,1,72209,71774,435
3040761,74.6477,84.0193,423,1655640,0.531196,0.23,1,72302,71879,423
3043681,16.5295,16.8038,425,1657100,0.530239,0.23,1,72304,71879,425
3046601,4.90591,3.36077,427,1658560,0.490048,0.23,1,72306,71879,427
3049521,2.58118,0.672154,429,1660020,0.45001,0.23,1,72308,71879,429
3051361,1.31624,0.134431,430,1661480,0.426002,0.14,1,72309,71879,430
3054281,7.46325,11.2269,425,1662940,0.4532,0.14,1,72318,71893,425
3057201,3.09265,2.24538,427,1664400,0.42664,0.14,1,72320,71893,427
3060101,50.2185,0.449075,489,1665860,0.565328,0.21,1,72382,71893,489
3062181,104.444,42.4898,554,1667320,0.465066,0.08,1,72500,71946,554
3065101,22.4887,114.898,423,1668780,0.501013,0.08,1,72502,72079,423
3068021,6.09775,22.9796,425,1670240,0.476203,0.08,1,72504,72079,425
3070501,7.61955,4.59592,433,1671700,0.367241,0.08,1,72512,72079,433
3073421,3.12391,10.5192,423,1673160,0.313448,0.08,1,72514,72091,423
3076321,2.22478,2.10384,425,1674620,0.35869,0,1,72516,72091,425
3079241,3.64496,6.02077,422,1676080,0.303738,0,1,72520,72098,422
3081521,2.32899,1.20415,424,1677540,0.260748,0.02,1,72522,72098,424
3084441,9.2658,10.6408,422,1679000,0.10015,0.02,1,72533,72111,422
3087361,3.45316,2.12817,424,1680460,0.18803,0.02,1,72535,72111,424
3090281,2.29063,0.425633,426,1681920,0.181606,0.02,1,72537,72111,426
3093201,2.05813,0.0851266,428,1683380,0.148321,0.02,1,72539,72111,428
3095041,1.21163,0.0170253,429,1684840,0.125664,0,1,72540,72111,429
3097961,5.04233,7.20341,426,1686300,0.0411328,0,1,72546,72120,426
3100241,2.60847,1.44068,428,1687760,0.104227,0.12,1,72548,72120,428
3103161,5.32169,9.88814,422,1689220,0.0208453,0.12,1,72554,72132,422
3106081,2.66434,1.97763,424,1690680,0.132169,0.12,1,72556,72132,424
3109001,2.13287,0.395525,426,1692140,0.122434,0.12,1,72558,72132,426
3111921,2.02657,0.0791051,428,1693600,0.0884868,0.12,1,72560,72132,428
3114841,2.00531,0.015821,430,1695060,0.0496974,0.12,1,72562,72132,430
3116881,2.00106,0.0031642,432,1696520,0.0659395,0,1,72564,72132,432
3119801,2.00021,4.80063,428,1697980,0.0851879,0,1,72566,72138,428
3122721,2.00004,0.960127,430,1699440,0.0570376,0,1,72568,72138,430
3125201,2.00001,0.192025,432,1700900,0.0274075,0.19,1,72570,72138,432
3128121,4.4,9.63841,425,1702360,0.149482,0.19,1,72575,72150,425
3131041,2.48,1.92768,427,1703820,0.141896,0.19,1,72577,72150,427
3133521,2.096,0.385536,429,1705280,0.108379,0.08,1,72579,72150,429
3135601,14.0192,7.27711,437,1706740,0.189676,0.31,1,72596,72159,437
3137681,16.4038,10.2554,443,1708200,0.333935,0.45,1,72613,72170,443
3139761,12.8808,8.45108,447,1709660,0.418787,0.51,1,72625,72178,447
3141841,11.3762,8.09022,450,1711120,0.491757,0.54,1,72636,72186,450
3144761,3.87523,4.81804,448,1712580,0.522352,0.54,1,72638,72190,448
3147681,2.37505,0.963609,450,1714040,0.54447,0.54,1,72640,72190,450
3149541,1.27501,0.192722,451,1715500,0.532894,0.56,1,72641,72190,451
3152461,1.855,8.83854,442,1716960,0.570579,0.56,1,72643,72201,442
3155381,1.971,1.76771,444,1718420,0.594116,0.56,1,72645,72201,444
3158301,1.9942,0.353542,446,1719880,0.566823,0.56,1,72647,72201,446
3159941,5.99884,0.0707083,453,1721340,0.529365,0.5,1,72654,72201,453
3162861,2.79977,8.81414,444,1722800,0.497873,0.5,1,72656,72212,444
3165781,2.15995,1.76283,446,1724260,0.547575,0.5,1,72658,72212,446
3168701,2.03199,0.352566,448,1725720,0.525515,0.5,1,72660,72212,448
3170341,74.8064,0.0705131,541,1727180,0.393103,0.57,1,72753,72212,541
3173261,16.5613,80.0141,443,1728640,0.342621,0.57,1,72755,72312,443
3176181,4.91226,16.0028,445,1730100,0.300524,0.57,1,72757,72312,445
3179101,2.58245,3.20056,447,1731560,0.492105,0.57,1,72759,72312,447
3182021,2.11649,0.640113,449,1733020,0.498421,0.57,1,72761,72312,449
3183861,7.6233,0.128023,458,1734480,0.539684,0.4,1,72770,72312,458
3186781,3.12466,7.2256,451,1735940,0.507937,0.4,1,72772,72321,451
3189061,52.6249,1.44512,516,1737400,0.549587,0.65,1,72837,72321,516
3190721,11.325,54.689,449,1738860,0.533917,0.45,1,72838,72389,449
3193641,85.465,103.738,437,1740320,0.530783,0.45,1,72942,72505,437
3196561,18.693,20.7476,439,1741780,0.642157,0.45,1,72944,72505,439
3199041,5.3386,4.14951,441,1743240,0.632431,0.22,1,72946,72505,441
3201961,2.66772,16.0299,424,1744700,0.598486,0.22,1,72948,72524,424
3204881,2.13354,3.20598,426,1746160,0.559697,0.22,1,72950,72524,426
3207801,2.02671,0.641196,428,1747620,0.519939,0.22,1,72952,72524,428
3210721,2.00534,0.128239,430,1749080,0.479988,0.22,1,72954,72524,430
3212561,1.20107,0.0256478,431,1750540,0.471998,0.21,1,72955,72524,431
3214641,1.84021,8.80513,422,1752000,0.5824,0.04,1,72957,72535,422
3217561,9.16804,8.96103,424,1753460,0.58848,0.04,1,72968,72544,424
3220481,3.43361,1.79221,426,1754920,0.565696,0.04,1,72970,72544,426
3223401,2.28672,0.358441,428,1756380,0.529139,0.04,1,72972,72544,428
3226081,2.05734,0.0716882,430,1757840,0.545828,0.04,1,72974,72544,430
3229001,2.01147,6.41434,424,1759300,0.589166,0.04,1,72976,72552,424
3231281,2.00229,1.28287,426,1760760,0.565833,0.07,1,72978,72552,426
3234201,6.80046,9.85657,422,1762220,0.633167,0.07,1,72986,72564,422
3237121,2.96009,1.97131,424,1763680,0.614633,0.07,1,72988,72564,424
3240041,2.19202,0.394263,426,1765140,0.586927,0.07,1,72990,72564,426
3242961,2.0384,0.0788526,428,1766600,0.549385,0.07,1,72992,72564,428
3245841,2.00768,0.0157705,430,1768060,0.565877,0,1,72994,72564,430
3248761,2.00154,5.60315,425,1769520,0.545175,0,1,72996,72571,425
3251681,2.00031,1.12063,427,1770980,0.509035,0,1,72998,72571,427
3254601,2.00006,0.224126,429,1772440,0.533807,0,1,73000,72571,429
3256241,1.20001,0.0448252,430,1773900,0.522761,0.14,1,73001,72571,430
3258321,4.24,4.80897,429,1775360,0.448552,0.2,1,73006,72577,429
3261241,7.248,7.36179,429,1776820,0.56971,0.2,1,73014,72585,429
3264161,3.0496,1.47236,431,1778280,0.561942,0.2,1,73016,72585,431
3266021,16.6099,0.294472,451,1779740,0.592388,0.31,1,73036,72585,451
3268101,24.922,12.0589,463,1781200,0.590478,0.46,1,73063,72600,463
3270181,20.1844,16.8118,464,1782660,0.574096,0.59,1,73082,72618,464
3272261,8.03688,14.5624,455,1784120,0.666819,0.53,1,73087,72632,455
3275181,3.20738,10.1125,448,1785580,0.653364,0.53,1,73089,72641,448
3278081,2.24148,2.02249,450,1787040,0.626673,0.58,1,73091,72641,450
3281001,2.0483,4.4045,447,1788500,0.597335,0.58,1,73093,72646,447
3283921,2.00966,0.8809,449,1789960,0.559467,0.58,1,73095,72646,449
3286401,2.00193,0.17618,451,1791420,0.679893,0.58,1,73097,72646,451
3289321,6.80039,8.83524,448,1792880,0.647979,0.58,1,73105,72657,448
3292241,2.96008,1.76705,450,1794340,0.657596,0.58,1,73107,72657,450
3295141,4.59202,0.353409,455,1795800,0.699519,0.54,1,73112,72657,455
3298061,2.5184,9.67068,445,1797260,0.691904,0.54,1,73114,72669,445
3300341,66.1037,1.93414,527,1798720,0.746381,0.56,1,73196,72669,527
3303261,14.8207,71.5868,440,1800180,0.725276,0.56,1,73198,72758,440
3306181,4.56415,14.3174,442,1801640,0.689055,0.56,1,73200,72758,442
3308661,8.11283,2.86347,451,1803100,0.737811,0.39,1,73209,72758,451
3311581,3.22257,6.97269,445,1804560,0.723562,0.39,1,73211,72766,445
3313861,9.44451,1.39454,456,1806020,0.776712,0.47,2,73222,72766,456
3316781,3.4889,9.07891,447,1807480,0.755342,0.47,2,73224,72777,447
3319061,59.0978,1.81578,520,1808940,0.783068,0.56,2,73297,72777,520
3321761,13.4196,58.7632,449,1810400,0.756614,0.67,2,73299,72850,449
3323841,75.4839,86.9526,446,1811860,0.783323,0.57,2,73390,72944,446
3326761,23.8968,21.3905,452,1813320,0.796664,0.57,2,73401,72949,452
3329681,6.37936,4.2781,454,1814780,0.759333,0.57,2,73403,72949,454
3332161,2.87587,0.855621,456,1816240,0.719867,0.49,1,73405,72949,456
3335081,2.17517,3.37112,454,1817700,0.671973,0.49,1,73407,72953,454
3338001,2.03503,0.674225,456,1819160,0.654395,0.49,1,73409,72953,456
3339861,4.40701,0.134845,461,1820620,0.722879,0.67,1,73414,72953,461
3342781,2.4814,8.82697,452,1822080,0.696576,0.67,1,73416,72964,452
3345681,2.09628,1.76539,454,1823540,0.667315,0.54,1,73418,72964,454
3348601,5.21926,5.95308,453,1825000,0.685463,0.54,1,73424,72971,453
3350881,2.64385,1.19062,455,1826460,0.657093,0.62,1,73426,72971,455
3353801,2.12877,3.43812,453,1827920,0.619419,0.62,1,73428,72975,453
3356721,2.02575,0.687625,455,1829380,0.587884,0.62,1,73430,72975,455
3358581,4.40515,0.137525,460,1830840,0.701577,0.61,1,73435,72975,460
3361501,2.48103,10.4275,449,1832300,0.692315,0.61,1,73437,72988,449
3364401,2.09621,2.0855,451,1833760,0.658463,0.54,1,73439,72988,451
3367321,2.01924,10.0171,441,1835220,0.683693,0.54,1,73441,73000,441
3370241,2.00385,2.00342,443,1836680,0.664739,0.54,1,73443,73000,443
3373161,2.00077,0.400684,445,1838140,0.684948,0.54,1,73445,73000,445
3376081,2.00015,0.0801368,447,1839600,0.65699,0.54,1,73447,73000,447
3379001,2.00003,0.0160274,449,1841060,0.619398,0.54,1,73449,73000,449
3381921,2.00001,0.00320547,451,1842520,0.66788,0.54,1,73451,73000,451
3383541,7.6,0.000641094,460,1843980,0.557576,0.61,1,73460,73000,460
3386461,3.12,8.00013,452,1845440,0.503515,0.61,1,73462,73010,452
3389361,2.224,1.60003,454,1846900,0.676703,0.62,1,73464,73010,454
3392281,8.4448,10.72,451,1848360,0.719341,0.62,1,73474,73023,451
3394561,3.28896,2.144,453,1849820,0.695868,0.69,1,73476,73023,453
3396641,20.6578,16.4288,458,1851280,0.763174,0.69,2,73501,73043,458
3398721,31.3316,28.8858,460,1852740,0.632635,0.62,1,73535,73075,460
3401641,15.8663,18.5772,456,1854200,0.718527,0.62,1,73547,73091,456
3404561,4.77326,3.71543,458,1855660,0.703705,0.62,1,73549,73091,458
3407461,4.15465,0.743086,462,1857120,0.700741,0.69,1,73553,73091,462
3410381,2.43093,5.74862,457,1858580,0.660148,0.69,1,73555,73098,457
3413301,2.08619,1.14972,459,1860040,0.73203,0.69,1,73557,73098,459
3416221,2.01724,0.229945,461,1861500,0.714406,0.69,1,73559,73098,461
3418901,10.0034,0.0459889,473,1862960,0.622881,0.74,1,73571,73098,473
3421821,3.60069,15.2092,456,1864420,0.692576,0.74,1,73573,73117,456
3424741,2.32014,3.04184,458,1865880,0.674515,0.74,1,73575,73117,458
3427661,2.06403,0.608368,460,1867340,0.646903,0.74,1,73577,73117,460
3430341,72.4128,0.121674,550,1868800,0.585381,0.72,1,73667,73117,550
3433261,16.0826,75.2243,458,1870260,0.541076,0.72,1,73669,73211,458
3436181,4.81651,15.0449,460,1871720,0.508215,0.72,1,73671,73211,460
3439101,2.5633,3.00897,462,1873180,0.669643,0.72,1,73673,73211,462
3440741,3.71266,0.601795,466,1874640,0.637929,0.75,1,73677,73211,466
3443661,2.34253,12.9204,452,1876100,0.607586,0.75,1,73679,73227,452
3446581,2.06851,2.58407,454,1877560,0.569517,0.75,1,73681,73227,454
3449061,62.8137,0.516814,532,1879020,0.497903,0.78,1,73759,73227,532
3451981,15.7627,64.1034,456,1880480,0.659581,0.78,1,73763,73307,456
3454261,73.5525,12.8207,544,1881940,0.627916,0.67,1,73851,73307,544
3456341,23.5105,75.3641,464,1883400,0.613583,0.65,1,73862,73398,464
3459261,6.3021,23.8728,455,1884860,0.578717,0.65,1,73864,73409,455
3462181,2.86042,4.77457,457,1886320,0.563743,0.65,1,73866,73409,457
3465101,2.17208,0.954913,459,1887780,0.536749,0.65,1,73868,73409,459
3466741,1.23442,0.190983,460,1889240,0.69935,0.75,1,73869,73409,460
3469661,1.84688,9.6382,450,1890700,0.69187,0.75,1,73871,73421,450
3472581,1.96938,1.92764,452,1892160,0.658374,0.75,1,73873,73421,452
3475501,1.99388,0.385528,454,1893620,0.619675,0.75,1,73875,73421,454
3478181,5.99877,0.0771056,461,1895080,0.587935,0.59,1,73882,73421,461
3481101,2.79975,6.41542,455,1896540,0.645587,0.59,1,73884,73429,455
3484001,2.15995,1.28308,457,1898000,0.625117,0.65,1,73886,73429,457
3486921,5.23199,8.25662,453,1899460,0.717023,0.65,1,73892,73439,453
3489841,2.6464,1.65132,455,1900920,0.695405,0.65,1,73894,73439,455
3492321,2.12928,0.330265,457,1902380,0.667081,0.63,1,73896,73439,457
3495241,3.62586,11.2661,447,1903840,0.597416,0.63,1,73900,73453,447
3498161,2.32517,2.25321,449,1905300,0.551483,0.63,1,73902,73453,449
3501081,2.06503,0.450642,451,1906760,0.614297,0.63,1,73904,73453,451
3504001,2.01301,0.0901284,453,1908220,0.594859,0.63,1,73906,73453,453
3506921,2.0026,0.0180257,455,1909680,0.638972,0.63,1,73908,73453,455
3509841,2.00052,0.00360514,457,1911140,0.615794,0.63,1,73910,73453,457
3512081,2.0001,0.000721027,459,1912600,0.579159,0.68,1,73912,73453,459
3515001,10,10.4001,458,1914060,0.619832,0.68,1,73924,73466,458
3517921,3.6,2.08003,460,1915520,0.595966,0.68,1,73926,73466,460
3520401,2.32,0.416006,462,1916980,0.567193,0.8,1,73928,73466,462
3523321,8.464,13.6832,455,1918440,0.681439,0.8,1,73938,73483,455
3525601,3.2928,2.73664,457,1919900,0.680288,0.69,1,73940,73483,457
3527681,20.6586,18.9473,459,1921360,0.680058,0.72,1,73965,73506,459
3529761,31.3317,31.7895,458,1922820,0.728011,0.75,1,73999,73541,458
3532681,13.4663,14.3579,457,1924280,0.697602,0.75,1,74008,73551,457
3534961,4.29327,2.87158,459,1925740,0.66752,0.74,1,74010,73551,459
3537881,5.65865,8.57432,455,1927200,0.725504,0.74,1,74016,73561,455
3540801,2.73173,1.71486,457,1928660,0.721101,0.74,1,74018,73561,457
3543721,2.14635,0.342973,459,1930120,0.68822,0.74,1,74020,73561,459
3546401,2.02927,0.0685945,461,1931580,0.721644,0.71,1,74022,73561,461
3549321,6.80585,9.61372,457,1933040,0.728329,0.71,1,74030,73573,457
3550981,2.16117,1.92274,458,1934500,0.713666,0.64,1,74031,73573,458
3553901,2.03223,3.58455,456,1935960,0.678733,0.64,1,74033,73577,456
3555761,1.20645,0.71691,457,1937420,0.655747,0.69,1,74034,73577,457
3557841,5.04129,2.54338,460,1938880,0.731149,0.65,1,74040,73580,460
3560761,71.4083,77.3087,452,1940340,0.73023,0.65,1,74128,73676,452
3563681,15.8817,15.4617,454,1941800,0.698046,0.65,1,74130,73676,454
3566601,4.77633,3.09235,456,1943260,0.659609,0.65,1,74132,73676,456
3569281,2.55527,0.618469,458,1944720,0.779922,0.72,2,74134,73676,458
3572201,6.11105,8.12369,455,1946180,0.683984,0.72,1,74141,73686,455
3575121,2.82221,1.62474,457,1947640,0.688797,0.72,1,74143,73686,457
3577601,2.16444,0.324948,459,1949100,0.649759,0.59,1,74145,73686,459
3580521,60.4329,66.465,451,1950560,0.665952,0.59,1,74220,73769,451
3582801,13.6866,13.293,453,1952020,0.78119,0.76,2,74222,73769,453
3584881,68.3373,71.4586,449,1953480,0.636238,0.53,1,74304,73855,449
3587801,24.8675,24.6917,450,1954940,0.767248,0.53,2,74318,73868,450
3590721,6.57349,4.93834,452,1956400,0.76145,0.53,2,74320,73868,452
3593201,2.9147,0.987669,454,1957860,0.72829,0.61,1,74322,73868,454
3596121,6.98294,9.79753,450,1959320,0.785658,0.61,2,74330,73880,450
3599041,2.99659,1.95951,452,1960780,0.789132,0.61,2,74332,73880,452
3601961,2.19932,0.391901,454,1962240,0.845826,0.61,2,74334,73880,454
3604881,2.03986,0.0783803,456,1963700,0.849165,0.61,2,74336,73880,456
3607141,5.20797,0.0156761,462,1965160,0.761833,0.74,2,74342,73880,462
3610061,2.64159,9.60314,452,1966620,0.784367,0.74,2,74344,73892,452
3612981,2.12832,1.92063,454,1968080,0.756873,0.74,2,74346,73892,454
3615041,2.02566,0.384125,456,1969540,0.719375,0.59,1,74348,73892,456
3617961,5.20513,11.2768,448,1971000,0.751875,0.59,2,74354,73906,448
3620881,2.64103,2.25536,450,1972460,0.782375,0.59,2,74356,73906,450
3623801,2.12821,0.451073,452,1973920,0.756475,0.59,2,74358,73906,452
3626721,2.02564,0.0902146,454,1975380,0.847295,0.59,2,74360,73906,454
3629641,2.00513,0.0180429,456,1976840,0.841459,0.59,2,74362,73906,456
3631681,2.00103,0.00360858,458,1978300,0.816292,0.73,2,74364,73906,458
3634601,4.40021,10.4007,450,1979760,0.787258,0.73,2,74369,73919,450
3637521,2.48004,2.08014,452,1981220,0.749452,0.73,1,74371,73919,452
3640441,2.09601,0.416029,454,1982680,0.82989,0.73,2,74373,73919,454
3643121,2.0192,0.0832058,456,1984140,0.821978,0.65,2,74375,73919,456
3646041,10.0038,9.61664,456,1985600,0.860396,0.65,2,74387,73931,456
3648961,3.60077,1.92333,458,1987060,0.828079,0.65,2,74389,73931,458
3651441,2.32015,0.384666,460,1988520,0.789616,0.68,2,74391,73931,460
3654361,9.26403,11.2769,457,1989980,0.837923,0.68,2,74402,73945,457
3656641,3.45281,2.25539,459,1991440,0.815585,0.73,2,74404,73945,459
3658721,25.4906,26.8511,457,1992900,0.883117,0.71,2,74435,73978,457
3660801,29.8981,28.5702,459,1994360,0.856623,0.72,2,74466,74007,459
3663721,10.7796,14.514,454,1995820,0.851325,0.72,2,74472,74018,454
3666641,3.75592,2.90281,456,1997280,0.858265,0.72,2,74474,74018,456
3669541,5.55119,0.580562,462,1998740,0.835653,0.68,2,74480,74018,462
3672461,2.71024,4.91611,458,2000200,0.791131,0.68,2,74482,74024,458
3675381,2.14205,0.983222,460,2001660,0.790226,0.68,2,74484,74024,460
3677441,2.02841,0.196644,462,2003120,0.758045,0.74,2,74486,74024,462
3680361,5.20568,9.63933,456,2004580,0.799609,0.74,2,74492,74036,456
3683281,2.64114,1.92787,458,2006040,0.783922,0.74,2,74494,74036,458
3686201,2.12823,0.385573,460,2007500,0.868784,0.74,2,74496,74036,460
3688261,5.22565,0.0771146,466,2008960,0.797757,0.71,2,74502,74036,466
3690341,67.4451,4.81542,543,2010420,0.791551,0.67,2,74585,74042,543
3693261,15.089,72.1631,456,2011880,0.76631,0.67,2,74587,74131,456
3695541,10.2178,14.4326,465,2013340,0.841262,0.71,2,74596,74131,465
3698461,5.24356,11.6865,458,2014800,0.792252,0.71,2,74600,74142,458
3701381,3.44871,2.3373,461,2016260,0.74245,0.71,1,74603,74142,461
3703861,2.28974,0.467461,463,2017720,0.70049,0.78,1,74605,74142,463
3706781,2.05795,8.89349,454,2019180,0.836098,0.78,2,74607,74153,454
3708641,1.21159,1.7787,455,2020640,0.84722,0.76,2,74608,74153,455
3711561,69.8423,65.9557,460,2022100,0.865444,0.76,2,74695,74235,460
3713841,16.3685,13.1911,463,2023560,0.829089,0.7,2,74698,74235,463
3715921,63.2737,64.2382,461,2025020,0.893818,0.73,2,74773,74312,461
3718841,23.8547,21.6476,464,2026480,0.802764,0.73,2,74787,74323,464
3721761,6.37095,4.32953,466,2027940,0.808553,0.73,2,74789,74323,466
3724241,2.87419,0.865906,468,2029400,0.889711,0.8,2,74791,74323,468
3727161,6.97484,12.9732,460,2030860,0.785942,0.8,2,74799,74339,460
3730081,2.99497,2.59464,462,2032320,0.733188,0.8,1,74801,74339,462
3733001,2.19899,0.518927,464,2033780,0.834638,0.8,2,74803,74339,464
3735681,2.0398,0.103785,466,2035240,0.830928,0.85,2,74805,74339,466
3738601,5.20796,8.02076,462,2036700,0.774185,0.85,2,74811,74349,462
3741521,2.64159,1.60415,464,2038160,0.738837,0.85,1,74813,74349,464
3744441,2.12832,0.32083,466,2039620,0.699767,0.85,1,74815,74349,466
3746081,1.22566,0.064166,467,2041080,0.675954,0.85,1,74816,74349,467
3749001,5.04513,9.61283,461,2042540,0.759191,0.85,2,74822,74361,461
3751921,2.60903,1.92257,463,2044000,0.743838,0.85,1,74824,74361,463
3754841,2.12181,0.384513,465,2045460,0.708768,0.85,1,74826,74361,465
3757521,2.02436,0.0769027,467,2046920,0.677754,0.82,1,74828,74361,467
3760441,5.20487,11.2154,459,2048380,0.823551,0.82,2,74834,74375,459
3763361,2.64097,2.24308,461,2049840,0.82871,0.82,2,74836,74375,461
3766281,2.12819,0.448615,463,2051300,0.797742,0.82,2,74838,74375,463
3769201,2.02564,0.089723,465,2052760,0.887548,0.82,2,74840,74375,465
3771041,1.20513,0.0179446,466,2054220,0.89751,0.71,2,74841,74375,466
3773961,1.84103,4.80359,462,2055680,0.867502,0.71,2,74843,74381,462
3775621,8.36821,0.960718,472,2057140,0.7815,0.82,2,74853,74381,472
3777701,8.87364,6.59214,473,2058600,0.8043,0.9,2,74862,74389,473
3780621,3.37473,9.31843,465,2060060,0.77686,0.9,2,74864,74399,465
3782481,1.47495,1.86369,466,2061520,0.883372,0.85,2,74865,74399,466
3785401,1.89499,7.57274,459,2062980,0.872674,0.85,2,74867,74408,459
3787681,1.979,1.51455,461,2064440,0.838535,0.73,2,74869,74408,461
3789761,29.9958,28.3029,463,2065900,0.791707,0.88,2,74906,74443,463
3792681,29.9992,29.6606,463,2067360,0.806341,0.88,2,74936,74473,463
3795381,11.5998,5.93212,470,2068820,0.705268,0.81,1,74943,74473,470
3798301,3.91997,7.58642,464,2070280,0.837054,0.81,2,74945,74481,464
3800161,1.58399,1.51728,465,2071740,0.903411,0.77,2,74946,74481,465
3803081,3.5168,3.50346,465,2073200,0.844682,0.77,2,74950,74485,465
3806001,2.30336,0.700691,467,2074660,0.800936,0.77,2,74952,74485,467
3807861,4.46067,0.140138,472,2076120,0.768187,0.86,2,74957,74485,472
3810781,2.49213,10.428,461,2077580,0.785637,0.86,2,74959,74498,461
3813701,2.09843,2.08561,463,2079040,0.757127,0.86,2,74961,74498,463
3816621,2.01969,0.417121,465,2080500,0.799425,0.86,2,74963,74498,465
3818261,1.20394,0.0834242,466,2081960,0.791885,0.76,2,74964,74498,466
3820341,69.0408,4.01668,547,2083420,0.870377,0.87,2,75050,74503,547
3823261,15.4082,74.4033,457,2084880,0.854075,0.87,2,75052,74595,457
3825541,11.0816,14.8807,467,2086340,0.906815,0.75,2,75062,74595,467
3828461,3.81633,8.57613,462,2087800,0.877363,0.75,2,75064,74602,462
3830741,3.16327,1.71523,465,2089260,0.831473,0.89,2,75067,74602,465
3833661,3.83265,3.54305,465,2090720,0.878295,0.89,2,75071,74606,465
3835941,3.16653,0.708609,468,2092180,0.839659,0.85,2,75074,74606,468
3838861,2.23331,4.94172,464,2093640,0.799932,0.85,2,75076,74612,464
3841141,71.6467,0.988344,553,2095100,0.743986,0.68,1,75165,74612,553
3844061,15.9293,75.3977,461,2096560,0.700797,0.68,1,75167,74706,461
3846341,63.9859,15.0795,537,2098020,0.732159,0.78,1,75243,74706,537
3848421,19.1972,62.2159,471,2099480,0.762432,0.91,2,75251,74780,471
3851341,7.03943,21.2432,464,2100940,0.704486,0.91,1,75255,74791,464
3853621,5.40789,4.24864,469,2102400,0.708897,0.79,1,75260,74791,469
3855281,1.88158,5.64973,464,2103860,0.693779,0.84,1,75261,74797,464
3858201,5.97632,9.12995,461,2105320,0.722756,0.84,1,75268,74807,461
3861121,2.79526,1.82599,463,2106780,0.704551,0.84,1,75270,74807,463
3864041,2.15905,0.365198,465,2108240,0.72491,0.84,1,75272,74807,465
3866721,2.03181,0.0730396,467,2109700,0.696982,0.87,1,75274,74807,467
3869641,2.00636,8.81461,458,2111160,0.755396,0.87,2,75276,74818,458
3872561,2.00127,1.76292,460,2112620,0.735079,0.87,1,75278,74818,460
3875481,2.00025,0.352584,462,2114080,0.699016,0.87,1,75280,74818,462
3877121,1.20005,0.0705169,463,2115540,0.675803,0.8,1,75281,74818,463
3880041,7.44001,8.8141,461,2117000,0.679161,0.8,1,75290,74829,461
3882961,3.088,1.76282,463,2118460,0.639832,0.8,1,75292,74829,463
3885881,2.2176,0.352564,465,2119920,0.599966,0.8,1,75294,74829,465
3888561,2.04352,0.0705128,467,2121380,0.567993,0.83,1,75296,74829,467
3890641,5.2087,5.6141,466,2122840,0.657599,0.84,1,75302,74836,466
3893561,4.24174,11.5228,457,2124300,0.61952,0.84,1,75306,74849,457
3896481,2.44835,2.30456,459,2125760,0.827904,0.84,2,75308,74849,459
3899401,2.08967,0.460913,461,2127220,0.837581,0.84,2,75310,74849,461
3902321,2.01793,0.0921826,463,2128680,0.815516,0.84,2,75312,74849,463
3904161,1.20359,0.0184365,464,2130140,0.795103,0.85,2,75313,74849,464
3906241,9.04072,8.80369,464,2131600,0.839021,0.86,2,75324,74860,464
3909161,9.00814,12.9607,459,2133060,0.735804,0.86,1,75333,74874,459
3912081,3.40163,2.59215,461,2134520,0.683161,0.86,1,75335,74874,461
3915001,2.28033,0.518429,463,2135980,0.784632,0.86,2,75337,74874,463
3917921,2.05607,0.103686,465,2137440,0.780926,0.86,2,75339,74874,465
3920181,34.0112,0.0207372,507,2138900,0.732185,0.81,1,75381,74874,507
3922261,26.0022,35.2041,487,2140360,0.706437,0.88,1,75405,74918,487
3925181,6.80045,27.8408,463,2141820,0.677287,0.88,1,75407,74944,463
3927461,6.16009,5.56817,469,2143280,0.759457,0.79,2,75413,74944,469
3930381,2.83202,7.51363,463,2144740,0.863892,0.79,2,75415,74952,463
3933281,2.1664,1.50273,465,2146200,0.852778,0.81,2,75417,74952,465
3936201,5.23328,9.10055,460,2147660,0.754556,0.81,2,75423,74963,460
3939121,2.64666,1.82011,462,2149120,0.702911,0.81,1,75425,74963,462
3942041,2.12933,0.364022,464,2150580,0.660582,0.81,1,75427,74963,464
3944721,2.02587,0.0728044,466,2152040,0.676116,0.82,1,75429,74963,466
3947641,10.8052,8.81456,468,2153500,0.783223,0.82,2,75442,74974,468
3950341,66.961,1.76291,549,2154960,0.812645,0.96,2,75523,74974,549
3953261,14.9922,69.1526,465,2156420,0.786529,0.96,2,75525,75060,465
3955541,7.79844,13.8305,471,2157880,0.781306,0.87,2,75531,75060,471
3958461,3.15969,9.9661,464,2159340,0.756261,0.87,2,75533,75069,464
3961361,2.23194,1.99322,466,2160800,0.727252,0.77,1,75535,75069,466
3964281,6.84639,13.1986,458,2162260,0.79345,0.77,2,75543,75085,458
3967201,4.56928,2.63973,462,2163720,0.79869,0.77,2,75547,75085,462
3969681,3.31386,0.527946,465,2165180,0.759738,0.76,2,75550,75085,465
3972601,67.0628,72.1056,458,2166640,0.839948,0.76,2,75633,75175,458
3974881,15.0126,14.4211,460,2168100,0.847989,0.68,2,75635,75175,460
3976961,59.0025,59.6842,459,2169560,0.729598,0.71,1,75705,75246,459
3979881,23.0005,23.1368,459,2171020,0.70592,0.71,1,75719,75260,459
3982161,6.2001,4.62737,461,2172480,0.829184,0.73,2,75721,75260,461
3985081,9.24002,10.5255,459,2173940,0.829837,0.73,2,75731,75272,459
3988001,3.448,2.10509,461,2175400,0.893967,0.73,2,75733,75272,461
3990921,2.2896,0.421019,463,2176860,0.874793,0.73,2,75735,75272,463
3992981,2.05792,0.0842038,465,2178320,0.838959,0.76,2,75737,75272,465
3995901,2.01158,11.2168,453,2179780,0.799792,0.76,2,75739,75286,453
3998821,2.00232,2.24337,455,2181240,0.751958,0.76,2,75741,75286,455
4001741,2.00046,0.448674,457,2182700,0.854392,0.76,2,75743,75286,457
4004661,2.00009,0.0897347,459,2184160,0.842878,0.76,2,75745,75286,459
4007581,2.00002,0.0179469,461,2185620,0.808576,0.76,2,75747,75286,461
4009621,8.4,0.00358939,471,2187080,0.777715,0.77,2,75757,75286,471
4012541,3.28,8.80072,462,2188540,0.827543,0.77,2,75759,75297,462
4015461,2.256,1.76014,464,2190000,0.805509,0.77,2,75761,75297,464
4018381,2.0512,0.352029,466,2191460,0.761102,0.77,2,75763,75297,466
4021061,2.01024,0.0704057,468,2192920,0.78422,0.67,2,75765,75297,468
4023141,6.80205,4.81408,470,2194380,0.788844,0.79,2,75773,75303,470
4026061,2.96041,8.96282,462,2195840,0.757769,0.79,2,75775,75313,462
4028981,2.19208,1.79256,464,2197300,0.711554,0.79,1,75777,75313,464
4031901,2.03842,0.358513,466,2198760,0.678311,0.79,1,75779,75313,466
4034581,9.20768,0.0717025,477,2200220,0.815662,0.81,2,75790,75313,477
4037281,3.44154,10.4143,466,2201680,0.819132,0.69,2,75792,75326,466
4039361,2.28831,8.48287,460,2203140,0.787826,0.7,2,75794,75334,460
4042281,7.65766,8.89657,460,2204600,0.797565,0.7,2,75803,75343,460
4045201,3.13153,1.77931,462,2206060,0.775513,0.7,2,75805,75343,462
4048121,2.22631,0.355863,464,2207520,0.827103,0.7,2,75807,75343,464
4050181,26.8453,0.0711726,497,2208980,0.621421,0.85,1,75840,75343,497
4052261,34.9691,33.6142,492,2210440,0.732284,0.82,1,75877,75385,492
4055181,8.59381,33.9228,460,2211900,0.722457,0.82,1,75879,75419,460
4058101,3.31876,6.78457,462,2213360,0.712491,0.82,1,75881,75419,462
4061021,2.26375,1.35691,464,2214820,0.678498,0.82,1,75883,75419,464
4063941,2.05275,0.271383,466,2216280,0.7917,0.82,2,75885,75419,466
4065781,1.21055,0.0542765,467,2217740,0.79834,0.7,2,75886,75419,467
4068701,1.84211,7.21086,460,2219200,0.775668,0.7,2,75888,75428,460
4071621,1.96842,1.44217,462,2220660,0.739134,0.7,1,75890,75428,462
4074101,5.19368,0.288434,468,2222120,0.675827,0.81,1,75896,75428,468
4075761,1.83874,4.05769,464,2223580,0.807165,0.81,2,75897,75433,464
4077841,10.7677,10.4115,465,2225040,0.825433,0.8,2,75910,75445,465
4080761,67.7535,70.0823,462,2226500,0.805087,0.8,2,75992,75530,462
4083681,15.1507,14.0165,464,2227960,0.769017,0.8,2,75994,75530,464
4085541,10.2301,2.80329,473,2229420,0.729803,0.84,1,76003,75530,473
4088461,3.64603,12.5607,460,2230880,0.737961,0.84,1,76005,75545,460
4091381,2.32921,2.51213,462,2232340,0.707592,0.84,1,76007,75545,462
4094301,2.06584,0.502426,464,2233800,0.677518,0.84,1,76009,75545,464
4095941,4.41317,0.100485,469,2235260,0.647504,0.87,1,76014,75545,469
4098861,2.48263,8.0201,461,2236720,0.729501,0.87,1,76016,75555,461
4100721,1.29653,1.60402,462,2238180,0.7299,0.69,1,76017,75555,462
4103641,69.8593,72.3208,459,2239640,0.72198,0.69,1,76104,75645,459
4105921,15.5719,14.4642,461,2241100,0.760396,0.79,2,76106,75645,461
4108001,59.1144,58.8928,461,2242560,0.672079,0.84,1,76176,75715,461
4110921,19.8229,17.3786,464,2244020,0.750416,0.84,2,76186,75722,464
4113201,5.56457,3.47571,466,2245480,0.734083,0.93,1,76188,75722,466
4115281,4.31291,8.69514,460,2246940,0.690817,0.74,1,76192,75732,460
4118201,8.06258,8.93903,460,2248400,0.698163,0.74,1,76201,75741,460
4121121,3.21252,1.78781,462,2249860,0.723633,0.74,1,76203,75741,462
4124041,2.2425,0.357561,464,2251320,0.696727,0.74,1,76205,75741,464
4126721,2.0485,0.0715122,466,2252780,0.715345,0.8,1,76207,75741,466
4129641,2.0097,4.8143,462,2254240,0.687069,0.8,1,76209,75747,462
4132561,2.00194,0.96286,464,2255700,0.697414,0.8,1,76211,75747,464
4135041,2.00039,0.192572,466,2257160,0.667483,0.79,1,76213,75747,466
4137961,5.20008,7.23851,463,2258620,0.637497,0.79,1,76219,75756,463
4139621,5.04002,1.4477,468,2260080,0.743499,0.77,1,76224,75756,468
4142541,2.608,10.6895,457,2261540,0.7327,0.77,1,76226,75769,457
4145461,2.1216,2.13791,459,2263000,0.70654,0.77,1,76228,75769,459
4148381,2.02432,0.427582,461,2264460,0.685308,0.77,1,76230,75769,461
4151301,2.00486,0.0855163,463,2265920,0.705062,0.77,1,76232,75769,463
4153141,6.00097,0.0171033,470,2267380,0.701012,0.67,1,76239,75769,470
4156061,2.80019,8.00342,462,2268840,0.668202,0.67,1,76241,75779,462
4158981,2.16004,1.60068,464,2270300,0.63764,0.67,1,76243,75779,464
4161461,4.43201,0.320137,469,2271760,0.711528,0.81,1,76248,75779,469
4163541,7.2864,6.46403,469,2273220,0.782306,0.79,2,76256,75787,469
4166461,3.05728,8.49281,462,2274680,0.764461,0.79,2,76258,75796,462
4169381,2.21146,1.69856,464,2276140,0.736892,0.79,1,76260,75796,464
4171861,2.84229,0.339712,467,2277600,0.683378,0.77,1,76263,75796,467
4173941,6.96846,7.26794,466,2279060,0.792676,0.74,2,76271,75805,466
4176861,2.99369,7.05359,461,2280520,0.782535,0.74,2,76273,75812,461
4178721,1.39874,1.41072,462,2281980,0.764507,0.63,2,76274,75812,462
4180801,33.0797,33.8821,461,2283440,0.792901,0.8,2,76315,75854,461
4183721,29.0159,32.3764,457,2284900,0.71858,0.8,1,76343,75886,457
4186641,7.40319,6.47529,459,2286360,0.783716,0.8,2,76345,75886,459
4189561,3.08064,1.29506,461,2287820,0.764743,0.8,2,76347,75886,461
4192481,2.21613,0.259011,463,2289280,0.752949,0.8,2,76349,75886,463
4194321,1.24323,0.0518023,464,2290740,0.73459,0.84,1,76350,75886,464
4197241,3.44865,8.81036,457,2292200,0.786918,0.84,2,76354,75897,457
4200161,2.28973,1.76207,459,2293660,0.765384,0.84,2,76356,75897,459
4203081,2.05795,0.352414,461,2295120,0.737077,0.84,1,76358,75897,461
4204721,1.21159,0.0704829,462,2296580,0.715415,0.84,1,76359,75897,462
4206801,3.44232,8.0141,456,2298040,0.823083,0.81,2,76363,75907,456
4208881,10.2885,14.4028,452,2299500,0.804617,0.72,2,76375,75923,452
4211801,66.8577,66.8806,453,2300960,0.760923,0.72,2,76456,76003,453
4214081,14.9715,13.3761,455,2302420,0.720185,0.65,1,76458,76003,455
4217001,10.9943,8.27522,458,2303880,0.736037,0.65,1,76468,76010,458
4219921,3.79886,1.65504,460,2305340,0.755207,0.65,2,76470,76010,460
4222841,2.35977,0.331009,462,2306800,0.727041,0.65,1,76472,76010,462
4224481,1.27195,0.0662018,463,2308260,0.705408,0.81,1,76473,76010,463
4227401,5.05439,8.81324,458,2309720,0.685082,0.81,1,76479,76021,458
4230321,2.61088,1.76265,460,2311180,0.649016,0.81,1,76481,76021,460
4233221,70.1222,0.35253,547,2312640,0.681803,0.7,1,76568,76021,547
4236141,15.6244,74.4705,456,2314100,0.656361,0.7,1,76570,76114,456
4238421,59.1249,14.8941,526,2315560,0.643272,0.81,1,76640,76114,526
4240501,18.225,58.9788,464,2317020,0.728654,0.7,1,76648,76184,464
4243421,5.245,17.3958,459,2318480,0.721731,0.7,1,76650,76191,459
4245701,8.249,3.47915,468,2319940,0.776346,0.69,2,76659,76191,468
4248621,3.2498,11.8958,456,2321400,0.755269,0.69,2,76661,76205,456
4251521,2.24996,2.37917,458,2322860,0.719054,0.66,1,76663,76205,458
4254441,6.04999,6.87583,457,2324320,0.655811,0.66,1,76670,76213,457
4257361,2.81,1.37517,459,2325780,0.715162,0.66,1,76672,76213,459
4260281,2.162,0.275033,461,2327240,0.695032,0.66,1,76674,76213,461
4262961,2.0324,0.0550067,463,2328700,0.667006,0.79,1,76676,76213,463
4265881,5.20648,8.011,459,2330160,0.653401,0.79,1,76682,76223,459
4268161,2.6413,1.6022,461,2331620,0.61868,0.72,1,76684,76223,461
4271081,5.32826,9.92044,455,2333080,0.659736,0.72,1,76690,76235,455
4274001,2.66565,1.98409,457,2334540,0.635947,0.72,1,76692,76235,457
4276921,2.13313,0.396818,459,2336000,0.615189,0.72,1,76694,76235,459
4279841,2.02663,0.0793635,461,2337460,0.579038,0.72,1,76696,76235,461
4281681,1.20533,0.0158727,462,2338920,0.619808,0.61,1,76697,76235,462
4284601,5.04107,7.20317,459,2340380,0.627962,0.61,1,76703,76244,459
4287521,2.60821,1.44063,461,2341840,0.605592,0.61,1,76705,76244,461
4290001,2.12164,0.288127,463,2343300,0.713118,0.82,1,76707,76244,463
4292081,3.62433,8.85763,456,2344760,0.686624,0.73,1,76711,76255,456
4295001,9.52487,5.77153,462,2346220,0.729325,0.73,1,76722,76260,462
4297281,3.50497,1.1543,464,2347680,0.705865,0.73,1,76724,76260,464
4300201,2.30099,13.0309,450,2349140,0.669173,0.73,1,76726,76276,450
4303121,2.0602,2.60617,452,2350600,0.629835,0.73,1,76728,76276,452
4306041,2.01204,0.521234,454,2352060,0.597967,0.73,1,76730,76276,454
4308961,2.00241,0.104247,456,2353520,0.559593,0.73,1,76732,76276,456
4311221,43.6005,0.0208494,510,2354980,0.663919,0.8,1,76786,76276,510
4313301,25.5201,41.6042,479,2356440,0.732784,0.84,1,76807,76328,479
4316221,7.50402,27.5208,458,2357900,0.722557,0.84,1,76810,76352,458
4319141,3.1008,5.50417,460,2359360,0.688511,0.84,1,76812,76352,460
4322061,2.22016,1.10083,462,2360820,0.769702,0.84,2,76814,76352,462
4324981,2.04403,0.220167,464,2362280,0.74594,0.84,1,76816,76352,464
4326821,1.20881,0.0440333,465,2363740,0.725188,0.69,1,76817,76352,465
4329741,1.84176,6.40881,459,2365200,0.713038,0.69,1,76819,76360,459
4332661,1.96835,1.28176,461,2366660,0.678608,0.69,1,76821,76360,461
4335581,1.99367,0.256352,463,2368120,0.719722,0.69,1,76823,76360,463
4337221,9.19873,0.0512704,474,2369580,0.759944,0.8,2,76834,76360,474
4339301,5.03975,12.0103,463,2371040,0.711989,0.81,1,76838,76375,463
4341381,70.6079,8.00205,543,2372500,0.798398,0.72,2,76925,76382,543
4344301,16.5216,73.6004,456,2373960,0.82368,0.72,2,76928,76472,456
4347221,4.90432,14.7201,458,2375420,0.788736,0.72,2,76930,76472,458
4350141,2.58086,2.94402,460,2376880,0.749747,0.72,1,76932,76472,460
4351781,1.31617,0.588803,461,2378340,0.733949,0.7,1,76933,76472,461
4354701,1.86323,4.91776,457,2379800,0.69879,0.7,1,76935,76478,457
4356981,5.97265,0.983552,464,2381260,0.587758,0.74,1,76942,76478,464
4359901,2.79453,8.19671,456,2382720,0.757552,0.74,2,76944,76488,456
4362181,68.5589,1.63934,541,2384180,0.83151,0.69,2,77029,76488,541
4365101,15.3118,67.5279,459,2385640,0.814302,0.69,2,77031,76572,459
4366961,3.86236,13.5056,460,2387100,0.83486,0.81,2,77032,76572,460
4369041,59.9725,61.1011,461,2388560,0.806972,0.75,2,77106,76645,461
4371961,16.7945,19.4202,458,2390020,0.881394,0.75,2,77112,76654,458
4374241,4.9589,3.88404,460,2391480,0.864279,0.77,2,77114,76654,460
4376321,4.19178,5.57681,458,2392940,0.884856,0.66,2,77118,76660,458
4379241,10.4384,13.9154,454,2394400,0.840971,0.66,2,77130,76676,454
4382161,3.68767,2.78307,456,2395860,0.800194,0.66,2,77132,76676,456
4385081,2.33753,0.556614,458,2397320,0.776039,0.66,2,77134,76676,458
4388001,2.06751,0.111323,460,2398780,0.747208,0.66,1,77136,76676,460
4390881,2.0135,0.0222646,462,2400240,0.805441,0.67,2,77138,76676,462
4393801,5.2027,11.2045,454,2401700,0.817088,0.67,2,77144,76690,454
4396721,2.64054,2.24089,456,2403160,0.819418,0.67,2,77146,76690,456
4399201,2.12811,0.448178,458,2404620,0.787884,0.57,2,77148,76690,458
4402121,5.22562,4.88964,458,2406080,0.789577,0.57,2,77154,76696,458
4405041,2.64512,0.977927,460,2407540,0.757915,0.57,2,77156,76696,460
4407521,2.12902,0.195585,462,2409000,0.727583,0.68,1,77158,76696,462
4410441,5.22581,12.0391,453,2410460,0.785517,0.68,2,77164,76711,453
4413361,2.64516,2.40782,455,2411920,0.821103,0.68,2,77166,76711,455
4416281,2.12903,0.481565,457,2413380,0.796221,0.68,2,77168,76711,457
4419201,2.02581,0.0963129,459,2414840,0.847244,0.68,2,77170,76711,459
4421041,1.20516,0.0192626,460,2416300,0.841449,0.74,2,77171,76711,460
4423121,1.84103,8.80385,451,2417760,0.81629,0.66,2,77173,76722,451
4426041,10.7682,4.96077,460,2419220,0.787258,0.66,2,77186,76726,460
4428321,3.75364,0.992154,462,2420680,0.821452,0.77,2,77188,76726,462
4431241,2.35073,8.99843,453,2422140,0.78829,0.77,2,77190,76737,453
4434161,2.07015,1.79969,455,2423600,0.741658,0.77,1,77192,76737,455
4437081,2.01403,0.359937,457,2425060,0.700332,0.77,1,77194,76737,457
4439761,2.00281,0.0719874,459,2426520,0.660066,0.71,1,77196,76737,459
4441841,47.6006,49.6144,456,2427980,0.844013,0.79,2,77255,76799,456
4444761,23.9201,21.9229,459,2429440,0.760803,0.79,2,77273,76814,459
4447681,6.38402,4.38458,461,2430900,0.744161,0.79,1,77275,76814,461
4450161,2.8768,0.876915,463,2432360,0.708832,0.67,1,77277,76814,463
4453081,2.17536,5.77538,458,2433820,0.789766,0.67,2,77279,76821,458
4456001,2.03507,1.15508,460,2435280,0.773953,0.67,2,77281,76821,460
4458921,2.00701,0.231015,462,2436740,0.762791,0.67,2,77283,76821,462
4460561,1.2014,0.0462031,463,2438200,0.744558,0.7,1,77284,76821,463
4463481,1.84028,7.20924,456,2439660,0.732912,0.7,1,77286,76830,456
4465761,1.96806,1.44185,458,2441120,0.706582,0.67,1,77288,76830,458
4468681,11.5936,10.6884,459,2442580,0.765316,0.67,2,77302,76843,459
4471381,67.1187,2.13767,540,2444040,0.817063,0.74,2,77383,76843,540
4474301,16.6237,71.6275,455,2445500,0.771413,0.74,2,77387,76932,455
4477221,6.52475,14.3255,459,2446960,0.874283,0.74,2,77391,76932,459
4479701,7.70495,2.8651,467,2448420,0.758857,0.59,2,77399,76932,467
4482621,3.14099,6.97302,461,2449880,0.895771,0.59,2,77401,76940,461
4485521,2.2282,1.3946,463,2451340,0.883154,0.76,2,77403,76940,463
4488441,3.64564,9.87892,455,2452800,0.896631,0.76,2,77407,76952,455
4490721,2.32913,1.97578,457,2454260,0.907326,0.92,2,77409,76952,457
4493641,74.0658,69.9952,462,2455720,0.821465,0.92,2,77501,77039,462
4496561,16.4132,13.999,464,2457180,0.772293,0.92,2,77503,77039,464
4499461,60.0826,2.79981,535,2458640,0.778459,0.91,2,77574,77039,535
4502381,15.2165,62.96,461,2460100,0.859692,0.91,2,77578,77117,461
4505281,5.44331,12.592,464,2461560,0.859938,0.78,2,77581,77117,464
4507361,4.28866,7.3184,462,2463020,0.875988,0.81,2,77585,77123,462
4509441,8.05773,7.86368,463,2464480,0.799198,0.77,2,77594,77131,463
4512361,6.41155,3.97274,466,2465940,0.799839,0.77,2,77600,77134,466
4514021,2.08231,0.794547,467,2467400,0.815968,0.78,2,77601,77134,467
4516941,2.01646,4.95891,463,2468860,0.787194,0.78,2,77603,77140,463
4519861,2.00329,0.991782,465,2470320,0.853439,0.78,2,77605,77140,465
4521921,2.00066,0.198356,467,2471780,0.834688,0.81,2,77607,77140,467
4524841,5.20013,10.4397,460,2473240,0.734937,0.81,1,77613,77153,460
4527761,2.64003,2.08793,462,2474700,0.770988,0.81,2,77615,77153,462
4530241,2.12801,0.417587,464,2476160,0.858197,0.7,2,77617,77153,464
4533161,5.2256,4.88352,464,2477620,0.779639,0.7,2,77623,77159,464
4536081,2.64512,0.976703,466,2479080,0.739928,0.7,1,77625,77159,466
4538561,2.12902,0.195341,468,2480540,0.763986,0.86,2,77627,77159,468
4541481,5.2258,8.83907,463,2482000,0.800797,0.86,2,77633,77170,463
4544401,2.64516,1.76781,465,2483460,0.784159,0.86,2,77635,77170,465
4546881,2.12903,0.353563,467,2484920,0.740832,0.76,1,77637,77170,467
4549801,2.02581,5.67071,462,2486380,0.820166,0.76,2,77639,77177,462
4552721,2.00516,1.13414,464,2487840,0.860033,0.76,2,77641,77177,464
4555621,10.001,0.226828,476,2489300,0.876007,0.83,2,77653,77177,476
4557701,3.60021,8.84537,467,2490760,0.887201,0.67,2,77655,77188,467
4560621,2.32004,7.36907,462,2492220,0.85744,0.67,2,77657,77195,462
4563541,2.06401,1.47381,464,2493680,0.827488,0.67,2,77659,77195,464
4566461,2.0128,0.294763,466,2495140,0.877498,0.67,2,77661,77195,466
4569141,9.20256,0.0589526,477,2496600,0.7275,0.81,1,77672,77195,477
4570801,2.64051,10.4118,465,2498060,0.6815,0.72,1,77673,77208,465
4572881,41.3281,46.0824,461,2499520,0.7923,0.76,2,77724,77263,461
4574961,17.8656,18.0165,462,2500980,0.87846,0.73,2,77736,77274,462
4577881,9.97312,13.2033,458,2502440,0.895692,0.73,2,77744,77286,458
4580801,3.59462,2.64066,460,2503900,0.859138,0.73,2,77746,77286,460
4583721,2.31892,0.528132,462,2505360,0.843828,0.73,2,77748,77286,462
4586641,2.06378,0.105626,464,2506820,0.808766,0.73,2,77750,77286,464
4589561,2.01276,0.0211253,466,2508280,0.817753,0.73,2,77752,77286,466
4591601,2.00255,0.00422505,468,2509740,0.875551,0.8,2,77754,77286,468
4594521,5.20051,12.0008,459,2511200,0.85511,0.8,2,77760,77301,459
4596801,3.4401,2.40017,462,2512660,0.803022,0.68,2,77763,77301,462
4598881,7.08802,5.28003,464,2514120,0.696604,0.92,1,77771,77307,464
4601801,65.4176,67.456,461,2515580,0.763321,0.92,2,77851,77390,461
4604721,16.2835,13.4912,465,2517040,0.816664,0.92,2,77855,77390,465
4606581,9.6567,2.69824,473,2518500,0.835333,0.75,2,77863,77390,473
4608241,2.73134,6.93965,466,2519960,0.823067,0.85,2,77864,77398,466
4611161,6.14627,14.1879,457,2521420,0.756613,0.85,2,77871,77414,457
4614081,2.82925,2.83759,459,2522880,0.719323,0.85,1,77873,77414,459
4617001,2.16585,0.567517,461,2524340,0.855865,0.85,2,77875,77414,461
4619921,2.03317,0.113503,463,2525800,0.883173,0.85,2,77877,77414,463
4621761,1.20663,0.0227007,464,2527260,0.872635,0.86,2,77878,77414,464
4624681,76.2413,77.6045,462,2528720,0.814527,0.86,2,77973,77511,462
4626961,16.8483,15.5209,464,2530180,0.770905,0.88,2,77975,77511,464
4629881,61.7697,62.3042,463,2531640,0.826181,0.88,2,78048,77585,463
4632801,13.9539,12.4608,465,2533100,0.813236,0.88,2,78050,77585,465
4635721,4.39079,2.49217,467,2534560,0.850647,0.88,2,78052,77585,467
4637781,2.47816,0.498433,469,2536020,0.826129,0.81,2,78054,77585,469
4639861,12.4956,4.09969,479,2537480,0.693226,0.87,1,78069,77590,479
4642781,4.09913,12.8199,466,2538940,0.754645,0.87,2,78071,77605,466
4645701,2.41983,2.56399,468,2540400,0.742929,0.87,1,78073,77605,468
4647761,2.08397,0.512797,470,2541860,0.732586,0.88,1,78075,77605,470
4650681,5.21679,9.70256,464,2543320,0.794517,0.88,2,78081,77617,464
4653601,2.64336,1.94051,466,2544780,0.774903,0.88,2,78083,77617,466
4656521,2.12867,0.388102,468,2546240,0.746981,0.88,1,78085,77617,468
4658161,1.22573,0.0776205,469,2547700,0.725396,0.9,1,78086,77617,469
4661081,1.84515,8.81552,460,2549160,0.689079,0.9,1,78088,77628,460
4664001,1.96903,1.7631,462,2550620,0.649816,0.9,1,78090,77628,462
4666921,1.99381,0.352621,464,2552080,0.729963,0.9,1,78092,77628,464
4669601,1.99876,0.0705242,466,2553540,0.777993,0.86,2,78094,77628,466
4672521,8.39975,8.0141,466,2555000,0.811599,0.86,2,78104,77638,466
4675441,3.27995,1.60282,468,2556460,0.79432,0.86,2,78106,77638,468
4677921,2.25599,0.320564,470,2557920,0.758864,0.89,2,78108,77638,470
4680001,2.0512,1.66411,470,2559380,0.719773,0.83,1,78110,77640,470
4682921,2.01024,2.73282,469,2560840,0.751955,0.83,2,78112,77643,469
4684581,6.80205,0.546564,477,2562300,0.750391,0.83,2,78120,77643,477
4687501,4.56041,16.9093,460,2563760,0.678078,0.83,1,78124,77664,460
4690421,3.31208,3.38186,463,2565220,0.751616,0.83,2,78127,77664,463
4693341,2.26242,0.676372,465,2566680,0.734323,0.83,1,78129,77664,465
4696261,2.05248,0.135274,467,2568140,0.690865,0.83,1,78131,77664,467
4698101,6.0105,0.0270549,474,2569600,0.746173,0.93,1,78138,77664,474
4701021,2.8021,8.00541,466,2571060,0.725235,0.93,1,78140,77674,466
4703301,51.7604,1.60108,530,2572520,0.721047,0.83,1,78204,77674,530
4706001,11.9521,53.1202,466,2573980,0.688209,0.84,1,78206,77740,466
4708921,8.79042,17.024,466,2575440,0.745642,0.84,1,78214,77748,466
4711201,3.35808,3.40481,468,2576900,0.717128,0.79,1,78216,77748,468
4714121,3.87162,12.681,457,2578360,0.663426,0.79,1,78220,77763,457
4717041,2.37432,2.53619,459,2579820,0.676685,0.79,1,78222,77763,459
4719961,2.07486,0.507238,461,2581280,0.767337,0.79,2,78224,77763,461
4722881,2.01497,0.101448,463,2582740,0.793467,0.79,2,78226,77763,463
4724721,1.20299,0.0202895,464,2584200,0.782694,0.8,2,78227,77763,464
4727641,8.2406,8.80406,463,2585660,0.700539,0.8,1,78237,77774,463
4729921,3.24812,1.76081,465,2587120,0.652108,0.84,1,78239,77774,465
4732841,67.8496,71.5522,460,2588580,0.706422,0.84,1,78323,77863,460
4735121,15.1699,14.3104,462,2590040,0.685284,0.8,1,78325,77863,462
4738041,11.834,6.86209,468,2591500,0.673057,0.8,1,78336,77868,468
4740741,3.9668,1.37242,470,2592960,0.646611,0.9,1,78338,77868,470
4743661,2.39336,6.67448,464,2594420,0.769322,0.9,2,78340,77876,464
4746581,2.07867,1.3349,466,2595880,0.761864,0.9,2,78342,77876,466
4749061,5.21573,0.266979,472,2597340,0.736373,0.88,1,78348,77876,472
4751981,2.64315,8.0534,464,2598800,0.699275,0.88,1,78350,77886,464
4754261,70.1286,1.61068,551,2600260,0.755855,0.92,2,78437,77886,551
4757181,17.2257,73.9221,463,2601720,0.711171,0.92,1,78441,77978,463
4759461,63.4451,14.7844,538,2603180,0.742234,0.82,1,78516,77978,538
4762381,14.289,67.7569,459,2604640,0.820447,0.82,2,78518,78059,459
4765301,4.45781,13.5514,461,2606100,0.796089,0.82,2,78520,78059,461
4768221,2.49156,2.71028,463,2607560,0.759218,0.82,2,78522,78059,463
4769861,10.0983,0.542055,475,2609020,0.791844,0.83,2,78534,78059,475
4772781,3.61966,16.9084,456,2610480,0.774369,0.83,2,78536,78080,456
4775701,2.32393,3.38168,458,2611940,0.762874,0.83,2,78538,78080,458
4778621,2.06479,0.676336,460,2613400,0.728575,0.83,1,78540,78080,460
4780261,4.41296,0.135267,465,2614860,0.785715,0.75,2,78545,78080,465
4783181,2.48259,9.62705,455,2616320,0.773143,0.75,2,78547,78092,455
4786101,2.09652,1.92541,457,2617780,0.738629,0.75,1,78549,78092,457
4789021,2.0193,0.385082,459,2619240,0.699726,0.75,1,78551,78092,459
4791941,2.00386,0.0770164,461,2620700,0.715945,0.75,1,78553,78092,461
4794401,2.00077,0.0154033,463,2622160,0.799189,0.66,2,78555,78092,463
4797321,2.00015,7.20308,456,2623620,0.783838,0.66,2,78557,78101,456
4800241,2.00003,1.44062,458,2625080,0.804768,0.66,2,78559,78101,458
4802101,6.80001,0.288123,466,2626540,0.848954,0.85,2,78567,78101,466
4805021,2.96,11.2576,454,2628000,0.833791,0.85,2,78569,78115,454
4807941,2.192,2.25152,456,2629460,0.790758,0.85,2,78571,78115,456
4810861,2.0384,0.450305,458,2630920,0.750152,0.85,2,78573,78115,458
4813121,2.00768,0.090061,460,2632380,0.71003,0.71,1,78575,78115,460
4815201,3.60154,5.61801,457,2633840,0.654006,0.68,1,78579,78122,457
4818121,8.72031,8.3236,458,2635300,0.762801,0.68,2,78589,78131,458
4821041,3.34406,1.66472,460,2636760,0.76056,0.68,2,78591,78131,460
4823521,2.26881,0.332944,462,2638220,0.728112,0.81,1,78593,78131,462
4826441,6.85376,8.06659,460,2639680,0.793622,0.81,2,78601,78141,460
4829361,2.97075,1.61332,462,2641140,0.782724,0.81,2,78603,78141,462
4831841,2.19415,0.322664,464,2642600,0.740545,0.83,1,78605,78141,464
4834761,49.2388,55.2645,456,2644060,0.780109,0.83,2,78666,78210,456
4837041,11.4478,11.0529,458,2645520,0.756022,0.7,2,78668,78210,458
4839961,11.8896,11.0106,459,2646980,0.759204,0.7,2,78680,78221,459
4842881,3.97791,2.20212,461,2648440,0.751841,0.7,2,78682,78221,461
4845781,3.99558,0.440423,465,2649900,0.750368,0.74,2,78686,78221,465
4848701,2.39912,10.4881,454,2651360,0.838074,0.74,2,78688,78234,454
4851621,2.07982,2.09762,456,2652820,0.823615,0.74,2,78690,78234,456
4854541,2.01596,0.419523,458,2654280,0.788723,0.74,2,78692,78234,458
4857221,8.40319,0.0839047,468,2655740,0.709745,0.65,1,78702,78234,468
4860141,3.28064,4.81678,464,2657200,0.661949,0.65,1,78704,78240,464
4862421,63.8561,0.963356,543,2658660,0.67639,0.84,1,78783,78240,543
4865341,15.9712,70.5927,459,2660120,0.599278,0.84,1,78787,78328,459
4867621,11.1942,14.1185,469,2661580,0.615856,0.78,1,78797,78328,469
4870541,3.83885,13.2237,458,2663040,0.579171,0.78,1,78799,78341,458
4873461,2.36777,2.64474,460,2664500,0.539834,0.78,1,78801,78341,460
4875941,5.27355,0.528948,466,2665960,0.707967,0.76,1,78807,78341,466
4878861,2.65471,8.90579,457,2667420,0.709593,0.76,1,78809,78352,457
4881781,2.13094,1.78116,459,2668880,0.797919,0.76,2,78811,78352,459
4884261,72.4262,0.356232,549,2670340,0.735584,0.82,1,78901,78352,549
4887181,17.6852,74.4712,460,2671800,0.659117,0.82,1,78905,78445,460
4889461,63.537,14.8942,535,2673260,0.755823,0.75,2,78980,78445,535
4892381,14.3074,64.5789,460,2674720,0.751165,0.75,2,78982,78522,460
4895301,4.46148,12.9158,462,2676180,0.718233,0.75,1,78984,78522,462
4897781,2.4923,2.58315,464,2677640,0.687647,0.79,1,78986,78522,464
4899861,12.4985,3.71663,475,2679100,0.769529,0.84,2,79001,78526,475
4902781,4.09969,14.3433,460,2680560,0.777906,0.84,2,79003,78543,460
4905701,2.41994,2.86867,462,2682020,0.747581,0.84,1,79005,78543,462
4908621,2.08399,0.573733,464,2683480,0.725516,0.84,1,79007,78543,464
4910261,1.2168,0.114747,465,2684940,0.705103,0.75,1,79008,78543,465
4913181,1.84336,4.02295,462,2686400,0.693021,0.75,1,79010,78548,462
4915461,3.56867,0.80459,466,2687860,0.802604,0.8,2,79014,78548,466
4918381,2.31373,6.56092,460,2689320,0.792521,0.8,2,79016,78556,460
4921301,2.06275,1.31218,462,2690780,0.758504,0.8,2,79018,78556,462
4924221,2.01255,0.262437,464,2692240,0.719701,0.8,1,79020,78556,464
4926901,2.00251,0.0524873,466,2693700,0.67994,0.83,1,79022,78556,466
4929821,2.0005,10.4105,455,2695160,0.647988,0.83,1,79024,78569,455
4932721,2.0001,2.0821,457,2696620,0.777598,0.7,2,79026,78569,457
4935641,7.60002,5.21642,460,2698080,0.795519,0.7,2,79035,78575,460
4938561,3.12,1.04328,462,2699540,0.767104,0.7,2,79037,78575,462
4941041,2.224,0.208657,464,2701000,0.737421,0.83,1,79039,78575,464
4943961,2.0448,9.64173,454,2702460,0.699484,0.83,1,79041,78587,454
4946241,2.00896,1.92835,456,2703920,0.659897,0.81,1,79043,78587,456
4949161,10.8018,11.5857,455,2705380,0.771979,0.81,2,79056,78601,455
4952081,3.76036,2.31713,457,2706840,0.762396,0.81,2,79058,78601,457
4954561,2.35207,0.463427,459,2708300,0.864479,0.73,2,79060,78601,459
4957481,5.27041,12.0927,450,2709760,0.908896,0.73,2,79066,78616,450
4960401,2.65408,2.41854,452,2711220,0.885779,0.73,2,79068,78616,452
4962881,2.13082,0.483707,454,2712680,0.857156,0.86,2,79070,78616,454
4965801,50.8262,44.8967,461,2714140,0.819431,0.86,2,79133,78672,461
4968081,11.7652,8.97935,463,2715600,0.779886,0.76,2,79135,78672,463
4971001,10.353,12.1959,460,2717060,0.819977,0.76,2,79145,78685,460
4973281,3.67061,2.43917,462,2718520,0.795995,0.74,2,79147,78685,462
4976201,4.73412,7.68784,458,2719980,0.887199,0.74,2,79152,78694,458
4979121,2.54682,1.53757,460,2721440,0.89744,0.74,2,79154,78694,460
4982041,2.10936,0.307513,462,2722900,0.867488,0.74,2,79156,78694,462
4984721,2.02187,0.0615027,464,2724360,0.829498,0.69,2,79158,78694,464
4987641,7.60437,12.8123,457,2725820,0.8459,0.69,2,79167,78710,457
4990561,3.12087,2.56246,459,2727280,0.81718,0.69,2,79169,78710,459
4992421,58.2242,0.512492,531,2728740,0.883436,0.74,2,79241,78710,531
4995341,14.8448,64.9025,454,2730200,0.832687,0.74,2,79245,78791,454
4997621,13.369,12.9805,467,2731660,0.846537,0.55,2,79258,78791,467
5000541,5.87379,9.7961,462,2733120,0.793307,0.55,2,79262,78800,462
5002821,6.77476,1.95922,469,2734580,0.902662,0.78,2,79269,78800,469
5005741,2.95495,10.7918,458,2736040,0.916532,0.78,2,79271,78813,458
5008661,2.19099,2.15837,460,2737500,0.895306,0.78,2,79273,78813,460
5011581,2.0382,0.431674,462,2738960,0.867061,0.78,2,79275,78813,462
5014261,74.0076,0.0863347,554,2740420,0.813412,0.69,2,79367,78813,554
5017181,16.4015,78.4173,458,2741880,0.770682,0.69,2,79369,78911,458
5019461,66.4803,15.6835,537,2743340,0.666137,0.7,1,79448,78911,537
5022381,14.8961,62.3367,465,2744800,0.605227,0.7,1,79450,78985,465
5025301,4.57921,12.4673,467,2746260,0.561045,0.7,1,79452,78985,467
5027781,4.11584,2.49347,471,2747720,0.712209,0.83,1,79456,78985,471
5029861,11.2232,11.6987,470,2749180,0.638442,0.83,1,79469,78999,470
5032781,3.84463,14.3397,457,2750640,0.615688,0.83,1,79471,79014,457
5035701,2.36893,2.86795,459,2752100,0.587138,0.83,1,79473,79014,459
5038621,2.07379,0.573589,461,2753560,0.669428,0.83,1,79475,79014,461
5041541,2.01476,0.114718,463,2755020,0.677886,0.83,1,79477,79014,463
5044001,2.00295,0.0229436,465,2756480,0.647577,0.71,1,79479,79014,465
5046921,4.40059,4.80459,464,2757940,0.769515,0.71,2,79484,79020,464
5049841,2.48012,0.960918,466,2759400,0.761903,0.71,2,79486,79020,466
5052321,2.09602,0.192184,468,2760860,0.728381,0.83,1,79488,79020,468
5055241,2.0192,10.4384,457,2762320,0.689676,0.83,1,79490,79033,457
5058161,2.00384,2.08769,459,2763780,0.769935,0.83,2,79492,79033,459
5061081,2.00077,0.417537,461,2765240,0.777987,0.83,2,79494,79033,461
5063761,2.00015,0.0835075,463,2766700,0.755597,0.75,2,79496,79033,463
5066681,2.00003,4.0167,460,2768160,0.719119,0.75,1,79498,79038,460
5068961,2.00001,0.80334,462,2769620,0.679824,0.8,1,79500,79038,462
5071881,9.2,8.16067,463,2771080,0.663965,0.8,1,79511,79048,463
5074801,5.04,1.63213,467,2772540,0.604793,0.8,1,79515,79048,467
5077281,2.608,0.326427,469,2774000,0.768959,0.89,2,79517,79048,469
5080201,7.7216,9.66529,466,2775460,0.769792,0.89,2,79526,79060,466
5082481,3.14432,1.93306,468,2776920,0.793958,0.87,2,79528,79060,468
5085401,7.02886,10.7866,463,2778380,0.846792,0.87,2,79536,79073,463
5088321,3.00577,2.15732,465,2779840,0.825358,0.87,2,79538,79073,465
5091241,2.20115,0.431464,467,2781300,0.789072,0.87,2,79540,79073,467
5093921,2.04023,0.0862929,469,2782760,0.805814,0.94,2,79542,79073,469
5096841,44.408,52.8173,458,2784220,0.809163,0.94,2,79597,79139,458
5099121,10.4816,10.5635,460,2785680,0.785833,0.76,2,79599,79139,460
5102041,10.8963,9.31269,462,2787140,0.733167,0.76,1,79610,79148,462
5104321,3.77926,1.86254,464,2788600,0.690633,0.9,1,79612,79148,464
5106401,3.15585,5.17251,461,2790060,0.778127,0.85,2,79615,79154,461
5109321,6.23117,11.4345,455,2791520,0.779625,0.85,2,79622,79167,455
5112241,2.84623,2.2869,457,2792980,0.819925,0.85,2,79624,79167,457
5115161,2.16925,0.45738,459,2794440,0.787985,0.85,2,79626,79167,459
5117221,7.63385,0.091476,468,2795900,0.813597,0.7,2,79635,79167,468
5120141,3.12677,5.6183,463,2797360,0.778719,0.7,2,79637,79174,463
5122421,57.4254,1.12366,534,2798820,0.787744,0.84,2,79708,79174,534
5124501,16.2851,56.2247,470,2800280,0.837549,0.86,2,79714,79244,470
5126161,4.05701,17.6449,463,2801740,0.83151,0.83,2,79715,79252,463
5128241,12.0114,9.12899,470,2803200,0.726302,0.93,1,79729,79259,470
5131161,4.00228,9.8258,462,2804660,0.74526,0.93,1,79731,79269,462
5132821,7.20046,1.96516,470,2806120,0.837052,0.8,2,79739,79269,470
5135741,3.04009,9.19303,461,2807580,0.84741,0.8,2,79741,79280,461
5138661,2.20802,1.83861,463,2809040,0.809482,0.8,2,79743,79280,463
5141581,2.0416,0.367721,465,2810500,0.777896,0.8,2,79745,79280,465
5143221,76.4083,0.0735442,560,2811960,0.851579,0.83,2,79840,79280,560
5146141,16.8817,80.8147,461,2813420,0.834316,0.83,2,79842,79381,461
5148001,4.17633,16.1629,462,2814880,0.814863,0.71,2,79843,79381,462
5150921,58.4353,69.6326,451,2816340,0.746973,0.71,1,79915,79464,451
5153841,13.2871,13.9265,453,2817800,0.701394,0.71,1,79917,79464,453
5156761,4.25741,2.7853,455,2819260,0.788279,0.71,2,79919,79464,455
5158401,1.65148,0.557061,456,2820720,0.789656,0.58,2,79920,79464,456
5161321,10.7303,7.31141,460,2822180,0.597931,0.58,1,79933,79473,460
5163601,3.74606,1.46228,462,2823640,0.735586,0.82,1,79935,79473,462
5166521,2.34921,5.89246,457,2825100,0.731117,0.82,1,79937,79480,457
5169441,2.06984,1.17849,459,2826560,0.690223,0.82,1,79939,79480,459
5172361,2.01397,0.235698,461,2828020,0.650045,0.82,1,79941,79480,461
5175041,2.00279,0.0471396,463,2829480,0.610009,0.81,1,79943,79480,463
5177961,3.60056,8.80943,456,2830940,0.626002,0.81,1,79947,79491,456
5180881,2.32011,1.76189,458,2832400,0.7492,0.81,1,79949,79491,458
5183801,2.06402,0.352377,460,2833860,0.79784,0.81,2,79951,79491,460
5185441,1.2128,0.0704754,461,2835320,0.791568,0.79,2,79952,79491,461
5188361,3.44256,11.2141,451,2836780,0.734314,0.79,1,79956,79505,451
5191281,2.28851,2.24282,453,2838240,0.690863,0.79,1,79958,79505,453
5194201,2.0577,0.448564,455,2839700,0.674173,0.79,1,79960,79505,455
5197121,2.01154,0.0897127,457,2841160,0.654835,0.79,1,79962,79505,457
5200001,2.00231,0.0179425,459,2842620,0.770967,0.81,2,79964,79505,459
5202921,11.6005,9.60359,461,2844080,0.714193,0.81,1,79978,79517,461
5205201,3.92009,1.92072,463,2845540,0.774839,0.78,2,79980,79517,463
5208121,3.98402,6.78414,459,2847000,0.722968,0.78,1,79984,79525,459
5209781,5.5968,1.35683,465,2848460,0.720594,0.74,1,79990,79525,465
5212701,2.71936,5.07137,461,2849920,0.688119,0.74,1,79992,79531,461
5214981,6.14387,1.01427,468,2851380,0.641624,0.82,1,79999,79531,468
5217061,2.82877,5.80285,463,2852840,0.656325,0.85,1,80001,79538,463
5219981,2.16575,5.96057,459,2854300,0.627265,0.85,1,80003,79544,459
5222901,2.03315,1.19211,461,2855760,0.773453,0.85,2,80005,79544,461
5224961,2.00663,0.238423,463,2857220,0.770691,0.68,2,80007,79544,463
5227881,51.6013,54.4477,459,2858680,0.698138,0.68,1,80071,79612,459
5230801,11.9203,10.8895,461,2860140,0.651628,0.68,1,80073,79612,461
5233701,10.3841,2.17791,471,2861600,0.722326,0.85,1,80083,79612,471
5236621,3.67681,9.23558,462,2863060,0.704465,0.85,1,80085,79623,462
5239521,2.33536,1.84712,464,2864520,0.660893,0.79,1,80087,79623,464
5242441,5.26707,7.56942,461,2865980,0.700179,0.79,1,80093,79632,461
5245361,2.65341,1.51388,463,2867440,0.700036,0.79,1,80095,79632,463
5247221,4.53068,0.302777,468,2868900,0.700007,0.72,1,80100,79632,468
5250141,2.50614,5.66056,463,2870360,0.708001,0.72,1,80102,79639,463
5252421,59.7012,1.13211,537,2871820,0.7096,0.89,1,80176,79639,537
5255341,13.5402,64.2264,459,2873280,0.67792,0.89,1,80178,79719,459
5257201,3.50805,12.8453,460,2874740,0.655584,0.85,1,80179,79719,460
5260121,16.7016,20.1691,458,2876200,0.643117,0.85,1,80199,79741,458
5263041,6.54032,4.03381,462,2877660,0.744623,0.85,1,80203,79741,462
5264901,4.50806,0.806762,466,2879120,0.700925,0.78,1,80207,79741,466
5267821,2.50161,2.56135,465,2880580,0.668185,0.78,1,80209,79744,465
5269681,1.30032,0.51227,466,2882040,0.645637,0.71,1,80210,79744,466
5271761,1.86006,3.30245,464,2883500,0.609127,0.72,1,80212,79748,464
5274681,75.572,80.6605,458,2884960,0.785825,0.72,2,80306,79848,458
5277601,16.7144,16.1321,460,2886420,0.789165,0.72,2,80308,79848,460
5280501,54.5429,3.22642,524,2887880,0.797833,0.73,2,80372,79848,524
5283421,14.1086,60.6453,453,2889340,0.727567,0.73,1,80376,79923,453
5286341,6.02172,12.1291,457,2890800,0.649513,0.73,1,80380,79923,457
5289261,3.60434,2.42581,460,2892260,0.577903,0.73,1,80383,79923,460
5290901,3.12087,0.485162,463,2893720,0.723581,0.75,1,80386,79923,463
5293821,2.22417,10.497,452,2895180,0.720716,0.75,1,80388,79936,452
5296101,9.24483,2.09941,463,2896640,0.712143,0.66,1,80399,79936,463
5299021,3.44897,3.61988,461,2898100,0.678429,0.66,1,80401,79940,461
5301301,3.88979,0.723976,465,2899560,0.767686,0.79,2,80405,79940,465
5304221,2.37796,9.7448,455,2901020,0.753537,0.79,2,80407,79952,455
5307141,2.07559,1.94896,457,2902480,0.838707,0.79,2,80409,79952,457
5310061,2.01512,0.389792,459,2903940,0.815741,0.79,2,80411,79952,459
5312981,2.00302,0.0779584,461,2905400,0.779148,0.79,2,80413,79952,461
5315861,4.4006,0.0155917,466,2906860,0.74783,0.66,1,80418,79952,466
5318781,2.48012,7.20312,459,2908320,0.709566,0.66,1,80420,79961,459
5321701,2.09602,1.44062,461,2909780,0.709913,0.66,1,80422,79961,461
5324621,2.0192,0.288125,463,2911240,0.677983,0.66,1,80424,79961,463
5326261,2.00384,0.0576249,465,2912700,0.799597,0.77,2,80426,79961,465
5329181,2.80077,5.61152,461,2914160,0.767919,0.77,2,80429,79968,461
5331041,1.36015,1.1223,462,2915620,0.745584,0.8,1,80430,79968,462
5333121,6.67203,9.02446,459,2917080,0.645117,0.74,1,80438,79979,459
5336041,6.13441,9.80489,455,2918540,0.729023,0.74,1,80444,79989,455
5338321,2.82688,1.96098,457,2920000,0.721805,0.67,1,80446,79989,457
5341241,3.76538,3.5922,457,2921460,0.656361,0.67,1,80450,79993,457
5343521,3.95308,0.718439,461,2922920,0.659272,0.82,1,80454,79993,461
5346441,7.99062,8.94369,459,2924380,0.675854,0.82,1,80463,80004,459
5349361,3.19812,1.78874,461,2925840,0.719171,0.82,1,80465,80004,461
5352261,3.83962,0.357747,465,2927300,0.863834,0.81,2,80469,80004,465
5355181,2.36792,8.07155,457,2928760,0.868767,0.81,2,80471,80014,457
5357461,49.2736,1.61431,518,2930220,0.901753,0.83,2,80532,80014,518
5360381,11.4547,52.3229,455,2931680,0.868351,0.83,2,80534,80079,455
5362661,10.2909,10.4646,465,2933140,0.86167,0.65,2,80544,80079,465
5365581,3.65819,8.49291,459,2934600,0.828334,0.65,2,80546,80087,459
5367441,1.53164,1.69858,460,2936060,0.805667,0.7,2,80547,80087,460
5370361,6.70633,10.7397,455,2937520,0.905133,0.7,2,80555,80100,455
5373281,2.94127,2.14794,457,2938980,0.893027,0.7,2,80557,80100,457
5375761,2.18825,0.429589,459,2940440,0.858605,0.74,2,80559,80100,459
5378681,5.23765,8.08592,455,2941900,0.795721,0.74,2,80565,80110,455
5380961,2.64753,1.61718,457,2943360,0.863144,0.62,2,80567,80110,457
5394701,2,9,458,2950660,0.72,0.62,1,80669,80211,458
5397621,2,1.8,460,2952120,0.888,0.62,2,80671,80211,460
5400541,2,0.36,462,2953580,0.9296,0.62,2,80673,80211,462
5402181,6,0.072,469,2955040,0.93792,0.81,2,80680,80211,469
5404261,74,9.6144,548,2956500,0.875584,0.79,2,80771,80223,548
5407181,16.4,74.7229,459,2957960,0.831117,0.79,2,80773,80314,459
5409461,52.88,14.9446,521,2959420,0.934223,0.67,2,80835,80314,521
5412381,12.176,54.1889,459,2960880,0.922845,0.67,2,80837,80378,459
5414241,3.2352,10.8378,460,2962340,0.912569,0.75,2,80838,80378,460
5417161,7.04704,12.5676,455,2963800,0.966514,0.75,2,80846,80391,455
5420081,3.00941,2.51351,457,2965260,0.945303,0.75,2,80848,80391,457
5423001,2.20188,0.502702,459,2966720,0.917061,0.75,2,80850,80391,459
5424641,1.24038,0.10054,460,2968180,0.895412,0.81,2,80851,80391,460
5427561,10.6481,10.4201,460,2969640,0.979082,0.81,2,80864,80404,460
5429841,3.72962,2.08402,462,2971100,0.979816,0.82,2,80866,80404,462
5432761,4.74592,8.4168,457,2972560,0.931963,0.82,2,80871,80414,457
5435681,2.54918,1.68336,459,2974020,0.970393,0.82,2,80873,80414,459
5456881,1,0,461,2985700,0.86,0.77,2,80889,80428,461
5459801,5,12,452,2987160,0.916,0.77,2,80895,80443,452
5462721,2.6,2.4,454,2988620,0.9832,0.77,2,80897,80443,454
5465621,5.32,0.48,460,2990080,0.91664,0.6,2,80903,80443,460
5468541,2.664,7.296,453,2991540,0.879328,0.6,2,80905,80452,453
5471441,2.1328,1.4592,455,2993000,0.839866,0.61,2,80907,80452,455
5474361,7.62656,4.29184,459,2994460,0.903973,0.61,2,80916,80457,459
6121041,2,0,457,62776,0.01,0.78,1,83829,83372,457
6123961,2,0,459,62809,0.002,0.78,1,83831,83372,459
6126881,2,0,461,62842,0.0004,0.78,1,83833,83372,461
6129801,2,0,463,62875,8e-05,0.78,1,83835,83372,463
6132721,2,0,465,62908,0.024016,0.78,1,83837,83372,465
6135641,2,0,467,62941,0.0288032,0.78,1,83839,83372,467
6138561,2,0,469,62974,0.0457606,0.78,1,83841,83372,469
6141481,5.2,0,475,63007,0.0491521,0.78,1,83847,83372,475
6144401,4.24,0,479,63040,0.0498304,0.78,1,83851,83372,479
6147321,4.848,0,484,63073,0.00996608,0.78,1,83856,83372,484
6150241,2.5696,0,486,63106,0.0419932,0.78,1,83858,83372,486
6153161,2.91392,0,489,63139,0.00839864,0.78,1,83861,83372,489
6156081,2.18278,0,491,63172,0.00967973,0.78,1,83863,83372,491
6159001,2.03656,0,493,63205,0.00193595,0.78,1,83865,83372,493
6161921,2.00731,0,495,63238,0.0243872,0.78,1,83867,83372,495
6164841,2.00146,0,497,63271,0.0288774,0.78,1,83869,83372,497
6167761,2.00029,0,499,63304,0.00577549,0.78,1,83871,83372,499
6170681,2.00006,0,501,63337,0.0091551,0.78,1,83873,83372,501
6173601,2.00001,0,503,63370,0.00983102,0.78,1,83875,83372,503
6176521,2,0,505,63403,0.0099662,0.05,1,83877,83372,505
6179441,298.8,364,423,63436,0.0579932,0.01,1,84250,83827,423
6182361,61.36,74.4,423,63469,0.0355986,0.01,1,84252,83829,423
6185281,13.872,14.88,425,63502,0.00711973,0,1,84254,83829,425
6188201,4.3744,4.576,425,63535,0.00142395,0,1,84256,83831,425
6191121,2.47488,2.5152,425,63568,0.000284789,0,1,84258,83833,425
6194041,2.09498,2.10304,425,63601,0.00805696,0.03,1,84260,83835,425
6196961,2.019,2.02061,425,63634,0.00961139,0.03,1,84262,83837,425
6199881,2.0038,2.00412,425,63667,0.00992228,0.05,1,84264,83839,425
6202801,4.40076,2.00082,428,63700,0.0259845,0.05,1,84269,83841,428
6205721,3.28015,5.20017,425,63733,0.0131969,0.05,1,84272,83847,425
6208641,4.65603,4.24003,426,63766,0.00263938,0,1,84277,83851,426
6211561,2.53121,4.84801,423,63799,0.00852788,0.05,1,84279,83856,423
6214481,2.90624,2.5696,424,63832,0.00170558,0,1,84282,83858,424
6217401,2.18125,2.91392,423,63865,0.00834111,0.01,1,84284,83861,423
6220321,2.03625,2.18278,423,63898,0.00166822,0,1,84286,83863,423
6223241,2.00725,2.03656,423,63931,0.0243336,0.03,1,84288,83865,423
6226161,2.00145,2.00731,423,63964,0.0288667,0.03,1,84290,83867,423
6229081,2.00029,2.00146,423,63997,0.00577335,0,1,84292,83869,423
6232001,2.00006,2.00029,423,64030,0.00915467,0.01,1,84294,83871,423
6234921,2.00001,2.00006,423,64063,0.00983093,0.01,1,84296,83873,423
6237841,2,2.00001,423,64096,0.00996619,0.01,1,84298,83875,423
6239301,161.2,2,622,64129,0.00199324,0.07,1,84499,83877,622
6242221,170.64,298.8,422,64162,0.00839865,0.03,1,84672,84250,422
6245141,35.728,61.36,422,64195,0.00967973,0,1,84674,84252,422
6248061,8.7456,13.872,422,64228,0.00193595,0,1,84676,84254,422
6250981,3.34912,4.3744,422,64261,0.000387189,0,1,84678,84256,422
6253901,2.26982,2.47488,422,64294,0.0240774,0.01,1,84680,84258,422
6256821,2.05396,2.09498,422,64327,0.00481549,0.01,1,84682,84260,422
6259741,2.01079,2.019,422,64360,0.0089631,0.01,1,84684,84262,422
6262661,2.00216,2.0038,422,64393,0.00979262,0.03,1,84686,84264,422
6265581,4.40043,4.40076,422,64426,0.0419585,0.01,1,84691,84269,422
6268501,3.28009,3.28015,422,64459,0.0323917,0,1,84694,84272,422
6271421,4.65602,4.65603,422,64492,0.0464783,0.01,1,84699,84277,422
6274341,2.5312,2.53121,422,64525,0.0172957,0,1,84701,84279,422
6277261,2.90624,2.90624,422,64558,0.00345913,0.01,1,84704,84282,422
6280181,2.18125,2.18125,422,64591,0.00869183,0,1,84706,84284,422
6283101,2.03625,2.03625,422,64624,0.00173837,0.03,1,84708,84286,422
6286021,2.00725,2.00725,422,64656,0.0243477,0.03,1,84710,84288,422
6288941,2.00145,2.00145,422,64688,0.0288695,0,1,84712,84290,422
6291861,2.00029,2.00029,422,64720,0.00577391,0.01,1,84714,84292,422
6294781,2.00006,2.00006,422,64752,0.00915478,0.01,1,84716,84294,422
6297701,2.00001,2.00001,422,64784,0.00983096,0.01,1,84718,84296,422
6300621,2,2,422,64816,0.00996619,0,1,84720,84298,422
6303541,298.8,161.2,594,64848,0.0419932,0.01,1,85093,84499,594
6306461,61.36,170.64,423,64880,0.0483986,0.01,1,85095,84672,423
6309381,13.872,35.728,423,64912,0.0176797,0,1,85097,84674,423
6312301,4.3744,8.7456,423,64944,0.00353595,0,1,85099,84676,423
6315221,2.47488,3.34912,423,64976,0.000707189,0.03,1,85101,84678,423
6318141,2.09498,2.26982,423,65008,0.00814144,0,1,85103,84680,423
6321061,2.019,2.05396,423,65040,0.00962829,0.01,1,85105,84682,423
6323981,2.0038,2.01079,423,65072,0.00992566,0.01,1,85107,84684,423
6326901,2.00076,2.00216,423,65104,0.00998513,0.05,1,85109,84686,423
6329821,3.60015,4.40043,422,65136,0.00999703,0.03,1,85113,84691,422
6332741,3.12003,3.28009,422,65168,0.0259994,0.05,1,85116,84694,422
6335661,4.62401,4.65602,422,65200,0.0131999,0.01,1,85121,84699,422
6338581,2.5248,2.5312,422,65232,0.01064,0,1,85123,84701,422
6341501,2.90496,2.90624,422,65264,0.002128,0.01,1,85126,84704,422
6344421,2.18099,2.18125,422,65296,0.0084256,0,1,85128,84706,422
6347341,2.0362,2.03625,422,65328,0.00168512,0.03,1,85130,84708,422
6350261,2.00724,2.00725,422,65360,0.024337,0.03,1,85132,84710,422
6353181,2.00145,2.00145,422,65392,0.0288674,0,1,85134,84712,422
6356101,2.00029,2.00029,422,65424,0.00577348,0.01,1,85136,84714,422
6359021,2.00006,2.00006,422,65456,0.0091547,0.01,1,85138,84716,422
6361941,2.00001,2.00001,422,65488,0.00983094,0.01,1,85140,84718,422
6364861,2,2,422,65520,0.00996619,0.05,1,85142,84720,422
6367781,298.8,298.8,422,65552,0.00999324,0.05,1,85515,85093,422
6370701,61.36,61.36,422,65584,0.00999865,0.01,1,85517,85095,422
6373621,13.872,13.872,422,65616,0.00999973,0,1,85519,85097,422
6376541,4.3744,4.3744,422,65648,0.00199995,0,1,85521,85099,422
6379461,2.47488,2.47488,422,65680,0.000399989,0.01,1,85523,85101,422
6382381,2.09498,2.09498,422,65712,0.00808,0.01,1,85525,85103,422
6385301,2.019,2.019,422,65744,0.009616,0.01,1,85527,85105,422
6388221,2.0038,2.0038,422,65776,0.0099232,0.01,1,85529,85107,422
6391141,2.00076,2.00076,422,65808,0.00998464,0.01,1,85531,85109,422
6394061,3.60015,3.60015,422,65840,0.0259969,0.03,1,85535,85113,422
6396981,3.12003,3.12003,422,65872,0.0451994,0.01,1,85538,85116,422
6399901,4.62401,4.62401,422,65904,0.0650399,0.01,1,85543,85121,422
6402821,2.5248,2.5248,422,65936,0.037008,0,1,85545,85123,422
6405741,2.90496,2.90496,422,65968,0.0154016,0.01,1,85548,85126,422
6408661,2.18099,2.18099,422,66000,0.0110803,0,1,85550,85128,422
6411581,2.0362,2.0362,422,66032,0.00221606,0.03,1,85552,85130,422
6414501,2.00724,2.00724,422,66064,0.0244432,0.03,1,85554,85132,422
6417421,2.00145,2.00145,422,66096,0.0288886,0,1,85556,85134,422
6420341,2.00029,2.00029,422,66128,0.00577773,0.01,1,85558,85136,422
6423261,2.00006,2.00006,422,66160,0.00915555,0.01,1,85560,85138,422
6426181,2.00001,2.00001,422,66192,0.00983111,0.01,1,85562,85140,422
6429101,2,2,422,66224,0.00996622,0.01,1,85564,85142,422
6432021,298.8,298.8,422,66256,0.0259932,0.01,1,85937,85515,422
6434941,61.36,61.36,422,66288,0.0291986,0.01,1,85939,85517,422
6437861,13.872,13.872,422,66320,0.0298397,0,1,85941,85519,422
6440781,4.3744,4.3744,422,66352,0.00596795,0,1,85943,85521,422
6443701,2.47488,2.47488,422,66384,0.00119359,0,1,85945,85523,422
6446621,2.09498,0.494976,424,66416,0.00823872,0.01,1,85947,85523,424
6449541,2.019,1.699,424,66448,0.00964774,0.01,1,85949,85525,424
6452461,2.0038,1.9398,424,66480,0.00992955,0.01,1,85951,85527,424
6455381,2.00076,1.98796,424,66512,0.00998591,0.01,1,85953,85529,424
6458301,3.60015,1.99759,426,66544,0.00999718,0.03,1,85957,85531,426
6461221,2.32003,3.59952,424,66576,0.00999944,0.05,1,85959,85535,424
6464141,4.46401,3.1199,426,66608,0.0259999,0.07,1,85964,85538,426
6467061,2.4928,4.62398,423,66640,0.0292,0.03,1,85966,85543,423
6469981,2.89856,2.5248,424,66671,0.01384,0.01,1,85969,85545,424
6472901,2.17971,2.90496,423,66702,0.010768,0.01,1,85971,85548,423
6475821,2.03594,2.18099,423,66733,0.0021536,0,1,85973,85550,423
6478741,2.00719,2.0362,423,66764,0.0244307,0.03,1,85975,85552,423
6481661,2.00144,2.00724,423,66795,0.0288861,0.03,1,85977,85554,423
6484581,2.00029,2.00145,423,66826,0.00577723,0,1,85979,85556,423
6487501,2.00006,2.00029,423,66857,0.00915545,0.01,1,85981,85558,423
6490421,2.00001,2.00006,423,66888,0.00983109,0.01,1,85983,85560,423
6493341,2,2.00001,423,66919,0.00996622,0.01,1,85985,85562,423
6494801,161.2,2,622,66950,0.00199324,0.03,1,86186,85564,622
6497721,170.64,298.8,422,66981,0.0243986,0.03,1,86359,85937,422
6500641,35.728,61.36,422,67012,0.0288797,0.03,1,86361,85939,422
6503561,8.7456,13.872,422,67043,0.0297759,0,1,86363,85941,422
6506481,3.34912,4.3744,422,67074,0.00595519,0,1,86365,85943,422
6509401,2.26982,2.47488,422,67105,0.025191,0.01,1,86367,85945,422
6512321,2.05396,2.09498,422,67136,0.00503821,0.01,1,86369,85947,422
6515241,2.01079,2.019,422,67167,0.00900764,0.01,1,86371,85949,422
6518161,2.00216,2.0038,422,67198,0.00980153,0.01,1,86373,85951,422
6521081,2.00043,2.00076,422,67229,0.00996031,0.01,1,86375,85953,422
6524001,3.60009,3.60015,422,67260,0.00999206,0.01,1,86379,85957,422
6526921,2.32002,2.32003,422,67291,0.0259984,0.03,1,86381,85959,422
6529841,4.464,4.46401,422,67322,0.0451997,0.03,1,86386,85964,422
6532761,2.4928,2.4928,422,67353,0.0490399,0.01,1,86388,85966,422
6535681,2.89856,2.89856,422,67384,0.033808,0.01,1,86391,85969,422
6538601,2.17971,2.17971,422,67415,0.0307616,0,1,86393,85971,422
6541521,2.03594,2.03594,422,67446,0.00615232,0.03,1,86395,85973,422
6544441,2.00719,2.00719,422,67477,0.0252305,0.03,1,86397,85975,422
6547361,2.00144,2.00144,422,67508,0.0290461,0,1,86399,85977,422
6550281,2.00029,2.00029,422,67539,0.00580922,0.01,1,86401,85979,422
6553201,2.00006,2.00006,422,67570,0.00916184,0.01,1,86403,85981,422
6556121,2.00001,2.00001,422,67601,0.00983237,0.01,1,86405,85983,422
6559041,2,2,422,67632,0.00996647,0,1,86407,85985,422
6561961,298.8,161.2,594,67663,0.00999329,0.03,1,86780,86186,594
6564881,61.36,170.64,423,67694,0.00999866,0.03,1,86782,86359,423
6567801,13.872,35.728,423,67725,0.00999973,0.03,1,86784,86361,423
6570721,4.3744,8.7456,423,67756,0.00999995,0,1,86786,86363,423
6573641,2.47488,3.34912,423,67787,0.00199999,0.03,1,86788,86365,423
6576561,2.09498,2.26982,423,67818,0.0084,0,1,86790,86367,423
6579481,2.019,2.05396,423,67849,0.00968,0.01,1,86792,86369,423
6582401,2.0038,2.01079,423,67880,0.009936,0.01,1,86794,86371,423
6585321,2.00076,2.00216,423,67911,0.0099872,0.01,1,86796,86373,423
6588241,2.00015,2.00043,423,67942,0.00999744,0.01,1,86798,86375,423
6591161,3.60003,3.60009,423,67973,0.00999949,0.03,1,86802,86379,423
6594081,2.32001,2.32002,423,68004,0.0099999,0.05,1,86804,86381,423
6597001,3.664,4.464,422,68035,0.00999998,0.05,1,86808,86386,422
6599921,2.3328,2.4928,422,68066,0.042,0.03,1,86810,86388,422
6602841,2.86656,2.89856,422,68097,0.0324,0.03,1,86813,86391,422
6605761,2.17331,2.17971,422,68128,0.03048,0,1,86815,86393,422
6608681,2.03466,2.03594,422,68159,0.006096,0.03,1,86817,86395,422
6611601,2.00693,2.00719,422,68190,0.0252192,0.03,1,86819,86397,422
6614521,2.00139,2.00144,422,68221,0.0290438,0,1,86821,86399,422
6617441,2.00028,2.00029,422,68252,0.00580877,0.01,1,86823,86401,422
6620361,2.00006,2.00006,422,68283,0.00916175,0.01,1,86825,86403,422
6623281,2.00001,2.00001,422,68314,0.00983235,0.01,1,86827,86405,422
6626201,2,2,422,68345,0.00996647,0.01,1,86829,86407,422
6629121,298.8,298.8,422,68376,0.00999329,0.01,1,87202,86780,422
6632041,61.36,61.36,422,68407,0.00999866,0.01,1,87204,86782,422
6634961,13.872,13.872,422,68438,0.00999973,0.01,1,87206,86784,422
6637881,4.3744,4.3744,422,68469,0.00999995,0,1,87208,86786,422
6640801,2.47488,2.47488,422,68500,0.00199999,0.01,1,87210,86788,422
6643721,2.09498,2.09498,422,68531,0.0084,0.01,1,87212,86790,422
6646641,2.019,2.019,422,68562,0.00968,0.01,1,87214,86792,422
6649561,2.0038,2.0038,422,68593,0.009936,0.01,1,87216,86794,422
6652481,2.00076,2.00076,422,68624,0.0099872,0.01,1,87218,86796,422
6655401,2.00015,2.00015,422,68655,0.00999744,0.01,1,87220,86798,422
6658321,3.60003,3.60003,422,68686,0.00999949,0.01,1,87224,86802,422
6661241,2.32001,2.32001,422,68717,0.0099999,0.01,1,87226,86804,422
6664161,3.664,3.664,422,68748,0.026,0.05,1,87230,86808,422
6667081,2.3328,2.3328,422,68779,0.0612,0.03,1,87232,86810,422
6670001,2.86656,2.86656,422,68809,0.05224,0.03,1,87235,86813,422
6672921,2.17331,2.17331,422,68839,0.050448,0,1,87237,86815,422
6675841,2.03466,2.03466,422,68869,0.0180896,0.03,1,87239,86817,422
6678761,2.00693,2.00693,422,68899,0.0276179,0.03,1,87241,86819,422
6681681,2.00139,2.00139,422,68929,0.0295236,0,1,87243,86821,422
6684601,2.00028,2.00028,422,68959,0.00590472,0.01,1,87245,86823,422
6687521,2.00006,2.00006,422,68989,0.00918094,0.01,1,87247,86825,422
6690441,2.00001,2.00001,422,69019,0.00983619,0.01,1,87249,86827,422
6693361,2,2,422,69049,0.00996724,0.01,1,87251,86829,422
6696281,298.8,298.8,422,69079,0.0259934,0.01,1,87624,87202,422
6699201,61.36,61.36,422,69109,0.0291987,0.01,1,87626,87204,422
6702121,13.872,13.872,422,69139,0.0298397,0.01,1,87628,87206,422
6705041,4.3744,4.3744,422,69169,0.0299679,0,1,87630,87208,422
6707961,2.47488,2.47488,422,69199,0.00599359,0.01,1,87632,87210,422
6710881,2.09498,2.09498,422,69229,0.00919872,0.01,1,87634,87212,422
6713801,2.019,2.019,422,69259,0.00983974,0.01,1,87636,87214,422
6716721,2.0038,2.0038,422,69289,0.00996795,0.01,1,87638,87216,422
6719641,2.00076,0.40076,424,69319,0.00999359,0.01,1,87640,87216,424
6722561,2.00015,1.68015,424,69349,0.00999872,0.01,1,87642,87218,424
6725481,3.60003,1.93603,426,69379,0.00999974,0.01,1,87646,87220,426
6728401,2.32001,3.58721,424,69409,0.00999995,0.01,1,87648,87224,424
6731321,2.864,2.31744,425,69439,0.026,0.03,1,87651,87226,425
6734241,2.1728,3.66349,423,69469,0.0292,0.07,1,87653,87230,423
6737161,2.83456,2.3327,424,69499,0.01384,0.05,1,87656,87232,424
6740081,2.16691,2.86654,423,69529,0.010768,0.05,1,87658,87235,423
6743001,2.03338,2.17331,423,69559,0.0101536,0.01,1,87660,87237,423
6745921,2.00668,2.03466,423,69589,0.0260307,0.03,1,87662,87239,423
6748841,2.00134,2.00693,423,69619,0.0292061,0.03,1,87664,87241,423
6751761,2.00027,2.00139,423,69649,0.00584123,0,1,87666,87243,423
6754681,2.00005,2.00028,423,69679,0.00916825,0.01,1,87668,87245,423
6757601,2.00001,2.00006,423,69709,0.00983365,0.01,1,87670,87247,423
6760521,2,2.00001,423,69739,0.00996673,0.01,1,87672,87249,423
6761981,161.2,2,622,69769,0.00199335,0.03,1,87873,87251,622
6764901,170.64,298.8,422,69799,0.0243987,0.03,1,88046,87624,422
6767821,35.728,61.36,422,69829,0.0288797,0.03,1,88048,87626,422
6770741,8.7456,13.872,422,69859,0.0297759,0.03,1,88050,87628,422
6773661,3.34912,4.3744,422,69889,0.0299552,0,1,88052,87630,422
6776581,2.26982,2.47488,422,69919,0.029991,0.01,1,88054,87632,422
6779501,2.05396,2.09498,422,69949,0.00599821,0.01,1,88056,87634,422
6782421,2.01079,2.019,422,69979,0.00919964,0.01,1,88058,87636,422
6785341,2.00216,2.0038,422,70009,0.00983993,0.01,1,88060,87638,422
6788261,2.00043,2.00076,422,70039,0.00996799,0.01,1,88062,87640,422
6791181,2.00009,2.00015,422,70069,0.0099936,0.01,1,88064,87642,422
6794101,3.60002,3.60003,422,70099,0.00999872,0.01,1,88068,87646,422
6797021,2.32,2.32001,422,70129,0.00999974,0.03,1,88070,87648,422
6799941,2.864,2.864,422,70159,0.0259999,0.03,1,88073,87651,422
6802861,2.1728,2.1728,422,70189,0.0452,0.01,1,88075,87653,422
6805781,2.83456,2.83456,422,70219,0.03304,0.01,1,88078,87656,422
6808701,2.16691,2.16691,422,70249,0.030608,0.01,1,88080,87658,422
6811621,2.03338,2.03338,422,70279,0.0301216,0.03,1,88082,87660,422
6814541,2.00668,2.00668,422,70309,0.0300243,0.03,1,88084,87662,422
6817461,2.00134,2.00134,422,70339,0.0300049,0,1,88086,87664,422
6820381,2.00027,2.00027,422,70369,0.00600097,0.01,1,88088,87666,422
6823301,2.00005,2.00005,422,70399,0.00920019,0.01,1,88090,87668,422
6826221,2.00001,2.00001,422,70429,0.00984004,0.01,1,88092,87670,422
6829141,2,2,422,70459,0.00996801,0,1,88094,87672,422
6832061,298.8,161.2,594,70489,0.0099936,0.03,1,88467,87873,594
6834981,61.36,170.64,423,70519,0.00999872,0.03,1,88469,88046,423
6837901,13.872,35.728,423,70549,0.00999974,0.03,1,88471,88048,423
6840821,4.3744,8.7456,423,70579,0.00999995,0.03,1,88473,88050,423
6843741,2.47488,3.34912,423,70609,0.00999999,0.03,1,88475,88052,423
6846661,2.09498,2.26982,423,70639,0.01,0,1,88477,88054,423
6849581,2.019,2.05396,423,70669,0.01,0.01,1,88479,88056,423
6852501,2.0038,2.01079,423,70699,0.01,0.01,1,88481,88058,423
6855421,2.00076,2.00216,423,70729,0.01,0.01,1,88483,88060,423
6858341,2.00015,2.00043,423,70759,0.01,0.01,1,88485,88062,423
6861261,2.00003,2.00009,423,70789,0.01,0.01,1,88487,88064,423
6864181,3.60001,3.60002,423,70819,0.01,0.01,1,88491,88068,423
6867101,2.32,2.32,423,70849,0.01,0.03,1,88493,88070,423
6870021,2.064,2.864,422,70879,0.01,0.05,1,88495,88073,422
6872941,2.0128,2.1728,422,70909,0.01,0.03,1,88497,88075,422
6875861,2.80256,2.83456,422,70939,0.026,0.03,1,88500,88078,422
6878781,2.16051,2.16691,422,70969,0.0292,0.03,1,88502,88080,422
6881701,2.0321,2.03338,422,70999,0.02984,0.03,1,88504,88082,422
6884621,2.00642,2.00668,422,71029,0.029968,0.03,1,88506,88084,422
6887541,2.00128,2.00134,422,71059,0.0299936,0,1,88508,88086,422
6890461,2.00026,2.00027,422,71088,0.00599872,0.01,1,88510,88088,422
6893381,2.00005,2.00005,422,71117,0.00919974,0.01,1,88512,88090,422
6896301,2.00001,2.00001,422,71146,0.00983995,0.01,1,88514,88092,422
6899221,2,2,422,71175,0.00996799,0.01,1,88516,88094,422
6902141,298.8,298.8,422,71204,0.0099936,0.01,1,88889,88467,422
6905061,61.36,61.36,422,71233,0.00999872,0.01,1,88891,88469,422
6907981,13.872,13.872,422,71262,0.00999974,0.01,1,88893,88471,422
6910901,4.3744,4.3744,422,71291,0.00999995,0.01,1,88895,88473,422
6913821,2.47488,2.47488,422,71320,0.00999999,0.01,1,88897,88475,422
6916741,2.09498,2.09498,422,71349,0.01,0.01,1,88899,88477,422
6919661,2.019,2.019,422,71378,0.01,0.01,1,88901,88479,422
6922581,2.0038,2.0038,422,71407,0.01,0.01,1,88903,88481,422
6925501,2.00076,2.00076,422,71436,0.01,0.01,1,88905,88483,422
6928421,2.00015,2.00015,422,71465,0.01,0.01,1,88907,88485,422
6931341,2.00003,2.00003,422,71494,0.01,0.01,1,88909,88487,422
6934261,3.60001,3.60001,422,71523,0.01,0.01,1,88913,88491,422
6937181,2.32,2.32,422,71552,0.01,0.01,1,88915,88493,422
6940101,2.064,2.064,422,71581,0.01,0.01,1,88917,88495,422
6943021,2.0128,2.0128,422,71610,0.01,0.03,1,88919,88497,422
6945941,2.80256,2.80256,422,71639,0.026,0.03,1,88922,88500,422
6948861,2.16051,2.16051,422,71668,0.0452,0.03,1,88924,88502,422
6951781,2.0321,2.0321,422,71697,0.04904,0.03,1,88926,88504,422
6954701,2.00642,2.00642,422,71726,0.049808,0.03,1,88928,88506,422
6957621,2.00128,2.00128,422,71755,0.0499616,0,1,88930,88508,422
6960541,2.00026,2.00026,422,71784,0.0179923,0.01,1,88932,88510,422
6963461,2.00005,2.00005,422,71813,0.0115985,0.01,1,88934,88512,422
6966381,2.00001,2.00001,422,71842,0.0103197,0.01,1,88936,88514,422
6969301,2,2,422,71871,0.0100639,0.01,1,88938,88516,422
6972221,298.8,298.8,422,71900,0.0260128,0.01,1,89311,88889,422
6975141,61.36,61.36,422,71929,0.0292026,0.01,1,89313,88891,422
6978061,13.872,13.872,422,71958,0.0298405,0.01,1,89315,88893,422
6980981,4.3744,4.3744,422,71987,0.0299681,0.01,1,89317,88895,422
6983901,2.47488,2.47488,422,72016,0.0299936,0.01,1,89319,88897,422
6986821,2.09498,2.09498,422,72045,0.0299987,0.01,1,89321,88899,422
6989741,2.019,2.019,422,72074,0.0299997,0.01,1,89323,88901,422
6992661,2.0038,2.0038,422,72103,0.0299999,0.01,1,89325,88903,422
6995581,2.00076,2.00076,422,72132,0.03,0.01,1,89327,88905,422
6998501,2.00015,2.00015,422,72161,0.03,0.01,1,89329,88907,422
7001421,2.00003,2.00003,422,72190,0.03,0.01,1,89331,88909,422
7004341,3.60001,3.60001,422,72219,0.03,0.01,1,89335,88913,422
7007261,2.32,0.720001,424,72248,0.03,0.01,1,89337,88913,424
7010181,2.064,1.744,424,72277,0.03,0.01,1,89339,88915,424
7013101,2.0128,1.9488,424,72306,0.03,0.01,1,89341,88917,424
7016021,2.00256,1.98976,424,72335,0.062,0.03,1,89343,88919,424
7018941,2.00051,2.79795,423,72364,0.0364,0.05,1,89345,88922,423
7021861,2.0001,2.15959,423,72393,0.03128,0.05,1,89347,88924,423
7024781,2.00002,2.03192,423,72422,0.030256,0.05,1,89349,88926,423
7027701,2,2.00638,423,72451,0.0300512,0.05,1,89351,88928,423
7030621,2,2.00128,423,72480,0.0300102,0.01,1,89353,88930,423
7033541,2,2.00026,423,72509,0.030002,0.01,1,89355,88932,423
7036461,2,2.00005,423,72538,0.0300004,0.01,1,89357,88934,423
7039381,2,2.00001,423,72567,0.0300001,0.01,1,89359,88936,423
7040841,161.2,2,622,72596,0.00600002,0.03,1,89560,88938,622
7043761,171.44,298.8,423,72625,0.0412,0.03,1,89734,89311,423
7046681,35.888,61.36,423,72654,0.04824,0.03,1,89736,89313,423
7049601,8.7776,13.872,423,72683,0.049648,0.03,1,89738,89315,423
7052521,3.35552,4.3744,423,72712,0.0499296,0.03,1,89740,89317,423
7055441,2.2711,2.47488,423,72741,0.0499859,0.03,1,89742,89319,423
7058361,2.05422,2.09498,423,72770,0.0179972,0.03,1,89744,89321,423
7061281,2.01084,2.019,423,72799,0.0115994,0.03,1,89746,89323,423
7064201,2.00217,2.0038,423,72828,0.0103199,0.03,1,89748,89325,423
7067121,2.00043,2.00076,423,72857,0.010064,0.03,1,89750,89327,423
7070041,2.00009,2.00015,423,72886,0.0100128,0.03,1,89752,89329,423
7072961,2.00002,2.00003,423,72915,0.0100026,0.03,1,89754,89331,423
7075881,3.6,3.60001,423,72944,0.0100005,0.03,1,89758,89335,423
7078801,2.32,2.32,423,72973,0.0100001,0.03,1,89760,89337,423
7081721,2.064,2.064,423,73002,0.01,0.03,1,89762,89339,423
7084641,2.0128,2.0128,423,73031,0.01,0.07,1,89764,89341,423
7087561,2.00256,2.00256,423,73060,0.01,0.03,1,89766,89343,423
7090481,2.00051,2.00051,423,73089,0.01,0.03,1,89768,89345,423
7093401,2.0001,2.0001,423,73118,0.01,0.03,1,89770,89347,423
7096321,2.00002,2.00002,423,73147,0.026,0.03,1,89772,89349,423
7099241,2,2,423,73176,0.0292,0.03,1,89774,89351,423
7102161,2,2,423,73205,0.02984,0.03,1,89776,89353,423
7105081,2,2,423,73234,0.029968,0.03,1,89778,89355,423
7108001,2,2,423,73263,0.0299936,0.03,1,89780,89357,423
7110921,2,2,423,73292,0.0299987,0,1,89782,89359,423
7113841,298.8,161.2,595,73321,0.0299997,0.05,1,90155,89560,595
7116761,61.36,171.44,423,73350,0.0299999,0.05,1,90157,89734,423
7119681,13.872,35.888,423,73379,0.03,0.05,1,90159,89736,423
7122601,4.3744,8.7776,423,73408,0.03,0.05,1,90161,89738,423
7125521,2.47488,3.35552,423,73437,0.03,0.05,1,90163,89740,423
7128441,2.09498,2.2711,423,73466,0.03,0.01,1,90165,89742,423
7131361,2.019,2.05422,423,73495,0.03,0.01,1,90167,89744,423
7134281,2.0038,2.01084,423,73524,0.03,0.01,1,90169,89746,423
7137201,2.00076,2.00217,423,73552,0.03,0.01,1,90171,89748,423
7140121,2.00015,2.00043,423,73580,0.03,0.01,1,90173,89750,423
7143041,2.00003,2.00009,423,73608,0.03,0.01,1,90175,89752,423
7145961,3.60001,2.00002,425,73636,0.03,0.01,1,90179,89754,425
7148881,2.32,3.6,423,73664,0.03,0.01,1,90181,89758,423
7151801,2.064,2.32,423,73692,0.03,0.01,1,90183,89760,423
7154721,2.0128,2.064,423,73720,0.03,0.01,1,90185,89762,423
7157641,2.00256,2.0128,423,73748,0.03,0.01,1,90187,89764,423
7160561,2.00051,2.00256,423,73776,0.03,0.01,1,90189,89766,423
7163481,2.0001,2.00051,423,73804,0.03,0.01,1,90191,89768,423
7166401,2.00002,2.0001,423,73832,0.03,0.03,1,90193,89770,423
7169321,2,2.00002,423,73860,0.03,0.03,1,90195,89772,423
7172241,2,2,423,73888,0.03,0.03,1,90197,89774,423
7175161,2,2,423,73916,0.03,0.03,1,90199,89776,423
7178081,2,2,423,73944,0.03,0.03,1,90201,89778,423
7181001,2,2,423,73972,0.03,0.03,1,90203,89780,423
7183921,2,2,423,74000,0.03,0.03,1,90205,89782,423
7186841,298.8,298.8,423,74028,0.014,0.03,1,90578,90155,423
7189761,61.36,61.36,423,74056,0.0108,0.03,1,90580,90157,423
7192681,13.872,13.872,423,74084,0.01016,0.03,1,90582,90159,423
7195601,4.3744,4.3744,423,74112,0.010032,0.03,1,90584,90161,423
7198521,2.47488,2.47488,423,74140,0.0100064,0.03,1,90586,90163,423
7201441,2.09498,2.09498,423,74168,0.0100013,0.03,1,90588,90165,423
7204361,2.019,2.019,423,74196,0.0100003,0.03,1,90590,90167,423
7207281,2.0038,2.0038,423,74224,0.0100001,0.03,1,90592,90169,423
7210201,2.00076,2.00076,423,74252,0.01,0.03,1,90594,90171,423
7213121,2.00015,2.00015,423,74280,0.01,0.03,1,90596,90173,423
7216041,2.00003,2.00003,423,74308,0.01,0.03,1,90598,90175,423
7218961,3.60001,3.60001,423,74336,0.01,0.03,1,90602,90179,423
7221881,2.32,2.32,423,74364,0.01,0.03,1,90604,90181,423
7224801,2.064,2.064,423,74392,0.01,0.03,1,90606,90183,423
7227721,2.0128,2.0128,423,74420,0.01,0.03,1,90608,90185,423
7230641,2.00256,2.00256,423,74448,0.042,0.03,1,90610,90187,423
7233561,2.00051,2.00051,423,74476,0.0164,0.03,1,90612,90189,423
7236481,2.0001,2.0001,423,74504,0.01128,0.03,1,90614,90191,423
7239401,2.00002,2.00002,423,74532,0.010256,0.03,1,90616,90193,423
7242321,2,2,423,74560,0.0100512,0.03,1,90618,90195,423
7245241,2,2,423,74588,0.0100102,0.03,1,90620,90197,423
7248161,2,2,423,74616,0.026002,0.03,1,90622,90199,423
7251081,2,2,423,74644,0.0292004,0.03,1,90624,90201,423
7254001,2,2,423,74672,0.0298401,0.03,1,90626,90203,423
7256921,2,2,423,74700,0.029968,0.01,1,90628,90205,423
7259841,298,298.8,422,74728,0.0299936,0.01,1,91000,90578,422
7262761,61.2,61.36,422,74756,0.0299987,0.01,1,91002,90580,422
7265681,13.84,13.872,422,74784,0.0299997,0.01,1,91004,90582,422
7268601,4.368,4.3744,422,74812,0.0299999,0.01,1,91006,90584,422
7271521,2.4736,2.47488,422,74840,0.03,0.01,1,91008,90586,422
7274441,2.09472,2.09498,422,74868,0.03,0.01,1,91010,90588,422
7277361,2.01894,2.019,422,74896,0.03,0.01,1,91012,90590,422
7280281,2.00379,2.0038,422,74924,0.03,0.01,1,91014,90592,422
7283201,2.00076,2.00076,422,74952,0.03,0.01,1,91016,90594,422
7286121,2.00015,2.00015,422,74980,0.03,0.01,1,91018,90596,422
7289041,2.00003,2.00003,422,75008,0.03,0.01,1,91020,90598,422
7291961,3.60001,3.60001,422,75036,0.03,0.01,1,91024,90602,422
7294881,2.32,2.32,422,75064,0.03,0.01,1,91026,90604,422
7297801,2.064,2.064,422,75092,0.03,0.01,1,91028,90606,422
7300721,2.0128,2.0128,422,75120,0.03,0.05,1,91030,90608,422
7303641,2.00256,2.00256,422,75148,0.062,0.05,1,91032,90610,422
7306561,2.00051,0.400512,424,75176,0.0364,0.01,1,91034,90610,424
7309481,2.0001,1.6801,424,75204,0.03128,0.01,1,91036,90612,424
7312401,2.00002,1.93602,424,75232,0.030256,0.01,1,91038,90614,424
7315321,2,1.9872,424,75260,0.0300512,0.01,1,91040,90616,424
7318241,2,1.99744,424,75288,0.0300102,0.01,1,91042,90618,424
7321161,2,1.99949,424,75316,0.030002,0.03,1,91044,90620,424
7324081,2,1.9999,424,75344,0.0300004,0.03,1,91046,90622,424
7327001,2,1.99998,424,75372,0.0300001,0.03,1,91048,90624,424
7329921,2,2,424,75400,0.03,0.03,1,91050,90626,424
7331381,161.2,2,623,75428,0.006,0.03,1,91251,90628,623
7334301,169.84,298,423,75456,0.0252,0.03,1,91423,91000,423
7337221,35.568,61.2,423,75484,0.02904,0.03,1,91425,91002,423
7340141,8.7136,13.84,423,75512,0.029808,0.03,1,91427,91004,423
7343061,3.34272,4.368,423,75540,0.0299616,0.03,1,91429,91006,423
7345981,2.26854,2.4736,423,75568,0.0299923,0.03,1,91431,91008,423
7348901,2.05371,2.09472,423,75596,0.00599846,0.03,1,91433,91010,423
7351821,2.01074,2.01894,423,75624,0.00919969,0.03,1,91435,91012,423
7354741,2.00215,2.00379,423,75652,0.00983994,0.03,1,91437,91014,423
7357661,2.00043,2.00076,423,75680,0.00996799,0.03,1,91439,91016,423
7360581,2.00009,2.00015,423,75708,0.0099936,0.03,1,91441,91018,423
7363501,2.00002,2.00003,423,75736,0.00999872,0.03,1,91443,91020,423
7366421,3.6,3.60001,423,75764,0.00999974,0.03,1,91447,91024,423
7369341,2.32,2.32,423,75792,0.00999995,0.03,1,91449,91026,423
7372261,2.064,2.064,423,75820,0.00999999,0.03,1,91451,91028,423
7375181,2.0128,2.0128,423,75848,0.01,0.07,1,91453,91030,423
7378101,2.00256,2.00256,423,75876,0.01,0.03,1,91455,91032,423
7381021,2.00051,2.00051,423,75904,0.01,0.03,1,91457,91034,423
7383941,2.0001,2.0001,423,75932,0.01,0.03,1,91459,91036,423
7386861,2.00002,2.00002,423,75960,0.01,0.03,1,91461,91038,423
7389781,2,2,423,75988,0.01,0.03,1,91463,91040,423
7392701,2,2,423,76016,0.01,0.03,1,91465,91042,423
7395621,2,2,423,76044,0.01,0.03,1,91467,91044,423
7398541,2,2,423,76072,0.026,0.03,1,91469,91046,423
7401461,2,2,423,76100,0.0292,0.03,1,91471,91048,423
7404381,3.6,2,425,76128,0.02984,0,1,91475,91050,425
7407301,295.92,161.2,593,76156,0.029968,0.03,1,91844,91251,593
7410221,60.784,169.84,423,76183,0.0299936,0.03,1,91846,91423,423
7413141,13.7568,35.568,423,76210,0.0299987,0.03,1,91848,91425,423
7416061,4.35136,8.7136,423,76237,0.0299997,0.03,1,91850,91427,423
7418981,2.47027,3.34272,423,76264,0.0299999,0.03,1,91852,91429,423
7421901,2.09405,2.26854,423,76291,0.03,0,1,91854,91431,423
7424821,2.01881,2.05371,423,76318,0.03,0.01,1,91856,91433,423
7427741,2.00376,2.01074,423,76345,0.03,0.01,1,91858,91435,423
7430661,2.00075,2.00215,423,76372,0.03,0.01,1,91860,91437,423
7433581,2.00015,2.00043,423,76399,0.03,0.01,1,91862,91439,423
7436501,2.00003,2.00009,423,76426,0.03,0.01,1,91864,91441,423
7439421,3.60001,2.00002,425,76453,0.03,0.01,1,91868,91443,425
7442341,2.32,3.6,423,76480,0.03,0.01,1,91870,91447,423
7445261,2.064,2.32,423,76507,0.03,0.01,1,91872,91449,423
7448181,2.0128,2.064,423,76534,0.03,0.01,1,91874,91451,423
7451101,2.00256,2.0128,423,76561,0.03,0.01,1,91876,91453,423
7454021,2.00051,2.00256,423,76588,0.03,0.01,1,91878,91455,423
7456941,2.0001,2.00051,423,76615,0.03,0.01,1,91880,91457,423
7459861,2.00002,2.0001,423,76642,0.03,0.01,1,91882,91459,423
7462781,2,2.00002,423,76669,0.03,0.01,1,91884,91461,423
7465701,2,2,423,76696,0.03,0.01,1,91886,91463,423
7468621,2,2,423,76723,0.03,0.01,1,91888,91465,423
7471541,2,2,423,76750,0.03,0.03,1,91890,91467,423
7474461,2,2,423,76777,0.03,0.03,1,91892,91469,423
7477381,2,2,423,76804,0.03,0.03,1,91894,91471,423
7480301,4.4,3.6,424,76831,0.046,0.03,1,91899,91475,424
7483221,295.28,295.92,423,76858,0.0652,0.03,1,92267,91844,423
7486141,60.656,60.784,423,76885,0.06904,0.03,1,92269,91846,423
7489061,13.7312,13.7568,423,76912,0.069808,0.03,1,92271,91848,423
7491981,4.34624,4.35136,423,76939,0.0699616,0.03,1,92273,91850,423
7494901,2.46925,2.47027,423,76966,0.0699923,0.03,1,92275,91852,423
7497821,2.09385,2.09405,423,76993,0.0699985,0.03,1,92277,91854,423
7500741,2.01877,2.01881,423,77020,0.0699997,0.03,1,92279,91856,423
7503661,2.00375,2.00376,423,77047,0.0699999,0.03,1,92281,91858,423
7506581,2.00075,2.00075,423,77074,0.07,0.03,1,92283,91860,423
7509501,2.00015,2.00015,423,77101,0.07,0.03,1,92285,91862,423
7512421,2.00003,2.00003,423,77128,0.07,0.03,1,92287,91864,423
7515341,3.60001,3.60001,423,77155,0.07,0.03,1,92291,91868,423
7518261,2.32,2.32,423,77182,0.07,0.03,1,92293,91870,423
7521181,2.064,2.064,423,77209,0.07,0.03,1,92295,91872,423
7524101,2.0128,2.0128,423,77236,0.07,0.03,1,92297,91874,423
7527021,2.00256,2.00256,423,77263,0.102,0.03,1,92299,91876,423
7529941,2.00051,2.00051,423,77290,0.0764,0.03,1,92301,91878,423
7532861,2.0001,2.0001,423,77317,0.07128,0.03,1,92303,91880,423
7535781,2.00002,2.00002,423,77344,0.070256,0.03,1,92305,91882,423
7538701,2,2,423,77371,0.0700512,0.03,1,92307,91884,423
7541621,2,2,423,77398,0.0700102,0.03,1,92309,91886,423
7544541,2,2,423,77425,0.070002,0.03,1,92311,91888,423
7547461,2,2,423,77452,0.0700004,0.03,1,92313,91890,423
7550381,2,2,423,77479,0.0700001,0.03,1,92315,91892,423
7553301,2,2,423,77506,0.07,0.05,1,92317,91894,423
7556221,4.4,4.4,423,77533,0.102,0.07,1,92322,91899,423
7559141,296.88,295.28,425,77560,0.4124,0.07,1,92692,92267,425
7562061,60.976,60.656,425,77587,0.47448,0.07,1,92694,92269,425
7564981,13.7952,13.7312,425,77614,0.486896,0.07,1,92696,92271,425
7567901,4.35904,4.34624,425,77641,0.489379,0.07,1,92698,92273,425
7570821,2.47181,2.46925,425,77668,0.489876,0.07,1,92700,92275,425
7573741,2.09436,2.09385,425,77695,0.489975,0.07,1,92702,92277,425
7576661,2.01887,2.01877,425,77722,0.489995,0.07,1,92704,92279,425
7579581,2.00377,2.00375,425,77749,0.489999,0.07,1,92706,92281,425
7582501,2.00075,2.00075,425,77776,0.49,0.07,1,92708,92283,425
7585421,2.00015,2.00015,425,77803,0.49,0.07,1,92710,92285,425
7588341,2.00003,2.00003,425,77830,0.49,0.07,1,92712,92287,425
7591261,3.60001,3.60001,425,77857,0.49,0.07,1,92716,92291,425
7594181,2.32,2.32,425,77884,0.49,0.07,1,92718,92293,425
7597101,2.064,2.064,425,77911,0.49,0.07,1,92720,92295,425
7600021,2.0128,2.0128,425,77938,0.49,0.11,1,92722,92297,425
7602941,2.00256,2.00256,425,77965,0.522,0.07,1,92724,92299,425
7605861,2.00051,2.00051,425,77992,0.4964,0.07,1,92726,92301,425
7608781,2.0001,2.0001,425,78019,0.49128,0.07,1,92728,92303,425
7611701,2.00002,2.00002,425,78046,0.490256,0.07,1,92730,92305,425
7614621,2,2,425,78073,0.490051,0.07,1,92732,92307,425
7617541,2,0.400001,427,78100,0.49001,0.07,1,92734,92307,427
7620461,2,1.68,427,78127,0.490002,0.07,1,92736,92309,427
7623381,2,1.936,427,78154,0.49,0.07,1,92738,92311,427
7626301,2,1.9872,427,78181,0.49,0.07,1,92740,92313,427
7629221,2,1.99744,427,78208,0.49,0.07,1,92742,92315,427
7632141,4.4,1.99949,430,78235,0.506,0.11,1,92747,92317,430
7633601,161.68,4.3999,626,78262,0.1012,0.49,1,92948,92322,626
7636521,184.336,296.88,446,78289,0.31624,0.49,1,93138,92692,446
7639441,38.4672,60.976,446,78316,0.359248,0.49,1,93140,92694,446
7642361,9.29344,13.7952,446,78343,0.36785,0.49,1,93142,92696,446
7645281,3.45869,4.35904,446,78370,0.36957,0.49,1,93144,92698,446
7648201,2.29174,2.47181,446,78397,0.369914,0.49,1,93146,92700,446
7651121,2.05835,2.09436,446,78424,0.337983,0.49,1,93148,92702,446
7654041,2.01167,2.01887,446,78451,0.331597,0.49,1,93150,92704,446
7656961,2.00233,2.00377,446,78478,0.330319,0.49,1,93152,92706,446
7659881,2.00047,2.00075,446,78505,0.330064,0.49,1,93154,92708,446
7662801,2.00009,2.00015,446,78532,0.330013,0.49,1,93156,92710,446
7665721,2.00002,2.00003,446,78559,0.330003,0.49,1,93158,92712,446
7668641,3.6,3.60001,446,78586,0.33,0.49,1,93162,92716,446
7671561,2.32,2.32,446,78613,0.33,0.49,1,93164,92718,446
7674481,2.064,2.064,446,78640,0.33,0.49,1,93166,92720,446
7677401,2.0128,2.0128,446,78667,0.33,0.53,1,93168,92722,446
7680321,2.00256,2.00256,446,78694,0.33,0.49,1,93170,92724,446
7683241,2.00051,2.00051,446,78721,0.33,0.49,1,93172,92726,446
7686161,2.0001,2.0001,446,78748,0.33,0.49,1,93174,92728,446
7689081,2.00002,2.00002,446,78775,0.33,0.49,1,93176,92730,446
7692001,2,2,446,78802,0.33,0.49,1,93178,92732,446
7694921,2,2,446,78829,0.33,0.49,1,93180,92734,446
7697841,2,2,446,78856,0.33,0.49,1,93182,92736,446
7700761,2,2,446,78883,0.33,0.49,1,93184,92738,446
7703681,2,2,446,78910,0.33,0.49,1,93186,92740,446
7706601,2,2,446,78937,0.33,0.51,1,93188,92742,446
7709521,6.8,4.4,449,78964,0.346,0,1,93196,92747,449
7710981,299.76,161.68,621,78990,0.2692,0.37,1,93569,92948,621
7713901,65.552,184.336,438,79016,0.25384,0.37,1,93576,93138,438
7716821,14.7104,38.4672,438,79042,0.250768,0.37,1,93578,93140,438
7719741,4.54208,9.29344,438,79068,0.266154,0.37,1,93580,93142,438
7722661,2.50842,3.45869,438,79094,0.269231,0.37,1,93582,93144,438
7725581,2.10168,2.29174,438,79120,0.269846,0.33,1,93584,93146,438
7728501,2.02034,2.05835,438,79146,0.269969,0.33,1,93586,93148,438
7731421,2.00407,2.01167,438,79172,0.269994,0.33,1,93588,93150,438
7734341,2.00081,2.00233,438,79198,0.269999,0.33,1,93590,93152,438
7737261,2.00016,2.00047,438,79224,0.27,0.33,1,93592,93154,438
7740181,2.00003,2.00009,438,79250,0.27,0.33,1,93594,93156,438
7743101,2.00001,2.00002,438,79276,0.27,0.33,1,93596,93158,438
7746021,3.6,3.6,438,79302,0.27,0.33,1,93600,93162,438
7748941,2.32,2.32,438,79328,0.27,0.33,1,93602,93164,438
7751861,2.064,2.064,438,79354,0.27,0.33,1,93604,93166,438
7754781,2.0128,2.0128,438,79380,0.27,0.33,1,93606,93168,438
7757701,2.00256,2.00256,438,79406,0.27,0.33,1,93608,93170,438
7760621,2.00051,2.00051,438,79432,0.27,0.33,1,93610,93172,438
7763541,2.0001,2.0001,438,79458,0.27,0.33,1,93612,93174,438
7766461,2.00002,2.00002,438,79484,0.27,0.33,1,93614,93176,438
7769381,2,2,438,79510,0.27,0.33,1,93616,93178,438
7772301,2,2,438,79536,0.27,0.33,1,93618,93180,438
7775221,2,0.4,440,79562,0.27,0.33,1,93620,93180,440
7778141,2,1.68,440,79588,0.27,0.33,1,93622,93182,440
7781061,2,1.936,440,79614,0.27,0.33,1,93624,93184,440
7783981,2,1.9872,440,79640,0.27,0.33,1,93626,93186,440
7786901,2,1.99744,440,79666,0.27,0.35,1,93628,93188,440
7788361,161.2,6.79949,633,79692,0.054,0.25,1,93829,93196,633
7791281,177.04,299.76,441,79718,0.2268,0.25,1,94010,93569,441
7794201,37.008,65.552,436,79744,0.26136,0.25,1,94012,93576,436
7797121,9.0016,14.7104,436,79770,0.268272,0.27,1,94014,93578,436
7800041,3.40032,4.54208,436,79796,0.269654,0.27,1,94016,93580,436
7802961,2.28006,2.50842,436,79822,0.269931,0.27,1,94018,93582,436
7805881,2.05601,2.10168,436,79848,0.269986,0.27,1,94020,93584,436
7808801,2.0112,2.02034,436,79874,0.269997,0.27,1,94022,93586,436
7811721,2.00224,2.00407,436,79900,0.269999,0.27,1,94024,93588,436
7814641,2.00045,2.00081,436,79926,0.27,0.27,1,94026,93590,436
7817561,2.00009,2.00016,436,79952,0.27,0.27,1,94028,93592,436
7820481,2.00002,2.00003,436,79978,0.27,0.27,1,94030,93594,436
7823401,3.6,2.00001,438,80004,0.27,0.27,1,94034,93596,438
7826321,2.32,3.6,436,80030,0.27,0.27,1,94036,93600,436
7829241,2.064,2.32,436,80056,0.27,0.27,1,94038,93602,436
7832161,2.0128,2.064,436,80082,0.27,0.27,1,94040,93604,436
7835081,2.00256,2.0128,436,80108,0.27,0.27,1,94042,93606,436
7838001,2.00051,2.00256,436,80134,0.27,0.27,1,94044,93608,436
7840921,2.0001,2.00051,436,80160,0.27,0.27,1,94046,93610,436
7843841,2.00002,2.0001,436,80186,0.27,0.27,1,94048,93612,436
7846761,2,2.00002,436,80212,0.27,0.27,1,94050,93614,436
7849681,2,2,436,80238,0.27,0.27,1,94052,93616,436
7852601,2,2,436,80264,0.27,0.27,1,94054,93618,436
7855521,2,2,436,80290,0.27,0.27,1,94056,93620,436
7858441,2,2,436,80316,0.27,0.27,1,94058,93622,436
7861361,2,2,436,80342,0.27,0.27,1,94060,93624,436
7864281,2,2,436,80368,0.27,0.27,1,94062,93626,436
7867201,150.8,2,622,80394,0.054,0.27,1,94250,93628,622
7870121,186.16,306,435,80420,0.2428,0.27,1,94445,94010,435
7873041,38.832,62.8,435,80446,0.29656,0.27,1,94447,94012,435
7875961,9.3664,14.16,435,80472,0.307312,0.27,1,94449,94014,435
7878881,3.47328,4.432,435,80498,0.309462,0.27,1,94451,94016,435
7881801,2.29466,2.4864,435,80524,0.309892,0.27,1,94453,94018,435
7884721,2.05893,2.09728,435,80550,0.309979,0.27,1,94455,94020,435
7887641,2.01179,2.01946,435,80576,0.309996,0.27,1,94457,94022,435
7890561,2.00236,2.00389,435,80602,0.309999,0.27,1,94459,94024,435
7893481,2.00047,2.00078,435,80628,0.31,0.27,1,94461,94026,435
7896401,2.00009,2.00016,435,80654,0.31,0.27,1,94463,94028,435
7899321,2.00002,2.00003,435,80680,0.31,0.27,1,94465,94030,435
7902241,3.6,3.60001,435,80706,0.31,0.27,1,94469,94034,435
7905161,2.32,2.32,435,80732,0.31,0.27,1,94471,94036,435
7908081,2.064,2.064,435,80758,0.31,0.27,1,94473,94038,435
7911001,2.0128,2.0128,435,80784,0.31,0.27,1,94475,94040,435
7913921,2.00256,2.00256,435,80810,0.342,0.27,1,94477,94042,435
7916841,2.00051,2.00051,435,80836,0.3164,0.27,1,94479,94044,435
7919761,2.0001,2.0001,435,80862,0.31128,0.27,1,94481,94046,435
7922681,2.00002,2.00002,435,80888,0.310256,0.27,1,94483,94048,435
7925601,2,2,435,80914,0.310051,0.27,1,94485,94050,435
7928521,2,2,435,80940,0.31001,0.27,1,94487,94052,435
7931441,2,2,435,80966,0.310002,0.27,1,94489,94054,435
7934361,2,2,435,80992,0.31,0.27,1,94491,94056,435
7937281,2,0.4,437,81018,0.31,0.27,1,94493,94056,437
7940201,2,1.68,437,81044,0.31,0.27,1,94495,94058,437
7943121,2,1.936,437,81070,0.31,0.27,1,94497,94060,437
7946041,143.6,1.9872,614,81096,0.07,0,1,94676,94062,614
7947501,189.52,150.797,627,81122,0.198,0.29,1,94877,94250,627
7950421,41.904,186.159,437,81148,0.2396,0.31,1,94882,94445,437
7953341,9.9808,38.8319,437,81174,0.24792,0.31,1,94884,94447,437
7956261,3.59616,9.36638,437,81200,0.249584,0.31,1,94886,94449,437
7959181,2.31923,3.47328,437,81226,0.265917,0.31,1,94888,94451,437
7962101,2.06385,2.29466,437,81252,0.269183,0.31,1,94890,94453,437
7965021,2.01277,2.05893,437,81278,0.237837,0.31,1,94892,94455,437
7967941,2.00255,2.01179,437,81304,0.231567,0.31,1,94894,94457,437
7970861,2.00051,2.00236,437,81330,0.230313,0.31,1,94896,94459,437
7973781,2.0001,2.00047,437,81356,0.230063,0.31,1,94898,94461,437
7976701,2.00002,2.00009,437,81382,0.238013,0.31,1,94900,94463,437
7979621,2,2.00002,437,81408,0.231602,0.31,1,94902,94465,437
7982541,3.6,3.6,437,81434,0.23032,0.31,1,94906,94469,437
7985461,2.32,2.32,437,81460,0.230064,0.31,1,94908,94471,437
7988381,2.064,2.064,437,81486,0.230013,0.31,1,94910,94473,437
7991301,2.0128,2.0128,437,81512,0.230003,0.35,1,94912,94475,437
7994221,2.00256,2.00256,437,81538,0.23,0.31,1,94914,94477,437
7997141,2.00051,2.00051,437,81564,0.23,0.31,1,94916,94479,437
8000061,2.0001,2.0001,437,81590,0.23,0.31,1,94918,94481,437
8002981,2.00002,2.00002,437,81616,0.23,0.31,1,94920,94483,437
8005901,2,2,437,81642,0.23,0.31,1,94922,94485,437
8008821,2,2,437,81668,0.23,0.31,1,94924,94487,437
8011741,2,2,437,81694,0.23,0.31,1,94926,94489,437
8014661,2,2,437,81720,0.23,0.31,1,94928,94491,437
8017581,2,2,437,81746,0.23,0.31,1,94930,94493,437
8020501,2,2,437,81772,0.23,0.31,1,94932,94495,437
8023421,2,2,437,81798,0.23,0.01,1,94934,94497,437
8026341,138.8,143.6,431,81824,0.07,0.23,1,95107,94676,431
8029261,193.36,189.52,437,81850,0.23,0.25,1,95314,94877,437
8032181,40.272,41.904,434,81876,0.262,0.25,1,95316,94882,434
8035101,9.6544,9.9808,434,81902,0.2684,0.25,1,95318,94884,434
8038021,3.53088,3.59616,434,81928,0.28568,0.27,1,95320,94886,434
8040941,2.30618,2.31923,434,81954,0.289136,0.27,1,95322,94888,434
8043861,2.06124,2.06385,434,81980,0.289827,0.23,1,95324,94890,434
8046781,2.01225,2.01277,434,82006,0.289965,0.23,1,95326,94892,434
8049701,2.00245,2.00255,434,82031,0.289993,0.23,1,95328,94894,434
8052621,2.00049,2.00051,434,82056,0.289999,0.23,1,95330,94896,434
8055541,2.0001,2.0001,434,82081,0.29,0.24,1,95332,94898,434
8058461,2.00002,2.00002,434,82106,0.29,0.23,1,95334,94900,434
8061381,3.6,2,436,82131,0.29,0.23,1,95338,94902,436
8064301,2.32,3.6,434,82156,0.29,0.23,1,95340,94906,434
8067221,2.064,2.32,434,82181,0.29,0.23,1,95342,94908,434
8070141,2.0128,2.064,434,82206,0.29,0.23,1,95344,94910,434
8073061,2.00256,2.0128,434,82231,0.29,0.23,1,95346,94912,434
8075981,2.00051,2.00256,434,82256,0.29,0.23,1,95348,94914,434
8078901,2.0001,2.00051,434,82281,0.29,0.23,1,95350,94916,434
8081821,2.00002,2.0001,434,82306,0.29,0.23,1,95352,94918,434
8084741,2,2.00002,434,82331,0.29,0.23,1,95354,94920,434
8087661,2,2,434,82356,0.29,0.23,1,95356,94922,434
8090581,2,2,434,82381,0.29,0.23,1,95358,94924,434
8093501,2,2,434,82406,0.29,0.23,1,95360,94926,434
8096421,2,2,434,82431,0.29,0.23,1,95362,94928,434
8099341,2,2,434,82456,0.29,0.23,1,95364,94930,434
8102261,2,2,434,82481,0.29,0.23,1,95366,94932,434
8105181,2,2,434,82506,0.29,0.03,1,95368,94934,434
8108101,134,138.8,428,82531,0.242,0.27,1,95535,95107,428
8111021,198.8,193.36,436,82556,0.1844,0.27,1,95750,95314,436
8113941,41.36,40.272,436,82581,0.17288,0.27,1,95752,95316,436
8116861,9.872,9.6544,436,82606,0.170576,0.29,1,95754,95318,436
8119781,3.5744,3.53088,436,82631,0.170115,0.29,1,95756,95320,436
8122701,2.31488,2.30618,436,82656,0.170023,0.29,1,95758,95322,436
8125621,2.06298,2.06124,436,82681,0.170005,0.29,1,95760,95324,436
8128541,2.0126,2.01225,436,82706,0.170001,0.29,1,95762,95326,436
8131461,2.00252,2.00245,436,82731,0.17,0.29,1,95764,95328,436
8134381,2.0005,2.00049,436,82756,0.17,0.29,1,95766,95330,436
8137301,2.0001,2.0001,436,82781,0.17,0.29,1,95768,95332,436
8140221,2.00002,2.00002,436,82806,0.17,0.29,1,95770,95334,436
8143141,3.6,3.6,436,82831,0.17,0.29,1,95774,95338,436
8146061,2.32,2.32,436,82856,0.17,0.29,1,95776,95340,436
8148981,2.064,2.064,436,82881,0.17,0.29,1,95778,95342,436
8151901,2.0128,2.0128,436,82906,0.17,0.29,1,95780,95344,436
8154821,2.00256,2.00256,436,82931,0.202,0.29,1,95782,95346,436
8157741,2.00051,2.00051,436,82956,0.1764,0.29,1,95784,95348,436
8160661,2.0001,2.0001,436,82981,0.17128,0.29,1,95786,95350,436
8163581,2.00002,2.00002,436,83006,0.170256,0.29,1,95788,95352,436
8166501,2,2,436,83031,0.170051,0.29,1,95790,95354,436
8169421,2,2,436,83056,0.17001,0.29,1,95792,95356,436
8172341,2,2,436,83081,0.170002,0.29,1,95794,95358,436
8175261,2,2,436,83106,0.17,0.29,1,95796,95360,436
8178181,2,2,436,83131,0.17,0.29,1,95798,95362,436
8181101,2,2,436,83156,0.17,0.29,1,95800,95364,436
8184021,2,2,436,83181,0.17,0.29,1,95802,95366,436
8186941,2,2,436,83206,0.17,0.23,1,95804,95368,436
8189861,129.2,134,430,83231,0.25,0.17,1,95965,95535,430
8192781,197.84,198.8,430,83256,0.186,0.17,1,96180,95750,430
8195701,41.168,41.36,430,83281,0.1732,0.17,1,96182,95752,430
8198621,9.8336,9.872,430,83306,0.17064,0.17,1,96184,95754,430
8201541,3.56672,3.5744,430,83331,0.170128,0.17,1,96186,95756,430
8204461,2.31334,2.31488,430,83356,0.170026,0.17,1,96188,95758,430
8207381,2.06267,2.06298,430,83381,0.186005,0.17,1,96190,95760,430
8210301,2.01253,2.0126,430,83406,0.189201,0.17,1,96192,95762,430
8213221,2.00251,2.00252,430,83431,0.18984,0.17,1,96194,95764,430
8216141,2.0005,2.0005,430,83456,0.189968,0.17,1,96196,95766,430
8219061,2.0001,2.0001,430,83481,0.189994,0.17,1,96198,95768,430
8221981,2.00002,2.00002,430,83506,0.189999,0.17,1,96200,95770,430
8224901,3.6,3.6,430,83531,0.19,0.17,1,96204,95774,430
8227821,2.32,2.32,430,83556,0.19,0.17,1,96206,95776,430
8230741,2.064,2.064,430,83581,0.19,0.17,1,96208,95778,430
8233661,2.0128,2.0128,430,83606,0.19,0.21,1,96210,95780,430
8236581,2.00256,2.00256,430,83631,0.222,0.17,1,96212,95782,430
8239501,2.00051,2.00051,430,83656,0.1964,0.17,1,96214,95784,430
8242421,2.0001,2.0001,430,83681,0.19128,0.17,1,96216,95786,430
8245341,2.00002,2.00002,430,83706,0.190256,0.17,1,96218,95788,430
8248261,2,2,430,83731,0.190051,0.17,1,96220,95790,430
8251181,2,2,430,83756,0.19001,0.17,1,96222,95792,430
8254101,2,2,430,83781,0.190002,0.17,1,96224,95794,430
8257021,2,2,430,83806,0.19,0.17,1,96226,95796,430
8259941,2,2,430,83831,0.19,0.17,1,96228,95798,430
8262861,2,2,430,83856,0.19,0.17,1,96230,95800,430
8265781,2,2,430,83881,0.19,0.17,1,96232,95802,430
8268701,2,2,430,83906,0.19,0.17,1,96234,95804,430
8271621,131.6,0.4,594,83931,0.238,0.27,1,96398,95804,594
8273081,187.12,128.88,634,83956,0.2476,0.17,1,96599,95965,634
8276001,47.024,197.776,431,83981,0.26552,0.17,1,96611,96180,431
8278921,11.0048,41.1552,431,84006,0.269104,0.17,1,96613,96182,431
8281841,3.80096,9.83104,431,84031,0.269821,0.17,1,96615,96184,431
8284761,2.36019,3.56621,431,84056,0.269964,0.17,1,96617,96186,431
8287681,2.07204,2.31324,431,84081,0.269993,0.19,1,96619,96188,431
8290601,2.01441,2.06265,431,84106,0.237999,0.19,1,96621,96190,431
8293521,2.00288,2.01253,431,84131,0.2316,0.19,1,96623,96192,431
8296441,2.00058,2.00251,431,84156,0.23032,0.19,1,96625,96194,431
8299361,2.00012,2.0005,431,84181,0.230064,0.19,1,96627,96196,431
8302281,2.00002,2.0001,431,84206,0.230013,0.19,1,96629,96198,431
8305201,2,2.00002,431,84231,0.230003,0.19,1,96631,96200,431
8308121,3.6,3.6,431,84256,0.23,0.19,1,96635,96204,431
8311041,2.32,2.32,431,84281,0.23,0.19,1,96637,96206,431
8313961,2.064,2.064,431,84306,0.23,0.19,1,96639,96208,431
8316881,2.0128,2.0128,431,84331,0.23,0.23,1,96641,96210,431
8319801,2.00256,2.00256,431,84356,0.23,0.19,1,96643,96212,431
8322721,2.00051,2.00051,431,84381,0.23,0.19,1,96645,96214,431
8325641,2.0001,2.0001,431,84406,0.23,0.19,1,96647,96216,431
8328561,2.00002,2.00002,431,84431,0.23,0.19,1,96649,96218,431
8331481,2,2,431,84456,0.23,0.19,1,96651,96220,431
8334401,2,2,431,84481,0.23,0.19,1,96653,96222,431
8337321,2,2,431,84506,0.23,0.19,1,96655,96224,431
8340241,2,2,431,84531,0.23,0.19,1,96657,96226,431
8343161,2,2,431,84556,0.23,0.19,1,96659,96228,431
8346081,2,2,431,84581,0.23,0.19,1,96661,96230,431
8349001,2,2,431,84606,0.23,0.19,1,96663,96232,431
8351921,2,2,431,84631,0.23,0.25,1,96665,96234,431
8354841,127.6,131.6,426,84656,0.214,0.25,1,96824,96398,426
8357761,200.72,187.12,444,84681,0.1948,0.27,1,97043,96599,444
8360681,41.744,47.024,434,84706,0.19096,0.27,1,97045,96611,434
8363601,9.9488,11.0048,434,84731,0.190192,0.27,1,97047,96613,434
8366521,3.58976,3.80096,434,84756,0.190038,0.27,1,97049,96615,434
8369441,2.31795,2.36019,434,84781,0.190008,0.27,1,97051,96617,434
8372361,2.06359,2.07204,434,84806,0.190002,0.23,1,97053,96619,434
8375281,2.01272,2.01441,434,84831,0.19,0.23,1,97055,96621,434
8378201,2.00254,2.00288,434,84856,0.19,0.23,1,97057,96623,434
8381121,2.00051,2.00058,434,84881,0.19,0.23,1,97059,96625,434
8384041,2.0001,2.00012,434,84906,0.19,0.23,1,97061,96627,434
8386961,2.00002,2.00002,434,84931,0.19,0.23,1,97063,96629,434
8389881,3.6,2,436,84956,0.19,0.23,1,97067,96631,436
8392801,2.32,3.6,434,84981,0.19,0.23,1,97069,96635,434
8395721,2.064,2.32,434,85006,0.19,0.23,1,97071,96637,434
8398641,2.0128,2.064,434,85031,0.19,0.23,1,97073,96639,434
8401561,2.00256,2.0128,434,85056,0.19,0.23,1,97075,96641,434
8404481,2.00051,2.00256,434,85081,0.206,0.23,1,97077,96643,434
8407401,2.0001,2.00051,434,85106,0.2092,0.23,1,97079,96645,434
8410321,2.00002,2.0001,434,85131,0.20984,0.23,1,97081,96647,434
8413241,2,2.00002,434,85156,0.209968,0.23,1,97083,96649,434
8416161,2,2,434,85181,0.209994,0.23,1,97085,96651,434
8419081,2,2,434,85206,0.209999,0.23,1,97087,96653,434
8422001,2,2,434,85231,0.21,0.23,1,97089,96655,434
8424921,2,2,434,85256,0.21,0.23,1,97091,96657,434
8427841,2,2,434,85281,0.21,0.23,1,97093,96659,434
8430761,2,2,434,85305,0.21,0.23,1,97095,96661,434
8433681,2,2,434,85329,0.21,0.23,1,97097,96663,434
8436601,125.2,2,588,85353,0.258,0.21,1,97253,96665,588
8439521,26.64,127.6,431,85377,0.2676,0.19,1,97255,96824,431
8442441,180.528,200.72,431,85401,0.25352,0.19,1,97474,97043,431
8445361,37.7056,41.744,431,85425,0.250704,0.19,1,97476,97045,431
8448281,9.14112,9.9488,431,85449,0.250141,0.19,1,97478,97047,431
8451201,3.42822,3.58976,431,85473,0.250028,0.19,1,97480,97049,431
8454121,2.28564,2.31795,431,85497,0.250006,0.19,1,97482,97051,431
8457041,2.05713,2.06359,431,85521,0.218001,0.19,1,97484,97053,431
8459961,2.01143,2.01272,431,85545,0.2116,0.19,1,97486,97055,431
8462881,2.00229,2.00254,431,85569,0.21032,0.19,1,97488,97057,431
8465801,2.00046,2.00051,431,85593,0.210064,0.19,1,97490,97059,431
8468721,2.00009,2.0001,431,85617,0.210013,0.19,1,97492,97061,431
8471641,2.00002,2.00002,431,85641,0.210003,0.19,1,97494,97063,431
8474561,4.4,3.6,432,85665,0.226001,0.19,1,97499,97067,432
8477481,2.48,2.32,432,85689,0.2292,0.19,1,97501,97069,432
8480401,2.096,2.064,432,85713,0.22984,0.19,1,97503,97071,432
8483321,2.0192,2.0128,432,85737,0.229968,0.19,1,97505,97073,432
8486241,2.00384,2.00256,432,85761,0.229994,0.21,1,97507,97075,432
8489161,2.00077,2.00051,432,85785,0.197999,0.21,1,97509,97077,432
8492081,2.00015,2.0001,432,85809,0.1916,0.21,1,97511,97079,432
8495001,2.00003,2.00002,432,85833,0.19032,0.21,1,97513,97081,432
8497921,2.00001,2,432,85857,0.190064,0.21,1,97515,97083,432
8500841,2,2,432,85881,0.190013,0.21,1,97517,97085,432
8503761,2,2,432,85905,0.190003,0.21,1,97519,97087,432
8506681,2,2,432,85929,0.190001,0.21,1,97521,97089,432
8509601,2,2,432,85953,0.19,0.21,1,97523,97091,432
8512521,2,2,432,85977,0.19,0.21,1,97525,97093,432
8515441,2,2,432,86001,0.19,0.21,1,97527,97095,432
8518361,2,2,432,86025,0.19,0.27,1,97529,97097,432
8521281,127.6,125.2,435,86049,0.254,0.27,1,97688,97253,435
8524201,27.12,26.64,435,86073,0.2668,0.25,1,97690,97255,435
8527121,178.224,180.528,432,86097,0.26936,0.25,1,97906,97474,432
8530041,37.2448,37.7056,432,86121,0.269872,0.25,1,97908,97476,432
8532961,9.04896,9.14112,432,86145,0.269974,0.25,1,97910,97478,432
8535881,3.40979,3.42822,432,86169,0.269995,0.25,1,97912,97480,432
8538801,2.28196,2.28564,432,86193,0.269999,0.21,1,97914,97482,432
8541721,2.05639,2.05713,432,86217,0.238,0.21,1,97916,97484,432
8544641,2.01128,2.01143,432,86241,0.2316,0.21,1,97918,97486,432
8547561,2.00226,2.00229,432,86265,0.24632,0.21,1,97920,97488,432
8550481,2.00045,2.00046,432,86289,0.249264,0.21,1,97922,97490,432
8553401,2.00009,2.00009,432,86313,0.249853,0.21,1,97924,97492,432
8556321,2.00002,2.00002,432,86337,0.249971,0.23,1,97926,97494,432
8559241,3.6,4.4,431,86361,0.249994,0.23,1,97930,97499,431
8562161,2.32,2.48,431,86385,0.249999,0.23,1,97932,97501,431
8565081,2.064,2.096,431,86409,0.25,0.23,1,97934,97503,431
8568001,2.0128,2.0192,431,86433,0.25,0.23,1,97936,97505,431
8570921,2.00256,2.00384,431,86457,0.282,0.19,1,97938,97507,431
8573841,2.00051,2.00077,431,86481,0.2564,0.19,1,97940,97509,431
8576761,2.0001,2.00015,431,86505,0.25128,0.19,1,97942,97511,431
8579681,2.00002,2.00003,431,86529,0.250256,0.19,1,97944,97513,431
8582601,2,2.00001,431,86553,0.250051,0.19,1,97946,97515,431
8585521,2,2,431,86577,0.25001,0.19,1,97948,97517,431
8588441,2,2,431,86601,0.250002,0.19,1,97950,97519,431
8591361,2,2,431,86625,0.25,0.19,1,97952,97521,431
8594281,2,2,431,86649,0.25,0.19,1,97954,97523,431
8597201,2,2,431,86673,0.25,0.19,1,97956,97525,431
8600121,2,2,431,86697,0.25,0.19,1,97958,97527,431
8603041,2,2,431,86721,0.25,0.27,1,97960,97529,431
8605961,130.8,127.6,435,86745,0.282,0.27,1,98123,97688,435
8608881,27.76,27.12,435,86769,0.2884,0.27,1,98125,97690,435
8611801,176.752,178.224,433,86793,0.40168,0.27,1,98339,97906,433
8614721,36.9504,37.2448,433,86817,0.424336,0.27,1,98341,97908,433
8617641,8.99008,7.44896,435,86841,0.428867,0.27,1,98343,97908,435
8620561,3.39802,3.08979,435,86865,0.429773,0.27,1,98345,97910,435
8623481,2.2796,2.21796,435,86889,0.429955,0.27,1,98347,97912,435
8626401,2.05592,2.04359,435,86913,0.397991,0.23,1,98349,97914,435
8629321,2.01118,2.00872,435,86937,0.391598,0.23,1,98351,97916,435
8632241,2.00224,2.00174,435,86961,0.39032,0.25,1,98353,97918,435
8635161,2.00045,2.00035,435,86985,0.390064,0.25,1,98355,97920,435
8638081,2.00009,2.00007,435,87009,0.390013,0.25,1,98357,97922,435
8641001,2.00002,2.00001,435,87033,0.390003,0.25,1,98359,97924,435
8643921,3.6,2,437,87057,0.390001,0.25,1,98363,97926,437
8646841,2.32,3.6,435,87081,0.39,0.25,1,98365,97930,435
8649761,2.064,2.32,435,87105,0.39,0.25,1,98367,97932,435
8652681,2.0128,2.064,435,87129,0.39,0.25,1,98369,97934,435
8655601,2.00256,2.0128,435,87153,0.39,0.29,1,98371,97936,435
8658521,2.00051,2.00256,435,87177,0.39,0.25,1,98373,97938,435
8661441,2.0001,2.00051,435,87201,0.39,0.25,1,98375,97940,435
8664361,2.00002,2.0001,435,87225,0.39,0.25,1,98377,97942,435
8667281,2,2.00002,435,87249,0.39,0.25,1,98379,97944,435
8670201,2,2,435,87273,0.39,0.25,1,98381,97946,435
8673121,2,2,435,87297,0.39,0.25,1,98383,97948,435
8676041,2,2,435,87321,0.39,0.25,1,98385,97950,435
8678961,2,2,435,87345,0.39,0.25,1,98387,97952,435
8681881,2,2,435,87369,0.39,0.25,1,98389,97954,435
8684801,2,2,435,87393,0.39,0.25,1,98391,97956,435
8687721,2,2,435,87417,0.39,0.25,1,98393,97958,435
8690641,132.4,2,598,87441,0.358,0.29,1,98558,97960,598
8693561,28.08,130.8,437,87465,0.3516,0.29,1,98560,98123,437
8695021,166.416,27.76,636,87489,0.37432,0.43,1,98761,98125,636
8697941,48.4832,176.752,441,87513,0.402864,0.43,1,98780,98339,441
8700861,11.2966,36.9504,441,87537,0.408573,0.43,1,98782,98341,441
8703781,3.85933,8.99008,441,87561,0.409715,0.43,1,98784,98343,441
8706701,2.37187,3.39802,441,87585,0.409943,0.43,1,98786,98345,441
8709621,2.07437,2.2796,441,87609,0.409989,0.39,1,98788,98347,441
8712541,2.01487,2.05592,441,87633,0.409998,0.39,1,98790,98349,441
8715461,2.00297,2.01118,441,87657,0.41,0.39,1,98792,98351,441
8718381,2.00059,2.00224,441,87681,0.41,0.39,1,98794,98353,441
8721301,2.00012,2.00045,441,87705,0.41,0.39,1,98796,98355,441
8724221,2.00002,2.00009,441,87729,0.426,0.39,1,98798,98357,441
8727141,2,2.00002,441,87753,0.4292,0.39,1,98800,98359,441
8730061,3.6,3.6,441,87777,0.42984,0.39,1,98804,98363,441
8732981,2.32,2.32,441,87801,0.429968,0.39,1,98806,98365,441
8735901,2.064,2.064,441,87825,0.429994,0.39,1,98808,98367,441
8738821,2.0128,2.0128,441,87849,0.429999,0.39,1,98810,98369,441
8741741,2.00256,2.00256,441,87873,0.43,0.39,1,98812,98371,441
8744661,2.00051,2.00051,441,87897,0.43,0.39,1,98814,98373,441
8747581,2.0001,2.0001,441,87921,0.43,0.39,1,98816,98375,441
8750501,2.00002,2.00002,441,87945,0.43,0.39,1,98818,98377,441
8753421,2,2,441,87969,0.43,0.39,1,98820,98379,441
8756341,2,2,441,87993,0.43,0.39,1,98822,98381,441
8759261,2,2,441,88017,0.43,0.39,1,98824,98383,441
8762181,2,2,441,88041,0.43,0.39,1,98826,98385,441
8765101,2,2,441,88065,0.43,0.39,1,98828,98387,441
8768021,2,2,441,88089,0.43,0.39,1,98830,98389,441
8770941,2,2,441,88113,0.43,0.39,1,98832,98391,441
8773861,2,2,441,88137,0.43,0.35,1,98834,98393,441
8776781,130.8,132.4,439,88161,0.446,0.35,1,98997,98558,439
8779701,27.76,28.08,439,88185,0.4492,0.38,1,98999,98560,439
8782621,183.152,166.416,460,88209,0.44184,0.41,1,99221,98761,460
8785541,38.2304,48.4832,443,88233,0.440368,0.41,1,99223,98780,443
8788461,9.24608,11.2966,443,88257,0.440074,0.41,1,99225,98782,443
8791381,3.44922,3.85933,443,88281,0.440015,0.41,1,99227,98784,443
8794301,2.28984,2.37187,443,88305,0.440003,0.41,1,99229,98786,443
8797221,2.05797,2.07437,443,88329,0.440001,0.41,1,99231,98788,443
8800141,2.01159,2.01487,443,88353,0.44,0.41,1,99233,98790,443
8803061,2.00232,2.00297,443,88377,0.448,0.41,1,99235,98792,443
8805981,2.00046,2.00059,443,88401,0.4496,0.41,1,99237,98794,443
8808901,2.00009,2.00012,443,88425,0.44992,0.43,1,99239,98796,443
8811821,2.00002,2.00002,443,88449,0.449984,0.43,1,99241,98798,443
8814741,2,2,443,88473,0.449997,0.43,1,99243,98800,443
8817661,3.6,3.6,443,88497,0.449999,0.43,1,99247,98804,443
8820581,2.32,2.32,443,88521,0.45,0.43,1,99249,98806,443
8823501,2.064,2.064,443,88545,0.45,0.43,1,99251,98808,443
8826421,2.0128,2.0128,443,88569,0.45,0.43,1,99253,98810,443
8829341,2.00256,2.00256,443,88593,0.45,0.43,1,99255,98812,443
8832261,2.00051,2.00051,443,88617,0.45,0.43,1,99257,98814,443
8835181,2.0001,2.0001,443,88641,0.45,0.43,1,99259,98816,443
8838101,2.00002,2.00002,443,88665,0.45,0.43,1,99261,98818,443
8841021,2,2,443,88689,0.45,0.43,1,99263,98820,443
8843941,2,2,443,88713,0.45,0.43,1,99265,98822,443
8846861,2,2,443,88737,0.45,0.43,1,99267,98824,443
8849781,2,2,443,88761,0.45,0.43,1,99269,98826,443
8852701,2,2,443,88785,0.45,0.43,1,99271,98828,443
8855621,2,2,443,88809,0.45,0.43,1,99273,98830,443
8858541,2,2,443,88833,0.45,0.43,1,99275,98832,443
8861461,2,2,443,88856,0.45,0.45,1,99277,98834,443
8864381,131.6,130.8,444,88879,0.49,0.45,1,99441,98997,444
8867301,27.92,27.76,444,88902,0.498,0.44,1,99443,98999,444
8870221,183.184,183.152,444,88925,0.5316,0.44,1,99665,99221,444
8873141,38.2368,38.2304,444,88948,0.53832,0.44,1,99667,99223,444
8876061,9.24736,9.24608,444,88971,0.539664,0.44,1,99669,99225,444
8878981,3.44947,3.44922,444,88994,0.539933,0.44,1,99671,99227,444
8881901,2.28989,2.28984,444,89017,0.539987,0.44,1,99673,99229,444
8884821,2.05798,2.05797,444,89040,0.507997,0.44,1,99675,99231,444
8887741,2.0116,2.01159,444,89063,0.501599,0.45,1,99677,99233,444
8890661,2.00232,2.00232,444,89086,0.50032,0.45,1,99679,99235,444
8893581,2.00046,2.00046,444,89109,0.500064,0.45,1,99681,99237,444
8896501,2.00009,2.00009,444,89132,0.500013,0.45,1,99683,99239,444
8899421,2.00002,2.00002,444,89155,0.500003,0.45,1,99685,99241,444
8902341,2,2,444,89178,0.516001,0.45,1,99687,99243,444
8905261,3.6,3.6,444,89201,0.5272,0.45,1,99691,99247,444
8908181,2.32,2.32,444,89224,0.52944,0.45,1,99693,99249,444
8911101,2.064,2.064,444,89247,0.529888,0.45,1,99695,99251,444
8914021,2.0128,2.0128,444,89270,0.529978,0.45,1,99697,99253,444
8916941,2.00256,2.00256,444,89293,0.561996,0.45,1,99699,99255,444
8919861,2.00051,2.00051,444,89316,0.536399,0.45,1,99701,99257,444
8922781,2.0001,2.0001,444,89339,0.53128,0.45,1,99703,99259,444
8925701,2.00002,2.00002,444,89362,0.530256,0.45,1,99705,99261,444
8928621,2,2,444,89385,0.530051,0.45,1,99707,99263,444
8931541,2,2,444,89408,0.53001,0.45,1,99709,99265,444
8934461,2,2,444,89431,0.530002,0.45,1,99711,99267,444
8937381,2,2,444,89454,0.53,0.45,1,99713,99269,444
8940301,2,2,444,89477,0.53,0.45,1,99715,99271,444
8943221,2,2,444,89500,0.53,0.45,1,99717,99273,444
8946141,2,2,444,89523,0.53,0.45,1,99719,99275,444
8949061,2,2,444,89546,0.53,0.5,1,99721,99277,444
8951981,134,131.6,447,89569,0.554,0.5,1,99888,99441,447
8954901,28.4,27.92,447,89592,0.5588,0.54,1,99890,99443,447
8957821,183.28,183.184,447,89615,0.57576,0.54,1,100112,99665,447
8960741,38.256,38.2368,447,89638,0.587152,0.54,1,100114,99667,447
8963661,9.2512,9.24736,447,89661,0.58943,0.54,1,100116,99669,447
8966581,3.45024,3.44947,447,89684,0.589886,0.54,1,100118,99671,447
8969501,2.29005,2.28989,447,89707,0.589977,0.5,1,100120,99673,447
8972421,2.05801,2.05798,447,89730,0.581995,0.5,1,100122,99675,447
8975341,2.0116,0.411596,449,89753,0.580399,0.5,1,100124,99675,449
8978261,2.00232,1.68232,449,89776,0.58008,0.5,1,100126,99677,449
8981181,2.00046,1.93646,449,89799,0.580016,0.5,1,100128,99679,449
8984101,2.00009,1.98729,449,89822,0.580003,0.5,1,100130,99681,449
8987021,2.00002,1.99746,449,89845,0.580001,0.5,1,100132,99683,449
8989941,2,1.99949,449,89868,0.58,0.52,1,100134,99685,449
8992861,3.6,1.9999,451,89891,0.58,0.53,1,100138,99687,451
8995781,2.32,3.59998,449,89914,0.58,0.53,1,100140,99691,449
8998701,2.064,2.32,449,89937,0.58,0.53,1,100142,99693,449
9001621,2.0128,2.064,449,89960,0.58,0.53,1,100144,99695,449
9004541,2.00256,2.0128,449,89983,0.58,0.57,1,100146,99697,449
9007461,2.00051,2.00256,449,90006,0.58,0.53,1,100148,99699,449
9010381,2.0001,2.00051,449,90029,0.58,0.53,1,100150,99701,449
9013301,2.00002,2.0001,449,90052,0.588,0.53,1,100152,99703,449
9016221,2,2.00002,449,90075,0.5896,0.53,1,100154,99705,449
9019141,2,2,449,90098,0.58992,0.53,1,100156,99707,449
9022061,2,2,449,90121,0.589984,0.53,1,100158,99709,449
9024981,2,2,449,90144,0.589997,0.53,1,100160,99711,449
9027901,2,2,449,90167,0.589999,0.53,1,100162,99713,449
9030821,2,2,449,90190,0.59,0.53,1,100164,99715,449
9033741,2,2,449,90213,0.59,0.53,1,100166,99717,449
9036661,2,2,449,90236,0.59,0.53,1,100168,99719,449
9039581,135.6,2,616,90259,0.51,0.56,1,100337,99721,616
9042501,28.72,134,451,90282,0.55,0.56,1,100339,99888,451
9043961,166.544,28.4,650,90305,0.67,0.58,1,100540,99890,650
9046881,51.7088,183.28,451,90328,0.774,0.59,2,100563,100112,451
9049801,11.9418,38.256,451,90351,0.7948,0.59,2,100565,100114,451
9052721,3.98835,9.2512,451,90374,0.79896,0.59,2,100567,100116,451
9055641,2.39767,3.45024,451,90397,0.799792,0.59,2,100569,100118,451
9058561,2.07953,2.29005,451,90420,0.767958,0.58,2,100571,100120,451
9061481,2.01591,2.05801,451,90443,0.729592,0.58,1,100573,100122,451
9064401,2.00318,2.0116,451,90466,0.721918,0.58,1,100575,100124,451
9067321,2.00064,2.00232,451,90489,0.720384,0.58,1,100577,100126,451
9070241,2.00013,2.00046,451,90512,0.752077,0.58,2,100579,100128,451
9073161,2.00003,2.00009,451,90535,0.750415,0.58,2,100581,100130,451
9076081,2.00001,2.00002,451,90558,0.750083,0.58,2,100583,100132,451
9079001,2,2,451,90581,0.758017,0.58,2,100585,100134,451
9081921,3.6,3.6,451,90604,0.759603,0.58,2,100589,100138,451
9084841,2.32,2.32,451,90627,0.775921,0.58,2,100591,100140,451
9087761,2.064,2.064,451,90650,0.779184,0.58,2,100593,100142,451
9090681,2.0128,2.0128,451,90673,0.779837,0.58,2,100595,100144,451
9093601,2.00256,2.00256,451,90696,0.779967,0.58,2,100597,100146,451
9096521,2.00051,2.00051,451,90719,0.779994,0.58,2,100599,100148,451
9099441,2.0001,2.0001,451,90742,0.779999,0.59,2,100601,100150,451
9102361,2.00002,2.00002,451,90765,0.78,0.59,2,100603,100152,451
9105281,2,2,451,90788,0.78,0.59,2,100605,100154,451
9108201,2,2,451,90811,0.78,0.59,2,100607,100156,451
9111121,2,2,451,90834,0.78,0.59,2,100609,100158,451
9114041,2,2,451,90857,0.78,0.59,2,100611,100160,451
9116961,2,2,451,90880,0.78,0.59,2,100613,100162,451
9119881,2,2,451,90903,0.78,0.59,2,100615,100164,451
9122801,2,2,451,90926,0.78,0.59,2,100617,100166,451
9125721,2,2,451,90949,0.788,0.49,2,100619,100168,451
9128641,134.8,135.6,450,90972,0.7736,0.56,2,100787,100337,450
9131561,28.56,28.72,450,90995,0.73872,0.7,1,100789,100339,450
9608361,94,77,438,45307,0,0.7,1,103577,103139,438
9611281,208.4,183.4,465,45354,0.168,0.62,1,103814,103349,465
9614201,50.48,51.88,457,45400,0.2176,0.69,1,103825,103368,457
9617121,21.296,18.376,461,45446,0.25952,0.63,1,103839,103378,461
9620041,9.0592,7.6752,462,45492,0.235904,0.56,1,103845,103383,462
9622961,6.61184,6.33504,462,45538,0.247181,0.74,1,103851,103389,462
9625881,16.5224,10.867,469,45584,0.281436,0.76,1,103870,103401,469
9628801,17.7045,18.1734,467,45630,0.264287,0.68,1,103888,103421,467
9631721,9.94089,16.4347,459,45676,0.212857,0.71,1,103896,103437,459
9634641,7.58818,9.68694,458,45722,0.282571,0.58,1,103903,103445,458
9637561,12.7176,18.7374,451,45768,0.328514,0.38,1,103917,103466,451
9640481,4.14353,17.3475,436,45814,0.337703,0.38,1,103919,103483,436
9643401,2.42871,3.4695,438,45860,0.339541,0.38,1,103921,103483,438
9646321,2.08574,0.693899,440,45906,0.339908,0.38,1,103923,103483,440
9649241,2.01715,0.13878,442,45952,0.339982,0.38,1,103925,103483,442
9652161,60.4034,0.027756,517,45998,0.155996,0,1,104000,103483,517
9653621,172.881,75.2056,624,46044,0.167199,0.21,1,104201,103577,624
9656541,71.3761,204.641,433,46090,0.15344,0.23,1,104247,103814,433
9659461,24.6752,49.7282,435,46136,0.118688,0.27,1,104260,103825,435
9662381,16.135,21.1456,435,46182,0.167738,0.23,1,104274,103839,435
9665301,9.62701,9.02913,437,46228,0.0815475,0.25,1,104282,103845,437
9668221,6.7254,6.60583,437,46274,0.12831,0.29,1,104288,103851,437
9671141,16.5451,16.5212,437,46320,0.193662,0.26,1,104307,103870,437
9674061,15.309,17.7042,434,46366,0.126732,0.2,1,104322,103888,434
9676981,9.4618,9.94085,434,46411,0.137346,0.3,1,104330,103896,434
9679901,11.4924,7.58817,439,46456,0.171469,0.34,1,104342,103903,439
9682821,13.4985,12.7176,439,46501,0.178294,0.34,1,104356,103917,439
9685741,4.29969,4.14353,439,46546,0.179659,0.34,1,104358,103919,439
9688661,2.45994,2.42871,439,46591,0.179932,0.34,1,104360,103921,439
9691581,2.09199,2.08574,439,46636,0.187986,0.34,1,104362,103923,439
9694501,2.0184,2.01715,439,46681,0.189597,0.11,1,104364,103925,439
9697421,49.2037,60.4034,425,46726,0.189919,0.17,1,104425,104000,425
9700341,207.441,172.881,471,46771,0.141984,0.15,1,104672,104201,471
9703261,49.4881,71.3761,435,46816,0.196397,0.11,1,104682,104247,435
9706181,26.6976,24.6752,443,46861,0.167279,0.18,1,104703,104260,443
9709101,12.5395,16.135,438,46906,0.0574559,0.06,1,104712,104274,438
9712021,7.30791,9.62701,436,46951,0.187491,0.14,1,104718,104282,436
9714941,15.8616,6.7254,448,46996,0.213498,0.21,1,104736,104288,448
9717861,12.7723,16.5451,441,47041,0.2427,0.11,1,104748,104307,441
9720781,10.5545,15.309,436,47086,0.18454,0.14,1,104758,104322,436
9723701,9.31089,9.4618,437,47131,0.180908,0.18,1,104767,104330,437
9726621,15.4622,11.4924,442,47176,0.196182,0.18,1,104784,104342,442
9729541,4.69244,13.4985,430,47221,0.199236,0.18,1,104786,104356,430
9732461,2.53849,4.29969,430,47266,0.207847,0.18,1,104788,104358,430
9735381,2.1077,2.45994,430,47311,0.265569,0.19,1,104790,104360,430
9738301,2.02154,2.09199,430,47356,0.277114,0.19,1,104792,104362,430
9741221,2.00431,2.0184,430,47401,0.279423,0.19,1,104794,104364,430
9744141,48.4009,49.2037,429,47445,0.335885,0.13,1,104854,104425,429
9747061,210.48,207.441,433,47489,0.131177,0.21,1,105105,104672,433
9749981,46.896,49.4881,429,47533,0.154235,0.16,1,105111,104682,429
9752901,20.5792,26.6976,422,47577,0.126847,0.03,1,105125,104703,422
9755821,18.5158,12.5395,431,47621,0.0973694,0.22,1,105143,104712,431
9758741,8.50317,7.30791,431,47665,0.0434739,0.22,1,105149,104718,431
9761661,18.5006,15.8616,434,47709,0.136695,0.25,1,105170,104736,434
9764581,10.1001,12.7723,430,47753,0.195339,0.17,1,105178,104748,430
9767501,9.22003,10.5545,429,47797,0.191068,0.18,1,105187,104758,429
9770421,13.044,9.31089,434,47841,0.230214,0.2,1,105201,104767,434
9773341,17.8088,15.4622,436,47885,0.222043,0.2,1,105220,104784,436
9776261,5.16176,4.69244,436,47929,0.188409,0.21,1,105222,104786,436
9779181,2.63235,2.53849,436,47973,0.181682,0.28,1,105224,104788,436
9782101,2.12647,2.1077,436,48017,0.148336,0.28,1,105226,104790,436
9785021,2.02529,2.02154,436,48061,0.149667,0.28,1,105228,104792,436
9787941,2.00506,2.00431,436,48105,0.205933,0.35,1,105230,104794,436
9790861,49.201,48.4009,437,48149,0.225187,0.08,1,105291,104854,437
9793781,201.04,210.48,425,48193,0.213037,0.16,1,105530,105105,425
9796701,47.408,46.896,428,48237,0.258607,0.12,1,105539,105111,428
9799621,17.4816,20.5792,424,48281,0.163721,0.09,1,105549,105125,424
9802541,21.8963,18.5158,429,48325,0.248744,0.03,1,105572,105143,429
9805461,9.17926,8.50317,429,48369,0.177749,0.16,1,105578,105149,429
9808381,19.4359,18.5006,430,48413,0.18755,0.21,1,105600,105170,430
9811301,10.2872,10.1001,430,48457,0.21351,0.19,1,105608,105178,430
9814221,6.85743,9.22003,427,48500,0.226702,0.24,1,105614,105187,427
9817141,11.7715,13.044,426,48543,0.22934,0.22,1,105627,105201,426
9820061,23.1543,17.8088,433,48586,0.277868,0.18,1,105653,105220,433
9822981,6.23086,5.16176,433,48629,0.295574,0.18,1,105655,105222,433
9825901,2.84617,2.63235,433,48672,0.299115,0.14,1,105657,105224,433
9828821,2.16923,2.12647,433,48715,0.251823,0.15,1,105659,105226,433
9831741,2.03385,2.02529,433,48758,0.274365,0.22,1,105661,105228,433
9834661,2.00677,2.00506,433,48801,0.246873,0.23,1,105663,105230,433
9837581,49.2014,49.201,433,48844,0.281375,0.23,1,105724,105291,433
9839041,170.64,9.8402,634,48887,0.192275,0.21,1,105925,105291,634
9841961,64.5281,193.168,433,48930,0.190455,0.27,1,105963,105530,433
9844881,17.7056,45.8336,430,48973,0.214091,0.14,1,105969,105539,430
9847801,10.7411,17.1667,429,49016,0.194818,0.27,1,105978,105549,429
9850721,22.1482,21.8333,431,49059,0.118964,0.16,1,106003,105572,431
9853641,10.8296,9.16667,433,49102,0.135793,0.19,1,106011,105578,433
9856561,19.7659,19.4333,433,49145,0.171159,0.22,1,106033,105600,433
9859481,11.1532,10.2867,434,49188,0.202232,0.23,1,106042,105608,434
9862401,7.03064,6.85733,434,49231,0.232446,0.23,1,106048,105614,434
9865321,11.8061,11.7715,434,49274,0.230489,0.29,1,106061,105627,434
9868241,22.3612,23.1543,433,49317,0.190098,0.3,1,106086,105653,433
9871161,6.07224,6.23086,433,49360,0.18202,0.3,1,106088,105655,433
9874081,2.81445,2.84617,433,49403,0.180404,0.24,1,106090,105657,433
9877001,2.16289,2.16923,433,49446,0.220081,0.28,1,106092,105659,433
9879921,2.03258,2.03385,433,49489,0.196016,0.24,1,106094,105661,433
9882841,3.60652,2.00677,435,49532,0.175203,0.29,1,106098,105663,435
9885761,50.3213,49.2014,436,49575,0.187041,0.17,1,106160,105724,436
9888681,197.264,170.64,469,49617,0.157408,0.19,1,106394,105925,469
9891601,42.6528,64.5281,435,49659,0.0874816,0.22,1,106398,105963,435
9894521,18.1306,17.7056,441,49701,0.193496,0.19,1,106410,105969,441
9897441,23.6261,10.7411,457,49743,0.102699,0.1,1,106435,105978,457
9900361,9.52522,22.1482,438,49785,0.14854,0.14,1,106441,106003,438
9903281,19.505,10.8296,452,49827,0.197708,0.18,1,106463,106011,452
9906201,11.901,19.7659,440,49869,0.207542,0.21,1,106473,106033,440
9909121,7.1802,11.1532,437,49911,0.201508,0.24,1,106479,106042,437
9912041,8.63604,7.03064,440,49953,0.192302,0.23,1,106488,106048,440
9914961,23.3272,11.8061,454,49995,0.20646,0.18,1,106515,106061,454
9917881,6.26544,22.3612,431,50037,0.209292,0.18,1,106517,106086,431
9920801,2.85309,6.07224,431,50079,0.225858,0.18,1,106519,106088,431
9923721,2.17062,2.81445,431,50121,0.197172,0.23,1,106521,106090,431
9926641,2.03412,2.16289,431,50163,0.199434,0.19,1,106523,106092,431
9929561,2.00682,2.03258,431,50205,0.167887,0.17,1,106525,106094,431
9932481,50.8014,3.60652,490,50247,0.313577,0.19,1,106588,106098,490
9933941,170.96,50.3213,629,50289,0.326715,0.15,1,106789,106160,629
9936861,56.5921,197.264,423,50331,0.353343,0.15,1,106817,106394,423
9939781,21.7184,39.4528,436,50373,0.286669,0.07,1,106830,106394,436
9942701,10.7437,11.0906,440,50415,0.233334,0.22,1,106838,106398,440
9945621,20.5487,11.8181,451,50457,0.198667,0.08,1,106861,106410,451
9948541,14.5097,22.3636,439,50499,0.0877333,0.16,1,106874,106435,439
9951461,18.9019,9.27272,453,50541,0.225547,0.21,1,106894,106441,453
9954381,11.7804,19.4545,441,50583,0.261109,0.21,1,106904,106463,441
9957301,7.95608,11.8909,438,50625,0.252222,0.2,1,106911,106473,438
9960221,9.59122,7.17818,442,50667,0.258444,0.19,1,106921,106479,442
9963141,20.3182,8.63564,456,50709,0.283689,0.21,1,106944,106488,456
9966061,11.2636,23.3271,438,50751,0.304738,0.21,1,106953,106515,438
9968981,3.85273,6.26543,438,50793,0.316948,0.23,1,106955,106517,438
9971901,2.37055,2.85309,438,50834,0.28739,0.19,1,106957,106519,438
9974821,2.07411,2.17062,438,50875,0.241478,0.2,1,106959,106521,438
9977741,2.01482,2.03412,438,50916,0.208296,0.16,1,106961,106523,438
9980661,52.403,2.00682,501,50957,0.321659,0.35,1,107026,106525,501
9983581,169.681,50.8014,637,50998,0.376332,0.36,1,107225,106588,637
9986501,56.3361,193.36,436,51039,0.379266,0.27,1,107253,106817,436
9989421,19.2672,49.0721,433,51080,0.379853,0.22,1,107263,106830,433
9992341,11.8534,16.2144,435,51121,0.291971,0.19,1,107273,106838,435
9995261,13.5707,21.6429,426,51162,0.370394,0.06,1,107287,106861,426
9998181,17.1141,14.7286,431,51203,0.282079,0.26,1,107305,106874,431
10001101,22.6228,18.9457,435,51244,0.384416,0.27,1,107329,106894,435
10004021,10.9246,11.7891,433,51285,0.404883,0.25,1,107337,106904,433
10006941,8.58491,7.95783,434,51326,0.424977,0.26,1,107345,106911,434
10009861,11.317,9.59157,436,51367,0.396995,0.29,1,107357,106921,436
10012781,21.4634,20.3183,437,51408,0.359399,0.31,1,107381,106944,437
10015701,5.89268,11.2637,430,51449,0.40788,0.32,1,107383,106953,430
10018621,2.77854,3.85273,430,51490,0.417576,0.28,1,107385,106955,430
10021541,3.75571,2.37055,432,51531,0.395515,0.23,1,107389,106957,432
10024461,6.35114,2.07411,437,51572,0.415103,0.2,1,107396,106959,437
10027381,2.87023,2.01482,437,51613,0.387021,0.35,1,107398,106961,437
10030301,54.174,52.403,439,51654,0.485404,0.39,1,107465,107026,439
10033221,170.835,169.681,440,51695,0.409081,0.38,1,107665,107225,440
10036141,57.367,56.3361,441,51736,0.449816,0.38,1,107694,107253,441
10039061,14.6734,19.2672,435,51777,0.465963,0.38,1,107698,107263,435
10041981,15.7347,3.85344,451,51818,0.477193,0.27,1,107714,107263,451
10044901,13.5469,8.77069,454,51859,0.391439,0.39,1,107727,107273,454
10047821,16.3094,12.9541,457,51900,0.470288,0.26,1,107744,107287,457
10050741,24.8619,16.9908,466,51941,0.486058,0.41,1,107771,107305,466
10053661,11.3724,22.5982,450,51982,0.489211,0.41,1,107779,107329,450
10056581,7.07448,10.9196,448,52023,0.497842,0.43,1,107785,107337,448
10059501,11.8149,8.58393,453,52063,0.491568,0.39,1,107798,107345,453
10062421,21.563,11.3168,465,52103,0.450314,0.35,1,107822,107357,465
10065341,5.9126,21.4634,443,52143,0.466063,0.42,1,107824,107381,443
10068261,2.78252,5.89267,443,52183,0.437213,0.42,1,107826,107383,443
10071181,2.1565,2.77853,443,52223,0.471443,0.39,1,107828,107385,443
10074101,7.6313,3.75571,448,52263,0.502288,0.42,1,107837,107389,448
10077021,3.12626,6.35114,443,52303,0.508458,0.38,1,107839,107396,443
10079941,58.2253,2.87023,513,52343,0.421692,0.51,1,107911,107398,513
10082861,170.845,54.174,645,52383,0.412338,0.39,1,108110,107465,645
10085781,58.169,170.835,475,52423,0.442468,0.46,1,108140,107665,475
10088701,14.8338,57.367,450,52463,0.440494,0.47,1,108144,107694,450
10091621,10.9668,14.6734,456,52503,0.416099,0.48,1,108154,107698,456
10094541,12.5934,15.7347,453,52543,0.38722,0.37,1,108167,107714,453
10097461,20.1187,13.5469,462,52583,0.461444,0.49,1,108189,107727,462
10100381,26.4237,16.3094,473,52623,0.388289,0.49,1,108217,107744,473
10103301,11.6847,24.8619,454,52663,0.461658,0.49,1,108225,107771,454
10106221,7.13695,11.3724,452,52703,0.476332,0.5,1,108231,107779,452
10109141,9.42739,7.07448,456,52743,0.479266,0.49,1,108241,107785,456
10112061,22.6855,11.8149,469,52783,0.447853,0.44,1,108267,107798,469
10114981,6.1371,21.563,447,52823,0.409571,0.47,1,108269,107822,447
10117901,2.82742,5.9126,447,52863,0.401914,0.43,1,108271,107824,447
10120821,2.16548,2.78252,447,52903,0.368383,0.48,1,108273,107826,447
10123741,6.0331,2.1565,452,52943,0.449677,0.51,1,108280,107828,452
10126661,2.80662,7.6313,445,52983,0.465935,0.51,1,108282,107837,445
10129581,56.5613,3.12626,513,53023,0.525187,0.4,1,108352,107839,513
10132501,169.712,58.2253,639,53063,0.569037,0.41,1,108550,107911,639
10135421,58.7425,170.845,471,53103,0.545807,0.45,1,108581,108110,471
10138341,14.9485,58.169,445,53143,0.541161,0.44,1,108585,108140,445
10141261,9.3897,14.8338,449,53183,0.540232,0.41,1,108593,108144,449
10144181,9.87794,10.9668,449,53223,0.516046,0.38,1,108603,108154,449
10147101,3.57559,12.5934,438,53263,0.511209,0.48,1,108605,108167,438
10150021,19.1151,20.1187,439,53303,0.350242,0.37,1,108628,108189,439
10152941,31.823,26.4237,446,53342,0.438048,0.48,1,108663,108217,446
10155861,12.7646,11.6847,446,53381,0.56761,0.48,1,108671,108225,446
10158781,7.35292,7.13695,446,53420,0.561522,0.48,1,108677,108231,446
10161701,9.47058,9.42739,446,53459,0.576304,0.44,1,108687,108241,446
10164621,19.4941,22.6855,442,53498,0.587261,0.4,1,108709,108267,442
10167541,7.89882,6.1371,445,53537,0.573452,0.4,1,108714,108269,445
10170461,3.17976,2.82742,445,53576,0.57069,0.36,1,108716,108271,445
10173381,2.23595,2.16548,445,53615,0.562138,0.47,1,108718,108273,445
10176301,3.64719,6.0331,442,53654,0.528428,0.47,1,108722,108280,442
10179221,5.52944,2.80662,446,53693,0.545686,0.54,1,108728,108282,446
10182141,60.3059,56.5613,450,53732,0.533137,0.58,1,108802,108352,450
10185061,168.061,169.712,447,53771,0.610627,0.54,1,108997,108550,447
10187981,60.0122,58.7425,449,53810,0.618125,0.54,1,109030,108581,449
10190901,15.2024,14.9485,449,53849,0.619625,0.54,1,109034,108585,449
10193821,7.84049,9.3897,447,53888,0.619925,0.51,1,109040,108593,447
10196741,7.9681,9.87794,445,53927,0.619985,0.51,1,109048,108603,445
10199661,3.19362,3.57559,445,53966,0.619997,0.31,1,109050,108605,445
10202581,17.4387,19.1151,443,54005,0.523999,0.46,1,109071,108628,443
10205501,37.8877,31.823,451,54044,0.5368,0.6,1,109114,108663,451
10208421,13.9775,12.7646,451,54083,0.60336,0.56,1,109122,108671,451
10211341,7.59551,7.35292,451,54122,0.624672,0.58,1,109128,108677,451
10214261,9.5191,9.47058,451,54161,0.636934,0.59,1,109138,108687,451
10217181,17.9038,19.4941,449,54200,0.631387,0.57,1,109158,108709,449
10220101,5.18076,7.89882,446,54239,0.630277,0.57,1,109160,108714,446
10223021,5.83615,3.17976,450,54278,0.630055,0.56,1,109166,108716,450
10225941,2.76723,2.23595,450,54317,0.598011,0.52,1,109168,108718,450
10228861,3.75345,3.64719,450,54356,0.591602,0.55,1,109172,108722,450
10231781,2.35069,5.52944,446,54395,0.59832,0.53,1,109174,108728,446
10234701,62.8701,60.3059,450,54434,0.623664,0.63,1,109252,108802,450
10237621,169.374,168.061,451,54473,0.692733,0.62,1,109448,108997,451
10240541,61.8748,60.0122,453,54512,0.610547,0.62,1,109483,109030,453
10243461,15.575,15.2024,453,54551,0.682109,0.62,1,109487,109034,453
10246381,7.91499,7.84049,453,54590,0.696422,0.62,1,109493,109040,453
10249301,6.383,7.9681,451,54629,0.699284,0.62,1,109499,109048,451
10252221,2.8766,3.19362,451,54668,0.699857,0.5,1,109501,109050,451
10255141,14.1753,17.4387,447,54706,0.651971,0.5,1,109518,109071,447
10258061,41.2351,3.48774,495,54744,0.642394,0.54,1,109566,109071,495
10260981,14.647,35.0976,460,54782,0.632479,0.62,1,109574,109114,460
10263901,7.7294,13.4195,458,54820,0.694496,0.63,1,109580,109122,458
10266821,9.54588,7.4839,462,54858,0.714899,0.64,1,109590,109128,462
10269741,16.3092,9.49678,470,54896,0.73498,0.63,1,109608,109138,470
10272661,4.86184,17.8994,452,54934,0.738996,0.63,1,109610,109158,452
10275581,4.97237,5.17987,455,54972,0.731799,0.63,1,109615,109160,455
10278501,2.59447,5.83597,451,55010,0.72236,0.59,1,109617,109166,451
10281421,2.11889,2.76719,451,55048,0.760472,0.59,2,109619,109168,451
10284341,2.82378,3.75344,450,55086,0.752094,0.6,2,109622,109172,450
10287261,66.9648,2.35069,531,55124,0.734419,0.63,1,109705,109174,531
10290181,172.593,62.8701,652,55162,0.738884,0.71,1,109904,109252,652
10293101,62.5186,169.374,491,55200,0.707777,0.59,1,109939,109448,491
10296021,15.7037,61.8748,460,55238,0.757555,0.7,2,109943,109483,460
10298941,7.94074,15.575,462,55276,0.775511,0.7,2,109949,109487,462
10301861,6.38815,7.91499,462,55314,0.763102,0.7,2,109955,109493,462
10304781,2.87763,6.383,458,55352,0.76062,0.7,2,109957,109499,458
10307701,14.9755,2.8766,474,55390,0.696124,0.64,1,109975,109501,474
10310621,38.9951,14.1753,502,55428,0.699225,0.64,1,110020,109518,502
10313541,17.399,41.2351,466,55466,0.723845,0.63,1,110032,109566,466
10316461,8.2798,14.647,464,55504,0.672769,0.71,1,110038,109574,464
10319381,9.65596,7.7294,468,55542,0.734554,0.72,1,110048,109580,468
10322301,16.3312,9.54588,476,55580,0.746911,0.74,1,110066,109590,476
10325221,4.86624,16.3092,460,55618,0.749382,0.74,1,110068,109608,460
10328141,2.57325,4.86184,460,55656,0.741876,0.73,1,110070,109610,460
10331061,2.11465,4.97237,457,55694,0.740375,0.72,1,110072,109615,457
10333981,2.02293,2.59447,457,55732,0.748075,0.77,1,110074,109617,457
10336901,2.80459,2.11889,458,55770,0.757615,0.75,2,110077,109619,458
10339821,66.9609,2.82378,538,55808,0.743523,0.73,1,110160,109622,538
10341281,174.192,66.9648,656,55846,0.756705,0.74,2,110361,109705,656
10344201,38.0384,172.593,461,55884,0.759341,0.7,2,110365,109904,461
10347121,34.8077,62.5186,460,55922,0.767868,0.77,2,110399,109939,460
10350041,10.1615,15.7037,460,55960,0.737574,0.78,1,110403,109943,460
10352961,6.83231,7.94074,460,55998,0.787515,0.76,2,110409,109949,460
10355881,6.16646,6.38815,460,56036,0.805503,0.76,2,110415,109955,460
10358801,2.83329,2.87763,460,56074,0.809101,0.68,2,110417,109957,460
10361721,8.56666,14.9755,452,56112,0.81782,0.7,2,110427,109975,452
10567581,53,8,517,58709,0.49,1,1,112280,111763,517
10570501,20.2,36,486,58745,0.426,1,1,112292,111806,486
10573421,12.04,22.4,477,58781,0.3332,1,1,112302,111825,477
10576341,14.408,11.68,483,58817,0.31464,1,1,112317,111834,483
10579261,9.2816,8.736,483,58853,0.246928,1,1,112325,111842,483
10582181,8.25632,6.5472,485,58889,0.201386,1,1,112333,111848,485
10585101,25.6513,5.30944,510,58925,0.0802771,1,1,112363,111853,510
10588021,14.7303,28.2619,488,58961,0.0400554,1,1,112375,111887,488
10590941,14.1461,14.4524,491,58997,0.0320111,1,1,112389,111898,491
10593861,12.4292,28.4905,471,59033,0.0304022,1,1,112401,111930,471
10596781,17.6858,15.2981,478,59069,0.0300804,1,1,112420,111942,478
10599701,10.7372,9.45962,479,59105,0.0300161,1,1,112429,111950,479
10602621,12.5474,13.0919,478,59141,0.0300032,1,1,112442,111964,478
10605541,13.7095,9.81838,483,59177,0.0620006,1,1,112456,111973,483
10608461,17.1419,10.7637,490,59213,0.0524001,1,1,112474,111984,490
10611381,10.6284,8.55274,491,59248,0.06648,1,1,112483,111992,491
10614301,11.7257,11.3105,491,59283,0.053296,1,1,112495,112004,491
10617221,11.1451,19.8621,480,59318,0.0506592,0.76,1,112506,112026,480
10620141,136.629,157.572,456,59353,0.0341318,0.69,1,112674,112218,456
10623061,33.7258,38.7145,455,59388,0.00682637,0.49,1,112682,112227,455
10625981,38.7452,50.1429,442,59423,0.0253653,0.41,1,112722,112280,442
10628901,13.349,19.6286,437,59458,0.0290731,0.31,1,112729,112292,437
10631821,10.6698,11.9257,437,59493,0.0298146,0.31,1,112739,112302,437
10634741,11.734,14.3851,434,59528,0.0459629,0.23,1,112751,112317,434
10637661,4.74679,9.27703,429,59563,0.0491926,0.19,1,112754,112325,429
10640581,4.94936,8.25541,426,59598,0.0338385,0.05,1,112759,112333,426
10643501,21.7899,25.6511,422,59633,0.0467677,0.03,1,112785,112363,422
10646421,13.958,14.7302,422,59668,0.0333535,0.03,1,112797,112375,422
10649341,14.7916,14.146,423,59703,0.0466707,0.03,1,112812,112389,423
10652261,12.5583,12.4292,423,59738,0.0173341,0.03,1,112824,112401,423
10655181,17.7117,17.6858,423,59773,0.0114668,0.03,1,112843,112420,423
10658101,10.7423,10.7372,423,59808,0.0262934,0.03,1,112852,112429,423
10661021,13.3485,12.5474,424,59843,0.0292587,0.07,1,112866,112442,424
10663941,12.2697,13.7095,422,59878,0.0298517,0.05,1,112878,112456,422
10666861,19.2539,17.1419,425,59913,0.66997,0.07,1,112899,112474,425
10669781,10.2508,10.6284,424,59948,0.797994,0.05,2,112907,112483,424
10672701,10.8502,11.7257,423,59983,0.791599,0.05,2,112918,112495,423
10675621,10.17,11.1451,422,60018,0.72632,0.03,1,112928,112506,422
10678541,136.434,136.629,422,60053,0.393264,0,1,113096,112674,422
10681461,34.4868,33.7258,423,60088,0.214653,0.03,1,113105,112682,423
10684381,38.0974,38.7452,422,60123,0.0829306,0.03,1,113144,112722,422
10687301,14.0195,13.349,423,60158,0.0245861,0.03,1,113152,112729,423
10690221,10.0039,10.6698,422,60193,0.0289172,0.05,1,113161,112739,422
10693141,12.4008,11.734,423,60228,0.0457834,0.05,1,113174,112751,423
10696061,4.08016,4.74679,422,60263,0.0171567,0.03,1,113176,112754,422
10698981,5.61603,4.94936,423,60298,0.0114313,0.05,1,113182,112759,423
10701901,21.9232,21.7899,423,60333,0.0342863,0.03,1,113208,112785,423
10704821,13.9846,13.958,423,60368,0.0868573,0.05,1,113220,112797,423
10707741,13.9969,14.7916,422,60403,0.0733714,0.01,1,113234,112812,422
10710661,12.3994,12.5583,422,60438,0.0946743,0.01,1,113246,112824,422
10713581,17.6799,17.7117,422,60473,0.170935,0.03,1,113265,112843,422
10716501,10.736,10.7423,422,60508,0.074187,0.03,1,113274,112852,422
10719421,13.3472,13.3485,422,60543,0.126837,0.03,1,113288,112866,422
10722341,45.0694,2.66969,475,60578,0.161367,0.03,1,113341,112866,475
10725261,23.4139,10.1339,481,60613,0.176273,0.83,1,113359,112878,481
10728181,10.2828,18.8268,467,60648,0.123255,0.83,1,113366,112899,467
10731101,8.45656,10.1654,467,60683,0.144651,0.79,1,113374,112907,467
10734021,6.49131,10.8331,462,60718,0.25293,0.71,1,113380,112918,462
10736941,116.498,10.1666,596,60753,0.234586,0.31,1,113524,112928,596
10739861,31.2997,136.433,438,60788,0.230917,0.17,1,113534,113096,438
10742781,31.0599,34.4867,460,60823,0.182183,0.05,1,113565,113105,460
10745701,12.612,38.0973,429,60858,0.108437,0.01,1,113573,113144,429
10748621,10.5224,14.0195,431,60893,0.0616873,0.03,1,113583,113152,431
10751541,12.5045,10.0039,435,60928,0.0523375,0.05,1,113596,113161,435
10754461,4.1009,12.4008,424,60962,0.0824675,0.01,1,113598,113174,424
10757381,5.62018,4.08016,428,60996,0.0564935,0.01,1,113604,113176,428
10760301,25.124,5.61603,452,61030,0.131299,0.04,1,113634,113182,452
10763221,13.0248,21.9232,436,61064,0.0902597,0.1,1,113644,113208,436
10766141,15.405,13.9846,440,61098,0.194052,0.07,1,113660,113220,440
10769061,13.481,13.9969,439,61132,0.23081,0.1,1,113673,113234,439
10771981,13.8962,12.3994,441,61166,0.0861621,0.19,1,113687,113246,441
10774901,13.1792,17.6799,435,61200,0.201232,0.05,1,113700,113265,435
10777821,12.2358,10.736,438,61234,0.200246,0.14,1,113712,113274,438
10780741,44.0472,13.3472,476,61268,0.240049,0.17,1,113764,113288,476
10783661,26.4094,45.0694,445,61302,0.0880099,0.18,1,113786,113341,445
10786581,17.2819,23.4139,442,61336,0.137602,0.11,1,113801,113359,442
10789501,9.85638,10.2828,443,61370,0.0595204,0.15,1,113809,113366,443
10792421,7.57128,8.45656,442,61404,0.0519041,0.28,1,113816,113374,442
10795341,113.514,6.49131,576,61438,0.178381,0.23,1,113956,113380,576
10798261,30.7028,116.498,442,61472,0.203676,0.23,1,113966,113524,442
10801181,23.7406,31.2997,454,61506,0.240735,0.17,1,113988,113534,454
10804101,11.1481,31.0599,431,61540,0.248147,0.09,1,113996,113565,431
10807021,11.0296,12.612,434,61574,0.265629,0.05,1,114007,113573,434
10809941,11.8059,10.5224,436,61608,0.269126,0.05,1,114019,113583,436
10812861,3.96118,12.5045,425,61642,0.269825,0.09,1,114021,113596,425
10815781,5.59224,4.1009,429,61676,0.269965,0.05,1,114027,113598,429
10818701,26.7184,5.62018,455,61710,0.061993,0.15,1,114059,113604,455
10821621,15.7437,25.124,438,61744,0.108399,0.08,1,114072,113634,438
10824541,19.1487,13.0248,448,61778,0.11768,0.22,1,114092,113644,448
10827461,8.62975,15.405,438,61812,0.119536,0.24,1,114098,113660,438
10830381,15.3259,13.481,442,61846,0.143907,0.05,1,114115,113673,442
10833301,15.8652,13.8962,444,61880,0.124781,0.23,1,114131,113687,444
10836221,12.773,13.1792,443,61914,0.168956,0.2,1,114143,113700,443
10839141,44.1546,12.2358,483,61948,0.233791,0.25,1,114195,113712,483
10842061,22.4309,44.0472,448,61982,0.198758,0.05,1,114212,113764,448
10844981,6.08618,26.4094,428,62016,0.159752,0.15,1,114214,113786,428
10847901,9.21724,17.2819,423,62050,0.22395,0.04,1,114224,113801,423
10850821,13.8434,9.85638,430,62084,0.25279,0.05,1,114239,113809,430
10853741,7.56869,7.57128,429,62118,0.218558,0.21,1,114245,113816,429
10856661,115.914,113.514,432,62152,0.243712,0.21,1,114388,113956,432
10859581,32.7827,30.7028,434,62186,0.248742,0.25,1,114400,113966,434
10862501,24.1565,23.7406,434,62220,0.281748,0.25,1,114422,113988,434
10865421,11.2313,11.1481,434,62254,0.28835,0.27,1,114430,113996,434
10868341,11.8463,11.0296,435,62288,0.28967,0.27,1,114442,114007,435
10871261,11.9693,11.8059,435,62322,0.289934,0.27,1,114454,114019,435
10874181,3.99385,3.96118,435,62356,0.257987,0.27,1,114456,114021,435
10877101,5.59877,5.59224,435,62390,0.283597,0.01,1,114462,114027,435
10880021,21.9198,26.7184,429,62424,0.240719,0.12,1,114488,114059,429
10882941,17.184,15.7437,432,62458,0.264144,0.12,1,114504,114072,432
10885861,14.6368,19.1487,426,62492,0.276829,0.12,1,114518,114092,426
10888781,12.5274,8.62975,432,62526,0.215366,0.15,1,114530,114098,432
10891701,15.3055,15.3259,431,62560,0.219073,0.12,1,114546,114115,431
10894621,12.6611,15.8652,427,62594,0.203815,0.18,1,114558,114131,427
10897541,12.9322,12.773,428,62628,0.168763,0.25,1,114571,114143,428
10900461,48.9864,44.1546,434,62662,0.233753,0.19,1,114629,114195,434
10903381,16.9973,22.4309,426,62696,0.262751,0.15,1,114638,114212,426
10906301,10.5995,6.08618,433,62729,0.22055,0.24,1,114647,114214,433
10909221,8.51989,9.21724,431,62762,0.11611,0.26,1,114655,114224,431
10912141,13.704,13.8434,431,62795,0.207222,0.21,1,114670,114239,431
10915061,7.5408,7.56869,431,62828,0.161444,0.25,1,114676,114245,431
10917981,118.308,115.914,434,62861,0.280289,0.25,1,114822,114388,434
10920901,33.2616,32.7827,434,62894,0.304058,0.29,1,114834,114400,434
10923821,24.2523,24.1565,434,62927,0.276812,0.29,1,114856,114422,434
10926741,11.2505,11.2313,434,62960,0.287362,0.29,1,114864,114430,434
10929661,11.8501,11.8463,434,62993,0.289472,0.29,1,114876,114442,434
10932581,11.97,11.9693,434,63026,0.289894,0.25,1,114888,114454,434
10935501,3.994,3.99385,434,63059,0.289979,0.29,1,114890,114456,434
10938421,6.3988,5.59877,435,63092,0.305996,0.23,1,114897,114462,435
10941341,22.8798,21.9198,436,63125,0.245199,0.27,1,114924,114488,436
10944261,9.37595,17.184,426,63158,0.16904,0.28,1,114930,114504,426
10947181,17.0752,14.6368,431,63191,0.217808,0.2,1,114949,114518,431
10950101,12.215,12.5274,430,63224,0.307562,0.22,1,114960,114530,430
10953021,16.843,15.3055,432,63257,0.277512,0.2,1,114978,114546,432
10955941,12.1686,12.6611,431,63290,0.343502,0.16,1,114989,114558,431
10958861,8.83372,12.9322,426,63323,0.2927,0.25,1,114997,114571,426
10961781,54.5667,48.9864,434,63356,0.33854,0.27,1,115063,114629,434
10964701,15.7133,16.9973,431,63389,0.347708,0.21,1,115069,114638,431
10967621,11.9427,10.5995,433,63422,0.365542,0.09,1,115080,114647,433
10970541,8.78853,8.51989,433,63455,0.345108,0.09,1,115088,114655,433
10973461,8.95771,1.70398,442,63488,0.325022,0.23,1,115097,114655,442
10976381,11.3915,12.3408,439,63521,0.385004,0.15,1,115109,114670,439
10979301,119.878,7.26816,580,63554,0.405001,0.31,1,115256,114676,580
10982221,33.5757,118.254,446,63587,0.409,0.31,1,115268,114822,446
10985141,25.1151,33.2507,457,63620,0.3938,0.27,1,115291,114834,457
10988061,11.423,24.2501,443,63653,0.39076,0.29,1,115299,114856,443
10990981,11.8846,11.25,447,63686,0.390152,0.29,1,115311,114864,447
10993901,11.9769,11.85,447,63719,0.39003,0.29,1,115323,114876,447
10996821,3.99538,11.97,437,63752,0.390006,0.29,1,115325,114888,437
10999741,5.59908,3.994,441,63785,0.390001,0.31,1,115331,114890,441
11002661,21.9198,6.3988,460,63818,0.39,0.23,1,115357,114897,460
11005581,10.784,22.8798,441,63851,0.294,0.15,1,115365,114924,441
11008501,18.9568,9.37595,456,63884,0.3068,0.23,1,115386,114930,456
11011421,13.3914,17.0752,449,63917,0.30136,0.33,1,115398,114949,449
11014341,16.2783,12.215,455,63950,0.300272,0.27,1,115415,114960,455
11017261,8.05565,16.843,443,63983,0.204054,0.36,1,115421,114978,443
11020181,10.4111,12.1686,443,64016,0.312811,0.28,1,115432,114989,443
11023101,57.2822,8.83372,504,64049,0.318562,0.35,1,115501,114997,504
11026021,16.2564,54.5667,444,64082,0.319712,0.35,1,115507,115063,444
11028941,10.4513,15.7133,447,64115,0.343942,0.37,1,115516,115069,447
11031861,9.29026,11.9427,445,64148,0.268788,0.34,1,115525,115080,445
11034781,12.2581,8.78853,450,64181,0.293758,0.32,1,115538,115088,450
11037701,7.25161,8.95771,447,64214,0.290752,0.4,1,115544,115097,447
11040621,123.85,11.3915,588,64247,0.37015,0.41,1,115697,115109,588
11043541,34.3701,119.878,453,64280,0.38603,0.41,1,115709,115256,453
11046461,24.474,33.5757,463,64313,0.405206,0.39,1,115731,115268,463
11049381,11.2948,25.1151,448,64346,0.409041,0.39,1,115739,115291,448
11052301,11.859,11.423,452,64379,0.409808,0.39,1,115751,115299,452
11055221,11.9718,11.8846,452,64412,0.409962,0.39,1,115763,115311,452
11058141,3.99436,11.9769,442,64445,0.409992,0.39,1,115765,115323,442
11061061,5.59887,3.99538,446,64478,0.425998,0.39,1,115771,115325,446
11063981,15.5198,5.59908,458,64511,0.4292,0.39,1,115789,115331,458
11066901,13.504,21.9198,445,64544,0.46184,0.27,1,115802,115357,445
11069821,17.9008,10.784,456,64577,0.412368,0.31,1,115821,115365,456
11072741,9.18016,18.9568,442,64610,0.322474,0.3,1,115828,115386,442
11075661,20.236,13.3914,453,64642,0.416495,0.3,1,115851,115398,453
11078581,8.84721,16.2783,442,64674,0.379299,0.18,1,115857,115415,442
11081501,4.96944,8.05565,440,64706,0.39586,0.34,1,115861,115421,440
11084421,62.5939,10.4111,506,64738,0.495172,0.32,1,115938,115432,506
11087341,17.3188,57.2822,443,64770,0.547034,0.32,1,115944,115501,443
11090261,6.66376,16.2564,441,64802,0.557407,0.35,1,115948,115507,441
11093181,12.5328,10.4513,446,64834,0.527481,0.25,1,115962,115516,446
11096101,10.5066,9.29026,447,64866,0.465496,0.3,1,115972,115525,447
11099021,8.50131,12.2581,442,64898,0.541099,0.29,1,115980,115538,442
11101941,3.30026,7.25161,438,64930,0.57222,0.39,1,115982,115544,438
11104861,125.46,123.85,441,64962,0.634444,0.39,1,116138,115697,441
11107781,35.492,34.3701,442,64994,0.630889,0.41,1,116151,115709,442
11110701,24.6984,24.474,442,65026,0.630178,0.41,1,116173,115731,442
11113621,11.3397,11.2948,442,65058,0.630036,0.41,1,116181,115739,442
11116541,11.8679,11.859,442,65090,0.630007,0.41,1,116193,115751,442
11119461,12.7736,11.9718,443,65122,0.614001,0.41,1,116206,115763,443
11122381,4.15472,3.99436,443,65154,0.6108,0.43,1,116208,115765,443
11125301,5.63094,5.59887,443,65186,0.64216,0.43,1,116214,115771,443
11128221,16.3262,15.5198,444,65218,0.632432,0.47,1,116233,115789,444
11131141,8.06524,13.504,437,65250,0.630486,0.4,1,116239,115802,437
11134061,23.213,17.9008,445,65282,0.662097,0.3,1,116266,115821,445
11136981,9.44261,9.18016,444,65314,0.572419,0.44,1,116272,115828,444
11139901,19.4885,20.236,443,65346,0.562484,0.37,1,116294,115851,443
11142821,8.6977,8.84721,443,65378,0.496497,0.4,1,116300,115857,443
11145741,8.13954,4.96944,447,65410,0.619299,0.52,1,116308,115861,447
11148661,65.6279,62.5939,450,65442,0.63586,0.56,1,116388,115938,450
11151581,17.9256,17.3188,450,65474,0.615172,0.56,1,116394,115944,450
11154501,6.78512,6.66376,450,65506,0.643034,0.52,1,116398,115948,450
11157421,7.75702,12.5328,444,65538,0.656607,0.45,1,116406,115962,444
11160341,14.3514,10.5066,450,65570,0.627321,0.56,1,116422,115972,450
11163261,9.27028,8.50131,450,65602,0.669464,0.58,1,116430,115980,450
11166181,3.45406,3.30026,450,65634,0.677893,0.65,1,116432,115982,450
11169101,127.091,125.46,452,65666,0.671579,0.63,1,116590,116138,452
11172021,35.0182,35.492,451,65698,0.670316,0.63,1,116602,116151,451
11174941,24.6036,24.6984,451,65730,0.654063,0.63,1,116624,116173,451
11177861,11.3207,11.3397,451,65762,0.650813,0.63,1,116632,116181,451
11180781,11.8641,11.8679,451,65794,0.650163,0.61,1,116644,116193,451
11183701,13.5728,12.7736,452,65826,0.650033,0.61,1,116658,116206,452
11186621,4.31457,4.15472,452,65858,0.650006,0.65,1,116660,116208,452
11189541,5.66291,5.63094,452,65890,0.650001,0.63,1,116666,116214,452
11192461,17.1326,16.3262,453,65922,0.666,0.63,1,116686,116233,453
11195381,8.22652,8.06524,453,65954,0.6692,0.67,1,116692,116239,453
11198301,22.4453,23.213,452,65986,0.55784,0.55,1,116718,116266,452
11201221,10.8891,9.44261,454,66018,0.591568,0.56,1,116726,116272,454
11204141,17.3778,19.4885,451,66050,0.630314,0.48,1,116745,116294,451
11207061,9.87556,8.6977,453,66082,0.582063,0.65,1,116753,116300,453
11209981,5.17511,8.13954,449,66114,0.620413,0.64,1,116757,116308,449
11212901,69.035,65.6279,454,66146,0.692083,0.61,1,116842,116388,454
11215821,19.407,17.9256,455,66178,0.698417,0.65,1,116849,116394,455
11218741,7.0814,6.78512,455,66210,0.731683,0.66,1,116853,116398,455
11221661,7.81628,7.75702,455,66242,0.722337,0.62,1,116861,116406,455
11224581,14.3633,14.3514,455,66274,0.736467,0.68,1,116877,116422,455
11227501,7.67265,9.27028,453,66306,0.643293,0.68,1,116883,116430,453
11230421,3.13453,3.45406,453,66338,0.592659,0.67,1,116885,116432,453
11233341,127.027,127.091,453,66370,0.750532,0.67,2,117043,116590,453
11236261,35.0054,35.0182,453,66402,0.782106,0.67,2,117055,116602,453
11239181,24.6011,7.00363,475,66434,0.756421,0.65,2,117077,116602,475
11242101,11.3202,19.0007,461,66466,0.751284,0.65,2,117085,116624,461
11245021,11.864,10.2001,465,66498,0.750257,0.65,2,117097,116632,465
11247941,13.5728,11.64,467,66530,0.750051,0.65,2,117111,116644,467
11250861,4.31456,13.528,455,66562,0.75001,0.65,2,117113,116658,455
11253781,5.66291,4.3056,459,66594,0.750002,0.65,2,117119,116660,459
11256701,17.9326,5.66112,474,66626,0.734,0.67,1,117140,116666,474
11259621,9.18652,17.1322,461,66657,0.7148,0.67,1,117147,116686,461
11262541,21.0373,8.22644,479,66688,0.64696,0.53,1,117171,116692,479
11265461,10.6075,22.4453,461,66719,0.665392,0.6,1,117179,116718,461
11268381,16.5215,10.8891,471,66750,0.677078,0.64,1,117197,116726,471
11271301,8.9043,17.3778,459,66781,0.567416,0.57,1,117204,116745,459
11274221,8.18086,9.87556,459,66812,0.673483,0.63,1,117212,116753,459
11277141,70.4362,5.17511,541,66843,0.662697,0.71,1,117298,116757,541
11280061,18.8872,69.035,462,66874,0.668539,0.7,1,117304,116842,462
11282981,7.77745,19.407,460,66905,0.669708,0.74,1,117309,116849,460
11285901,8.75549,7.0814,465,66936,0.661942,0.72,1,117318,116853,465
11288821,8.9511,7.81628,466,66967,0.676388,0.74,1,117327,116861,466
11291741,12.1902,14.3633,463,66998,0.663278,0.62,1,117340,116877,463
11294661,4.03804,7.67265,459,67029,0.628656,0.58,1,117342,116883,459
11297581,128.008,3.13453,616,67060,0.725731,0.79,1,117501,116885,616
11300501,35.2015,127.027,470,67091,0.777146,0.79,2,117513,117043,470
11303421,24.6403,35.0054,480,67122,0.787429,0.75,2,117535,117055,480
11306341,11.3281,24.6011,466,67153,0.789486,0.75,2,117543,117077,466
11309261,11.8656,11.3202,470,67184,0.805897,0.75,2,117555,117085,470
11312181,13.5731,11.864,472,67215,0.809179,0.75,2,117569,117097,472
11315101,4.31462,13.5728,460,67246,0.809836,0.75,2,117571,117111,460
11318021,5.66292,4.31456,464,67277,0.809967,0.75,2,117577,117113,464
11320941,17.1326,5.66291,478,67308,0.809993,0.73,2,117597,117119,478
11323861,8.22652,17.9326,463,67339,0.809999,0.71,2,117603,117140,463
11326781,18.4453,9.18652,477,67370,0.826,0.63,2,117624,117147,477
11329701,12.4891,21.0373,464,67401,0.8052,0.67,2,117635,117171,464
11332621,9.69781,10.6075,465,67432,0.77704,0.68,2,117644,117179,465
11335541,13.1396,16.5215,461,67463,0.779408,0.54,2,117658,117197,461
11338461,9.02791,8.9043,462,67494,0.683882,0.7,1,117666,117204,462
11341381,70.6056,8.18086,540,67525,0.760776,0.66,2,117752,117212,540
11344301,18.9211,70.4362,460,67556,0.824155,0.67,2,117758,117298,460
11347221,6.98422,18.8872,458,67587,0.868831,0.67,2,117762,117304,458
11350141,9.39684,7.77745,463,67618,0.869766,0.66,2,117772,117309,463
11353061,8.27937,8.75549,462,67649,0.877953,0.68,2,117780,117318,462
11355981,6.45587,8.9511,459,67680,0.871591,0.66,2,117786,117327,459
11358901,3.69117,12.1902,449,67711,0.870318,0.62,2,117789,117340,449
11361821,138.338,4.03804,619,67742,0.838064,0.75,2,117961,117342,619
11364741,37.2676,128.008,472,67773,0.799613,0.79,2,117973,117501,472
11367661,25.0535,35.2015,482,67804,0.791923,0.79,2,117995,117513,482
11370581,11.4107,24.6403,468,67835,0.790385,0.79,2,118003,117535,468
11373501,3.88214,11.3281,462,67866,0.790077,0.81,2,118005,117543,462
11376421,10.3764,11.8656,462,67897,0.822015,0.81,2,118017,117555,462
11379341,13.2753,13.5731,462,67928,0.828403,0.81,2,118031,117569,462
11382261,4.25506,4.31462,462,67959,0.829681,0.81,2,118033,117571,462
11385181,5.65101,5.66292,462,67990,0.829936,0.81,2,118039,117577,462
11388101,17.1302,17.1326,462,68021,0.829987,0.81,2,118059,117597,462
11391021,8.22604,8.22652,462,68052,0.829997,0.83,2,118065,117603,462
11393941,17.6452,18.4453,461,68083,0.861999,0.8,2,118085,117624,461
11396861,13.129,12.4891,462,68114,0.8284,0.77,2,118097,117635,462
11399781,10.6258,9.69781,463,68145,0.78168,0.78,2,118107,117644,463
11402701,8.52516,13.1396,457,68176,0.796336,0.66,2,118115,117658,457
11405621,13.705,9.02791,464,68207,0.767267,0.78,2,118130,117666,464
11408541,72.341,70.6056,465,68238,0.833453,0.84,2,118217,117752,465
11411461,19.2682,18.9211,465,68269,0.886691,0.88,2,118223,117758,465
11414381,7.05364,6.98422,465,68300,0.889338,0.87,2,118227,117762,465
11417301,9.41073,9.39684,465,68331,0.905868,0.88,2,118237,117772,465
11420221,9.08215,8.27937,466,68362,0.893174,0.87,2,118246,117780,466
11423141,6.61643,6.45587,466,68393,0.914635,0.87,2,118252,117786,466
11426061,2.92329,3.69117,465,68424,0.886927,0.83,2,118254,117789,465
11428981,134.985,138.338,461,68455,0.945385,0.79,2,118422,117961,461
11779381,10,10,477,72032,0.84,1,2,120824,120347,477
11782301,10,8.4,479,72061,0.816,1,2,120834,120355,479
11785221,10,17.68,469,72090,0.7872,1,2,120844,120375,469
11788141,10,11.536,469,72119,0.78944,1,2,120854,120385,469
11791061,14,10.3072,474,72148,0.805888,1,2,120869,120395,474
11793981,18.8,10.0614,484,72177,0.793178,0.98,2,120889,120405,484
11796901,10.16,8.41229,484,72206,0.790636,1,2,120897,120413,484
11799821,9.232,8.08246,485,72235,0.742127,1,1,120906,120421,485
11802741,7.4464,1.61649,492,72264,0.748425,0.99,1,120913,120421,492
11805661,6.28928,5.9233,491,72293,0.781685,1,2,120919,120428,491
11808581,9.25786,5.98466,495,72322,0.756337,1,2,120929,120434,495
11811501,7.45157,10.7969,490,72351,0.703267,1,1,120936,120446,490
11814421,11.0903,14.1594,487,72380,0.780653,1,2,120948,120461,487
11817341,11.0181,16.4319,481,72409,0.748131,1,1,120959,120478,481
11820261,75.0036,8.08638,566,72438,0.781626,1,2,121050,120484,566
11846541,14,9,479,72699,0.75,0.87,2,121278,120799,479
11849461,9.2,13.8,472,72728,0.75,0.84,1,121286,120814,472
11852381,8.24,10.76,470,72757,0.75,0.81,1,121294,120824,470
11855301,9.648,10.152,470,72786,0.75,0.78,1,121304,120834,470
11858221,9.1296,10.0304,469,72815,0.75,0.79,1,121313,120844,469
11861141,13.8259,10.0061,474,72844,0.67,0.81,1,121328,120854,474
11864061,17.9652,14.0012,478,72873,0.59,0.79,1,121347,120869,478
11866981,9.99304,18.8002,466,72902,0.51,0.79,1,121355,120889,466
11869901,8.39861,10.16,466,72931,0.494,0.73,1,121363,120897,466
11872821,8.07972,9.23201,465,72960,0.4908,0.75,1,121371,120906,465
11875741,6.41594,7.4464,464,72989,0.49016,0.79,1,121377,120913,464
11878661,7.68319,6.28928,466,73018,0.490032,0.75,1,121385,120919,466
11881581,9.53664,9.25786,466,73047,0.506006,0.69,1,121395,120929,466
11884501,9.90733,7.45157,469,73076,0.461201,0.8,1,121405,120936,469
11887421,10.7815,11.0903,468,73105,0.48424,0.74,1,121416,120948,468
11890341,78.9563,11.0181,553,73134,0.152848,0.79,1,121512,120959,553
11893261,38.1913,75.0036,490,73163,0.0385696,1,1,121540,121050,490
11896181,23.6383,45.4007,472,73192,0.0477139,1,1,121560,121088,472
11899101,40.7276,23.4801,499,73221,0.0495428,1,1,121605,121106,499
11902021,17.7455,13.496,500,73250,0.0659086,1,1,121617,121117,500
11904941,13.9491,12.2992,501,73279,0.0691817,1,1,121630,121129,501
11907861,9.98982,12.0598,498,73308,0.749836,0.96,1,121639,121141,498
11910781,61.998,12.812,560,73337,0.685967,0.73,1,121714,121154,560
11913701,18.7996,84.1624,466,73366,0.673193,0.77,1,121722,121256,466
11916621,14.9599,23.2325,472,73395,0.670639,0.75,1,121736,121264,472
11919541,9.39198,15.8465,466,73424,0.670128,0.75,1,121744,121278,466
11922461,8.2784,9.5693,466,73453,0.670026,0.75,1,121752,121286,466
11925381,8.85568,8.31386,467,73482,0.686005,0.75,1,121761,121294,467
11928301,6.57114,9.66277,463,73511,0.689201,0.75,1,121767,121304,463
11931221,9.31423,9.13255,464,73539,0.68984,0.65,1,121777,121313,464
11934141,13.8628,13.8265,464,73567,0.673968,0.57,1,121792,121328,464
11937061,9.17257,17.9653,453,73595,0.670794,0.49,1,121800,121347,453
11939981,8.23451,9.99306,453,73623,0.670159,0.49,1,121808,121355,453
11942901,8.0469,8.39861,453,73651,0.670032,0.49,1,121816,121363,453
11945821,6.40938,8.07972,451,73679,0.670006,0.49,1,121822,121371,451
11948741,2.88188,6.41594,447,73707,0.670001,0.49,1,121824,121377,447
11951661,6.97638,7.68319,447,73735,0.67,0.51,1,121832,121385,447
11954581,6.99527,9.53664,444,73763,0.686,0.45,1,121839,121395,444
11957501,10.1991,9.90733,445,73791,0.6892,0.49,1,121850,121405,445
11960421,10.0398,10.7815,444,73819,0.67384,0.07,1,121860,121416,444
11963341,62.008,78.9563,423,73847,0.766768,0.01,2,121935,121512,423
11966261,35.6016,38.1913,424,73875,0.673354,0.05,1,121964,121540,424
11969181,22.3203,23.6383,423,73903,0.606671,0.05,1,121983,121560,423
11972101,40.4641,40.7276,423,73931,0.385334,0.07,1,122028,121605,423
11975021,18.4928,17.7455,424,73959,0.325067,0.07,1,122041,121617,424
11977941,47.6986,13.9491,466,73987,0.297013,0.92,1,122096,121630,466
11980861,15.9397,9.98982,465,74015,0.323403,0.67,1,122104,121639,465
11983781,55.1879,61.998,455,74043,0.344681,0.67,1,122169,121714,455
11986701,17.4376,18.7996,455,74071,0.348936,0.67,1,122177,121722,455
11989621,14.6875,14.9599,455,74099,0.317787,0.67,1,122191,121736,455
11992541,9.3375,9.39198,455,74127,0.311557,0.67,1,122199,121744,455
11995461,8.2675,8.2784,455,74155,0.310311,0.69,1,122207,121752,455
11998381,9.6535,8.85568,456,74183,0.310062,0.69,1,122217,121761,456
12001301,6.7307,6.57114,456,74211,0.310012,0.69,1,122223,121767,456
12004221,9.34614,9.31423,456,74239,0.326003,0.67,1,122233,121777,456
12007141,13.0692,13.8628,455,74267,0.3292,0.67,1,122247,121792,455
12010061,9.01385,9.17257,455,74295,0.32984,0.67,1,122255,121800,455
12012981,8.20277,8.23451,455,74323,0.329968,0.67,1,122263,121808,455
12015901,8.04055,8.0469,455,74351,0.329994,0.67,1,122271,121816,455
12018821,6.40811,6.40938,455,74379,0.361999,0.67,1,122277,121822,455
12021741,2.88162,2.88188,455,74407,0.3364,0.67,1,122279,121824,455
12024661,7.77632,6.97638,456,74435,0.34728,0.69,1,122288,121832,456
12027581,6.35527,6.99527,455,74463,0.349456,0.69,1,122294,121839,455
12030501,10.0711,10.1991,455,74491,0.397891,0.67,1,122305,121850,455
12033421,11.6142,10.0398,457,74519,0.439578,0.79,1,122317,121860,457
12036341,62.3228,62.008,457,74547,0.639916,0.65,1,122392,121935,457
12039261,31.6646,35.6016,452,74575,0.679983,0.59,1,122416,121964,452
12042181,19.1329,22.3203,449,74603,0.687997,0.33,1,122432,121983,449
12045101,29.4266,40.4641,436,74631,0.705599,0.31,1,122464,122028,436
12048021,15.4853,18.4928,435,74659,0.70912,0.29,1,122476,122041,435
12050941,47.8971,47.6986,436,74687,0.741824,0.33,1,122532,122096,436
12053861,15.9794,15.9397,436,74715,0.764365,0.35,2,122540,122104,436
12056781,55.9959,55.1879,437,74743,0.912873,0.35,2,122606,122169,437
12059701,17.5992,17.4376,437,74771,0.942575,0.31,2,122614,122177,437
12062621,14.7198,14.6875,437,74799,0.916515,0.31,2,122628,122191,437
12065541,9.34397,9.3375,437,74827,0.927303,0.31,2,122636,122199,437
12068461,8.26879,8.2675,437,74855,0.929461,0.31,2,122644,122207,437
12071381,10.4538,9.6535,438,74883,0.945892,0.31,2,122655,122217,438
12074301,6.89075,6.7307,438,74911,0.949178,0.33,2,122661,122223,438
12077221,9.37815,9.34614,438,74939,0.917836,0.33,2,122671,122233,438
12080141,13.0756,13.0692,438,74967,0.911567,0.33,2,122685,122247,438
12083061,9.01513,9.01385,438,74995,0.910313,0.33,2,122693,122255,438
12085981,8.20303,8.20277,438,75023,0.910063,0.33,2,122701,122263,438
12088901,8.04061,8.04055,438,75051,0.910013,0.37,2,122709,122271,438
12091821,6.40812,6.40811,438,75079,0.910003,0.33,2,122715,122277,438
12094741,2.88162,2.88162,438,75107,0.910001,0.35,2,122717,122279,438
12097661,8.57632,7.77632,439,75135,0.91,0.35,2,122727,122288,439
12100581,7.31526,1.55526,446,75163,0.926,0.35,2,122734,122288,446
12103501,12.6631,5.11105,454,75191,0.8972,0.41,2,122748,122294,454
12106421,14.5326,9.82221,458,75219,0.93944,0.45,2,122763,122305,458
12284541,18,10,488,76899,0.77,1,2,124054,123566,488
12287461,13.2,10,490,76926,0.738,1,1,124066,123576,490
12290381,12.24,10,492,76953,0.6996,1,1,124078,123586,492
12293301,12.848,10,495,76980,0.65992,1,1,124091,123596,495
12296221,12.9696,9.2,499,77007,0.635984,1,1,124104,123605,499
12299141,12.9939,10.64,501,77034,0.583197,1,1,124117,123616,501
12302061,13.7988,10.128,505,77061,0.492639,1,1,124131,123626,505
12304981,14.7598,11.6256,508,77088,0.378528,1,1,124146,123638,508
12307901,12.552,11.1251,509,77115,0.323706,1,1,124158,123649,509
12386741,359.31,423.825,428,36500,0.0727411,0,1,124604,124176,428
12389661,92.6621,103.165,431,36558,0.0225482,0.01,1,124630,124199,431
12392581,29.7324,35.033,427,36616,0.0125096,0,1,124644,124217,427
12395501,74.7465,18.2066,499,36674,0.00250193,0,1,124730,124231,499
12398421,35.7493,76.4413,434,36732,0.000500386,0.03,1,124756,124322,434
12401341,83.9499,35.2883,505,36790,0.0561001,0.35,1,124852,124347,505
12404261,61.59,71.8577,480,36847,0.01122,0,1,124908,124428,480
12407181,32.318,71.9715,433,36904,0.002244,0,1,124933,124500,433
12410101,22.4636,31.9943,431,36961,0.000448801,0,1,124953,124522,431
12413021,26.8927,23.9989,437,37018,8.97601e-05,0.01,1,124981,124544,437
12415941,24.5785,26.3998,434,37075,0.024018,0.05,1,125005,124571,434
12418861,10.5157,20.48,422,37132,0.0128036,0.05,1,125012,124590,422
12421781,10.1031,8.89599,426,37189,0.0105607,0.01,1,125022,124596,426
12424701,25.2206,8.1792,447,37246,0.0101121,0.01,1,125051,124604,447
12427621,16.2441,22.4358,435,37303,0.0260224,0.01,1,125065,124630,435
12430541,72.0488,15.6872,507,37360,0.00520449,0,1,125151,124644,507
12433461,35.2098,71.9374,447,37417,0.0010409,0,1,125177,124730,447
12436381,86.242,35.1875,520,37473,0.0242082,0.07,1,125276,124756,520
12439301,59.6484,83.8375,477,37529,0.00484164,0,1,125329,124852,477
12442221,31.9297,61.5675,446,37585,0.000968327,0,1,125354,124908,446
12445141,22.3859,32.3135,441,37641,0.000193665,0,1,125374,124933,441
12448061,26.8772,22.4627,449,37697,0.00803873,0,1,125402,124953,449
12450981,25.3754,26.8925,446,37753,0.00960775,0.03,1,125427,124981,446
12453901,9.87509,24.5785,428,37809,0.0259215,0.01,1,125433,125005,428
12456821,9.97502,10.5157,431,37865,0.0291843,0.01,1,125443,125012,431
12459741,25.995,10.1031,451,37921,0.00583686,0.01,1,125473,125022,451
12462661,16.399,25.2206,436,37977,0.0251674,0.03,1,125487,125051,436
12465581,71.2798,16.2441,507,38033,0.00503347,0,1,125572,125065,507
12468501,35.056,72.0488,447,38089,0.00100669,0,1,125598,125151,447
12471421,87.8112,35.2098,522,38144,0.0402013,0.03,1,125699,125177,522
12474341,58.3622,86.242,474,38199,0.0160403,0,1,125750,125276,474
12477261,32.4724,59.6484,447,38254,0.00320805,0,1,125776,125329,447
12480181,21.6945,31.9297,441,38309,0.000641611,0,1,125795,125354,441
12483101,26.7389,22.3859,449,38364,0.0241283,0.01,1,125823,125374,449
12486021,26.1478,26.8772,447,38419,0.0128257,0.01,1,125849,125402,447
12488941,10.0296,25.3754,428,38474,0.0425651,0.03,1,125855,125427,428
12491861,10.8059,9.87509,433,38529,0.064513,0.03,1,125866,125433,433
12494781,24.5612,9.97502,451,38584,0.0209026,0,1,125894,125443,451
12497701,6.51224,25.995,423,38639,0.00418052,0.03,1,125896,125473,423
12500621,11.7024,16.399,422,38694,0.0408361,0,1,125909,125487,422
12503541,70.3405,71.2798,422,38749,0.00816722,0,1,125994,125572,422
12506461,34.8681,35.056,422,38804,0.00163344,0.05,1,126020,125598,422
12509381,89.3736,87.8112,424,38858,0.00832669,0.01,1,126123,125699,424
12512301,57.8747,58.3622,423,38912,0.00166534,0,1,126173,125750,423
12515221,32.3749,32.4724,423,38966,0.000333068,0,1,126199,125776,423
12518141,21.675,21.6945,423,39020,6.66135e-05,0.03,1,126218,125795,423
12521061,25.935,26.7389,422,39074,0.00801332,0.01,1,126245,125823,422
12523981,27.587,26.1478,424,39128,0.00160266,0.05,1,126273,125849,424
12526901,10.3174,10.0296,424,39182,0.0403205,0.07,1,126279,125855,424
12529821,11.6635,10.8059,425,39236,0.0160641,0.01,1,126291,125866,425
12532741,23.1327,24.5612,423,39290,0.00321282,0,1,126317,125894,423
12535661,6.22654,6.51224,423,39344,0.0406426,0.05,1,126319,125896,423
12538581,10.8453,11.7024,422,39398,0.0161285,0,1,126331,125909,422
12541501,70.1691,70.3405,422,39452,0.0032257,0,1,126416,125994,422
12544421,34.8338,34.8681,422,39506,0.00064514,0.01,1,126442,126020,422
12547341,89.3668,89.3736,422,39559,0.00812903,0,1,126545,126123,422
12550261,57.8734,57.8747,422,39612,0.00962581,0,1,126595,126173,422
12553181,32.3747,32.3749,422,39665,0.00192516,0,1,126621,126199,422
12556101,21.6749,21.675,422,39718,0.000385032,0.01,1,126640,126218,422
12559021,25.935,25.935,422,39771,0.00807701,0,1,126667,126245,422
12561941,27.587,27.587,422,39824,0.0016154,0.05,1,126695,126273,422
12564861,10.3174,10.3174,422,39877,0.0403231,0.01,1,126701,126279,422
12567781,13.2635,11.6635,424,39930,0.0160646,0,1,126715,126291,424
12570701,21.8527,23.1327,422,39983,0.0112129,0.05,1,126739,126317,422
12573621,5.97054,6.22654,422,40036,0.0262426,0.01,1,126741,126319,422
12576541,10.7941,10.8453,422,40089,0.0452485,0.01,1,126753,126331,422
12579461,69.3588,2.16906,506,40142,0.0090497,0,1,126837,126331,506
12582381,34.6718,68.4338,447,40195,0.00180994,0,1,126863,126416,447
12585301,89.3344,34.4868,524,40248,0.024362,0.01,1,126966,126442,524
12588221,57.8669,89.2974,471,40300,0.0128724,0.01,1,127016,126545,471
12591141,32.3734,57.8595,447,40352,0.00257448,0,1,127042,126595,447
12594061,21.6747,32.3719,440,40404,0.000514896,0,1,127061,126621,440
12596981,25.9349,21.6744,448,40456,0.024103,0.01,1,127088,126640,448
12599901,27.587,25.9349,449,40508,0.0048206,0,1,127116,126667,449
12602821,10.3174,27.587,427,40560,0.00896412,0.05,1,127122,126695,427
12605741,13.2635,10.3174,435,40612,0.0257928,0.01,1,127136,126701,435
12608661,21.8527,13.2635,445,40664,0.0291586,0.01,1,127160,126715,445
12611581,5.97054,21.8527,423,40716,0.0298317,0.03,1,127162,126739,423
12614501,10.7941,5.97054,433,40768,0.0139663,0.05,1,127174,126741,433
12617421,69.3588,10.7941,505,40820,0.00279327,0,1,127258,126753,505
12620341,34.6718,69.3588,447,40872,0.000558654,0,1,127284,126837,447
12623261,90.1344,34.6718,525,40924,0.0401117,0.03,1,127388,126863,525
12626181,58.0269,89.3344,472,40976,0.0160223,0.01,1,127438,126966,472
12629101,31.6054,57.8669,447,41028,0.00320447,0,1,127463,127016,447
12632021,21.5211,32.3734,440,41079,0.000640894,0,1,127482,127042,440
12634941,25.9042,21.6747,448,41130,0.000128179,0.03,1,127509,127061,448
12637861,28.3808,25.9349,450,41181,2.56357e-05,0,1,127538,127088,450
12640781,10.4762,27.587,428,41232,0.00800513,0.01,1,127544,127116,428
12643701,12.4952,10.3174,435,41283,0.00960103,0.03,1,127557,127122,435
12646621,21.699,13.2635,445,41334,0.0259202,0.03,1,127581,127136,445
12649541,5.93981,21.8527,423,41385,0.029184,0.03,1,127583,127160,423
12652461,10.788,5.97054,433,41436,0.0298368,0.01,1,127595,127162,433
12655381,69.3576,10.7941,505,41487,0.00596736,0,1,127679,127174,505
12658301,34.6715,69.3588,447,41538,0.00119347,0,1,127705,127258,447
12661221,8.5343,34.6718,423,41589,0.000238694,0.05,1,127707,127284,423
12664141,85.7069,90.1344,424,41640,0.00804774,0.01,1,127812,127388,424
12667061,55.5414,58.0269,422,41691,0.00160955,0,1,127860,127438,422
12669981,32.7083,31.6054,424,41742,0.00832191,0,1,127887,127463,424
12672901,21.7417,21.5211,424,41793,0.00166438,0,1,127906,127482,424
12675821,25.1483,25.9042,423,41844,0.00833288,0,1,127932,127509,423
12678741,28.2297,28.3808,423,41894,0.0256666,0.01,1,127961,127538,423
12681661,10.4459,10.4762,423,41944,0.0291333,0.01,1,127967,127544,423
12684581,12.4892,12.4952,423,41994,0.0298267,0.03,1,127980,127557,423
12687501,21.6978,21.699,423,42044,0.0459653,0.03,1,128004,127581,423
12690421,5.93957,5.93981,423,42094,0.0491931,0.03,1,128006,127583,423
12693341,10.7879,10.788,423,42144,0.0178386,0,1,128018,127595,423
12696261,68.5576,69.3576,422,42194,0.00356772,0,1,128101,127679,422
12699181,34.5115,34.6715,422,42244,0.000713544,0,1,128127,127705,422
12702101,8.5023,8.5343,422,42294,0.000142709,0.01,1,128129,127707,422
12705021,85.7005,85.7069,422,42344,0.00802854,0,1,128234,127812,422
12707941,55.5401,55.5414,422,42394,0.00160571,0.01,1,128282,127860,422
12710861,32.708,32.7083,422,42444,0.00832114,0,1,128309,127887,422
12713781,21.7416,21.7417,422,42494,0.00166423,0.01,1,128328,127906,422
12716701,25.1483,25.1483,422,42544,0.0243328,0.03,1,128354,127932,422
12719621,28.2297,28.2297,422,42594,0.0288666,0.03,1,128383,127961,422
12722541,10.4459,10.4459,422,42644,0.0297733,0.03,1,128389,127967,422
12725461,13.2892,12.4892,423,42693,0.0139547,0.05,1,128403,127980,423
12728381,21.0578,21.6978,422,42742,0.0267909,0.05,1,128426,128004,422
12731301,5.81157,5.93957,422,42791,0.0293582,0.01,1,128428,128006,422
12734221,10.7623,10.7879,422,42840,0.0138716,0,1,128440,128018,422
12737141,68.5525,68.5576,422,42889,0.00277433,0,1,128523,128101,422
12740061,34.5105,34.5115,422,42938,0.000554865,0,1,128549,128127,422
12742981,8.5021,8.5023,422,42987,0.024111,0,1,128551,128129,422
12745901,84.9004,1.70046,526,43036,0.0448222,0.01,1,128655,128129,526
12748821,55.3801,84.3401,469,43085,0.0169644,0,1,128703,128234,469
12751741,33.476,55.268,449,43134,0.00339289,0.01,1,128731,128282,449
12754661,21.0952,32.6536,440,43183,0.000678577,0,1,128749,128309,440
12757581,25.019,21.7307,447,43232,0.00813572,0.03,1,128775,128328,447
12760501,28.2038,25.1461,450,43281,0.0256271,0.03,1,128804,128354,450
12763421,10.4408,28.2292,427,43330,0.00512543,0.03,1,128810,128383,427
12766341,13.2882,10.4458,435,43379,0.00902509,0.01,1,128824,128389,435
12769261,21.0576,13.2892,444,43428,0.041805,0.03,1,128847,128403,444
12772181,5.81153,21.0578,423,43477,0.048361,0.03,1,128849,128426,423
12775101,10.7623,5.81157,433,43526,0.0176722,0.01,1,128861,128428,433
12778021,68.5525,10.7623,504,43574,0.00353444,0,1,128944,128440,504
12780941,34.5105,68.5525,447,43622,0.000706888,0,1,128970,128523,447
12783861,8.5021,34.5105,423,43670,0.0241414,0.03,1,128972,128549,423
12786781,86.5004,8.5021,527,43718,0.0768283,0.05,1,129078,128551,527
12789701,54.9001,84.9004,470,43766,0.0233657,0.01,1,129125,128655,470
12792621,32.58,55.3801,449,43814,0.00467313,0,1,129152,128703,449
12795541,20.916,33.476,439,43862,0.000934626,0,1,129170,128731,439
12798461,24.9832,21.0952,447,43910,0.0241869,0.01,1,129196,128749,447
12801381,28.1966,25.019,450,43958,0.00483738,0.03,1,129225,128775,450
12804301,10.4393,28.2038,427,44006,0.00896748,0,1,129231,128804,427
12807221,13.2879,10.4408,435,44054,0.0257935,0.01,1,129245,128810,435
12810141,21.0576,13.2882,444,44102,0.0131587,0.05,1,129268,128824,444
12813061,5.81151,21.0576,423,44150,0.0106317,0.05,1,129270,128847,423
12815981,10.7623,5.81153,433,44198,0.0261263,0.01,1,129282,128849,433
12818901,68.5525,10.7623,504,44246,0.00522527,0,1,129365,128861,504
12821821,35.3105,68.5525,448,44294,0.00104505,0,1,129392,128944,448
12824741,8.6621,34.5105,424,44342,0.024209,0.03,1,129394,128970,424
12827661,88.9324,8.5021,531,44390,0.0448418,0.09,1,129503,128972,531
12830581,52.1865,86.5004,468,44438,0.0489684,0.01,1,129546,129078,468
12833501,12.0373,54.9001,423,44485,0.0497937,0,1,129548,129125,423
12836421,24.0075,32.58,423,44532,0.0179587,0,1,129575,129152,423
12839341,20.0015,20.916,424,44579,0.00359175,0.03,1,129594,129170,424
12842261,24.0003,24.9832,423,44626,0.00871835,0,1,129619,129196,423
12845181,28.0001,28.1966,423,44673,0.0257437,0.01,1,129648,129225,423
12848101,10.4,10.4393,423,44720,0.0291487,0.03,1,129654,129231,423
12851021,13.28,13.2879,423,44767,0.0138297,0.01,1,129668,129245,423
12853941,21.056,21.0576,423,44814,0.042766,0.01,1,129691,129268,423
12856861,5.8112,5.81151,423,44861,0.0485532,0.03,1,129693,129270,423
12859781,10.7622,10.7623,423,44908,0.0177106,0,1,129705,129282,423
12862701,67.7524,68.5525,422,44955,0.00354213,0,1,129787,129365,422
12865621,35.1505,35.3105,422,45002,0.000708425,0.03,1,129814,129392,422
12868541,8.6301,8.6621,422,45049,0.0241417,0.05,1,129816,129394,422
12871461,90.526,88.9324,424,45096,0.0288283,0.05,1,129927,129503,424
12874381,52.5052,52.1865,424,45143,0.0937657,0.05,1,129970,129546,424
12877301,12.101,12.0373,424,45190,0.106753,0.01,1,129972,129548,424
12880221,22.4202,24.0075,422,45237,0.0293506,0,1,129997,129575,422
12883141,19.684,20.0015,422,45284,0.0298701,0.01,1,130016,129594,422
12886061,23.9368,24.0003,422,45331,0.029974,0.03,1,130041,129619,422
12888981,27.9874,28.0001,422,45378,0.0299948,0.03,1,130070,129648,422
12891901,10.3975,10.4,422,45424,0.029999,0.01,1,130076,129654,422
12894821,13.2795,13.28,422,45470,0.0139998,0.05,1,130090,129668,422
12897741,21.0559,21.056,422,45516,0.0428,0.05,1,130113,129691,422
12900661,5.81118,5.8112,422,45562,0.01656,0.01,1,130115,129693,422
12903581,10.7622,10.7622,422,45608,0.011312,0,1,130127,129705,422
12906501,67.7524,67.7524,422,45654,0.0022624,0,1,130209,129787,422
12909421,35.1505,35.1505,422,45700,0.00045248,0.03,1,130236,129814,422
12912341,8.6301,8.6301,422,45746,0.0080905,0.03,1,130238,129816,422
12915261,91.326,90.526,423,45792,0.0576181,0.11,1,130350,129927,423
12918181,55.0652,52.5052,426,45838,0.0355236,0.11,1,130396,129970,426
12921101,12.613,12.101,426,45884,0.0311047,0.01,1,130398,129972,426
12924021,19.3226,22.4202,422,45930,0.0142209,0.01,1,130419,129997,422
12926941,18.2645,4.48404,440,45976,0.00284419,0.03,1,130437,129997,440
12929861,24.4529,16.0968,447,46022,0.0245688,0.03,1,130463,130016,447
12932781,27.2906,23.2194,450,46068,0.0289138,0.03,1,130491,130041,450
12935701,10.2581,27.8439,427,46114,0.00578275,0.03,1,130497,130070,427
12938621,13.2516,10.3688,435,46160,0.00915655,0.01,1,130511,130076,435
12941541,21.0503,13.2738,444,46206,0.00983131,0.05,1,130534,130090,444
12944461,5.81006,21.0548,423,46252,0.00996626,0.01,1,130536,130113,423
12947381,10.762,5.81095,433,46298,0.00999325,0.01,1,130548,130115,433
12950301,67.7524,10.7622,503,46344,0.00199865,0,1,130630,130127,503
12953221,35.1505,67.7524,448,46389,0.00039973,0,1,130657,130209,448
12956141,8.6301,35.1505,423,46434,0.00807995,0.01,1,130659,130236,423
12959061,92.126,8.6301,534,46479,0.073616,0.07,1,130772,130238,534
12961981,55.2252,91.326,468,46524,0.118723,0.03,1,130818,130350,468
12964901,12.645,55.0652,424,46569,0.127745,0.03,1,130820,130396,424
12967821,18.529,12.613,442,46614,0.113549,0.01,1,130840,130398,442
12970741,18.9058,19.3226,440,46659,0.0227098,0,1,130859,130419,440
12973661,24.5812,18.2645,448,46704,0.028542,0.03,1,130885,130437,448
12976581,26.5162,24.4529,449,46749,0.00570839,0.03,1,130912,130463,449
12979501,10.1032,27.2906,427,46794,0.0251417,0,1,130918,130491,427
12982421,13.2206,10.2581,435,46839,0.0290283,0.01,1,130932,130497,435
12985341,21.0441,13.2516,444,46884,0.0298057,0.01,1,130955,130511,444
12988261,5.80883,21.0503,423,46929,0.0299611,0.01,1,130957,130534,423
12991181,10.7618,5.81006,433,46974,0.0299922,0.01,1,130969,130536,433
12994101,67.7524,10.762,503,47019,0.0139984,0,1,131051,130548,503
12997021,35.9505,67.7524,449,47064,0.00279969,0,1,131079,130630,449
12999941,8.79009,35.1505,424,47109,0.00855994,0.01,1,131081,130657,424
13002861,94.558,8.6301,538,47154,0.041712,0.09,1,131197,130659,538
13005781,56.5116,92.126,472,47199,0.0323424,0.13,1,131244,130772,472
13008701,12.9023,55.2252,428,47244,0.0304685,0.13,1,131246,130818,428
13011621,16.1805,12.645,443,47289,0.0460937,0.11,1,131263,130820,443
13014541,17.6361,18.529,441,47334,0.00921874,0,1,131281,130840,441
13017461,24.3272,18.9058,448,47379,0.0258437,0.03,1,131307,130859,448
13020381,6.46544,24.5812,424,47423,0.0291688,0,1,131309,130885,424
13023301,22.0931,26.5162,423,47467,0.0138337,0.03,1,131335,130912,423
13026221,9.21862,10.1032,423,47511,0.0427667,0.03,1,131341,130918,423
13029141,13.0437,13.2206,423,47555,0.0165533,0.03,1,131355,130932,423
13032061,21.0087,21.0441,423,47599,0.0433107,0.03,1,131378,130955,423
13034981,5.80175,5.80883,423,47643,0.0166621,0.03,1,131380,130957,423
13037901,10.7604,10.7618,423,47687,0.0113324,0.01,1,131392,130969,423
13040821,66.9521,67.7524,422,47731,0.0102665,0,1,131473,131051,422
13043741,35.7904,35.9505,422,47775,0.0020533,0.01,1,131501,131079,422
13046661,8.75808,8.79009,422,47819,0.00841066,0.05,1,131503,131081,422
13049581,96.1516,94.558,424,47863,0.00968213,0.03,1,131621,131197,424
13052501,57.6303,56.5116,425,47907,0.0579364,0.03,1,131669,131244,425
13055421,13.1261,12.9023,425,47951,0.0675873,0.05,1,131671,131246,425
13058341,15.4252,16.1805,424,47995,0.0535175,0,1,131687,131263,424
13061261,15.885,17.6361,422,48039,0.0667035,0.03,1,131703,131281,422
13064181,24.777,24.3272,423,48083,0.0373407,0.03,1,131730,131307,423
13067101,6.5554,6.46544,423,48127,0.0314681,0.01,1,131732,131309,423
13070021,21.3111,22.0931,422,48171,0.0142936,0.05,1,131757,131335,422
13072941,9.06222,9.21862,422,48215,0.0428587,0.01,1,131763,131341,422
13075861,13.0124,13.0437,422,48259,0.0485717,0.05,1,131777,131355,422
13078781,21.0025,21.0087,422,48303,0.0497143,0.01,1,131800,131378,422
13081701,5.8005,5.80175,422,48347,0.0179429,0.01,1,131802,131380,422
13084621,10.7601,10.7604,422,48391,0.0115886,0.01,1,131814,131392,422
13087541,67.752,66.9521,423,48435,0.00231771,0,1,131896,131473,423
13090461,35.1504,35.7904,422,48479,0.0244635,0.01,1,131923,131501,422
13093381,8.63008,8.75808,422,48522,0.00489271,0.01,1,131925,131503,422
13096301,96.926,96.1516,423,48565,0.0249785,0.07,1,132044,131621,423
13099221,57.7852,57.6303,423,48608,0.0449957,0.07,1,132092,131669,423
13102141,13.157,13.1261,423,48651,0.0809991,0.05,1,132094,131671,423
13105061,16.2314,15.4252,424,48694,0.0721998,0.07,1,132111,131687,424
13107981,16.0463,15.885,424,48737,0.03844,0.03,1,132127,131703,424
13110901,23.2093,24.777,422,48780,0.063688,0.03,1,132152,131730,422
13113821,6.24185,6.5554,422,48823,0.0687376,0.01,1,132154,131732,422
13116741,21.2484,21.3111,422,48866,0.0217475,0.01,1,132179,131757,422
13119661,9.84967,4.26222,429,48909,0.0283495,0.05,1,132186,131757,429
13122581,11.5699,5.65244,435,48952,0.0136699,0.05,1,132198,131763,435
13125501,20.714,12.3305,444,48995,0.026734,0.05,1,132221,131777,444
13128421,5.7428,20.8661,423,49038,0.0293468,0.01,1,132223,131800,423
13131341,10.7486,5.77322,433,49081,0.0138694,0.01,1,132235,131802,433
13134261,67.7497,10.7546,503,49124,0.00277387,0,1,132317,131814,503
13137181,35.1499,67.7509,448,49167,0.0245548,0.03,1,132344,131896,448
13140101,8.62999,35.1502,423,49210,0.00491095,0,1,132346,131923,423
13143021,98.526,8.63004,542,49253,0.0569822,0.03,1,132467,131925,542
13145941,58.1052,96.926,471,49296,0.0993964,0.05,1,132515,132044,471
13148861,13.221,57.7852,425,49339,0.107879,0.09,1,132517,132092,425
13151781,15.4442,13.157,439,49382,0.109576,0.07,1,132533,132094,439
13154701,15.8888,16.2314,438,49425,0.109915,0.03,1,132549,132111,438
13157621,23.1778,16.0463,447,49468,0.141983,0.07,1,132574,132127,447
13160541,6.23555,23.2093,424,49511,0.148397,0.07,1,132576,132152,424
13163461,20.4471,6.24185,446,49554,0.0536793,0.01,1,132600,132154,446
13166381,9.68942,21.2484,428,49597,0.0187359,0.03,1,132607,132179,428
13169301,11.5379,9.84967,433,49639,0.0277472,0.01,1,132619,132186,433
13172221,20.7076,11.5699,444,49681,0.0455494,0.03,1,132642,132198,444
13175141,5.74152,20.714,423,49723,0.0491099,0.03,1,132644,132221,423
13178061,10.7483,5.7428,433,49765,0.033822,0.01,1,132656,132223,433
13180981,67.7497,10.7486,503,49807,0.0067644,0,1,132738,132235,503
13183901,35.9499,67.7497,449,49849,0.00935288,0.03,1,132766,132317,449
13186821,8.78999,35.1499,424,49891,0.00187058,0,1,132768,132344,424
13189741,100.158,8.62999,545,49933,0.0243741,0.07,1,132891,132346,545
13192661,60.0316,98.526,474,49975,0.0448748,0.11,1,132941,132467,474
13195581,13.6063,58.1052,428,50017,0.048975,0.11,1,132943,132515,428
13198501,15.5213,13.221,442,50059,0.049795,0.11,1,132959,132517,442
13201421,16.7043,15.4442,443,50101,0.033959,0.11,1,132976,132533,443
13204341,24.1409,15.8888,453,50143,0.0627918,0.15,1,133002,132549,453
13207261,6.42817,23.1778,430,50185,0.0685584,0.15,1,133004,132574,430
13210181,15.6856,6.23555,446,50227,0.0377117,0.03,1,133022,132576,446
13213101,8.73713,20.4471,429,50269,0.0475423,0.01,1,133029,132600,429
13216021,12.1474,9.68942,435,50311,0.0175085,0.03,1,133042,132607,435
13218941,4.02949,11.5379,425,50353,0.0435017,0.05,1,133044,132619,425
13221861,17.6059,20.7076,423,50395,0.0807003,0.05,1,133065,132642,423
13224781,5.12118,5.74152,423,50437,0.0881401,0.03,1,133067,132644,423
13227701,10.6242,10.7483,423,50479,0.057628,0,1,133079,132656,423
13230621,66.9249,67.7497,422,50521,0.0115256,0.01,1,133160,132738,422
13233541,35.785,35.9499,422,50563,0.0103051,0,1,133188,132766,422
13236461,8.75699,8.78999,422,50605,0.00206102,0.03,1,133190,132768,422
13239381,100.951,100.158,423,50647,0.0404122,0.05,1,133314,132891,423
13242301,60.9903,60.0316,424,50689,0.0480824,0.05,1,133365,132941,424
13245221,13.7981,13.6063,424,50731,0.0176165,0.05,1,133367,132943,424
13248141,15.5596,15.5213,424,50773,0.0115233,0.03,1,133383,132959,424
13251061,15.9119,16.7043,423,50814,0.0423047,0.07,1,133399,132976,423
13253981,25.5824,24.1409,425,50855,0.0644609,0.07,1,133427,133002,425
13256901,6.71648,6.42817,425,50896,0.0368922,0.03,1,133429,133004,425
13259821,14.9433,15.6856,424,50937,0.0793784,0.05,1,133446,133022,424
13262741,7.78866,8.73713,423,50978,0.0878757,0.01,1,133452,133029,423
13265661,12.7577,12.1474,424,51019,0.0895751,0.05,1,133466,133042,424
13268581,4.15155,4.02949,424,51060,0.089915,0.09,1,133468,133044,424
13271501,17.6303,17.6059,424,51101,0.105983,0.09,1,133489,133065,424
13274421,5.12606,5.12118,424,51142,0.109197,0.05,1,133491,133067,424
13277341,9.02521,10.6242,422,51183,0.109839,0,1,133501,133079,422
13280261,66.605,66.9249,422,51224,0.0219679,0.01,1,133582,133160,422
13283181,35.721,35.785,422,51265,0.0123936,0,1,133610,133188,422
13286101,8.7442,8.75699,422,51306,0.00247871,0.05,1,133612,133190,422
13289021,102.549,100.951,424,51347,0.0244957,0.05,1,133738,133314,424
13291941,59.7098,60.9903,422,51388,0.0288991,0.01,1,133787,133365,422
13294861,13.542,13.7981,422,51429,0.0297798,0.01,1,133789,133367,422
13297781,15.5084,15.5596,422,51470,0.029956,0.05,1,133805,133383,422
13300701,15.9017,15.9119,422,51511,0.0299912,0.07,1,133821,133399,422
13303621,27.9803,25.5824,425,51552,0.0139982,0.03,1,133852,133427,425
13306541,7.19607,6.71648,425,51593,0.0107996,0.09,1,133854,133429,425
13309461,15.8392,14.9433,426,51634,0.0421599,0.09,1,133872,133446,426
13312381,7.96784,7.78866,426,51675,0.016432,0.09,1,133878,133452,426
13315301,13.5936,12.7577,427,51716,0.0432864,0.09,1,133893,133466,427
13318221,4.31871,4.15155,427,51757,0.0486573,0.09,1,133895,133468,427
13321141,16.8637,0.830309,447,51798,0.0177315,0.11,1,133915,133468,447
13324061,4.97275,16.9661,428,51839,0.0115463,0.11,1,133917,133489,428
13326981,5.79455,4.99321,432,51880,0.0103093,0.11,1,133923,133491,432
13329901,65.1589,8.99864,502,51921,0.00206185,0,1,134003,133501,502
13332821,35.4318,66.5997,449,51962,0.00841237,0.01,1,134031,133582,449
13335741,8.68636,35.7199,423,52003,0.00168247,0,1,134033,133610,423
13338661,103.337,8.74399,548,52043,0.0563365,0.03,1,134160,133612,548
13341581,59.8675,102.549,471,52083,0.0992673,0.03,1,134209,133738,471
13344501,13.5735,59.7098,424,52123,0.107853,0.03,1,134211,133787,424
13347421,15.5147,13.542,438,52163,0.109571,0.03,1,134227,133789,438
13350341,15.9029,15.5084,438,52203,0.109914,0.03,1,134243,133805,438
13353261,27.1806,15.9017,452,52243,0.109983,0.01,1,134273,133821,452
13356181,7.03612,27.9803,423,52283,0.109997,0.01,1,134275,133852,423
13359101,16.6072,7.19607,440,52323,0.109999,0.05,1,134294,133854,440
13362021,8.12144,15.8392,428,52363,0.0939999,0.01,1,134300,133872,428
13364941,12.8243,7.96784,436,52403,0.0908,0.05,1,134314,133878,436
13367861,4.16486,13.5936,423,52443,0.09016,0.05,1,134316,133893,423
13370781,16.833,4.31871,441,52483,0.122032,0.01,1,134336,133895,441
13373701,4.96659,16.8637,423,52523,0.128406,0.01,1,134338,133915,423
13376621,5.79332,4.97275,427,52563,0.129681,0.01,1,134344,133917,427
13379541,65.1587,5.79455,501,52603,0.0259363,0,1,134424,133923,501
13382461,35.4317,65.1589,449,52643,0.0131873,0.01,1,134452,134003,449
13385381,8.68635,35.4318,423,52683,0.00263745,0,1,134454,134031,423
13388301,106.537,8.68636,552,52723,0.0245275,0.07,1,134585,134033,552
13391221,61.3075,103.337,475,52763,0.0449055,0.11,1,134635,134160,475
13394141,13.8615,59.8675,428,52803,0.0489811,0.11,1,134637,134209,428
13397061,15.5723,13.5735,442,52843,0.0497962,0.11,1,134653,134211,442
13399981,15.9145,15.5147,442,52883,0.0499592,0.11,1,134669,134227,442
13402901,26.3829,15.9029,455,52923,0.0339919,0.11,1,134698,134243,455
13405821,6.87658,27.1806,427,52963,0.0627984,0.11,1,134700,134273,427
13408741,16.5753,7.03612,444,53003,0.0845597,0.11,1,134719,134275,444
13411661,8.11506,16.6072,431,53043,0.0889119,0.09,1,134725,134294,431
13414581,12.823,8.12144,439,53083,0.0897824,0.09,1,134739,134300,439
13417501,4.1646,12.8243,427,53123,0.0899565,0.09,1,134741,134314,427
13420421,18.4329,4.16486,447,53163,0.137991,0.13,1,134763,134316,447
13423341,5.28658,16.833,429,53203,0.147598,0.13,1,134765,134336,429
13426261,2.65732,4.96659,429,53243,0.14952,0.13,1,134767,134338,429
13429181,5.33146,5.79332,429,53283,0.149904,0,1,134773,134344,429
13432101,59.4663,65.1587,422,53323,0.0299808,0.01,1,134846,134424,422
13435021,34.2933,35.4317,422,53362,0.0139962,0,1,134874,134452,422
13437941,8.45865,8.68635,422,53401,0.00279923,0.03,1,134876,134454,422
13440861,107.292,106.537,423,53440,0.0245598,0.05,1,135008,134585,423
13443781,62.2583,61.3075,424,53479,0.044912,0.05,1,135059,134635,424
13446701,14.0517,13.8615,424,53518,0.0169824,0.05,1,135061,134637,424
13449621,15.6103,15.5723,424,53557,0.0113965,0.05,1,135077,134653,424
13452541,15.9221,15.9145,424,53596,0.0422793,0.03,1,135093,134669,424
13455461,27.1844,26.3829,425,53635,0.0164559,0.07,1,135123,134698,425
13458381,7.03688,6.87658,425,53674,0.0432912,0.09,1,135125,134700,425
13461301,17.4074,16.5753,426,53713,0.0166582,0.09,1,135145,134719,426
13464221,8.28148,8.11506,426,53752,0.0433316,0.09,1,135151,134725,426
13467141,12.8563,12.823,426,53791,0.0326663,0.09,1,135165,134739,426
13470061,4.17126,4.1646,426,53830,0.0305333,0.15,1,135167,134741,426
13472981,20.8343,18.4329,429,53869,0.0461067,0.15,1,135192,134763,429
13475901,5.76685,5.28658,429,53908,0.0492213,0.15,1,135194,134765,429
13478821,2.75337,2.65732,429,53947,0.0498443,0.15,1,135196,134767,429
13481741,5.35067,5.33146,429,53986,0.0659688,0,1,135202,134773,429
13484661,53.8701,59.4663,422,54025,0.0131938,0.01,1,135268,134846,422
13487581,33.174,34.2933,422,54064,0.0106388,0,1,135296,134874,422
13490501,8.2348,8.45865,422,54103,0.00212775,0.03,1,135298,134876,422
13493421,108.047,107.292,423,54142,0.00842555,0.05,1,135431,135008,423
13496341,61.6094,62.2583,422,54181,0.0256851,0.01,1,135481,135059,422
13499261,13.9219,14.0517,422,54220,0.029137,0.01,1,135483,135061,422
13502181,15.5844,15.6103,422,54259,0.0298274,0.05,1,135499,135077,422
13505101,15.9169,15.9221,422,54298,0.0299655,0.01,1,135515,135093,422
13508021,27.1834,27.1844,422,54337,0.0299931,0.05,1,135545,135123,422
13510941,7.03667,7.03688,422,54376,0.0299986,0.01,1,135547,135125,422
13513861,17.4073,17.4074,422,54415,0.0299997,0.05,1,135567,135145,422
13516781,9.08147,8.28148,423,54454,0.0459999,0.03,1,135574,135151,423
13519701,13.8163,12.8563,424,54493,0.0332,0.03,1,135589,135165,424
13522621,4.36326,4.17126,424,54532,0.03064,0.05,1,135591,135167,424
13525541,21.6727,20.8343,425,54571,0.030128,0.05,1,135617,135192,425
13528461,5.93453,5.76685,425,54610,0.0300256,0.05,1,135619,135194,425
13531381,2.78691,2.75337,425,54649,0.0300051,0.07,1,135621,135196,425
13534301,5.35738,5.35067,425,54688,0.00600102,0.07,1,135627,135202,425
13537221,50.6715,1.07013,487,54726,0.0012002,0,1,135689,135202,487
13540141,32.5343,53.014,449,54764,0.00824004,0.01,1,135717,135268,449
13543061,8.10686,33.0028,423,54802,0.00164801,0,1,135719,135296,423
13545981,108.021,8.20056,554,54840,0.0403296,0.01,1,135852,135298,554
13548901,62.4043,108.04,472,54878,0.0800659,0.03,1,135903,135431,472
13551821,14.0809,61.608,424,54916,0.0880132,0.03,1,135905,135481,424
13554741,15.6162,13.9216,438,54954,0.0896026,0.03,1,135921,135483,438
13557661,15.9232,15.5843,438,54992,0.0899205,0.03,1,135937,135499,438
13560581,27.1846,15.9169,452,55030,0.0899841,0.03,1,135967,135515,452
13563501,7.03693,27.1834,424,55068,0.0899968,0.03,1,135969,135545,424
13566421,17.4074,7.03667,442,55106,0.0899994,0.03,1,135989,135547,442
13569341,8.28148,17.4073,428,55144,0.0899999,0.05,1,135995,135567,428
13572261,13.6563,9.08147,436,55182,0.09,0.03,1,136010,135574,436
13575181,4.33126,13.8163,423,55220,0.09,0.03,1,136012,135589,423
13578101,21.6663,4.36326,447,55258,0.106,0.03,1,136038,135591,447
13581021,5.93325,21.6727,423,55296,0.1092,0.03,1,136040,135617,423
13583941,2.78665,5.93453,423,55334,0.10984,0.03,1,136042,135619,423
13586861,5.35733,2.78691,427,55372,0.077968,0,1,136048,135621,427
13589781,50.6715,5.35738,483,55410,0.0155936,0,1,136110,135627,483
13592701,32.5343,50.6715,449,55448,0.0111187,0.01,1,136138,135689,449
13595621,8.10686,32.5343,423,55486,0.00222374,0,1,136140,135717,423
13598541,110.421,8.10686,557,55524,0.0244447,0.05,1,136276,135719,557
13601461,63.6843,108.021,476,55562,0.044889,0.09,1,136328,135852,476
13604381,14.3369,62.4043,427,55600,0.0489778,0.09,1,136330,135903,427
13607301,15.6674,14.0809,441,55638,0.0497956,0.09,1,136346,135905,441
13610221,15.9335,15.6162,441,55676,0.0499591,0.09,1,136362,135921,441
13613141,27.1867,15.9232,455,55714,0.0499918,0.09,1,136392,135937,455
13616061,7.03734,27.1846,427,55752,0.0499984,0.09,1,136394,135967,427
13618981,17.4075,7.03693,445,55790,0.0499997,0.09,1,136414,135969,445
13621901,8.28149,17.4074,431,55828,0.0499999,0.09,1,136420,135989,431
13624821,13.6563,8.28148,440,55866,0.066,0.09,1,136435,135995,440
13627741,4.33126,13.6563,427,55904,0.0692,0.09,1,136437,136010,427
13630661,20.8663,4.33126,450,55942,0.08584,0.11,1,136462,136012,450
13633581,5.77325,21.6663,426,55980,0.089168,0.11,1,136464,136038,426
13636501,2.75465,5.93325,426,56018,0.0898336,0.11,1,136466,136040,426
13639421,6.15093,2.78665,431,56056,0.105967,0.07,1,136473,136042,431
13642341,47.6302,5.35733,483,56094,0.0771933,0,1,136531,136048,483
13645261,31.926,50.6715,449,56132,0.0394387,0.01,1,136559,136110,449
13648181,7.98521,32.5343,423,56169,0.00788773,0,1,136561,136138,423
13651101,3.19704,8.10686,423,56206,0.00157755,0.03,1,136563,136140,423
13654021,109.439,110.421,423,56243,0.00831551,0.05,1,136699,136276,423
13656941,64.2879,63.6843,424,56280,0.0256631,0.05,1,136752,136328,424
13659861,14.4576,14.3369,424,56317,0.00513262,0.05,1,136754,136330,424
13662781,15.6915,15.6674,424,56354,0.00902652,0.05,1,136770,136346,424
13665701,15.9383,15.9335,424,56391,0.0418053,0.05,1,136786,136362,424
13668621,27.1877,27.1867,424,56428,0.0163611,0.05,1,136816,136392,424
13671541,7.03753,7.03734,424,56465,0.0432722,0.05,1,136818,136394,424
13674461,17.4075,17.4075,424,56502,0.0166544,0.05,1,136838,136414,424
13677381,8.2815,8.28149,424,56539,0.0433309,0.07,1,136844,136420,424
13680301,14.4563,13.6563,425,56576,0.0166662,0.07,1,136860,136435,425
13683221,4.49126,4.33126,425,56613,0.0113332,0.09,1,136862,136437,425
13686141,21.6983,20.8663,426,56650,0.0422666,0.09,1,136888,136462,426
13689061,5.93965,5.77325,426,56687,0.0644533,0.09,1,136890,136464,426
13691981,2.78793,2.75465,426,56724,0.0688907,0.11,1,136892,136466,426
13694901,6.95759,6.15093,427,56761,0.0857781,0.07,1,136900,136473,427
13697821,43.7915,47.6302,422,56798,0.137156,0.03,1,136953,136531,422
13700741,31.9583,31.926,423,56835,0.0354311,0,1,136982,136559,423
13703661,7.99166,7.98521,423,56872,0.00708622,0,1,136984,136561,423
13706581,3.19833,3.19704,423,56909,0.00141724,0.01,1,136986,136563,423
13709501,108.64,109.439,422,56946,0.0242835,0.03,1,137121,136699,422
13712421,64.1279,64.2879,422,56983,0.0608567,0,1,137174,136752,422
13715341,14.4256,14.4576,422,57020,0.0361713,0.01,1,137176,136754,422
13718261,15.6851,15.6915,422,57057,0.0312343,0.05,1,137192,136770,422
13721181,15.937,15.9383,422,57094,0.0302469,0.01,1,137208,136786,422
13724101,27.1874,27.1877,422,57131,0.0300494,0.05,1,137238,136816,422
13727021,7.03748,7.03753,422,57168,0.0300099,0.01,1,137240,136818,422
13729941,17.4075,17.4075,422,57205,0.030002,0.05,1,137260,136838,422
13732861,8.2815,8.2815,422,57242,0.0300004,0.01,1,137266,136844,422
13735781,16.0563,14.4563,424,57279,0.0300001,0.01,1,137284,136860,424
13738701,4.81126,4.49126,424,57316,0.03,0.05,1,137286,136862,424
13741621,23.3623,21.6983,426,57353,0.014,0.07,1,137314,136888,426
13744541,6.27245,5.93965,426,57390,0.0108,0.07,1,137316,136890,426
13747461,2.85449,2.78793,426,57427,0.02616,0.09,1,137318,136892,426
13750381,6.9709,6.95759,426,57464,0.013232,0.15,1,137326,136900,426
13753301,42.9942,43.7915,425,57501,0.0266464,0.01,1,137378,136953,425
13756221,29.3988,31.9583,422,57538,0.00532928,0,1,137404,136982,422
13759141,7.47977,7.99166,422,57575,0.00106586,0,1,137406,136984,422
13762061,3.09595,3.19833,422,57612,0.000213171,0,1,137408,136986,422
13764981,108.619,0.639666,557,57648,0.0400426,0.03,1,137543,136986,557
13767901,64.1238,108.128,475,57684,0.0800085,0.07,1,137596,137121,475
13770821,14.4248,64.0256,424,57720,0.0880017,0.03,1,137598,137174,424
13773741,15.685,14.4051,438,57756,0.0896003,0.03,1,137614,137176,438
13776661,15.937,15.681,438,57792,0.0899201,0.03,1,137630,137192,438
13779581,27.1874,15.9362,452,57828,0.089984,0.03,1,137660,137208,452
13782501,7.03748,27.1872,424,57864,0.0899968,0.03,1,137662,137238,424
13785421,17.4075,7.03745,442,57900,0.0899994,0.03,1,137682,137240,442
13788341,8.2815,17.4075,428,57936,0.0899999,0.03,1,137688,137260,428
13791261,15.2563,8.2815,439,57972,0.074,0.03,1,137705,137266,439
13794181,4.65126,16.0563,423,58008,0.0708,0.03,1,137707,137284,423
13797101,23.3303,4.81126,449,58044,0.08616,0.01,1,137735,137286,449
13800021,6.26605,23.3623,423,58080,0.089232,0.01,1,137737,137314,423
13802941,2.85321,6.27245,423,58116,0.0898464,0.03,1,137739,137316,423
13805861,6.97064,2.85449,429,58152,0.0579693,0.01,1,137747,137318,429
13808781,42.9941,6.9709,473,58188,0.0835939,0.03,1,137799,137326,473
13811701,29.3988,42.9942,447,58224,0.0247188,0,1,137825,137378,447
13814621,7.47977,29.3988,423,58260,0.00494375,0,1,137827,137404,423
13817541,3.09595,7.47977,423,58296,0.000988751,0,1,137829,137406,423
13820461,110.219,3.09595,558,58332,0.0401977,0.05,1,137966,137408,558
13823381,66.0438,108.619,478,58368,0.0320395,0.09,1,138021,137543,478
13826301,14.8088,64.1238,427,58404,0.0304079,0.09,1,138023,137596,427
13829221,15.7618,14.4248,441,58440,0.0620816,0.09,1,138039,137598,441
13832141,15.9524,15.685,441,58476,0.0684163,0.09,1,138055,137614,441
13835061,27.1905,15.937,455,58512,0.0696833,0.09,1,138085,137630,455
13837981,7.03809,27.1874,427,58548,0.0699367,0.09,1,138087,137660,427
13840901,17.4076,7.03748,445,58584,0.0699873,0.09,1,138107,137662,445
13843821,8.28152,17.4075,431,58620,0.0699975,0.09,1,138113,137682,431
13846741,15.2563,8.2815,442,58656,0.0859995,0.07,1,138130,137688,442
13849661,4.65126,15.2563,427,58692,0.0891999,0.07,1,138132,137705,427
13852581,21.7303,4.65126,451,58728,0.08984,0.09,1,138158,137707,451
13855501,5.94605,23.3303,425,58764,0.089968,0.09,1,138160,137735,425
13858421,2.78921,6.26605,425,58800,0.0899936,0.09,1,138162,137737,425
13861341,6.95784,2.85321,431,58836,0.0899987,0.05,1,138170,137739,431
13864261,42.9916,6.97064,475,58872,0.122,0.09,1,138222,137747,475
13867181,28.5983,42.9941,448,58908,0.1124,0.01,1,138247,137799,448
13870101,7.31966,29.3988,424,58944,0.07848,0,1,138249,137825,424
13873021,3.06393,7.47977,424,58980,0.039696,0,1,138251,137827,424
13875941,111.013,3.09595,560,59016,0.0319392,0.05,1,138389,137829,560
13878861,65.4026,110.219,477,59052,0.0463878,0.03,1,138443,137966,477
13881781,14.6805,66.0438,424,59088,0.0492776,0.03,1,138445,138021,424
13884701,4.5361,14.8088,424,59124,0.0498555,0.07,1,138447,138023,424
13887621,14.5072,15.7618,425,59160,0.0339711,0.07,1,138464,138039,425
13890541,15.7014,15.9524,425,59196,0.0627942,0.07,1,138480,138055,425
13893461,27.1403,27.1905,425,59232,0.0365588,0.07,1,138510,138085,425
13896381,7.02806,7.03809,425,59267,0.0633118,0.07,1,138512,138087,425
13899301,17.4056,17.4076,425,59302,0.0366624,0.07,1,138532,138107,425
13902221,8.28112,8.28152,425,59337,0.0633325,0.09,1,138538,138113,425
13905141,16.0562,15.2563,426,59372,0.0526665,0.09,1,138556,138130,426
13908061,4.81124,4.65126,426,59407,0.0505333,0.09,1,138558,138132,426
13910981,21.7623,21.7303,426,59442,0.0501067,0.09,1,138584,138158,426
13913901,5.95245,5.94605,426,59477,0.0500213,0.09,1,138586,138160,426
13916821,2.79049,2.78921,426,59512,0.0500043,0.09,1,138588,138162,426
13919741,6.9581,6.95784,426,59547,0.0500009,0.13,1,138596,138170,426
13922661,44.5916,42.9916,428,59582,0.0660002,0.11,1,138650,138222,428
13925581,24.9183,28.5983,423,59617,0.0692,0.07,1,138670,138247,423
13928501,6.58366,7.31966,423,59652,0.06984,0.03,1,138672,138249,423
13931421,2.91673,3.06393,423,59687,0.101968,0.03,1,138674,138251,423
13934341,110.983,111.013,423,59722,0.124394,0.05,1,138812,138389,423
13937261,66.1967,65.4026,424,59757,0.176879,0.05,1,138867,138443,424
13940181,14.8393,14.6805,424,59792,0.187376,0.05,1,138869,138445,424
13943101,4.56787,4.5361,424,59827,0.189475,0.03,1,138871,138447,424
13946021,13.7136,14.5072,423,59862,0.205895,0.07,1,138887,138464,423
13948941,15.5427,15.7014,423,59897,0.225179,0.03,1,138903,138480,423
13951861,27.1085,27.1403,423,59932,0.229036,0.07,1,138933,138510,423
13954781,7.02171,7.02806,423,59967,0.229807,0.03,1,138935,138512,423
13957701,17.4043,17.4056,423,60002,0.229961,0.07,1,138955,138532,423
13960621,8.28087,8.28112,423,60037,0.229992,0.05,1,138961,138538,423
13963541,16.8562,16.0562,424,60072,0.213998,0.05,1,138980,138556,424
13966461,4.97123,4.81124,424,60107,0.2108,0.05,1,138982,138558,424
13969381,21.7942,21.7623,424,60142,0.21016,0.05,1,139008,138584,424
13972301,5.95885,5.95245,424,60177,0.210032,0.05,1,139010,138586,424
13975221,2.79177,2.79049,424,60212,0.210006,0.05,1,139012,138588,424
13978141,6.95835,6.9581,424,60247,0.210001,0.07,1,139020,138596,424
13981061,45.3917,44.5916,425,60282,0.226,0.07,1,139075,138650,425
13983981,25.0783,24.9183,425,60317,0.2292,0.07,1,139095,138670,425
13986901,6.61567,6.58366,425,60352,0.22984,0.11,1,139097,138672,425
13989821,2.92313,2.91673,425,60387,0.197968,0.13,1,139099,138674,425
13992741,113.385,110.983,428,60422,0.207594,0.19,1,139240,138812,428
13995661,69.0769,66.1967,431,60457,0.177519,0.19,1,139298,138867,431
13998581,15.4154,14.8393,431,60492,0.171504,0.19,1,139300,138869,431
14001501,4.68308,4.56787,431,60527,0.170301,0.19,1,139302,138871,431
14004421,13.7366,0.913573,447,60562,0.15406,0.21,1,139318,138871,447
14007341,16.3473,12.9827,448,60597,0.166812,0.23,1,139335,138887,448
14010261,27.2695,15.3965,462,60632,0.169362,0.23,1,139365,138903,462
14013181,7.05389,27.0793,434,60667,0.169872,0.23,1,139367,138933,434
14016101,17.4108,7.01586,452,60702,0.169975,0.23,1,139387,138935,452
14019021,8.28216,17.4032,438,60737,0.169995,0.23,1,139393,138955,438
14021941,16.0564,8.28063,450,60772,0.169999,0.21,1,139411,138961,450
14024861,4.81129,16.8561,433,60807,0.17,0.21,1,139413,138980,433
14027781,21.7623,4.97123,457,60842,0.186,0.21,1,139439,138982,457
14030701,5.95245,21.7942,433,60877,0.1892,0.21,1,139441,139008,433
14033621,2.79049,5.95885,433,60912,0.18984,0.21,1,139443,139010,433
14036541,6.9581,2.79177,439,60946,0.189968,0.21,1,139451,139012,439
14039461,44.5916,6.95835,485,60980,0.205994,0.23,1,139505,139020,485
14042381,24.9183,45.3917,450,61014,0.209199,0.23,1,139525,139075,450
14045301,6.58366,25.0783,432,61048,0.20984,0.23,1,139527,139095,432
14048221,2.91673,6.61567,432,61082,0.209968,0.19,1,139529,139097,432
14051141,112.583,2.92313,570,61116,0.241994,0.21,1,139669,139099,570
14054061,68.1167,113.385,486,61150,0.312399,0.17,1,139726,139240,486
14056981,15.2233,69.0769,430,61184,0.35848,0.17,1,139728,139298,430
14059901,4.64467,15.4154,430,61218,0.335696,0.17,1,139730,139300,430
14062821,13.7289,4.68308,444,61252,0.331139,0.15,1,139746,139302,444
14065741,17.1458,13.7366,446,61286,0.346228,0.17,1,139764,139318,446
14068661,27.4292,16.3473,459,61320,0.381246,0.17,1,139794,139335,459
14071581,7.08583,27.2695,431,61354,0.388249,0.17,1,139796,139365,431
14074501,17.4172,7.05389,449,61388,0.38965,0.17,1,139816,139367,449
14077421,8.28343,17.4108,435,61422,0.38993,0.17,1,139822,139387,435
14080341,16.0567,8.28216,447,61456,0.389986,0.17,1,139840,139393,447
14083261,4.81134,16.0564,431,61490,0.389997,0.17,1,139842,139411,431
14086181,22.5623,4.81129,456,61524,0.373999,0.19,1,139869,139413,456
14089101,6.11245,21.7623,432,61558,0.3708,0.19,1,139871,139439,432
14092021,2.82249,5.95245,432,61592,0.37016,0.19,1,139873,139441,432
14094941,6.9645,2.79049,438,61626,0.370032,0.19,1,139881,139443,438
14097861,45.3929,6.9581,485,61660,0.386006,0.21,1,139936,139451,485
14100781,25.0786,44.5916,451,61694,0.389201,0.21,1,139956,139505,451
14103701,6.61572,24.9183,433,61728,0.38984,0.21,1,139958,139525,433
14106621,2.92314,6.58366,433,61762,0.389968,0.21,1,139960,139527,433
14109541,114.985,2.91673,574,61796,0.341994,0.25,1,140103,139529,574
14112461,70.9969,112.583,494,61830,0.364399,0.33,1,140163,139669,494
14115381,15.7994,68.1167,439,61864,0.36888,0.37,1,140165,139726,439
14118301,4.75988,15.2233,439,61898,0.369776,0.33,1,140167,139728,439
14121221,14.552,4.64467,454,61932,0.353955,0.33,1,140184,139730,454
14124141,18.1104,13.7289,457,61966,0.366791,0.35,1,140203,139746,457
14127061,5.22208,17.1458,441,62000,0.369358,0.39,1,140205,139764,441
14129981,25.0444,27.4292,441,62034,0.385872,0.39,1,140235,139794,441
14132901,6.60888,7.08583,441,62068,0.421174,0.39,1,140237,139796,441
14135821,17.3218,17.4172,441,62102,0.396235,0.39,1,140257,139816,441
14138741,8.26436,8.28343,441,62136,0.423247,0.39,1,140263,139822,441
14141661,16.0529,16.0567,441,62170,0.412649,0.39,1,140281,139840,441
14144581,4.81057,4.81134,441,62204,0.41053,0.37,1,140283,139842,441
14147501,21.7621,22.5623,440,62238,0.410106,0.37,1,140309,139869,440
14150421,5.95242,6.11245,440,62272,0.410021,0.37,1,140311,139871,440
14153341,2.79048,2.82249,440,62306,0.410004,0.37,1,140313,139873,440
14156261,6.9581,6.9645,440,62340,0.410001,0.39,1,140321,139881,440
14159181,46.1916,45.3929,441,62374,0.426,0.39,1,140377,139936,441
14162101,25.2383,25.0786,441,62408,0.4292,0.39,1,140397,139956,441
14165021,6.64766,6.61572,441,62442,0.42984,0.39,1,140399,139958,441
14167941,2.92953,2.92314,441,62476,0.461968,0.33,1,140401,139960,441
14170861,112.586,114.985,438,62510,0.468394,0.37,1,140541,140103,438
14173781,72.1172,70.9969,440,62544,0.517679,0.37,1,140603,140163,440
14176701,16.0234,15.7994,440,62578,0.527536,0.37,1,140605,140165,440
14179621,4.80469,4.75988,440,62612,0.529507,0.35,1,140607,140167,440
14182541,15.3609,14.552,441,62646,0.561901,0.37,1,140625,140184,441
14185461,17.4722,18.1104,440,62680,0.56838,0.37,1,140643,140203,440
14188381,5.09444,5.22208,440,62714,0.569676,0.39,1,140645,140205,440
14191301,25.8189,25.0444,441,62747,0.601935,0.43,1,140676,140235,441
14194221,6.76378,6.60888,441,62780,0.608387,0.39,1,140678,140237,441
14197141,18.1528,17.3218,442,62813,0.641677,0.43,1,140699,140257,442
14200061,8.43055,8.26436,442,62846,0.648336,0.41,1,140705,140263,442
14202981,16.0861,16.0529,442,62879,0.617667,0.41,1,140723,140281,442
14205901,4.81722,4.81057,442,62912,0.611533,0.41,1,140725,140283,442
14208821,21.7634,21.7621,442,62945,0.610307,0.41,1,140751,140309,442
14211741,5.95269,5.95242,442,62978,0.610061,0.41,1,140753,140311,442
14214661,2.79054,2.79048,442,63011,0.610012,0.41,1,140755,140313,442
14217581,6.95811,6.9581,442,63044,0.610002,0.43,1,140763,140321,442
14220501,46.9916,46.1916,443,63077,0.626,0.43,1,140820,140377,443
14223421,25.3983,25.2383,443,63110,0.6292,0.43,1,140840,140397,443
14226341,6.67966,6.64766,443,63143,0.62984,0.47,1,140842,140399,443
14229261,2.93593,2.92953,443,63176,0.597968,0.47,1,140844,140401,443
14232181,114.987,112.586,446,63209,0.607594,0.53,1,140987,140541,446
14235101,74.1974,72.1172,448,63242,0.609519,0.53,1,141051,140603,448
14238021,16.4395,16.0234,448,63275,0.577904,0.53,1,141053,140605,448
14240941,4.8879,4.80469,448,63308,0.603581,0.57,1,141055,140607,448
14243861,16.9776,15.3609,450,63341,0.576716,0.57,1,141075,140625,450
14246781,17.7955,17.4722,450,63374,0.571343,0.57,1,141093,140643,450
14249701,5.1591,5.09444,450,63407,0.570269,0.61,1,141095,140645,450
14252621,27.4318,25.8189,452,63440,0.602054,0.61,1,141128,140676,452
14255541,7.08636,5.16378,454,63473,0.576411,0.61,1,141130,140676,454
14258461,17.4173,2.63276,472,63506,0.571282,0.65,1,141150,140678,472
14261381,8.28345,17.3266,457,63539,0.570256,0.65,1,141156,140699,457
14264301,16.0567,8.26531,469,63572,0.570051,0.61,1,141174,140705,469
14267221,4.81134,16.0531,453,63605,0.57001,0.61,1,141176,140723,453
14270141,21.7623,4.81061,477,63638,0.586002,0.61,1,141202,140725,477
14273061,5.95245,21.7621,453,63671,0.5892,0.61,1,141204,140751,453
14275981,2.79049,5.95242,453,63704,0.58984,0.61,1,141206,140753,453
14278901,6.9581,2.79048,459,63737,0.597968,0.61,1,141214,140755,459
14281821,46.1916,6.9581,507,63770,0.591594,0.63,1,141270,140763,507
14284741,25.2383,46.9916,470,63803,0.606319,0.63,1,141290,140820,470
14287661,6.64766,25.3983,452,63836,0.609264,0.63,1,141292,140840,452
14290581,2.92953,6.67966,452,63869,0.609853,0.59,1,141294,140842,452
14293501,115.786,2.93593,594,63902,0.641971,0.61,1,141438,140844,594
14296421,72.7572,114.987,513,63935,0.696394,0.61,1,141500,140987,513
14299341,16.1514,74.1974,451,63968,0.707279,0.57,1,141502,141051,451
14302261,4.83029,16.4395,451,64001,0.709456,0.61,1,141504,141053,451
14305181,15.3661,4.8879,467,64034,0.725891,0.57,1,141522,141055,467
14308101,17.4732,16.9776,465,64067,0.729178,0.57,1,141540,141075,465
14311021,5.09464,17.7955,449,64100,0.729836,0.57,1,141542,141093,449
14313941,29.0189,5.1591,482,64133,0.761967,0.61,2,141577,141095,482
14316861,7.40379,27.4318,451,64166,0.768393,0.57,2,141579,141128,451
14319781,17.4808,7.08636,469,64199,0.769679,0.57,2,141599,141130,469
14322701,8.29615,17.4173,455,64232,0.769936,0.57,2,141605,141150,455
14325621,16.8592,8.28345,468,64265,0.769987,0.57,2,141624,141156,468
14328541,4.97185,16.0567,452,64298,0.801997,0.57,2,141626,141174,452
14331461,21.7944,4.81134,476,64331,0.7764,0.59,2,141652,141176,476
14334381,5.95887,21.7623,452,64364,0.77128,0.59,2,141654,141202,452
14337301,2.79177,5.95245,452,64397,0.770256,0.59,2,141656,141204,452
14340221,6.95836,2.79049,458,64430,0.770051,0.6,2,141664,141206,458
14343141,46.9917,6.9581,507,64463,0.78601,0.59,2,141721,141214,507
14346061,25.3983,46.1916,471,64496,0.789202,0.61,2,141741,141270,471
14348981,6.67967,25.2383,453,64529,0.78984,0.61,2,141743,141290,453
14351901,2.93593,6.64766,453,64562,0.789968,0.61,2,141745,141292,453
14354821,117.387,2.92953,597,64595,0.757994,0.65,2,141891,141294,597
14357741,75.4774,115.786,518,64627,0.735599,0.71,1,141956,141438,518
14360661,16.6955,72.7572,458,64659,0.73112,0.71,1,141958,141500,458
14363581,4.9391,16.1514,458,64691,0.730224,0.71,1,141960,141502,458
14366501,16.1878,4.83029,475,64723,0.746045,0.73,1,141979,141504,475
14369421,19.2376,15.3661,477,64755,0.749209,0.73,1,141999,141522,477
14372341,5.44751,17.4732,461,64787,0.749842,0.73,1,142001,141540,461
14375261,29.0895,5.09464,494,64819,0.765968,0.77,2,142036,141542,494
14378181,7.4179,29.0189,461,64851,0.769194,0.77,2,142038,141577,461
14381101,17.4836,7.40379,479,64883,0.801839,0.77,2,142058,141579,479
14384021,8.29672,17.4808,465,64915,0.808368,0.77,2,142064,141599,465
14386941,3.25934,8.29615,461,64947,0.809674,0.77,2,142066,141605,461
14389861,15.0519,16.8592,460,64979,0.809935,0.81,2,142084,141624,460
14392781,4.61037,4.97185,460,65011,0.809987,0.77,2,142086,141626,460
14395701,21.7221,21.7944,460,65043,0.809997,0.77,2,142112,141652,460
14398621,5.94441,5.95887,460,65075,0.809999,0.77,2,142114,141654,460
14401541,2.78888,2.79177,460,65107,0.81,0.77,2,142116,141656,460
14404461,6.95778,6.95836,460,65139,0.81,0.79,2,142124,141664,460
14407381,47.7916,46.9917,461,65171,0.81,0.79,2,142182,141721,461
14410301,25.5583,25.3983,461,65203,0.826,0.79,2,142202,141741,461
14413221,6.71166,6.67967,461,65235,0.8292,0.79,2,142204,141743,461
14416141,2.94233,2.93593,461,65267,0.86184,0.75,2,142206,141745,461
14419061,115.788,117.387,459,65299,0.868368,0.73,2,142350,141891,459
14421981,74.3577,75.4774,458,65331,0.885674,0.73,2,142414,141956,458
14424901,16.4715,16.6955,458,65363,0.889135,0.73,2,142416,141958,458
14427821,4.89431,4.9391,458,65395,0.889827,0.75,2,142418,141960,458
14430741,16.9789,16.1878,459,65427,0.921965,0.75,2,142438,141979,459
14433661,20.9958,19.2376,461,65459,0.896393,0.75,2,142460,141999,461
14436581,5.79915,5.44751,461,65491,0.891279,0.77,2,142462,142001,461
14439501,29.1598,29.0895,461,65523,0.938256,0.77,2,142497,142036,461
14509581,20,21,469,66291,0.95,0.95,2,142989,142520,469
14512501,8.8,9,469,66323,0.918,0.95,2,142995,142526,469
14515421,3.36,3.4,469,66355,0.9276,0.95,2,142997,142528,469
14807421,9,14,479,69442,0.83,1,2,145026,144547,479
14810341,10.6,18,471,69472,0.862,1,2,145037,144566,471
14877501,9,9,472,70162,0.93,0.87,2,145498,145026,472
14880421,129,10.6,620,70192,0.786,1,2,145657,145037,620
14883341,89,122.92,548,70222,0.7252,1,1,145736,145188,548
14886261,28.2,81.384,490,70252,0.72904,1,1,145749,145259,490
14889181,14.44,26.6768,488,70282,0.713808,1,1,145760,145272,488
14892101,14.088,16.5354,488,70312,0.742762,1,1,145774,145286,488
14895021,14.0176,14.5071,488,70342,0.748552,1,1,145788,145300,488
14897941,14.0035,14.1014,488,70372,0.74971,1,1,145802,145314,488
14900861,10.0007,14.0203,483,70402,0.733942,1,1,145811,145328,483
14903781,12.4001,10.0041,487,70432,0.714788,0.94,1,145824,145337,487
14906701,11.28,12.4008,485,70462,0.726958,1,1,145835,145350,485
14909621,10.256,9.68016,486,70492,0.761392,1,2,145845,145359,486
14912541,10.0512,9.93603,486,70522,0.768278,1,2,145855,145369,486
14915461,11.6102,10.7872,487,70552,0.801656,1,2,145867,145380,487
14918381,11.922,9.35744,490,70582,0.808331,1,2,145879,145389,490
14921301,11.9844,13.0715,488,70612,0.825666,1,2,145891,145403,488
14924221,10.3969,13.0143,485,70642,0.829133,1,2,145901,145416,485
14927141,9.27938,9.80286,485,70672,0.829827,1,2,145910,145425,485
14930061,9.05588,9.16057,485,70702,0.813965,1,2,145919,145434,485
14932981,7.41117,8.23211,484,70732,0.826793,1,2,145926,145442,484
14935901,15.8822,7.24642,495,70762,0.829359,0.94,2,145944,145449,495
14938821,4.77645,19.8493,474,70792,0.829872,0.88,2,145946,145472,474
14941741,7.35529,10.3699,474,70822,0.829974,0.92,2,145954,145480,474
14944661,7.87106,9.27397,473,70852,0.845995,0.93,2,145962,145489,473
14947581,7.97421,9.05479,472,70882,0.849199,0.75,2,145970,145498,472
14950501,116.795,129.011,457,70912,0.86584,0.71,2,146114,145657,457
14953421,86.559,89.0022,457,70942,0.853168,0.73,2,146193,145736,457
14956341,26.9118,28.2004,456,70972,0.818634,0.71,2,146205,145749,456
14959261,14.9824,14.4401,457,71002,0.811727,0.75,2,146217,145760,457
14962181,14.1965,14.088,457,71032,0.810345,0.75,2,146231,145774,457
14965101,14.0393,14.0176,457,71062,0.810069,0.75,2,146245,145788,457
14968021,14.0079,14.0035,457,71091,0.810014,0.73,2,146259,145802,457
14970941,10.8016,10.0007,458,71120,0.810003,0.71,2,146269,145811,458
14973861,11.7603,12.4001,457,71149,0.826001,0.73,2,146281,145824,457
14976781,13.5521,11.28,460,71178,0.8292,0.77,2,146295,145835,460
14979701,10.7104,10.256,460,71207,0.82984,0.77,2,146305,145845,460
14982621,11.7421,10.0512,462,71236,0.829968,0.81,2,146317,145855,462
14985541,11.9484,11.6102,462,71265,0.829994,0.81,2,146329,145867,462
14988461,12.7897,11.922,463,71294,0.861999,0.83,2,146342,145879,463
14991381,12.1579,11.9844,463,71323,0.8524,0.83,2,146354,145891,463
14994301,11.2316,10.3969,464,71352,0.86648,0.83,2,146365,145901,464
14997221,8.64632,9.27938,463,71381,0.869296,0.81,2,146373,145910,463
15000141,8.12926,9.05588,462,71410,0.853859,0.83,2,146381,145919,462
15003061,8.02585,7.41117,463,71439,0.866772,0.83,2,146389,145926,463
15005981,16.0052,15.8822,463,71468,0.869354,0.83,2,146407,145944,463
15008901,4.80103,4.77645,463,71497,0.869871,0.83,2,146409,145946,463
15011821,8.16021,7.35529,464,71526,0.885974,0.85,2,146418,145954,464
15014741,8.03204,7.87106,464,71555,0.921195,0.85,2,146426,145962,464
15017661,8.00641,7.97421,464,71584,0.944239,0.87,2,146434,145970,464
15076061,18,18,465,72164,0.95,0.87,2,146872,146407,465
15078981,5.2,5.2,465,72193,0.95,0.89,2,146874,146409,465
15081901,9.04,8.24,466,72222,0.918,0.89,2,146884,146418,466
15084821,8.208,1.648,474,72251,0.9436,0.93,2,146892,146418,474
15087741,8.0416,6.7296,474,72280,0.93272,0.95,2,146900,146426,474
15445441,176,117,551,35888,0.05,0.79,1,149486,148935,551
15448361,57.6,105,477,35947,0.05,0.69,1,149514,149037,477
15451281,36.32,49.8,472,36006,0.258,0.65,1,149545,149073,472
15454201,27.264,37.16,463,36065,0.2836,0.55,1,149570,149107,463
15457121,31.8528,31.432,466,36124,0.30472,0.45,1,149603,149137,466
15460041,23.1706,33.4864,453,36183,0.292944,0.31,1,149624,149171,453
15462961,22.2341,29.0973,447,36241,0.322589,0.31,1,149646,149199,447
15465881,25.2468,25.0195,449,36299,0.296518,0.13,1,149672,149223,449
15468801,23.4494,31.4039,439,36357,0.307304,0.05,1,149695,149256,439
15471721,13.4899,24.6808,427,36415,0.293461,0.05,1,149706,149279,427
15474641,5.09797,10.5362,423,36473,0.306692,0,1,149709,149286,423
15477561,21.0196,21.3072,424,36531,0.245338,0.05,1,149734,149310,424
15480481,144.204,145.061,423,36589,0.137068,0.05,1,149909,149486,423
15483401,60.8408,51.4123,435,36647,0.131414,0.31,1,149949,149514,435
15486321,36.9682,35.0825,435,36705,0.0822827,0.29,1,149980,149545,435
15489241,28.1936,27.0165,436,36763,0.0724565,0.31,1,150006,149570,436
15492161,31.2387,31.8033,435,36820,0.102491,0.29,1,150038,149603,435
15495081,23.8477,23.1607,436,36877,0.0764983,0.33,1,150060,149624,436
15498001,22.3695,22.2321,436,36934,0.0712996,0.29,1,150082,149646,436
15500921,25.2739,25.2464,436,36991,0.0862599,0.31,1,150108,149672,436
15503841,22.6548,23.4493,435,37048,0.089252,0.29,1,150130,149695,435
15506761,14.131,13.4899,436,37105,0.12185,0.31,1,150142,149706,436
15509681,4.42619,5.09797,435,37162,0.0963701,0.31,1,150144,149709,435
15512601,16.8852,1.01959,455,37219,0.091274,0.23,1,150164,149709,455
15515521,139.377,20.2039,600,37276,0.0262548,0.11,1,150334,149734,600
15518441,59.8754,144.041,465,37333,0.061251,0.13,1,150374,149909,465
15521361,35.9751,60.8082,455,37390,0.0682502,0.07,1,150404,149949,455
15524281,27.995,36.9616,450,37447,0.08565,0.07,1,150430,149980,450
15527201,31.199,28.1923,456,37503,0.08913,0.11,1,150462,150006,456
15530121,23.8398,31.2385,446,37559,0.105826,0.07,1,150484,150038,446
15533041,23.168,23.8477,447,37615,0.0931652,0.07,1,150507,150060,447
15535961,25.4336,22.3695,451,37671,0.090633,0.09,1,150533,150082,451
15538881,22.6867,25.2739,447,37727,0.0901266,0.09,1,150555,150108,447
15541801,14.1373,22.6548,437,37783,0.0900253,0.13,1,150567,150130,437
15544721,4.42747,14.131,427,37839,0.0900051,0.09,1,150569,150142,427
15547641,16.8855,4.42619,445,37895,0.106001,0.09,1,150589,150144,445
15550561,138.577,16.8852,594,37951,0.0612002,0.01,1,150758,150164,594
15553481,59.7154,139.377,464,38007,0.03624,0.07,1,150798,150334,464
15556401,36.7431,59.8754,455,38063,0.079248,0.07,1,150829,150374,455
15559321,28.1486,35.9751,451,38119,0.0878496,0.09,1,150855,150404,451
15562241,32.0297,27.995,458,38174,0.0735699,0.09,1,150888,150430,458
15565161,24.0059,31.199,448,38229,0.070714,0.11,1,150910,150462,448
15568081,22.4012,23.8398,448,38284,0.0701428,0.09,1,150932,150484,448
15571001,25.2802,23.168,451,38339,0.0860286,0.09,1,150958,150507,451
15573921,22.656,25.4336,447,38394,0.0892057,0.09,1,150980,150533,447
15576841,14.9312,22.6867,438,38449,0.0738411,0.09,1,150993,150555,438
15579761,4.58624,14.1373,428,38504,0.102768,0.09,1,150995,150567,428
15582681,16.9172,4.42747,446,38559,0.108554,0.11,1,151015,150569,446
15585601,134.583,16.8855,590,38614,0.0617107,0.05,1,151179,150589,590
15588521,28.5167,138.577,423,38669,0.0523421,0.03,1,151181,150758,423
15591441,37.7033,59.7154,423,38724,0.0504684,0.09,1,151221,150798,423
15594361,34.7407,36.7431,426,38779,0.0660937,0.09,1,151255,150829,426
15597281,27.7481,28.1486,426,38833,0.0692187,0.07,1,151281,150855,426
15600201,31.1496,32.0297,425,38887,0.117844,0.07,1,151313,150888,425
15603121,23.8299,24.0059,425,38941,0.127569,0.07,1,151335,150910,425
15606041,22.366,22.4012,425,38995,0.129514,0.09,1,151357,150932,425
15608961,26.0732,25.2802,426,39049,0.145903,0.09,1,151384,150958,426
15611881,22.8146,22.656,426,39103,0.149181,0.07,1,151406,150980,426
15614801,15.7629,14.9312,427,39157,0.117836,0.11,1,151420,150993,427
15617721,4.75259,4.58624,427,39211,0.143567,0.11,1,151422,150995,427
15620641,16.9505,16.9172,427,39265,0.116713,0.05,1,151442,151015,427
15623561,132.19,134.583,424,39319,0.127343,0.05,1,151603,151179,424
15626481,28.038,28.5167,424,39373,0.129469,0.05,1,151605,151181,424
15629401,38.4076,37.7033,425,39427,0.161894,0.07,1,151646,151221,425
15632321,34.8815,34.7407,425,39481,0.184379,0.07,1,151680,151255,425
15635241,28.5763,27.7481,426,39534,0.220876,0.13,1,151707,151281,426
15638161,31.3153,31.1496,426,39587,0.228175,0.13,1,151739,151313,426
15641081,23.8631,23.8299,426,39640,0.197635,0.13,1,151761,151335,426
15644001,22.3726,22.366,426,39693,0.191527,0.15,1,151783,151357,426
15646921,26.8745,26.0732,427,39746,0.190305,0.15,1,151811,151384,427
15649841,22.9749,22.8146,427,39799,0.190061,0.11,1,151833,151406,427
15652761,15.795,15.7629,427,39852,0.190012,0.15,1,151847,151420,427
15655681,4.759,4.75259,427,39905,0.190002,0.11,1,151849,151422,427
15658601,16.9518,16.9505,427,39958,0.222,0.13,1,151869,151442,427
15661521,132.99,132.19,428,40011,0.2284,0.13,1,152031,151603,428
15664441,28.1981,28.038,428,40064,0.26168,0.13,1,152033,151605,428
15667361,39.2396,5.6076,470,40117,0.252336,0.17,1,152075,151605,470
15670281,35.8479,33.9215,464,40170,0.250467,0.19,1,152110,151646,464
15673201,28.7696,33.9843,457,40223,0.266093,0.23,1,152137,151680,457
15676121,31.3539,28.3969,462,40275,0.285219,0.23,1,152169,151707,462
15679041,23.8708,31.2794,452,40327,0.289044,0.19,1,152191,151739,452
15681961,22.3742,23.8559,452,40379,0.289809,0.19,1,152213,151761,452
15684881,26.8748,22.3712,458,40431,0.289962,0.19,1,152241,151783,458
15687801,22.975,26.8742,452,40483,0.289992,0.19,1,152263,151811,452
15690721,15.795,22.9748,444,40535,0.305998,0.19,1,152277,151833,444
15693641,4.759,15.795,432,40587,0.3092,0.19,1,152279,151847,432
15696561,16.9518,4.75899,450,40639,0.30984,0.23,1,152299,151849,450
15699481,134.59,16.9518,594,40691,0.341968,0.23,1,152463,151869,594
15702401,28.5181,132.99,434,40743,0.348394,0.27,1,152465,152031,434
15705321,40.1036,28.1981,475,40795,0.333679,0.25,1,152508,152033,475
15708241,36.0207,39.2396,468,40847,0.314736,0.25,1,152543,152075,468
15711161,29.6041,35.8479,461,40899,0.326947,0.27,1,152571,152110,461
15714081,32.3208,28.7696,467,40951,0.377389,0.29,1,152604,152137,467
15717001,24.0642,31.3539,457,41003,0.387478,0.29,1,152626,152169,457
15719921,22.4128,23.8708,457,41054,0.389496,0.29,1,152648,152191,457
15722841,26.8826,22.3742,463,41105,0.389899,0.29,1,152676,152213,463
15725761,22.9765,26.8748,457,41156,0.38998,0.29,1,152698,152241,457
15728681,16.5953,22.975,450,41207,0.373996,0.31,1,152713,152263,450
15731601,4.91906,15.795,438,41258,0.370799,0.31,1,152715,152277,438
15734521,16.9838,4.759,456,41309,0.37016,0.31,1,152735,152279,456
15737441,136.197,16.9518,602,41360,0.386032,0.35,1,152901,152299,602
15740361,28.8394,134.59,440,41411,0.389206,0.35,1,152903,152463,440
15743281,39.3679,28.5181,480,41462,0.389841,0.33,1,152945,152465,480
15746201,35.0736,40.1036,471,41513,0.405968,0.31,1,152979,152508,471
15749121,8.61471,36.0207,438,41564,0.409194,0.33,1,152981,152543,438
15752041,24.1229,29.6041,438,41615,0.441839,0.39,1,153009,152571,438
15754961,33.6246,32.3208,441,41666,0.480368,0.39,1,153045,152604,441
15757881,24.3249,24.0642,441,41717,0.488074,0.39,1,153067,152626,441
15760801,22.465,22.4128,441,41768,0.489615,0.39,1,153089,152648,441
15763721,26.893,26.8826,441,41819,0.489923,0.39,1,153117,152676,441
15766641,22.9786,22.9765,441,41869,0.505985,0.37,1,153139,152698,441
15769561,15.7957,16.5953,440,41919,0.477197,0.37,1,153153,152713,440
15772481,4.75914,4.91906,440,41969,0.503439,0.37,1,153155,152715,440
15775401,16.9518,16.9838,440,42019,0.476688,0.39,1,153175,152735,440
15778321,136.99,136.197,441,42069,0.551338,0.39,1,153342,152901,441
15781241,28.9981,28.8394,441,42119,0.534268,0.39,1,153344,152903,441
15784161,40.1996,39.3679,442,42169,0.546853,0.41,1,153387,152945,442
15787081,35.2399,35.0736,442,42219,0.549371,0.41,1,153421,152979,442
15790001,8.64798,8.61471,442,42269,0.581874,0.45,1,153423,152981,442
15792921,24.9296,24.1229,443,42319,0.572375,0.49,1,153452,153009,443
15795841,34.5859,33.6246,444,42369,0.618475,0.49,1,153489,153045,444
15798761,24.5172,24.3249,444,42419,0.627695,0.49,1,153511,153067,444
15801681,22.5034,22.465,444,42469,0.629539,0.49,1,153533,153089,444
15804601,27.7007,26.893,445,42519,0.645908,0.51,1,153562,153117,445
15807521,23.1401,22.9786,445,42569,0.617182,0.47,1,153584,153139,445
15810441,15.828,15.7957,445,42619,0.611436,0.51,1,153598,153153,445
15813361,4.76561,4.75914,445,42669,0.610287,0.47,1,153600,153155,445
15816281,16.9531,16.9518,445,42718,0.642057,0.57,1,153620,153175,445
15819201,139.391,136.99,448,42767,0.600411,0.53,1,153790,153342,448
15822121,29.4781,28.9981,448,42816,0.624082,0.55,1,153792,153344,448
15825041,41.0956,40.1996,449,42865,0.596816,0.55,1,153836,153387,449
15827961,35.4191,35.2399,449,42914,0.623363,0.59,1,153870,153421,449
15830881,8.68382,8.64798,449,42963,0.628673,0.57,1,153872,153423,449
15833801,24.1368,24.9296,448,43012,0.613734,0.57,1,153900,153452,448
15836721,36.0274,4.98592,487,43061,0.626747,0.63,1,153939,153452,487
15839641,26.4055,30.5972,474,43110,0.629349,0.63,1,153963,153489,474
15842561,22.8811,23.7194,474,43159,0.62987,0.63,1,153985,153511,474
15845481,26.9762,22.3439,480,43208,0.629974,0.65,1,154013,153533,480
15848401,22.9952,27.6688,473,43257,0.661995,0.61,1,154035,153562,473
15851321,15.799,23.1338,465,43306,0.668399,0.61,1,154049,153584,465
15854241,4.75981,15.8268,453,43355,0.66968,0.61,1,154051,153598,453
15857161,16.952,4.76535,471,43404,0.669936,0.65,1,154071,153600,471
15860081,138.59,16.9531,620,43453,0.701987,0.59,1,154240,153620,620
15863001,29.3181,139.391,452,43502,0.708397,0.63,1,154242,153790,452
15865921,41.0636,29.4781,494,43551,0.709679,0.59,1,154286,153792,494
15868841,35.4127,41.0956,484,43599,0.709936,0.63,1,154320,153836,484
15871761,8.68254,35.4191,452,43647,0.709987,0.63,1,154322,153870,452
15874681,24.9365,8.68382,479,43695,0.693997,0.61,1,154351,153872,479
15877601,36.9873,24.1368,491,43743,0.6748,0.63,1,154391,153900,491
15880521,26.5975,36.0274,476,43791,0.67096,0.63,1,154415,153939,476
15883441,22.9195,26.4055,474,43839,0.702192,0.63,1,154437,153963,474
15886361,27.7839,22.8811,481,43887,0.740438,0.63,1,154466,153985,481
15889281,23.9568,26.9762,476,43935,0.732088,0.67,1,154489,154013,476
15892201,15.9914,22.9952,468,43983,0.730418,0.67,1,154503,154035,468
15895121,4.79827,15.799,456,44031,0.730084,0.67,1,154505,154049,456
15898041,16.9597,4.75981,474,44079,0.730017,0.67,1,154525,154051,474
15900961,140.192,16.952,625,44127,0.778003,0.71,2,154696,154071,625
15903881,29.6384,138.59,458,44175,0.787601,0.71,2,154698,154240,458
15906801,41.1277,29.3181,500,44223,0.80552,0.71,2,154742,154242,500
15909721,35.4255,41.0636,490,44271,0.809104,0.71,2,154776,154286,490
15912641,8.68511,35.4127,458,44319,0.809821,0.71,2,154778,154320,458
15915561,24.137,8.68254,484,44367,0.809964,0.69,2,154806,154322,484
15918481,36.0274,24.9365,494,44415,0.809993,0.67,2,154845,154351,494
15921401,27.2055,36.9873,479,44462,0.841999,0.67,2,154870,154391,479
15924321,7.0411,26.5975,457,44509,0.8164,0.71,2,154872,154415,457
15927241,19.0082,22.9195,457,44556,0.84328,0.75,2,154894,154437,457
15930161,28.6016,27.7839,459,44603,0.832656,0.73,2,154925,154466,459
15933081,23.3203,23.9568,458,44650,0.862531,0.73,2,154947,154489,458
15936001,15.8641,15.9914,458,44697,0.852506,0.73,2,154961,154503,458
15938921,4.77281,4.79827,458,44744,0.882501,0.73,2,154963,154505,458
15941841,16.9546,16.9597,458,44791,0.8565,0.79,2,154983,154525,458
15944761,142.591,140.192,461,44838,0.9313,0.79,2,155157,154696,461
15947681,30.1182,29.6384,461,44885,0.91426,0.81,2,155159,154698,461
16187121,47,50,477,48587,0.75,1,2,157680,157203,477
16190041,21.4,25.2,473,48630,0.686,1,1,157695,157222,473
16192961,14.68,14.64,474,48673,0.6572,1,1,157708,157234,474
16195881,14.936,11.728,478,48716,0.60344,1,1,157723,157245,478
16198801,33.3872,27.9456,484,48759,0.496688,1,1,157761,157277,484
16201721,17.8774,15.9891,485,48802,0.411338,1,1,157775,157290,485
16204641,17.1755,19.9978,481,48845,0.378268,1,1,157792,157311,481
16207561,15.4351,3.99956,496,48888,0.339654,1,1,157807,157311,496
16210481,13.487,14.3999,492,48931,0.363931,1,1,157820,157328,492
16213401,16.2974,13.28,496,48974,0.304786,1,1,157837,157341,496
16216321,126.459,14.656,635,49017,0.100957,0.96,1,157991,157356,635
16219241,43.6919,130.931,498,49060,0.0601914,1,1,158014,157516,498
16222161,30.3384,48.5862,497,49103,0.0360383,0.97,1,158041,157544,497
16225081,18.0677,32.9172,483,49146,0.0312077,0.91,1,158056,157573,483
16228001,16.4135,19.3834,483,49189,0.0142415,0.84,1,158072,157589,483
16230921,24.0827,18.2767,491,49232,0.0268483,0.89,1,158098,157607,491
16233841,36.0165,24.4553,504,49275,0.0613697,0.75,1,158137,157633,504
16236761,16.8033,42.4911,469,49318,0.0362739,0.67,1,158149,157680,469
16239681,12.9607,20.4982,466,49361,0.0312548,0.65,1,158161,157695,466
16242601,13.7921,14.4996,467,49404,0.046251,0.59,1,158175,157708,467
16245521,25.1584,14.8999,480,49447,0.0492502,0.47,1,158203,157723,480
16248441,14.6317,33.38,454,49490,0.01785,0.39,1,158215,157761,454
16251361,14.1263,17.876,454,49533,0.04357,0.37,1,158229,157775,454
16254281,15.6253,17.1752,453,49576,0.016714,0.33,1,158245,157792,453
16257201,12.7251,15.435,450,49618,0.0113428,0.37,1,158257,157807,450
16260121,14.545,13.487,452,49660,0.0262686,0.29,1,158272,157820,452
16263041,114.909,16.2974,575,49702,0.0292537,0.05,1,158412,157837,575
16265961,42.9818,126.459,446,49744,0.0458507,0.05,1,158437,157991,446
16268881,28.5964,43.6919,448,49786,0.0651701,0.03,1,158462,158014,448
16271801,19.3193,30.3384,438,49828,0.021034,0.03,1,158479,158041,438
16274721,15.0639,18.0677,437,49870,0.0282068,0.01,1,158493,158056,437
16277641,23.8128,16.4135,447,49912,0.0296414,0.03,1,158519,158072,447
16280561,36.7626,24.0827,461,49954,0.0139283,0.07,1,158559,158098,461
16283481,16.9525,36.0165,434,49996,0.0267857,0.03,1,158571,158137,434
16286401,13.7905,16.8033,435,50038,0.0453571,0.03,1,158584,158149,435
16289321,13.9581,12.9607,437,50080,0.0330714,0.05,1,158598,158161,437
16292241,23.5916,13.7921,449,50122,0.0306143,0.05,1,158624,158175,449
16295161,15.9183,25.1584,435,50164,0.0301229,0.01,1,158638,158203,435
16298081,12.7837,14.6317,435,50206,0.0300246,0.05,1,158650,158215,435
16301001,15.3567,14.1263,437,50248,0.0300049,0.01,1,158666,158229,437
16303921,13.4713,15.6253,434,50290,0.030001,0.01,1,158679,158245,434
16306841,4.29427,12.7251,424,50332,0.0620002,0.03,1,158681,158257,424
16309761,12.0589,14.545,423,50374,0.1004,0.03,1,158695,158272,423
16312681,114.412,114.909,423,50416,0.07608,0.05,1,158835,158412,423
16315601,43.6824,42.9818,424,50458,0.103216,0.07,1,158861,158437,424
16318521,29.5365,28.5964,425,50500,0.140643,0.01,1,158887,158462,425
16321441,17.9073,19.3193,423,50542,0.132129,0.03,1,158902,158479,423
16324361,15.5815,15.0639,424,50584,0.114426,0.03,1,158917,158493,424
16327281,23.9163,23.8128,424,50626,0.0468851,0.01,1,158943,158519,424
16330201,35.9833,36.7626,423,50668,0.00937703,0.03,1,158982,158559,423
16333121,16.7967,16.9525,423,50710,0.00987541,0.05,1,158994,158571,423
16336041,13.7593,13.7905,423,50752,0.0259751,0.03,1,159007,158584,423
16338961,13.9519,13.9581,423,50794,0.045195,0.03,1,159021,158598,423
16341881,23.5904,23.5916,423,50835,0.017039,0.03,1,159047,158624,423
16344801,15.9181,15.9183,423,50876,0.0114078,0.03,1,159061,158638,423
16347721,12.7836,12.7837,423,50917,0.0102816,0.03,1,159073,158650,423
16350641,16.1567,15.3567,424,50958,0.0260563,0.03,1,159090,158666,424
16353561,14.4313,13.4713,425,50999,0.0452113,0.07,1,159104,158679,425
16356481,4.48627,4.29427,425,51040,0.0490423,0.11,1,159106,158681,425
16359401,12.0973,12.0589,425,51081,0.0818085,0.07,1,159120,158695,425
16362321,114.419,114.412,425,51122,0.120362,0.11,1,159260,158835,425
16365241,44.4839,43.6824,426,51163,0.128072,0.15,1,159287,158861,426
16368161,30.4968,29.5365,427,51204,0.113614,0.13,1,159314,158887,427
16371081,17.2994,17.9073,426,51245,0.0787229,0.11,1,159328,158902,426
16374001,14.6599,15.5815,425,51286,0.0717446,0.03,1,159342,158917,425
16376921,22.132,23.9163,423,51327,0.102349,0,1,159366,158943,423
16379841,34.8264,35.9833,422,51368,0.0764698,0.01,1,159404,158982,422
16382761,16.5653,16.7967,422,51409,0.039294,0.03,1,159416,158994,422
16385681,13.7131,13.7593,422,51450,0.0478588,0.05,1,159429,159007,422
16388601,13.9426,13.9519,422,51491,0.0495718,0.01,1,159443,159021,422
16391521,23.5885,23.5904,422,51532,0.0819144,0.01,1,159469,159047,422
16394441,15.9177,15.9181,422,51573,0.0563829,0.01,1,159483,159061,422
16397361,12.7835,12.7836,422,51614,0.0832766,0.03,1,159495,159073,422
16400281,17.7567,16.1567,424,51655,0.0726553,0.05,1,159514,159090,424
16403201,14.7513,14.4313,424,51696,0.0385311,0.05,1,159528,159104,424
16406121,4.55027,4.48627,424,51737,0.0317062,0.09,1,159530,159106,424
16409041,12.9101,12.0973,425,51778,0.0623412,0.09,1,159545,159120,425
16411961,114.582,2.41945,565,51819,0.0684682,0.13,1,159685,159120,565
16414881,44.5164,112.484,452,51860,0.0536936,0.13,1,159712,159260,452
16417801,29.7033,44.0968,451,51901,0.0507387,0.11,1,159738,159287,451
16420721,17.1407,30.4194,438,51942,0.0501477,0.07,1,159752,159314,438
16423641,14.6281,17.2839,438,51983,0.0660295,0.07,1,159766,159328,438
16426561,22.1256,14.6568,448,52024,0.0852059,0.11,1,159790,159342,448
16429481,33.2251,22.1314,460,52064,0.0890412,0.07,1,159826,159366,460
16432401,16.245,34.8263,434,52104,0.0898082,0.03,1,159838,159404,434
16435321,14.449,16.5653,436,52144,0.0899617,0.05,1,159852,159416,436
16438241,14.0898,13.7131,437,52184,0.0899923,0.05,1,159866,159429,437
16441161,23.618,13.9426,449,52224,0.105998,0.09,1,159892,159443,449
16444081,15.9236,23.5885,437,52264,0.1092,0.05,1,159906,159469,437
16447001,12.7847,15.9177,435,52304,0.10984,0.09,1,159918,159483,435
16449921,16.9569,12.7835,441,52344,0.125968,0.07,1,159936,159495,441
16452841,15.3914,17.7567,437,52384,0.145194,0.03,1,159951,159514,437
16455761,4.67828,14.7513,425,52424,0.149039,0.03,1,159953,159528,425
16458681,12.1357,4.55027,437,52464,0.117808,0.07,1,159967,159530,437
16461601,116.027,12.9101,564,52504,0.127562,0.07,1,160109,159545,564
16464521,44.0054,114.582,450,52544,0.145512,0.05,1,160135,159685,450
16467441,29.6011,44.5164,449,52584,0.165102,0.05,1,160161,159712,449
16470361,17.9202,29.7033,438,52624,0.18502,0.05,1,160176,159738,438
16473281,15.584,17.1407,439,52664,0.221004,0.07,1,160191,159752,439
16476201,22.3168,14.6281,449,52704,0.228201,0.09,1,160215,159766,449
16479121,33.2634,22.1256,461,52744,0.22964,0.09,1,160251,159790,461
16482041,16.2527,33.2251,437,52784,0.229928,0.09,1,160263,159826,437
16484961,14.4505,16.245,439,52824,0.229986,0.09,1,160277,159838,439
16487881,14.0901,14.449,439,52864,0.229997,0.09,1,160291,159852,439
16490801,24.418,14.0898,452,52904,0.213999,0.11,1,160318,159866,452
16493721,16.0836,23.618,440,52944,0.2108,0.11,1,160332,159892,440
16496641,13.6167,15.9236,439,52984,0.19416,0.11,1,160345,159906,439
16499561,17.1233,12.7847,445,53024,0.190832,0.13,1,160363,159918,445
16502481,14.6247,16.9569,441,53064,0.190166,0.15,1,160377,159936,441
16505401,4.52493,15.3914,428,53104,0.190033,0.15,1,160379,159951,428
16508321,12.105,4.67828,440,53144,0.190007,0.11,1,160393,159953,440
16511241,116.821,12.1357,569,53184,0.254001,0.13,1,160536,159967,569
16514161,44.9642,116.027,454,53224,0.2828,0.15,1,160563,160109,454
16517081,10.5928,44.0054,430,53264,0.28856,0.17,1,160565,160135,430
16520001,22.9186,29.6011,430,53304,0.321712,0.19,1,160591,160161,430
16522921,17.3837,17.9202,431,53343,0.296342,0.23,1,160607,160176,431
16525841,17.0767,15.584,433,53382,0.307269,0.23,1,160624,160191,433
16528761,22.6153,22.3168,433,53421,0.341454,0.23,1,160648,160215,433
16531681,33.3231,33.2634,433,53460,0.348291,0.23,1,160684,160251,433
16534601,16.2646,16.2527,433,53499,0.349658,0.23,1,160696,160263,433
16537521,14.4529,14.4505,433,53538,0.381932,0.23,1,160710,160277,433
16540441,14.0906,14.0901,433,53577,0.388386,0.21,1,160724,160291,433
16543361,23.6181,24.418,432,53616,0.357677,0.21,1,160750,160318,432
16546281,15.9236,16.0836,432,53655,0.351535,0.19,1,160764,160332,432
16549201,12.7847,13.6167,431,53694,0.366307,0.19,1,160776,160345,431
16552121,16.9569,17.1233,431,53733,0.369261,0.19,1,160794,160363,431
16555041,14.5914,14.6247,431,53772,0.369852,0.19,1,160808,160377,431
16557961,4.51828,4.52493,431,53811,0.36997,0.19,1,160810,160379,431
16560881,12.1037,12.105,431,53850,0.401994,0.27,1,160824,160393,431
16563801,120.021,116.821,435,53889,0.440399,0.29,1,160971,160536,435
16566721,46.4041,44.9642,436,53928,0.44808,0.29,1,160999,160563,436
16569641,10.8808,10.5928,436,53967,0.417616,0.33,1,161001,160565,436
16572561,22.9762,22.9186,436,54006,0.459523,0.29,1,161027,160591,436
16575481,17.3952,17.3837,436,54045,0.451905,0.31,1,161043,160607,436
16578401,18.679,17.0767,438,54084,0.466381,0.35,1,161062,160624,438
16581321,23.7358,22.6153,439,54123,0.469276,0.35,1,161087,160648,439
16584241,33.5472,33.3231,439,54162,0.469855,0.35,1,161123,160684,439
16587161,16.3094,16.2646,439,54201,0.437971,0.39,1,161135,160696,439
16590081,14.4619,14.4529,439,54240,0.431594,0.39,1,161149,160710,439
16593001,14.0924,14.0906,439,54279,0.430319,0.35,1,161163,160724,439
16595921,23.6185,23.6181,439,54318,0.462064,0.35,1,161189,160750,439
16598841,16.7237,15.9236,440,54357,0.452413,0.37,1,161204,160764,440
16601761,12.9447,12.7847,440,54396,0.482483,0.37,1,161216,160776,440
16604681,16.9889,16.9569,440,54435,0.488497,0.37,1,161234,160794,440
16607601,14.5978,14.5914,440,54474,0.457699,0.37,1,161248,160808,440
16610521,4.51956,4.51828,440,54513,0.45154,0.41,1,161250,160810,440
16613441,12.1039,12.1037,440,54552,0.450308,0.45,1,161264,160824,440
16616361,121.621,120.021,442,54591,0.498062,0.45,1,161413,160971,442
16619281,46.7242,46.4041,442,54630,0.475612,0.41,1,161441,160999,442
16622201,10.9448,10.8808,442,54669,0.471122,0.47,1,161443,161001,442
16625121,23.789,22.9762,443,54707,0.470225,0.47,1,161470,161027,443
16628041,17.5578,4.59523,459,54745,0.470045,0.45,1,161486,161027,459
16630961,17.9116,13.719,461,54783,0.470009,0.47,1,161504,161043,461
16633881,23.5823,17.9438,467,54821,0.454002,0.47,1,161529,161062,467
16636801,33.5165,23.5888,478,54859,0.4668,0.47,1,161565,161087,478
16639721,16.3033,33.5178,454,54897,0.46936,0.43,1,161577,161123,454
16642641,14.4607,16.3036,456,54935,0.469872,0.43,1,161591,161135,456
16645561,14.0921,14.4607,456,54973,0.469974,0.43,1,161605,161149,456
16648481,23.6184,14.0921,468,55011,0.469995,0.47,1,161631,161163,468
16651401,17.5237,23.6184,458,55049,0.469999,0.45,1,161647,161189,458
16654321,13.1047,16.7237,455,55087,0.486,0.49,1,161659,161204,455
16657241,17.0209,12.9447,461,55125,0.5052,0.49,1,161677,161216,461
16660161,14.6042,16.9889,457,55163,0.50904,0.45,1,161691,161234,457
16663081,4.52084,14.5978,445,55201,0.509808,0.45,1,161693,161248,445
16666001,12.1042,4.51956,457,55239,0.509962,0.45,1,161707,161250,457
16668921,122.421,12.1039,593,55277,0.541992,0.51,1,161857,161264,593
16671841,47.6842,121.621,473,55315,0.532398,0.47,1,161886,161413,473
16674761,11.1368,46.7242,447,55353,0.53048,0.47,1,161888,161441,447
16677681,23.0274,10.9448,471,55391,0.530096,0.47,1,161914,161443,471
16680601,17.4055,23.789,460,55429,0.530019,0.47,1,161930,161470,460
16683521,17.8811,17.5578,462,55467,0.530004,0.47,1,161948,161486,462
16686441,22.7762,17.9116,468,55505,0.562001,0.45,1,161972,161504,468
16689361,34.1552,23.5823,480,55543,0.5844,0.47,1,162009,161529,480
16692281,16.431,33.5165,456,55581,0.60488,0.47,1,162021,161565,456
16695201,14.4862,16.3033,458,55619,0.608976,0.47,1,162035,161577,458
16698121,14.0972,14.4607,458,55657,0.609795,0.47,1,162049,161591,458
16701041,23.6194,14.0921,470,55695,0.609959,0.47,1,162075,161605,470
16703961,18.3239,23.6184,461,55733,0.625992,0.47,1,162092,161631,461
16706881,14.0648,17.5237,458,55771,0.581198,0.49,1,162105,161647,458
16709801,17.213,13.1047,464,55809,0.60424,0.51,1,162123,161659,464
16712721,14.6426,17.0209,460,55847,0.608848,0.51,1,162137,161677,460
16715641,4.52852,14.6042,448,55885,0.60977,0.51,1,162139,161691,448
16718561,12.1057,4.52084,460,55923,0.609954,0.51,1,162153,161693,460
16721481,124.021,12.1042,598,55961,0.625991,0.55,1,162305,161707,598
16724401,47.2042,122.421,476,55999,0.645198,0.53,1,162333,161857,476
16727321,11.0408,47.6842,449,56037,0.64904,0.53,1,162335,161886,449
16730241,23.0082,11.1368,473,56075,0.649808,0.53,1,162361,161888,473
16733161,17.4016,23.0274,463,56113,0.665962,0.53,1,162377,161914,463
16736081,17.8803,17.4055,465,56150,0.669192,0.53,1,162395,161930,465
16739001,5.17607,17.8811,449,56187,0.669838,0.57,1,162397,161948,449
16741921,21.0352,22.7762,450,56224,0.685968,0.59,1,162422,161972,450
16744841,35.407,34.1552,452,56261,0.721194,0.61,1,162461,162009,452
16747761,16.6814,16.431,452,56298,0.728239,0.61,1,162473,162021,452
16750681,14.5363,14.4862,452,56335,0.761648,0.61,2,162487,162035,452
16753601,14.1073,14.0972,452,56372,0.76833,0.61,2,162501,162049,452
16756521,23.6215,23.6194,452,56409,0.737666,0.63,1,162527,162075,452
16759441,17.5243,18.3239,451,56446,0.731533,0.57,1,162543,162092,451
16762361,14.7049,14.0648,452,56483,0.762307,0.61,2,162557,162105,452
16765281,17.341,17.213,452,56520,0.736461,0.61,1,162575,162123,452
16768201,14.6682,14.6426,452,56557,0.747292,0.61,1,162589,162137,452
16771121,4.53364,4.52852,452,56594,0.749458,0.61,1,162591,162139,452
16774041,12.1067,12.1057,452,56631,0.781892,0.63,2,162605,162153,452
16776961,125.621,124.021,454,56668,0.788378,0.65,2,162759,162305,454
16779881,47.5243,47.2042,454,56705,0.821676,0.65,2,162787,162333,454
16782801,11.1049,11.0408,454,56742,0.828335,0.65,2,162789,162335,454
16785721,23.821,23.0082,455,56779,0.813667,0.67,2,162816,162361,455
16788641,17.5642,17.4016,455,56816,0.810733,0.67,2,162832,162377,455
16791561,17.9128,17.8803,455,56853,0.810147,0.67,2,162850,162395,455
16794481,5.18257,5.17607,455,56890,0.810029,0.69,2,162852,162397,455
16797401,21.8365,21.0352,456,56927,0.810006,0.73,2,162878,162422,456
16800321,37.1673,35.407,458,56964,0.826001,0.73,2,162919,162461,458
16803241,17.0335,16.6814,458,57001,0.8292,0.77,2,162931,162473,458
16806161,14.6067,14.5363,458,57038,0.84584,0.77,2,162945,162487,458
16809081,14.1213,14.1073,458,57075,0.849168,0.73,2,162959,162501,458
16812001,23.6243,23.6215,458,57112,0.881834,0.73,2,162985,162527,458
16814921,17.5249,17.5243,458,57149,0.856367,0.77,2,163001,162543,458
16817841,14.705,14.7049,458,57186,0.851273,0.73,2,163015,162557,458
16820761,18.141,17.341,459,57223,0.866255,0.75,2,163034,162575,459
16823681,14.8282,14.6682,459,57260,0.837251,0.75,2,163048,162589,459
16826601,4.56564,4.53364,459,57297,0.83145,0.79,2,163050,162591,459
16829521,12.1131,12.1067,459,57334,0.83029,0.79,2,163064,162605,459
16832441,127.223,125.621,461,57371,0.846058,0.83,2,163220,162759,461
16835361,47.8445,47.5243,461,57408,0.849212,0.83,2,163248,162787,461
16838281,11.1689,11.1049,461,57445,0.849842,0.81,2,163250,162789,461
16841201,24.6338,23.821,462,57482,0.865968,0.81,2,163278,162816,462
16844121,17.7268,17.5642,462,57519,0.901194,0.81,2,163294,162832,462
16847041,17.9454,17.9128,462,57556,0.924239,0.81,2,163312,162850,462
16849961,5.18907,5.18257,462,57593,0.928848,0.81,2,163314,162852,462
16852881,21.8378,21.8365,462,57630,0.92977,0.81,2,163340,162878,462
16855801,37.1676,4.3673,503,57666,0.881954,0.83,2,163381,162878,503
16858721,17.8335,33.6735,475,57702,0.888391,0.83,2,163394,162919,475
16861641,14.7667,16.3347,477,57738,0.857678,0.85,2,163408,162931,477
16864561,14.1533,14.4669,477,57774,0.867536,0.85,2,163422,162945,477
16867481,23.6307,14.0934,489,57810,0.869507,0.89,2,163448,162959,489
16870401,17.5261,23.6187,479,57846,0.885902,0.85,2,163464,162985,479
16873321,14.7052,17.5237,477,57882,0.88918,0.85,2,163478,163001,477
16876241,17.341,14.7047,481,57918,0.889836,0.87,2,163496,163015,481
16879161,14.6682,18.1409,476,57954,0.889967,0.83,2,163510,163034,476
16882081,4.53364,14.8282,464,57990,0.889993,0.83,2,163512,163048,464
16885001,12.1067,4.56564,476,58026,0.889999,0.83,2,163526,163050,476
16902521,19,16,483,58242,0.93,0.93,2,163777,163294,483
16905441,5.4,17.6,467,58278,0.93,0.93,2,163779,163312,467
16908361,21.88,5.12,491,58314,0.93,0.93,2,163805,163314,491
16911281,36.376,21.824,505,58350,0.93,0.87,2,163845,163340,505
16914201,16.8752,37.1648,476,58386,0.93,0.89,2,163857,163381,476
17147801,13,14,491,61201,0.81,1,2,165765,165274,491
17150721,15.4,13.2,494,61235,0.794,1,2,165781,165287,494
17153641,15.88,17.84,491,61269,0.7668,1,2,165797,165306,491
17156561,13.576,13.968,491,61303,0.73736,1,1,165810,165319,491
17159481,22.7152,17.9936,497,61337,0.699472,1,1,165835,165338,497
17162401,15.743,15.5987,496,61371,0.723894,1,1,165849,165353,496
17165321,15.9486,14.3197,498,61405,0.776779,1,2,165865,165367,498
17168241,15.1897,15.6639,497,61439,0.771356,1,2,165880,165383,497
17171161,16.6379,14.3328,500,61473,0.770271,1,2,165897,165397,500
17174081,15.3276,20.4666,493,61507,0.866054,1,2,165912,165419,493
17177001,109.466,16.8933,610,61541,0.901211,0.97,2,166045,165435,610
17179921,42.6931,112.979,499,61575,0.908242,1,2,166071,165572,499
17182841,24.5386,44.9957,491,61609,0.877648,0.99,2,166091,165600,491
17185761,16.9077,26.5991,484,61643,0.88753,0.98,2,166106,165622,484
17188681,9.78154,18.1198,476,61677,0.889506,0.97,2,166114,165638,476
17191601,13.1563,10.824,481,61711,0.889901,0.94,2,166128,165647,481
17194521,13.0313,14.1648,479,61745,0.87398,0.95,2,166141,165662,479
17197441,18.6063,13.233,486,61779,0.870796,0.93,2,166161,165675,486
17200361,33.3213,18.6466,503,61813,0.854159,0.81,2,166198,165695,503
17203281,16.2643,38.9293,471,61847,0.882832,0.8,2,166210,165739,471
17206201,13.6529,18.1859,471,61881,0.888566,0.81,2,166223,165752,471
17209121,14.7306,14.0372,473,61915,0.873713,0.79,2,166238,165765,473
17212041,14.9461,15.6074,472,61949,0.854743,0.76,2,166253,165781,472
17214961,14.1892,15.9215,470,61983,0.818949,0.73,2,166267,165797,470
17217881,4.43784,13.5843,459,62017,0.81179,0.69,2,166269,165810,459
17220801,16.8876,22.7169,454,62051,0.858358,0.73,2,166289,165835,454
17223721,16.9775,15.7434,457,62085,0.819672,0.79,2,166306,165849,457
17226641,16.1955,15.9487,457,62119,0.811934,0.77,2,166322,165865,457
17229561,15.2391,15.1897,457,62153,0.826387,0.77,2,166337,165880,457
17232481,21.4478,16.6379,463,62187,0.829277,0.89,2,166360,165897,463
17235401,17.0896,15.3276,464,62221,0.797855,0.91,2,166376,165912,464
17238321,110.618,109.466,465,62255,0.871571,0.91,2,166510,166045,465
17241241,41.3236,42.6931,463,62289,0.854314,0.87,2,166534,166071,463
17244161,25.8647,24.5386,465,62323,0.850863,0.89,2,166556,166091,465
17247081,17.9729,16.9077,466,62357,0.882173,0.89,2,166572,166106,466
17250001,9.99459,9.78154,466,62391,0.888435,0.89,2,166580,166114,466
17252921,11.5989,13.1563,464,62425,0.857687,0.87,2,166592,166128,464
17255841,13.5198,13.0313,465,62459,0.883537,0.87,2,166606,166141,465
17258761,18.704,18.6063,465,62493,0.856707,0.85,2,166626,166161,465
17261681,34.1408,33.3213,466,62527,0.899342,0.89,2,166664,166198,466
17264601,15.6282,16.2643,465,62561,0.923868,0.89,2,166675,166210,465
17267521,12.7256,13.6529,464,62595,0.896774,0.87,2,166687,166223,464
17270441,13.7451,14.7306,463,62629,0.923355,0.85,2,166701,166238,463
17273361,13.949,14.9461,462,62663,0.928671,0.81,2,166715,166253,462
17276281,14.7898,14.1892,463,62697,0.913734,0.81,2,166730,166267,463
17279201,4.55796,4.43784,463,62730,0.910747,0.87,2,166732,166269,463
17282121,15.3116,16.8876,461,62763,0.910149,0.81,2,166750,166289,461
17285041,17.4623,16.9775,462,62796,0.92603,0.81,2,166768,166306,462
17320081,20,20,464,63192,0.93,0.91,2,167090,166626,464
17615001,100,16,595,66467,0.55,1,1,169328,168733,595
17617921,53.6,109.6,504,66499,0.454,1,1,169370,168866,504
17620841,25.12,38.72,501,66531,0.3868,1,1,169388,168887,501
17623761,18.624,25.344,496,66563,0.34136,1,1,169405,168909,496
17626681,16.5248,21.8688,491,66595,0.332272,1,1,169421,168930,491
17629601,17.705,21.1738,488,66627,0.314454,1,1,169439,168951,488
17632521,16.341,14.6348,491,66658,0.230891,1,1,169455,168964,491
17635441,23.2682,16.527,499,66689,0.166178,1,1,169480,168981,499
17638361,20.6536,16.1054,503,66720,0.297236,1,1,169500,168997,503
17641281,13.7307,20.0211,494,66751,0.307447,1,1,169512,169018,494
17644201,13.1461,21.6042,485,66782,0.309489,1,1,169525,169040,485
17647121,12.2292,19.5208,478,66813,0.277898,1,1,169537,169059,478
17650041,12.8458,13.5042,479,66844,0.22358,1,1,169550,169071,479
17652961,25.7692,13.9008,494,66875,0.212716,1,1,169579,169085,494
17655881,16.3538,13.9802,494,66906,0.482543,0.96,1,169593,169099,494
17658801,11.2708,14.796,489,66937,0.504509,0.96,1,169603,169114,489
17661721,7.85415,12.5592,484,66968,0.540902,0.95,1,169610,169126,484
17664641,14.3708,8.91184,492,66999,0.53218,1,1,169626,169134,492
17667561,14.0742,18.5824,485,67030,0.594436,1,1,169640,169155,485
17670481,18.0148,15.7165,489,67061,0.590887,1,1,169659,169170,489
17673401,17.203,19.9433,485,67092,0.542177,0.94,1,169676,169191,485
17676321,16.2406,18.3887,483,67123,0.532435,0.87,1,169692,169209,483
17679241,70.4481,18.8777,548,67154,0.498487,0.55,1,169776,169228,548
17682161,41.2896,83.7755,482,67185,0.523697,0.43,1,169810,169328,482
17685081,18.6579,50.3551,453,67216,0.512739,0.37,1,169823,169370,453
17688001,16.5316,24.471,451,67247,0.446548,0.33,1,169839,169388,451
17690921,12.9063,18.4942,446,67278,0.40131,0.33,1,169851,169405,446
17693841,16.1813,16.4988,447,67309,0.392262,0.31,1,169868,169421,447
17696761,16.0363,17.6998,445,67340,0.358452,0.21,1,169884,169439,445
17699681,29.6072,16.34,462,67371,0.27169,0.15,1,169917,169455,462
17702601,21.1214,23.268,456,67402,0.254338,0.33,1,169936,169480,456
17705521,13.0243,20.6536,447,67433,0.266868,0.31,1,169947,169500,447
17708441,10.6049,13.7307,445,67464,0.237374,0.31,1,169957,169512,445
17711361,10.121,13.1461,442,67495,0.231475,0.27,1,169967,169525,442
17714281,12.4242,12.2292,443,67526,0.246295,0.21,1,169980,169537,443
17717201,25.6848,12.8458,459,67557,0.137259,0.21,1,170009,169550,459
17720121,29.137,25.7692,460,67588,0.0514518,0.55,1,170039,169579,460
17723041,14.6274,16.3538,457,67619,0.0502904,0.51,1,170050,169593,457
17725961,10.1255,11.2708,456,67650,0.0660581,0.55,1,170059,169603,456
17728881,14.8251,7.85415,465,67681,0.0372116,0.53,1,170075,169610,465
17731801,14.165,14.3708,463,67712,0.0314423,0.61,1,170089,169626,463
17734721,17.233,14.0742,467,67743,0.0302885,0.59,1,170107,169640,467
17737641,16.2466,18.0148,464,67774,0.0300577,0.53,1,170123,169659,464
17740561,16.0493,17.203,463,67805,0.0300115,0.53,1,170139,169676,463
17743481,70.4099,16.2406,531,67836,0.0460023,0.49,1,170223,169692,531
17746401,15.682,70.4481,449,67867,0.0492005,0.53,1,170225,169776,449
17749321,27.9364,41.2896,446,67898,0.0818401,0.51,1,170256,169810,446
17752241,13.5873,18.6579,443,67929,0.104368,0.43,1,170266,169823,443
17755161,13.9175,16.5316,441,67960,0.140874,0.39,1,170280,169839,441
17758081,11.5835,12.9063,440,67991,0.132175,0.39,1,170291,169851,440
17761001,15.1167,16.1813,439,68022,0.130435,0.35,1,170307,169868,439
17763921,14.2233,16.0363,437,68053,0.130087,0.25,1,170321,169884,437
17766841,27.6447,29.6072,435,68084,0.162017,0.25,1,170352,169917,435
17769761,19.9289,21.1214,434,68115,0.168403,0.27,1,170370,169936,434
17772681,11.9858,13.0243,433,68146,0.137681,0.23,1,170380,169947,433
17775601,10.3972,10.6049,433,68177,0.131536,0.23,1,170390,169957,433
17778521,10.0794,10.121,433,68208,0.130307,0.25,1,170400,169967,433
17781441,11.6159,12.4242,432,68239,0.130061,0.11,1,170412,169980,432
17784361,18.3232,25.6848,423,68270,0.186012,0.03,1,170432,170009,423
17787281,27.6646,29.137,423,68301,0.173202,0.05,1,170462,170039,423
17790201,15.1329,14.6274,424,68332,0.21864,0.07,1,170474,170050,424
17793121,9.42659,10.1255,423,68363,0.195728,0.03,1,170482,170059,423
17796041,14.6853,14.8251,423,68394,0.191146,0.03,1,170498,170075,423
17798961,14.1371,14.165,423,68425,0.190229,0.03,1,170512,170089,423
17801881,17.2274,17.233,423,68456,0.190046,0.03,1,170530,170107,423
17804801,16.2455,16.2466,423,68487,0.222009,0.03,1,170546,170123,423
17807721,16.0491,16.0493,423,68518,0.196402,0.05,1,170562,170139,423
17810641,71.2098,70.4099,424,68549,0.20728,0.05,1,170647,170223,424
17813561,15.842,15.682,424,68580,0.209456,0.09,1,170649,170225,424
17816481,30.3684,27.9364,427,68611,0.241891,0.11,1,170683,170256,427
17819401,14.0737,13.5873,427,68642,0.232378,0.15,1,170693,170266,427
17822321,14.0147,13.9175,427,68673,0.246476,0.13,1,170707,170280,427
17825241,12.4029,11.5835,428,68704,0.249295,0.13,1,170719,170291,428
17828161,15.2806,15.1167,428,68735,0.249859,0.13,1,170735,170307,428
17831081,14.2561,14.2233,428,68766,0.265972,0.17,1,170749,170321,428
17834001,27.6512,27.6447,428,68796,0.285194,0.17,1,170780,170352,428
17836921,19.9302,19.9289,428,68826,0.289039,0.13,1,170798,170370,428
17839841,11.986,11.9858,428,68856,0.257808,0.13,1,170808,170380,428
17842761,10.3972,10.3972,428,68886,0.251562,0.13,1,170818,170390,428
17845681,10.0794,10.0794,428,68916,0.250312,0.13,1,170828,170400,428
17848601,11.6159,11.6159,428,68946,0.250062,0.2,1,170840,170412,428
17851521,19.9232,18.3232,430,68976,0.250012,0.17,1,170862,170432,430
17854441,28.7846,27.6646,431,69006,0.266003,0.23,1,170893,170462,431
17857361,15.3569,15.1329,431,69036,0.3172,0.19,1,170905,170474,431
17860281,9.47139,9.42659,431,69066,0.31144,0.19,1,170913,170482,431
17863201,14.6943,14.6853,431,69096,0.342288,0.19,1,170929,170498,431
17866121,14.1389,14.1371,431,69126,0.348458,0.19,1,170943,170512,431
17869041,17.2278,17.2274,431,69156,0.317692,0.23,1,170961,170530,431
17871961,16.2456,16.2455,431,69186,0.343538,0.19,1,170977,170546,431
17874881,16.0491,16.0491,431,69216,0.316708,0.21,1,170993,170562,431
17877801,72.0098,71.2098,432,69246,0.327342,0.21,1,171079,170647,432
17880721,16.002,15.842,432,69276,0.329468,0.25,1,171081,170649,432
17883641,31.2004,30.3684,433,69306,0.345894,0.25,1,171116,170683,433
17886561,14.2401,6.07368,443,69336,0.317179,0.23,1,171126,170683,443
17889481,14.048,9.21474,447,69366,0.343436,0.25,1,171140,170693,447
17892401,12.4096,13.0429,445,69396,0.348687,0.25,1,171152,170707,445
17895321,16.0819,12.2086,450,69426,0.333737,0.25,1,171169,170719,450
17898241,14.4164,15.2417,448,69456,0.330747,0.27,1,171183,170735,448
17901161,26.8833,14.2483,464,69486,0.346149,0.29,1,171213,170749,464
17904081,19.7767,27.6497,451,69516,0.34923,0.29,1,171231,170780,451
17907001,11.9553,19.9299,443,69546,0.349846,0.25,1,171241,170798,443
17909921,10.3911,11.986,443,69576,0.349969,0.25,1,171251,170808,443
17912841,10.0782,10.3972,443,69606,0.349994,0.25,1,171261,170818,443
17915761,11.6156,10.0794,445,69636,0.349999,0.25,1,171273,170828,445
17918681,19.9231,11.6159,455,69666,0.35,0.25,1,171295,170840,455
17921601,29.5846,19.9232,465,69696,0.35,0.27,1,171327,170862,465
17924521,17.1169,28.7846,448,69726,0.366,0.33,1,171341,170893,448
17927441,9.82338,15.3569,444,69756,0.3692,0.31,1,171349,170905,444
17930361,14.7647,9.47139,452,69786,0.38584,0.35,1,171365,170913,452
17933281,14.1529,14.6943,450,69816,0.389168,0.35,1,171379,170929,450
17936201,17.2306,14.1389,454,69846,0.389834,0.31,1,171397,170943,454
17939121,16.2461,17.2278,452,69876,0.389967,0.35,1,171413,170961,452
17942041,16.0492,16.2456,452,69906,0.389993,0.31,1,171429,170977,452
17944961,72.8098,16.0491,523,69936,0.373999,0.33,1,171516,170993,523
17947881,16.162,72.0098,439,69966,0.3708,0.33,1,171518,171079,439
17950801,30.4324,16.002,471,69996,0.37016,0.35,1,171552,171081,471
17953721,14.8865,31.2004,447,70026,0.386032,0.31,1,171563,171116,447
17956641,14.9773,14.2401,452,70056,0.373206,0.35,1,171578,171126,452
17959561,12.5955,14.048,450,70086,0.386641,0.35,1,171590,171140,450
17962481,15.3191,12.4096,454,70116,0.405328,0.33,1,171606,171152,454
17965401,14.2638,16.0819,451,70146,0.409066,0.33,1,171620,171169,451
17968321,27.6528,14.4164,468,70176,0.441813,0.35,1,171651,171183,468
17971241,19.9306,26.8833,456,70206,0.448363,0.35,1,171669,171213,456
17974161,11.9861,19.7767,448,70236,0.449673,0.35,1,171679,171231,448
17977081,10.3972,11.9553,448,70266,0.449935,0.35,1,171689,171241,448
17980001,10.0794,10.3911,448,70296,0.449987,0.35,1,171699,171251,448
17982921,11.6159,10.0782,450,70326,0.449997,0.35,1,171711,171261,450
17985841,19.9232,11.6156,460,70356,0.449999,0.35,1,171733,171273,460
17988761,30.3846,19.9231,471,70386,0.434,0.35,1,171766,171295,471
17991681,17.2769,29.5846,453,70416,0.4308,0.37,1,171780,171327,453
17994601,10.6554,17.1169,448,70446,0.46216,0.37,1,171789,171341,448
17997521,14.9311,9.82338,456,70476,0.436432,0.39,1,171805,171349,456
18000441,14.1862,14.7647,454,70506,0.431286,0.39,1,171819,171365,454
18003361,17.2372,14.1529,458,70536,0.430257,0.39,1,171837,171379,458
18006281,16.2474,17.2306,456,70566,0.430051,0.39,1,171853,171397,456
18009201,16.0495,16.2461,456,70596,0.43001,0.39,1,171869,171413,456
18012121,72.0099,16.0492,526,70626,0.430002,0.37,1,171955,171429,526
18015041,16.002,72.8098,441,70656,0.43,0.37,1,171957,171516,441
18017961,30.4004,16.162,473,70686,0.43,0.37,1,171991,171518,473
18020881,14.0801,30.4324,449,70716,0.43,0.39,1,172001,171552,449
18023801,15.616,14.8865,454,70746,0.446,0.37,1,172017,171563,454
18026721,4.7232,14.9773,441,70776,0.4492,0.39,1,172019,171578,441
18029641,11.3446,12.5955,442,70806,0.46584,0.41,1,172032,171590,442
18032561,15.0689,15.3191,442,70836,0.517168,0.41,1,172048,171606,442
18035481,14.2138,14.2638,442,70866,0.527434,0.45,1,172062,171620,442
18038401,29.2428,27.6528,444,70896,0.513487,0.45,1,172095,171651,444
18041321,20.2486,19.9306,444,70926,0.542697,0.45,1,172113,171669,444
18044241,12.0497,11.9861,444,70956,0.532539,0.45,1,172123,171679,444
18047161,10.4099,10.3972,444,70986,0.530508,0.45,1,172133,171689,444
18050081,10.082,10.0794,444,71016,0.530102,0.45,1,172143,171699,444
18053001,11.6164,11.6159,444,71046,0.53002,0.45,1,172155,171711,444
18055921,19.9233,19.9232,444,71076,0.578004,0.43,1,172177,171733,444
18058841,29.5847,30.3846,443,71105,0.555601,0.43,1,172209,171766,443
18061761,17.9169,17.2769,444,71134,0.56712,0.47,1,172224,171780,444
18064681,9.98339,10.6554,443,71163,0.537424,0.43,1,172232,171789,443
18067601,14.7967,14.9311,443,71192,0.531485,0.43,1,172248,171805,443
18070521,14.1593,14.1862,443,71221,0.562297,0.43,1,172262,171819,443
18073441,17.2319,17.2372,443,71250,0.568459,0.43,1,172280,171837,443
18076361,16.2464,16.2474,443,71279,0.601692,0.43,1,172296,171853,443
18079281,16.0493,16.0495,443,71308,0.576338,0.43,1,172312,171869,443
18082201,72.0099,72.0099,443,71337,0.587268,0.43,1,172398,171955,443
18085121,16.002,16.002,443,71366,0.589454,0.43,1,172400,171957,443
18088041,30.4004,30.4004,443,71395,0.589891,0.43,1,172434,171991,443
18090961,14.8801,14.0801,444,71424,0.605978,0.45,1,172445,172001,444
18093881,15.776,15.616,444,71453,0.609196,0.45,1,172461,172017,444
18096801,4.7552,4.7232,444,71482,0.641839,0.47,1,172463,172019,444
18099721,12.151,11.3446,445,71511,0.616368,0.53,1,172477,172032,445
18102641,16.0302,15.0689,446,71540,0.643274,0.53,1,172494,172048,446
18105561,14.406,14.2138,446,71569,0.664655,0.51,1,172508,172062,446
18108481,30.0812,29.2428,447,71598,0.700931,0.55,1,172542,172095,447
18111401,21.2162,20.2486,448,71627,0.708186,0.53,1,172561,172113,448
18114321,12.2432,12.0497,448,71656,0.677637,0.53,1,172571,172123,448
18117241,10.4486,10.4099,448,71685,0.671528,0.53,1,172581,172133,448
18120161,10.0897,10.082,448,71714,0.670305,0.53,1,172591,172143,448
18123081,12.4179,11.6164,449,71743,0.686061,0.59,1,172604,172155,449
18126001,20.0836,19.9233,449,71772,0.657212,0.55,1,172626,172177,449
18128921,29.6167,29.5847,449,71801,0.683442,0.57,1,172658,172209,449
18131841,17.1233,17.9169,448,71830,0.688689,0.53,1,172672,172224,448
18134761,9.82467,9.98339,448,71859,0.657738,0.53,1,172680,172232,448
18137681,16.3649,14.7967,450,71888,0.683547,0.57,1,172698,172248,450
18140601,14.473,14.1593,450,71917,0.688709,0.57,1,172712,172262,450
18143521,17.2946,17.2319,450,71946,0.689742,0.61,1,172730,172280,450
18146441,16.2589,16.2464,450,71975,0.705948,0.57,1,172746,172296,450
18149361,16.0518,16.0493,450,72004,0.67719,0.59,1,172762,172312,450
18152281,72.8104,72.0099,451,72033,0.687438,0.59,1,172849,172398,451
18155201,16.1621,16.002,451,72062,0.721488,0.59,1,172851,172400,451
18158121,30.4324,30.4004,451,72091,0.728297,0.61,1,172885,172434,451
18161041,15.6865,14.8801,452,72120,0.69766,0.61,1,172897,172445,452
18163961,15.9373,15.776,452,72149,0.691532,0.65,1,172913,172461,452
18166881,4.78746,4.7552,452,72178,0.706306,0.61,1,172915,172463,452
18169801,12.1575,12.151,452,72207,0.709261,0.61,1,172929,172477,452
18172721,17.6315,2.43021,471,72236,0.693852,0.65,1,172948,172477,471
18175641,14.7263,14.086,468,72265,0.69077,0.67,1,172962,172494,468
18178561,30.1453,14.0172,488,72294,0.706154,0.71,1,172996,172508,488
18181481,21.2291,30.0034,473,72323,0.693231,0.71,1,173015,172542,473
18184401,12.2458,21.2007,464,72352,0.690646,0.67,1,173025,172561,464
18187321,10.4492,12.2401,464,72381,0.690129,0.67,1,173035,172571,464
18190241,10.0898,10.448,464,72410,0.690026,0.67,1,173045,172581,464
18193161,11.618,10.0896,466,72439,0.690005,0.69,1,173057,172591,466
18196081,19.9236,12.4179,475,72468,0.690001,0.65,1,173079,172604,475
18199001,29.5847,20.0836,485,72497,0.69,0.69,1,173111,172626,485
18201921,17.1169,29.6167,467,72526,0.722,0.69,1,173125,172658,467
18204841,9.82339,17.1233,461,72555,0.7284,0.65,1,173133,172672,461
18207761,16.3647,9.82467,471,72584,0.72968,0.69,1,173151,172680,471
18210681,14.4729,16.3649,467,72613,0.729936,0.69,1,173165,172698,467
18213601,17.2946,14.473,471,72642,0.745987,0.69,1,173183,172712,471
18216521,17.0589,17.2946,470,72671,0.781197,0.71,2,173200,172730,470
18219441,16.2118,16.2589,470,72700,0.78824,0.67,2,173216,172746,470
18222361,73.6424,16.0518,542,72729,0.805648,0.69,2,173304,172762,542
18225281,16.3285,72.8104,457,72758,0.80913,0.73,2,173306,172849,457
18228201,30.4657,16.1621,489,72787,0.809826,0.73,2,173340,172851,489
18231121,15.6931,30.4324,467,72816,0.809965,0.69,2,173352,172885,467
18234041,16.7386,15.6865,472,72845,0.793993,0.69,2,173369,172897,472
18236961,4.94773,15.9373,458,72874,0.790799,0.71,2,173371,172913,458
18239881,12.1895,4.78746,470,72903,0.79016,0.71,2,173385,172915,470
18242801,16.8379,12.1575,474,72932,0.790032,0.69,2,173403,172929,474
18245721,15.3676,17.6315,470,72961,0.806006,0.69,2,173418,172948,470
18248641,30.2735,14.7263,490,72990,0.777201,0.71,2,173452,172962,490
18251561,20.4547,30.1453,474,73019,0.78744,0.69,2,173470,172996,474
18254481,12.0909,21.2291,465,73048,0.789488,0.69,2,173480,173015,465
18257401,10.4182,12.2458,465,73077,0.805898,0.69,2,173490,173025,465
18260321,10.0836,10.4492,465,73106,0.82518,0.69,2,173500,173035,465
18263241,11.6167,10.0898,467,73135,0.829036,0.69,2,173512,173045,467
18266161,19.9233,11.618,477,73164,0.829807,0.69,2,173534,173057,477
18269081,31.1847,19.9236,489,73193,0.797961,0.69,2,173568,173079,489
18272001,17.4369,29.5847,471,73222,0.823592,0.73,2,173582,173111,471
18274921,9.88739,17.1169,465,73251,0.828718,0.73,2,173590,173125,465
18277841,16.3775,9.82339,475,73280,0.829744,0.73,2,173608,173133,475
18280761,14.4755,16.3647,471,73309,0.829949,0.73,2,173622,173151,471
18283681,18.8951,14.4729,477,73338,0.82999,0.75,2,173642,173165,477
18286601,18.179,17.2946,477,73367,0.829998,0.79,2,173660,173183,477
18289521,16.4358,17.0589,476,73396,0.83,0.79,2,173676,173200,476
18292441,74.4872,16.2118,549,73425,0.83,0.81,2,173765,173216,549
18295361,16.4974,73.6424,463,73454,0.83,0.81,2,173767,173304,463
18298281,30.4995,16.3285,495,73483,0.83,0.81,2,173801,173306,495
18301201,15.6999,30.4657,473,73512,0.83,0.81,2,173813,173340,473
18304121,15.94,15.6931,477,73540,0.83,0.79,2,173829,173352,477
18307041,4.788,16.7386,462,73568,0.83,0.79,2,173831,173369,462
18309961,12.1576,4.94773,474,73596,0.83,0.79,2,173845,173371,474
18312881,16.8315,12.1895,478,73624,0.83,0.79,2,173863,173385,478
18315801,14.5663,16.8379,474,73652,0.846,0.81,2,173877,173403,474
18318721,30.1133,15.3676,493,73680,0.8492,0.77,2,173911,173418,493
18321641,7.62265,30.2735,461,73708,0.84984,0.79,2,173913,173452,461
18324561,15.9245,20.4547,461,73736,0.881968,0.79,2,173931,173470,461
18327481,11.9849,12.0909,462,73764,0.888394,0.81,2,173942,173480,462
18330401,11.197,10.4182,463,73792,0.905679,0.83,2,173953,173490,463
18333321,10.2394,10.0836,463,73820,0.909136,0.83,2,173963,173500,463
18336241,11.6479,11.6167,463,73848,0.925827,0.83,2,173975,173512,463
18870601,8,13,517,78871,0.86,1,2,177420,176903,517
18873521,8,17.8,506,78898,0.884,1,2,177428,176922,506
18876441,14.4,17.96,504,78925,0.8088,1,2,177444,176940,504
18879361,14.88,17.192,502,78952,0.80976,1,2,177459,176957,502
18882281,17.376,20.2384,499,78978,0.713952,1,1,177477,176978,499
18885201,19.4752,19.2477,500,79004,0.64679,1,1,177497,176997,500
18888121,41.495,19.8495,527,79030,0.473358,1,1,177544,177017,527
18891041,30.699,36.7699,514,79056,0.358672,1,1,177572,177058,514
18893961,22.1398,44.954,487,79082,0.271734,1,1,177592,177105,487
18896881,20.428,24.1908,488,79108,0.174347,1,1,177612,177124,488
18899801,23.2856,17.6382,496,79134,0.0588694,1,1,177636,177140,496
18902721,27.8571,16.3276,509,79160,0.0517739,1,1,177665,177156,509
18905641,21.5714,16.0655,513,79186,0.0103548,1,1,177685,177172,513
18908561,18.7143,33.6131,493,79212,0.330071,1,1,177703,177210,493
18911481,18.1429,22.7226,491,79238,0.370014,1,1,177721,177230,491
18914401,16.4286,18.1445,490,79264,0.354003,1,1,177737,177247,490
18917321,27.2857,18.0289,502,79290,0.334801,1,1,177767,177265,502
18920241,16.6571,16.4058,500,79316,0.33096,0.92,1,177781,177281,500
18923161,8.93143,15.2812,492,79342,0.354192,0.99,1,177788,177296,492
18926081,5.78629,11.0562,487,79368,0.334838,0.97,1,177793,177306,487
18929001,12.3573,8.61125,493,79394,0.346968,1,1,177807,177314,493
18931921,10.4715,16.1222,485,79420,0.317394,1,1,177817,177332,485
18934841,13.2943,11.2244,489,79446,0.343479,1,1,177831,177342,489
18937761,13.0589,15.0449,486,79472,0.316696,0.99,1,177844,177358,486
18940681,13.8118,17.409,482,79498,0.263339,0.91,1,177858,177376,482
18943601,4.36235,17.8818,466,79524,0.252668,0.85,1,177860,177394,466
18946521,14.4725,17.9764,465,79550,0.218534,0.86,1,177877,177412,465
18949441,9.29449,9.99527,465,79576,0.195707,0.89,1,177885,177420,465
18952361,7.4589,8.39905,464,79602,0.175141,0.79,1,177892,177428,464
18955281,11.0918,14.4798,460,79628,0.139028,0.81,1,177904,177444,460
18958201,13.4184,14.896,459,79654,0.163806,0.69,1,177918,177459,459
18961121,14.6837,17.3792,456,79680,0.104761,0.63,1,177933,177477,456
18964041,16.5367,19.4758,453,79706,0.0929522,0.43,1,177950,177497,453
18966961,30.5073,41.4952,440,79732,0.0185904,0.33,1,177984,177544,440
18969881,25.3015,30.699,436,79758,0.0277181,0.25,1,178008,177572,436
18972801,16.2603,22.1398,430,79784,0.0455436,0.15,1,178022,177592,430
18975721,16.0521,20.428,426,79810,0.0171087,0.03,1,178038,177612,426
18978641,20.8104,23.2856,424,79836,0.0594217,0.05,1,178060,177636,424
18981561,25.7621,27.8571,422,79862,0.0358844,0,1,178087,177665,422
18984481,41.9524,21.5714,448,79888,0.0151769,0.41,1,178133,177685,448
18987401,20.3905,18.7143,445,79914,0.0270354,0.38,1,178148,177703,445
18990321,17.6781,18.1429,444,79940,0.0134071,0.35,1,178165,177721,444
18993241,13.9356,16.4286,441,79966,0.0266814,0.33,1,178178,177737,441
18996161,24.3871,27.2857,438,79992,0.0293363,0.33,1,178205,177767,438
18999081,16.0774,16.6571,438,80018,0.0618673,0.36,1,178219,177781,438
19002001,10.4155,8.93143,440,80044,0.0523735,0.33,1,178228,177788,440
19004921,5.2831,5.78629,439,80070,0.0504747,0.35,1,178232,177793,439
19007841,10.6566,12.3573,437,80096,0.0820949,0.31,1,178244,177807,437
19010761,10.1313,10.4715,437,80122,0.056419,0.35,1,178254,177817,437
19013681,12.4263,13.2943,436,80148,0.0672838,0.31,1,178267,177831,436
19016601,11.2853,13.0589,434,80174,0.0534568,0.25,1,178278,177844,434
19019521,11.0571,13.8118,431,80200,0.0666914,0.25,1,178289,177858,431
19022441,3.81141,4.36235,431,80226,0.0693383,0.21,1,178291,177860,431
19025361,12.7623,14.4725,429,80252,0.0538677,0.19,1,178306,177877,429
19028281,8.95246,9.29449,429,80278,0.0827735,0.17,1,178314,177885,429
19031201,6.59049,7.4589,428,80304,0.0565547,0.13,1,178320,177892,428
19034121,10.9181,11.0918,428,80330,0.115311,0.17,1,178332,177904,428
19037041,12.5836,13.4184,427,80356,0.111062,0.09,1,178345,177918,427
19039961,11.3167,14.6837,423,80382,0.0942124,0.09,1,178356,177933,423
19042881,15.8633,16.5367,423,80408,0.0908425,0,1,178373,177950,423
19045801,29.5727,30.5073,422,80434,0.0181685,0.03,1,178406,177984,422
19048721,26.7145,25.3015,424,80460,0.0276337,0.05,1,178432,178008,424
19051641,14.9429,16.2603,422,80486,0.0295267,0.01,1,178444,178022,422
19054561,16.5886,16.0521,423,80512,0.0459053,0.07,1,178461,178038,423
19057481,20.1177,20.8104,422,80538,0.0331811,0.03,1,178482,178060,422
19060401,25.6235,25.7621,422,80564,0.0306362,0.01,1,178509,178087,422
19063321,41.9247,41.9524,422,80590,0.0141272,0.03,1,178555,178133,422
19066241,21.1849,20.3905,423,80616,0.0108254,0.01,1,178571,178148,423
19069161,17.037,17.6781,422,80642,0.0101651,0.03,1,178587,178165,422
19072081,14.6074,13.9356,423,80668,0.058033,0.03,1,178601,178178,423
19075001,24.5215,24.3871,423,80694,0.0196066,0.07,1,178628,178205,423
19077921,16.1043,16.0774,423,80720,0.0439213,0.05,1,178642,178219,423
19080841,11.2209,10.4155,424,80746,0.0487843,0.05,1,178652,178228,424
19083761,5.44417,5.2831,424,80772,0.0497569,0.09,1,178656,178232,424
19086681,10.6888,10.6566,424,80798,0.0659514,0.05,1,178668,178244,424
19089601,10.1378,10.1313,424,80824,0.0691903,0.07,1,178678,178254,424
19092521,11.6276,12.4263,423,80850,0.0698381,0.05,1,178690,178267,423
19095441,11.9255,11.2853,424,80876,0.0699676,0.07,1,178702,178278,424
19098361,10.3851,11.0571,423,80902,0.0699935,0.07,1,178712,178289,423
19101281,3.67702,3.81141,423,80928,0.0699987,0.05,1,178714,178291,423
19104201,13.5354,12.7623,424,80954,0.0699997,0.09,1,178730,178306,424
19107121,9.10708,8.95246,424,80980,0.0699999,0.09,1,178738,178314,424
19110041,7.42142,1.79049,431,81006,0.086,0.05,1,178745,178314,431
19112961,11.0843,5.1581,437,81032,0.0572,0.13,1,178757,178320,437
19115881,11.8169,10.6316,437,81058,0.06744,0.11,1,178769,178332,437
19118801,11.1634,12.5263,435,81084,0.085488,0.09,1,178780,178345,435
19121721,16.6327,11.3053,442,81110,0.0570976,0.09,1,178798,178356,442
19124641,26.5265,15.8611,454,81136,0.0354195,0,1,178827,178373,454
19127561,26.9053,29.5722,448,81162,0.0150839,0.03,1,178854,178406,448
19130481,14.9811,26.7144,434,81188,0.0270168,0.03,1,178866,178432,434
19133401,15.7962,14.9429,438,81214,0.0454034,0.05,1,178882,178444,438
19136321,19.9592,16.5886,442,81240,0.0650807,0.03,1,178903,178461,442
19139241,25.5918,20.1177,448,81266,0.0370161,0.03,1,178930,178482,448
19142161,41.9184,25.6235,467,81292,0.0314032,0.01,1,178976,178509,467
19145081,21.1837,41.9247,437,81318,0.0462806,0.01,1,178992,178555,437
19148001,17.8367,21.1849,438,81344,0.0332561,0.01,1,179009,178571,438
19150921,14.7673,17.037,436,81370,0.0626512,0.07,1,179023,178587,436
19153841,25.3535,14.6074,450,81396,0.0365302,0.01,1,179051,178601,450
19156761,16.2707,24.5215,437,81422,0.0313061,0.05,1,179065,178628,437
19159681,12.0541,16.1043,434,81448,0.0462612,0.05,1,179076,178642,434
19162601,5.61083,11.2209,428,81474,0.0332522,0.05,1,179080,178652,428
19165521,10.7222,5.44417,436,81500,0.0306504,0.07,1,179092,178656,436
19168441,10.1444,10.6888,434,81526,0.0301301,0.07,1,179102,178668,434
19171361,11.6289,10.1378,436,81552,0.030026,0.07,1,179114,178678,436
19174281,11.9258,11.6276,436,81578,0.0300052,0.07,1,179126,178690,436
19177201,10.3852,11.9255,434,81604,0.030001,0.07,1,179136,178702,434
19180121,3.67703,10.3851,426,81630,0.0300002,0.07,1,179138,178712,426
19183041,13.5354,3.67702,440,81656,0.03,0.07,1,179154,178714,440
19185961,9.10708,13.5354,432,81682,0.03,0.07,1,179162,178730,432
19188881,6.62142,9.10708,430,81708,0.03,0.09,1,179168,178738,430
19191801,11.7243,7.42142,436,81734,0.046,0.05,1,179181,178745,436
19194721,11.9449,11.0843,436,81760,0.0652,0.07,1,179193,178757,436
19197641,10.389,11.8169,434,81786,0.08504,0.09,1,179203,178769,434
19200561,16.4778,11.1634,441,81812,0.089008,0.05,1,179221,178780,441
19203481,25.6956,16.6327,451,81838,0.105802,0.03,1,179249,178798,451
19206401,26.7391,26.5265,449,81864,0.0611603,0.01,1,179276,178827,449
19209321,15.7478,26.9053,435,81890,0.0682321,0.03,1,179289,178854,435
19212241,15.9496,14.9811,439,81916,0.0376464,0.05,1,179305,178866,439
19215161,18.3899,15.7962,442,81942,0.0475293,0.07,1,179324,178882,442
19218081,25.278,19.9592,448,81968,0.0335059,0.03,1,179351,178903,448
19221001,41.8556,25.5918,467,81994,0.0147012,0.03,1,179397,178930,467
19223921,22.7711,41.9184,439,82019,0.0109402,0.05,1,179415,178976,439
19226841,18.9542,21.1837,441,82044,0.026188,0.03,1,179433,178992,441
19229761,14.9908,17.8367,438,82069,0.0292376,0.07,1,179447,179009,438
19232681,23.7982,14.7673,450,82094,0.0458475,0.03,1,179473,179023,450
19235601,15.9596,25.3535,436,82119,0.0331695,0.03,1,179487,179051,436
19238521,11.9919,16.2707,433,82144,0.0466339,0.05,1,179498,179065,433
19241441,5.59839,12.0541,426,82169,0.0173268,0.03,1,179502,179076,426
19244361,10.7197,5.61083,434,82194,0.0114654,0.03,1,179514,179080,434
19247281,10.1439,10.7222,432,82219,0.0262931,0.03,1,179524,179092,432
19250201,11.6288,10.1444,434,82244,0.0292586,0.03,1,179536,179102,434
19253121,11.9258,11.6289,434,82269,0.0298517,0.03,1,179548,179114,434
19256041,10.3852,11.9258,432,82294,0.0299703,0.03,1,179558,179126,432
19258961,3.67703,10.3852,424,82319,0.0299941,0.03,1,179560,179136,424
19261881,13.5354,3.67703,438,82344,0.0299988,0.03,1,179576,179138,438
19264801,9.10708,13.5354,430,82369,0.0299998,0.03,1,179584,179154,430
19267721,6.62142,9.10708,428,82394,0.03,0.03,1,179590,179162,428
19270641,12.5243,6.62142,436,82419,0.03,0.05,1,179604,179168,436
19273561,4.10486,11.7243,425,82444,0.03,0.07,1,179606,179181,425
19276481,11.221,11.9449,426,82469,0.046,0.09,1,179619,179193,426
19279401,10.2442,10.389,426,82494,0.0492,0.09,1,179629,179203,426
19282321,16.4488,16.4778,426,82519,0.04984,0.11,1,179647,179221,426
19285241,24.8898,25.6956,425,82544,0.113968,0.05,1,179674,179249,425
19288161,25.778,26.7391,424,82569,0.126794,0.07,1,179700,179276,424
19291081,14.7556,15.7478,423,82594,0.0973587,0.03,1,179712,179289,423
19294001,15.7511,15.9496,423,82619,0.123472,0.05,1,179728,179305,423
19296921,17.5502,18.3899,422,82644,0.144694,0.03,1,179746,179324,422
19299841,25.11,25.278,422,82669,0.0689389,0.01,1,179773,179351,422
19302761,41.822,41.8556,422,82694,0.0217878,0.01,1,179819,179397,422
19305681,23.5644,22.7711,423,82719,0.0123576,0.03,1,179838,179415,423
19308601,19.1129,18.9542,423,82744,0.0424715,0.03,1,179856,179433,423
19311521,15.8226,14.9908,424,82769,0.0324943,0.05,1,179871,179447,424
19314441,23.1645,23.7982,423,82794,0.0304989,0.03,1,179896,179473,423
19317361,15.8329,15.9596,423,82819,0.0460998,0.05,1,179910,179487,423
19320281,11.1666,11.9919,422,82844,0.03322,0.01,1,179920,179498,422
19323201,5.43332,5.59839,422,82869,0.062644,0.01,1,179924,179502,422
19326121,11.4867,10.7197,423,82894,0.0525288,0.03,1,179937,179514,423
19329041,10.2973,10.1439,423,82919,0.0505058,0.03,1,179947,179524,423
19331961,11.6595,11.6288,423,82944,0.0661011,0.03,1,179959,179536,423
19334881,11.9319,11.9258,423,82969,0.0692202,0.03,1,179971,179548,423
19337801,10.3864,10.3852,423,82994,0.069844,0.03,1,179981,179558,423
19340721,3.67728,3.67703,423,83019,0.0699688,0.03,1,179983,179560,423
19343641,13.5355,13.5354,423,83044,0.0699938,0.03,1,179999,179576,423
19346561,9.10709,9.10708,423,83069,0.101999,0.03,1,180007,179584,423
19349481,6.62142,6.62142,423,83094,0.0763998,0.03,1,180013,179590,423
19352401,12.5243,12.5243,423,83119,0.07128,0.03,1,180027,179604,423
19355321,4.10486,4.10486,423,83144,0.070256,0.05,1,180029,179606,423
19358241,12.021,11.221,424,83169,0.102051,0.05,1,180043,179619,424
19361161,10.4042,10.2442,424,83194,0.0764102,0.05,1,180053,179629,424
19364081,17.2808,16.4488,425,83219,0.087282,0.13,1,180072,179647,425
19367001,25.8562,24.8898,426,83244,0.0734564,0.13,1,180100,179674,426
19369921,25.9712,25.778,426,83269,0.118691,0.09,1,180126,179700,426
19372841,14.7942,14.7556,426,83294,0.111738,0.13,1,180138,179712,426
19375761,15.7588,15.7511,426,83319,0.142348,0.15,1,180154,179728,426
19378681,18.3518,17.5502,427,83344,0.14847,0.05,1,180173,179746,427
19381601,21.2704,25.11,422,83369,0.149694,0.01,1,180195,179773,422
19384521,41.0541,41.822,422,83394,0.0699388,0.01,1,180241,179819,422
19387441,23.4108,23.5644,422,83419,0.0219878,0.05,1,180260,179838,422
19390361,19.0822,19.1129,422,83444,0.0123976,0.03,1,180278,179856,422
19393281,15.8164,15.8226,422,83469,0.0264795,0.03,1,180293,179871,422
19396201,23.1633,23.1645,422,83494,0.0292959,0.05,1,180318,179896,422
19399121,16.6327,15.8329,423,83519,0.0298592,0.03,1,180333,179910,423
19402041,11.3265,11.1666,423,83544,0.0299718,0.07,1,180343,179920,423
19404961,5.46531,5.43332,423,83569,0.0299944,0.05,1,180347,179924,423
19407881,12.2931,11.4867,424,83594,0.0299989,0.05,1,180361,179937,424
19410801,11.2586,10.2973,425,83619,0.0459998,0.07,1,180372,179947,425
19413721,11.8517,11.6595,425,83644,0.0492,0.07,1,180384,179959,425
19416641,11.9703,11.9319,425,83669,0.06584,0.07,1,180396,179971,425
19419561,10.3941,10.3864,425,83694,0.069168,0.07,1,180406,179981,425
19422481,3.67881,3.67728,425,83719,0.0698336,0.07,1,180408,179983,425
19425401,13.5358,13.5355,425,83744,0.0699667,0.11,1,180424,179999,425
19428321,9.10715,9.10709,425,83769,0.0699933,0.07,1,180432,180007,425
19431241,6.62143,6.62142,425,83794,0.0699987,0.07,1,180438,180013,425
19434161,12.5243,12.5243,425,83819,0.102,0.07,1,180452,180027,425
19437081,4.10486,4.10486,425,83844,0.0763999,0.11,1,180454,180029,425
19440001,12.021,12.021,425,83869,0.07128,0.07,1,180468,180043,425
19442921,10.4042,10.4042,425,83894,0.070256,0.09,1,180478,180053,425
19445841,16.4808,17.2808,424,83919,0.102051,0.09,1,180496,180072,424
19448761,25.6962,3.45617,452,83944,0.0764102,0.07,1,180524,180072,452
19451681,27.5392,23.0912,452,83969,0.055282,0.13,1,180552,180100,452
19454601,15.1078,25.4182,438,83994,0.0510564,0.11,1,180564,180126,438
19457521,16.6216,14.6836,443,84019,0.0502113,0.15,1,180581,180138,443
19460441,19.3243,15.7367,447,84044,0.0500423,0.15,1,180601,180154,447
19463361,20.6649,18.3473,449,84069,0.0500084,0.15,1,180622,180173,449
19466281,36.133,21.2695,467,84094,0.0500017,0.05,1,180662,180195,467
19469201,22.4266,41.0539,440,84119,0.0340003,0.01,1,180681,180241,440
19472121,18.8853,23.4108,439,84144,0.0308001,0.01,1,180699,180260,439
19475041,15.7771,19.0822,436,84169,0.04616,0.03,1,180714,180278,436
19477961,23.1554,15.8164,446,84194,0.017232,0.03,1,180739,180293,446
19480881,17.4311,23.1633,437,84219,0.0274464,0.03,1,180755,180318,437
19483801,11.4862,16.6327,432,84244,0.0294893,0.03,1,180765,180333,432
19486721,5.49724,11.3265,426,84269,0.0298979,0.03,1,180769,180343,426
19489641,12.2994,5.46531,436,84294,0.0459796,0.03,1,180783,180347,436
19492561,12.0599,12.2931,434,84319,0.0491959,0.05,1,180795,180361,434
19495481,12.812,11.2586,436,84344,0.0658392,0.05,1,180808,180372,436
19498401,12.1624,11.8517,436,84369,0.0531678,0.07,1,180820,180384,436
19501321,10.4325,11.9703,434,84394,0.0506336,0.07,1,180830,180396,434
19504241,3.6865,10.3941,426,84419,0.0501267,0.07,1,180832,180406,426
19507161,13.5373,3.67881,440,84444,0.0500253,0.07,1,180848,180408,440
19510081,9.10746,13.5358,432,84469,0.0500051,0.07,1,180856,180424,432
19513001,6.62149,9.10715,430,84494,0.050001,0.07,1,180862,180432,430
19515921,12.5243,6.62143,438,84519,0.0500002,0.11,1,180876,180438,438
19518841,4.10486,12.5243,426,84544,0.05,0.07,1,180878,180452,426
19521761,12.021,4.10486,438,84569,0.05,0.07,1,180892,180454,438
19524681,10.4042,12.021,434,84594,0.05,0.07,1,180902,180468,434
19527601,16.4808,10.4042,442,84619,0.05,0.11,1,180920,180478,442
19530521,26.4962,16.4808,453,84644,0.066,0.07,1,180949,180496,453
19533441,26.0992,25.6962,451,84669,0.0692,0.05,1,180975,180524,451
19536361,14.8198,27.5392,435,84694,0.08584,0.05,1,180987,180552,435
19539281,16.564,15.1078,440,84719,0.121168,0.05,1,181004,180564,440
19542201,20.1128,16.6216,444,84744,0.128234,0.05,1,181025,180581,444
19545121,20.0226,19.3243,444,84769,0.129647,0.05,1,181045,180601,444
19548041,36.0045,20.6649,463,84794,0.129929,0.05,1,181085,180622,463
19550961,20.8009,36.133,440,84819,0.145986,0.03,1,181102,180662,440
19553881,19.3602,22.4266,440,84844,0.101197,0.03,1,181121,180681,440
19556801,15.072,18.8853,436,84869,0.0922394,0.05,1,181135,180699,436
19559721,23.0144,15.7771,446,84894,0.0744479,0.01,1,181160,180714,446
19562641,18.2029,23.1554,438,84919,0.0548896,0.03,1,181177,180739,438
19565561,11.6406,17.4311,432,84944,0.0509779,0.03,1,181187,180755,432
19568481,6.32812,11.4862,427,84969,0.0661956,0.03,1,181192,180765,427
19571401,12.4656,5.49724,437,84994,0.0372391,0.05,1,181206,180769,437
19574321,12.0931,12.2994,435,85019,0.0314478,0.05,1,181218,180783,435
19577241,12.8186,12.0599,436,85044,0.0462896,0.07,1,181231,180795,436
19580161,12.1637,12.812,435,85069,0.0492579,0.05,1,181243,180808,435
19583081,10.4327,12.1624,433,85094,0.0498516,0.05,1,181253,180820,433
19586001,3.68655,10.4325,425,85119,0.0499703,0.05,1,181255,180830,425
19588921,13.5373,3.6865,439,85144,0.0499941,0.05,1,181271,180832,439
19591841,9.10746,13.5373,431,85169,0.0659988,0.05,1,181279,180848,431
19594761,6.62149,9.10746,429,85194,0.0691998,0.05,1,181285,180856,429
19597681,12.5243,6.62149,437,85219,0.0698399,0.05,1,181299,180862,437
19600601,4.10486,12.5243,425,85244,0.069968,0.05,1,181301,180876,425
19603521,12.021,4.10486,437,85269,0.0859936,0.05,1,181315,180878,437
19606441,10.4042,12.021,433,85293,0.0891987,0.05,1,181325,180892,433
19609361,16.4808,10.4042,441,85317,0.0898397,0.05,1,181343,180902,441
19612281,27.2962,16.4808,453,85341,0.0899679,0.07,1,181373,180920,453
19615201,26.2592,26.4962,450,85365,0.0899936,0.07,1,181399,180949,450
19618121,6.85185,26.0992,426,85389,0.0899987,0.09,1,181401,180975,426
19621041,10.9704,14.8198,426,85413,0.138,0.13,1,181413,180987,426
19623961,18.1941,16.564,429,85437,0.1636,0.13,1,181433,181004,429
19626881,19.6388,20.1128,428,85461,0.20072,0.13,1,181453,181025,428
19629801,19.9278,20.0226,428,85485,0.208144,0.13,1,181473,181045,428
19632721,35.9856,36.0045,428,85509,0.193629,0.15,1,181513,181085,428
19635641,19.9971,20.8009,427,85533,0.222726,0.09,1,181529,181102,427
19638561,18.3994,19.3602,426,85557,0.228545,0.09,1,181547,181121,426
19641481,14.8799,15.072,426,85581,0.197709,0.07,1,181561,181135,426
19644401,22.176,23.0144,425,85605,0.223542,0.05,1,181585,181160,425
19647321,17.2352,18.2029,424,85629,0.196708,0.05,1,181601,181177,424
19650241,11.447,11.6406,424,85653,0.191342,0.07,1,181611,181187,424
19653161,5.48941,6.32812,423,85677,0.222268,0.03,1,181615,181192,423
19656081,12.2979,12.4656,423,85701,0.228454,0.03,1,181629,181206,423
19659001,12.0596,12.0931,423,85725,0.213691,0.05,1,181641,181218,423
19661921,13.6119,12.8186,424,85749,0.210738,0.05,1,181655,181231,424
19664841,12.3224,12.1637,424,85773,0.178148,0.05,1,181667,181243,424
19667761,10.4645,10.4327,424,85797,0.17163,0.05,1,181677,181253,424
19670681,3.6929,3.68655,424,85821,0.170326,0.05,1,181679,181255,424
19673601,14.3386,13.5373,425,85845,0.186065,0.07,1,181696,181271,425
19676521,9.26772,9.10746,425,85869,0.237213,0.07,1,181704,181279,425
19679441,6.65354,6.62149,425,85893,0.215443,0.07,1,181710,181285,425
19682361,12.5307,12.5243,425,85917,0.211089,0.07,1,181724,181299,425
19685281,4.10614,4.10486,425,85941,0.210218,0.09,1,181726,181301,425
19688201,12.8212,12.021,426,85965,0.258044,0.09,1,181741,181315,426
19691121,10.5642,10.4042,426,85989,0.235609,0.09,1,181751,181325,426
19694041,16.5128,16.4808,426,86013,0.231122,0.09,1,181769,181343,426
19696961,27.3026,27.2962,426,86037,0.230224,0.09,1,181799,181373,426
19699881,27.0605,26.2592,427,86061,0.246045,0.09,1,181826,181399,427
19702801,7.0121,6.85185,427,86085,0.249209,0.15,1,181828,181401,427
19705721,11.0024,10.9704,427,86109,0.217842,0.17,1,181840,181413,427
19708641,20.6005,18.1941,430,86133,0.227568,0.21,1,181863,181433,430
19711561,20.1201,19.6388,430,86157,0.245514,0.21,1,181883,181453,430
19714481,20.024,19.9278,430,86181,0.265103,0.19,1,181903,181473,430
19717401,36.8048,35.9856,431,86205,0.285021,0.23,1,181944,181513,431
19720321,20.161,19.9971,431,86229,0.273004,0.23,1,181960,181529,431
19723241,18.4322,18.3994,431,86253,0.270601,0.19,1,181978,181547,431
19726161,14.8864,14.8799,431,86277,0.30212,0.23,1,181992,181561,431
19729081,22.1773,22.176,431,86301,0.276424,0.19,1,182016,181585,431
19732001,17.2355,17.2352,431,86325,0.303285,0.19,1,182032,181601,431
19734921,11.4471,11.447,431,86349,0.276657,0.23,1,182042,181611,431
19737841,5.48942,5.48941,431,86373,0.271331,0.23,1,182046,181615,431
19740761,13.0979,12.2979,432,86397,0.286266,0.21,1,182061,181629,432
19743681,12.2196,12.0596,432,86421,0.289253,0.21,1,182073,181641,432
19746601,12.0439,13.6119,430,86445,0.289851,0.17,1,182085,181655,430
19749521,12.0088,12.3224,430,86469,0.28997,0.17,1,182097,181667,430
19752441,10.4018,10.4645,430,86493,0.289994,0.17,1,182107,181677,430
19755361,3.68035,3.6929,430,86517,0.289999,0.19,1,182109,181679,430
19758281,15.9361,14.3386,432,86541,0.306,0.25,1,182128,181696,432
19761201,9.58721,9.26772,432,86565,0.3252,0.21,1,182136,181704,432
19764121,6.71744,6.65354,432,86589,0.32904,0.21,1,182142,181710,432
19767041,12.5435,12.5307,432,86613,0.361808,0.21,1,182156,181724,432
19769961,4.1087,4.10614,432,86637,0.336362,0.27,1,182158,181726,432
19772881,13.6217,12.8212,433,86661,0.331272,0.23,1,182174,181741,433
19775801,10.7243,10.5642,433,86685,0.346254,0.23,1,182184,181751,433
19778721,16.5449,16.5128,433,86709,0.397251,0.23,1,182202,181769,433
19781641,27.309,27.3026,433,86733,0.37545,0.25,1,182232,181799,433
19784561,26.2618,27.0605,432,86757,0.37109,0.25,1,182258,181826,432
19787481,6.85236,7.0121,432,86781,0.370218,0.21,1,182260,181828,432
19790401,10.9705,11.0024,432,86805,0.370044,0.23,1,182272,181840,432
19793321,19.7941,20.6005,431,86829,0.370009,0.23,1,182294,181863,431
19796241,19.9588,4.1201,451,86853,0.370002,0.25,1,182314,181863,451
19799161,20.7918,16.824,452,86877,0.37,0.27,1,182335,181883,452
19802081,38.5584,19.3648,475,86901,0.386,0.29,1,182378,181903,475
19805001,20.5117,36.673,450,86925,0.3572,0.27,1,182394,181944,450
19807921,18.5023,20.1346,452,86949,0.36744,0.27,1,182412,181960,452
19810841,14.9005,18.4269,448,86973,0.369488,0.31,1,182426,181978,448
19813761,22.1801,14.8854,458,86997,0.369898,0.27,1,182450,181992,458
19816681,17.236,22.1771,450,87021,0.36998,0.31,1,182466,182016,450
19819601,11.4472,17.2354,444,87045,0.369996,0.27,1,182476,182032,444
19822521,5.48944,11.4471,438,87069,0.369999,0.27,1,182480,182042,438
19825441,13.8979,5.48942,450,87093,0.37,0.29,1,182496,182046,450
19828361,12.3796,13.0979,447,87117,0.37,0.29,1,182508,182061,447
19831281,12.0759,12.2196,447,87141,0.386,0.29,1,182520,182073,447
19834201,12.0152,12.0439,447,87165,0.3892,0.29,1,182532,182085,447
19837121,10.403,12.0088,445,87189,0.38984,0.29,1,182542,182097,445
19840041,3.68061,10.4018,437,87213,0.389968,0.29,1,182544,182107,437
19842961,17.5361,3.68035,456,87237,0.373994,0.31,1,182565,182109,456
19845881,9.90722,15.9361,445,87261,0.402799,0.33,1,182573,182128,445
19848801,6.78144,9.58721,443,87285,0.40856,0.33,1,182579,182136,443
19851721,12.5563,6.71744,451,87309,0.409712,0.37,1,182593,182142,451
19854641,4.11126,12.5435,439,87333,0.409942,0.33,1,182595,182156,439
19857561,14.4223,4.1087,454,87357,0.393988,0.33,1,182612,182158,454
19860481,10.8845,13.6217,448,87381,0.390798,0.35,1,182622,182174,448
19863401,17.3769,10.7243,457,87405,0.39016,0.41,1,182641,182184,457
19866321,27.4754,16.5449,469,87429,0.390032,0.37,1,182671,182202,469
19869241,26.2951,27.309,465,87453,0.390006,0.37,1,182697,182232,465
19872161,6.85901,26.2618,441,87477,0.390001,0.37,1,182699,182258,441
19875081,10.9718,6.85236,451,87501,0.39,0.37,1,182711,182260,451
19878001,19.7944,10.9705,461,87525,0.39,0.37,1,182733,182272,461
19880921,19.9589,19.7941,459,87549,0.39,0.37,1,182753,182294,459
19883841,20.7918,19.9588,460,87573,0.406,0.37,1,182774,182314,460
19886761,37.7584,20.7918,481,87597,0.4092,0.39,1,182816,182335,481
19889681,21.1517,38.5584,455,87621,0.42584,0.35,1,182833,182378,455
19892601,18.6303,20.5117,457,87645,0.429168,0.37,1,182851,182394,457
19895521,14.9261,18.5023,453,87669,0.429834,0.37,1,182865,182412,453
19898441,22.1852,14.9005,463,87693,0.445967,0.37,1,182889,182426,463
19901361,17.237,22.1801,455,87717,0.449193,0.37,1,182905,182450,455
19904281,11.4474,17.236,449,87741,0.449839,0.37,1,182915,182466,449
19907201,5.48948,11.4472,443,87765,0.449968,0.37,1,182919,182476,443
19910121,13.8979,5.48944,455,87789,0.449994,0.37,1,182935,182480,455
19913041,13.1796,13.8979,452,87813,0.465999,0.37,1,182948,182496,452
19915961,12.2359,12.3796,452,87837,0.4372,0.39,1,182960,182508,452
19918881,12.0472,12.0759,452,87861,0.43144,0.39,1,182972,182520,452
19921801,10.4094,12.0152,450,87885,0.430288,0.39,1,182982,182532,450
19924721,3.68189,10.403,442,87909,0.430058,0.39,1,182984,182542,442
19927641,18.3364,3.68061,462,87933,0.430012,0.37,1,183006,182544,462
19930561,10.0673,17.5361,449,87957,0.430002,0.41,1,183014,182565,449
19933481,6.81346,9.90722,447,87981,0.43,0.41,1,183020,182573,447
19936401,12.5627,6.78144,455,88005,0.43,0.41,1,183034,182579,455
19939321,4.11254,12.5563,443,88029,0.43,0.41,1,183036,182593,443
19942241,13.6225,4.11126,457,88053,0.446,0.39,1,183052,182595,457
19945161,11.5245,14.4223,451,88077,0.4652,0.39,1,183063,182612,451
19948081,16.7049,10.8845,459,88101,0.43704,0.39,1,183081,182622,459
19951001,27.341,17.3769,470,88125,0.447408,0.39,1,183111,182641,470
19953921,26.2682,27.4754,466,88149,0.449482,0.39,1,183137,182671,466
19956841,6.85364,26.2951,442,88173,0.449896,0.39,1,183139,182697,442
19959761,10.9707,6.85901,452,88197,0.465979,0.39,1,183151,182699,452
19962681,19.7941,10.9718,462,88221,0.485196,0.39,1,183173,182711,462
19965601,19.9588,19.7944,460,88245,0.489039,0.39,1,183193,182733,460
19968521,21.5918,19.9589,462,88269,0.489808,0.41,1,183215,182753,462
19971441,38.7184,20.7918,484,88293,0.473962,0.41,1,183258,182774,484
19974361,9.34367,37.7584,444,88317,0.486792,0.43,1,183260,182816,444
19977281,14.6687,21.1517,443,88341,0.553358,0.43,1,183276,182833,443
19980201,17.3337,18.6303,443,88365,0.566672,0.43,1,183294,182851,443
19983121,15.4667,14.9261,444,88389,0.553334,0.45,1,183309,182865,444
19986041,22.2934,22.1852,444,88413,0.598667,0.45,1,183333,182889,444
19988961,17.2587,17.237,444,88437,0.575733,0.45,1,183349,182905,444
19991881,11.4517,11.4474,444,88461,0.571147,0.45,1,183359,182915,444
19994801,5.49035,5.48948,444,88485,0.602229,0.45,1,183363,182919,444
19997721,13.8981,13.8979,444,88509,0.608446,0.47,1,183379,182935,444
20000641,12.3796,13.1796,443,88533,0.577689,0.43,1,183391,182948,443
20003561,12.0759,12.2359,443,88557,0.571538,0.43,1,183403,182960,443
20006481,12.0152,12.0472,443,88581,0.570308,0.43,1,183415,182972,443
20009401,10.403,10.4094,443,88605,0.570062,0.43,1,183425,182982,443
20012321,3.68061,3.68189,443,88629,0.570012,0.43,1,183427,182984,443
20015241,18.3361,18.3364,443,88653,0.602002,0.43,1,183449,183006,443
20018161,10.0672,10.0673,443,88677,0.6084,0.43,1,183457,183014,443
20021081,6.81344,6.81346,443,88701,0.57768,0.43,1,183463,183020,443
20024001,13.3627,12.5627,444,88725,0.587536,0.43,1,183478,183034,444
20026921,4.27254,4.11254,444,88749,0.589507,0.45,1,183480,183036,444
20029841,13.6545,13.6225,444,88773,0.589901,0.47,1,183496,183052,444
20032761,10.7309,11.5245,443,88797,0.55798,0.43,1,183506,183063,443
20035681,17.3462,16.7049,444,88821,0.567596,0.45,1,183525,183081,444
20038601,27.4692,27.341,444,88844,0.585519,0.45,1,183555,183111,444
20041521,27.0938,26.2682,445,88867,0.605104,0.45,1,183582,183137,445
20044441,7.01877,6.85364,445,88890,0.609021,0.47,1,183584,183139,445
20047361,11.8038,10.9707,446,88913,0.625804,0.49,1,183597,183151,446
20050281,19.9608,19.7941,446,88936,0.645161,0.49,1,183619,183173,446
20053201,19.9921,19.9588,446,88959,0.649032,0.49,1,183639,183193,446
20056121,21.5984,21.5918,446,88982,0.649806,0.47,1,183661,183215,446
20059041,40.3197,38.7184,448,89005,0.633961,0.49,1,183706,183258,448
20061961,9.66394,9.34367,448,89028,0.630792,0.57,1,183708,183260,448
20064881,14.7328,14.6687,448,89051,0.630158,0.57,1,183724,183276,448
20067801,17.3466,17.3337,448,89074,0.614032,0.55,1,183742,183294,448
20070721,17.0693,15.4667,450,89097,0.642806,0.61,1,183759,183309,450
20073641,22.6139,22.2934,450,89120,0.648561,0.57,1,183783,183333,450
20076561,17.3228,17.2587,450,89143,0.697712,0.57,1,183799,183349,450
20079481,11.4646,11.4517,450,89166,0.675542,0.61,1,183809,183359,450
20082401,5.49291,5.49035,450,89189,0.671108,0.61,1,183813,183363,450
20085321,13.8986,13.8981,450,89212,0.670222,0.57,1,183829,183379,450
20088241,12.3797,12.3796,450,89235,0.670044,0.57,1,183841,183391,450
20091161,12.0759,12.0759,450,89258,0.670009,0.57,1,183853,183403,450
20094081,12.0152,12.0152,450,89281,0.670002,0.57,1,183865,183415,450
20097001,10.403,10.403,450,89304,0.67,0.57,1,183875,183425,450
20099921,3.68061,3.68061,450,89327,0.67,0.61,1,183877,183427,450
20102841,18.3361,18.3361,450,89350,0.67,0.61,1,183899,183449,450
20105761,10.0672,10.0672,450,89373,0.702,0.57,1,183907,183457,450
20108681,6.81344,6.81344,450,89396,0.6764,0.59,1,183913,183463,450
20111601,12.5627,13.3627,449,89419,0.70328,0.59,1,183927,183478,449
20114521,4.11254,4.27254,449,89442,0.676656,0.59,1,183929,183480,449
20117441,13.6225,13.6545,449,89465,0.671331,0.55,1,183945,183496,449
20120361,10.7245,10.7309,449,89488,0.670266,0.57,1,183955,183506,449
20123281,18.1449,17.3462,450,89511,0.718053,0.59,1,183975,183525,450
20126201,28.429,27.4692,451,89534,0.727611,0.61,1,184006,183555,451
20129121,28.0858,27.0938,452,89557,0.729522,0.61,1,184034,183582,452
20132041,7.21716,7.01877,452,89580,0.761904,0.63,2,184036,183584,452
20134961,11.0434,11.8038,451,89603,0.736381,0.65,1,184048,183597,451
20137881,20.6087,19.9608,452,89626,0.763276,0.65,2,184071,183619,452
20140801,20.1217,19.9921,452,89649,0.752655,0.65,2,184091,183639,452
20143721,21.6243,21.5984,452,89672,0.750531,0.63,2,184113,183661,452
20146641,39.5249,40.3197,451,89695,0.782106,0.63,2,184157,183706,451
20149561,9.50497,9.66394,451,89718,0.756421,0.63,2,184159,183708,451
20152481,14.701,14.7328,451,89741,0.751284,0.63,2,184175,183724,451
20155401,18.1402,2.94656,470,89764,0.734257,0.61,1,184194,183724,470
20158321,18.028,14.9893,470,89787,0.746851,0.65,1,184212,183742,470
20161241,23.6056,16.5979,478,89810,0.73337,0.65,1,184237,183759,478
20164161,17.5211,22.5196,470,89833,0.746674,0.71,1,184253,183783,470
20167081,11.5042,17.3039,464,89856,0.749335,0.67,1,184263,183799,464
20170001,5.50084,11.4608,458,89879,0.749867,0.67,1,184267,183809,458
20172921,13.9002,5.49216,470,89902,0.749973,0.67,1,184283,183813,470
20175841,12.38,13.8984,466,89925,0.749995,0.67,1,184295,183829,466
20178761,12.076,12.3797,466,89948,0.749999,0.67,1,184307,183841,466
20181681,12.0152,12.0759,466,89971,0.75,0.67,1,184319,183853,466
20184601,10.403,12.0152,464,89994,0.75,0.67,1,184329,183865,464
20187521,3.68061,10.403,456,90017,0.75,0.67,1,184331,183875,456
20190441,18.3361,3.68061,476,90040,0.75,0.67,1,184353,183877,476
20193361,10.0672,18.3361,462,90063,0.75,0.71,1,184361,183899,462
20196281,6.81344,10.0672,460,90086,0.75,0.67,1,184367,183907,460
20199201,12.5627,6.81344,468,90109,0.75,0.71,1,184381,183913,468
20202121,4.11254,12.5627,456,90132,0.75,0.67,1,184383,183927,456
20205041,13.6225,4.11254,470,90155,0.75,0.67,1,184399,183929,470
20207961,10.7245,13.6225,464,90178,0.75,0.67,1,184409,183945,464
20210881,18.9449,10.7245,475,90201,0.766,0.73,2,184430,183955,475
20213801,30.189,18.1449,488,90224,0.7532,0.73,2,184463,183975,488
20216721,28.4378,28.429,485,90247,0.75064,0.73,2,184491,184006,485
20219641,7.28756,28.0858,459,90270,0.750128,0.77,2,184493,184034,459
20222561,11.8575,7.21716,470,90293,0.798026,0.73,2,184506,184036,470
20225481,20.7715,11.0434,481,90316,0.807605,0.77,2,184529,184048,481
20228401,20.1543,20.6087,478,90339,0.777521,0.75,2,184549,184071,478
20231321,21.6309,20.1217,480,90362,0.771504,0.75,2,184571,184091,480
20234241,39.5262,21.6243,502,90385,0.770301,0.79,2,184615,184113,502
20237161,9.50523,39.5249,460,90408,0.77006,0.75,2,184617,184157,460
20240081,14.701,9.50497,474,90431,0.770012,0.75,2,184633,184159,474
20243001,17.3402,14.701,476,90454,0.770002,0.73,2,184651,184175,476
20245921,18.668,18.1402,476,90477,0.786,0.75,2,184670,184194,476
20248841,23.7336,18.028,483,90500,0.7732,0.73,2,184695,184212,483
20251761,17.5467,23.6056,474,90523,0.80264,0.75,2,184711,184237,474
20254681,11.5093,17.5211,468,90546,0.808528,0.75,2,184721,184253,468
20257601,5.50187,11.5042,462,90569,0.809706,0.75,2,184725,184263,462
20260521,13.9004,5.50084,474,90592,0.809941,0.75,2,184741,184267,474
20263441,12.3801,13.9002,470,90615,0.825988,0.75,2,184753,184283,470
20266361,12.076,12.38,470,90638,0.829198,0.75,2,184765,184295,470
20269281,12.0152,12.076,470,90661,0.82984,0.75,2,184777,184307,470
20272201,10.403,12.0152,468,90684,0.845968,0.75,2,184787,184319,468
20275121,3.68061,10.403,460,90707,0.849194,0.75,2,184789,184329,460
20278041,18.3361,3.68061,480,90730,0.849839,0.75,2,184811,184331,480
20280961,10.0672,18.3361,466,90753,0.849968,0.75,2,184819,184353,466
20283881,6.81344,10.0672,464,90776,0.849994,0.75,2,184825,184361,464
20286801,12.5627,6.81344,472,90799,0.849999,0.75,2,184839,184367,472
20289721,4.11254,12.5627,460,90822,0.85,0.75,2,184841,184381,460
20292641,13.6225,4.11254,474,90845,0.85,0.75,2,184857,184383,474
20295561,10.7245,13.6225,468,90868,0.85,0.75,2,184867,184399,468
20298481,19.7449,10.7245,480,90891,0.85,0.77,2,184889,184409,480
20301401,29.549,18.9449,491,90914,0.866,0.75,2,184921,184430,491
20304321,29.1098,30.189,487,90937,0.9012,0.75,2,184950,184463,487
20307241,7.42196,28.4378,461,90960,0.87624,0.75,2,184952,184491,461
20310161,11.8844,7.28756,472,90983,0.871248,0.81,2,184965,184493,472
20313081,20.7769,11.8575,482,91006,0.88625,0.81,2,184988,184506,482
20316001,20.1554,20.7715,479,91029,0.88925,0.77,2,185008,184529,479
20318921,21.6311,20.1543,481,91052,0.88985,0.77,2,185030,184549,481
20321841,39.5262,21.6309,503,91075,0.90597,0.77,2,185074,184571,503
20324761,9.50524,39.5262,461,91098,0.909194,0.77,2,185076,184615,461
20327681,14.701,9.50523,475,91121,0.909839,0.77,2,185092,184617,475
20330601,17.3402,14.701,477,91144,0.909968,0.77,2,185110,184633,477
20333521,19.468,17.3402,479,91167,0.909994,0.79,2,185130,184651,479
20336441,23.8936,18.668,485,91190,0.941999,0.77,2,185155,184670,485
20339361,6.37872,23.7336,462,91213,0.9484,0.81,2,185157,184695,462
20844521,43,39,493,45354,0.13,0.93,1,187797,187304,493
20847441,34.2,43,481,45400,0.114,0.77,1,187829,187348,481
20850361,52.44,44.6,493,45446,0.1588,0.67,1,187886,187393,493
20853281,27.288,48.12,465,45492,0.10376,0.55,1,187907,187442,465
20856201,24.6576,33.624,459,45538,0.060752,0.41,1,187931,187472,459
20859121,33.7315,37.9248,456,45584,0.0361504,0.35,1,187967,187511,456
20862041,28.3463,41.185,441,45630,0.0632301,0.13,1,187994,187553,441
20864961,20.0693,29.037,433,45676,0.052646,0.01,1,188012,187579,433
20867881,19.2139,25.8074,427,45722,0.0665292,0.03,1,188031,187604,427
20870801,24.6428,19.5615,435,45768,0.0133058,0.03,1,188057,187622,435
20872801,20.9286,31.1123,421,45814,0.0426612,0.09,1,188077,187656,421
20875721,76.9857,75.8225,425,45860,0.0325322,0.09,1,188168,187743,425
20878641,16.9971,15.1645,427,45906,0.0305064,0.09,1,188170,187743,427
20881561,4.99943,3.0329,429,45952,0.0301013,0.17,1,188172,187743,429
20884481,9.79989,9.40658,429,45998,0.0620203,0.17,1,188183,187754,429
20887401,35.56,1.88132,471,46044,0.052404,0.13,1,188225,187754,471
20890321,31.912,34.7763,459,46090,0.0664808,0.11,1,188256,187797,459
20893241,51.9824,32.5553,484,46136,0.0852962,0.17,1,188313,187829,484
20896161,26.3965,52.1111,447,46182,0.0570592,0.09,1,188333,187886,447
20899081,20.4793,27.2222,445,46228,0.0674118,0.05,1,188352,187907,445
20902001,33.6959,24.6444,458,46274,0.0374824,0.03,1,188389,187931,458
20904921,29.1392,33.7289,450,46320,0.0314965,0.07,1,188417,187967,450
20907841,18.6278,28.3458,439,46366,0.0462993,0.05,1,188433,187994,439
20910761,18.9256,20.0692,440,46411,0.0492599,0.07,1,188452,188012,440
20913681,25.3851,19.2138,448,46456,0.033852,0,1,188479,188031,448
20916601,6.67702,24.6428,424,46501,0.0307704,0.05,1,188481,188057,424
20919521,88.5354,20.9286,513,46546,0.0301541,0.03,1,188590,188077,513
20922441,20.1071,76.9857,425,46591,0.0460308,0.03,1,188593,188168,425
20925361,5.62142,16.9971,425,46636,0.0172062,0.03,1,188595,188170,425
20928281,11.5243,4.99943,436,46681,0.0114412,0.07,1,188608,188172,436
20931201,34.3049,9.79989,465,46726,0.0422882,0.05,1,188648,188183,465
20934121,30.861,35.56,453,46771,0.0484577,0.07,1,188678,188225,453
20937041,54.1722,31.912,482,46816,0.0816915,0.09,1,188738,188256,482
20939961,26.8344,51.9824,445,46861,0.0883383,0.05,1,188758,188313,445
20942881,19.7669,26.3965,443,46906,0.105668,0.07,1,188776,188333,443
20945801,31.9534,20.4793,459,46951,0.0931335,0.03,1,188811,188352,459
20948721,29.5907,33.6959,451,46996,0.0746267,0.03,1,188840,188389,451
20951641,17.1181,29.1392,437,47041,0.0869253,0.05,1,188854,188417,437
20954561,18.6236,18.6278,440,47086,0.0893851,0.05,1,188873,188433,440
20957481,26.1247,18.9256,449,47131,0.041877,0.03,1,188901,188452,449
20960401,6.82494,25.3851,424,47176,0.0323754,0.03,1,188903,188479,424
20963321,87.765,6.67702,530,47221,0.0464751,0.03,1,189011,188481,530
20966241,20.753,88.5354,425,47266,0.049295,0.05,1,189015,188590,425
20969161,5.7506,20.1071,424,47311,0.049859,0.01,1,189017,188593,424
20972081,11.5501,5.62142,435,47356,0.0099718,0.01,1,189030,188595,435
20975001,3.91002,11.5243,424,47401,0.0419944,0.05,1,189032,188608,424
20977921,32.782,34.3049,424,47445,0.0963989,0.05,1,189072,188648,424
20980841,30.5564,30.861,424,47489,0.0752798,0.09,1,189102,188678,424
20983761,55.7113,54.1722,426,47533,0.135056,0.09,1,189164,188738,426
20986681,27.9423,26.8344,427,47577,0.131011,0.11,1,189185,188758,427
20989601,19.9885,19.7669,427,47621,0.130202,0.09,1,189203,188776,427
20992521,31.1977,31.9534,426,47665,0.13004,0.07,1,189237,188811,426
20995441,29.4395,29.5907,426,47709,0.130008,0.09,1,189266,188840,426
20998361,17.8879,17.1181,427,47753,0.114002,0.09,1,189281,188854,427
21001281,14.7776,18.6236,422,47797,0.1428,0.03,1,189295,188873,422
21004201,25.3555,26.1247,422,47841,0.0845601,0.03,1,189323,188901,422
21007121,6.6711,6.82494,422,47885,0.072912,0.05,1,189325,188903,422
21010041,87.7342,87.765,422,47929,0.0145824,0.05,1,189433,189011,422
21012961,20.7468,20.753,422,47973,0.0109165,0.05,1,189437,189015,422
21015881,5.74937,5.7506,422,48017,0.0101833,0,1,189439,189017,422
21018801,13.1499,11.5501,424,48061,0.0260367,0.05,1,189454,189030,424
21021721,4.22997,3.91002,424,48105,0.00520733,0.11,1,189456,189032,424
21024641,33.646,32.782,425,48149,0.0410415,0.07,1,189497,189072,425
21027561,30.7292,30.5564,425,48193,0.0962083,0.15,1,189527,189102,425
21030481,57.3458,55.7113,427,48237,0.107242,0.13,1,189591,189164,427
21033401,27.4692,27.9423,426,48281,0.141448,0.13,1,189611,189185,426
21036321,19.8938,19.9885,426,48325,0.16429,0.13,1,189629,189203,426
21039241,31.1788,31.1977,426,48369,0.184858,0.13,1,189663,189237,426
21042161,29.4358,29.4395,426,48413,0.204972,0.11,1,189692,189266,426
21045081,18.6872,17.8879,427,48457,0.176994,0.15,1,189708,189281,427
21048001,14.9374,14.7776,427,48500,0.187399,0.07,1,189722,189295,427
21050921,21.3875,25.3555,422,48543,0.22148,0.07,1,189745,189323,422
21053841,5.8775,6.6711,422,48586,0.228296,0,1,189747,189325,422
21056761,87.5755,87.7342,422,48629,0.0456592,0.01,1,189855,189433,422
21059681,20.7151,20.7468,422,48672,0.0171318,0.01,1,189859,189437,422
21062601,5.74302,5.74937,422,48715,0.0114264,0.03,1,189861,189439,422
21065521,13.1486,13.1499,422,48758,0.0262853,0,1,189876,189454,422
21068441,4.22972,4.22997,422,48801,0.00525705,0.05,1,189878,189456,422
21071361,35.2459,33.646,424,48844,0.00905141,0.05,1,189921,189497,424
21074281,31.8492,6.7292,455,48887,0.0578103,0.11,1,189952,189497,455
21077201,58.3698,25.3458,490,48930,0.0515621,0.11,1,190017,189527,490
21080121,28.474,56.2692,447,48973,0.0343124,0.15,1,190038,189591,447
21083041,20.0948,27.2538,445,49016,0.0308625,0.17,1,190056,189611,445
21085961,32.019,19.8508,462,49059,0.0461725,0.19,1,190091,189629,462
21088881,30.4038,31.1702,458,49102,0.0492345,0.21,1,190121,189663,458
21091801,19.6808,29.434,446,49145,0.0498469,0.17,1,190138,189692,446
21094721,15.9362,18.6868,445,49188,0.0659694,0.19,1,190153,189708,445
21097641,20.7872,14.9374,453,49231,0.0691939,0.23,1,190175,189722,453
21100561,5.75745,21.3875,432,49274,0.0698388,0.23,1,190177,189745,432
21103481,80.3515,5.87749,529,49317,0.0139678,0,1,190276,189747,529
21106401,19.2703,87.5755,425,49360,0.0267936,0.01,1,190280,189855,425
21109321,5.45406,20.7151,423,49403,0.0293587,0.01,1,190282,189859,423
21112241,13.0908,5.74302,436,49446,0.0138717,0.03,1,190297,189861,436
21115161,4.21816,13.1486,423,49489,0.0107743,0,1,190299,189876,423
21118081,35.2436,4.22972,464,49532,0.0421549,0.01,1,190342,189878,464
21121001,34.2487,35.2459,455,49575,0.032431,0.07,1,190376,189921,455
21123921,58.0497,31.8492,488,49617,0.0464862,0.05,1,190440,189952,488
21126841,27.6099,58.3698,443,49659,0.0652972,0.03,1,190460,190017,443
21129761,19.922,28.474,440,49701,0.0690594,0.03,1,190478,190038,440
21132681,32.7844,20.0948,458,49743,0.0698119,0.05,1,190514,190056,458
21135601,31.3569,32.019,454,49785,0.0859624,0.05,1,190545,190091,454
21138521,19.0714,30.4038,440,49827,0.0891925,0.05,1,190561,190121,440
21141441,16.6143,19.6808,439,49869,0.0898385,0.07,1,190577,190138,439
21144361,20.9229,15.9362,446,49911,0.0899677,0.07,1,190599,190153,446
21147281,5.78457,20.7872,426,49953,0.0899935,0.07,1,190601,190175,426
21150201,77.9569,5.75745,520,49995,0.0259987,0,1,190697,190177,520
21153121,19.5914,80.3515,426,50037,0.0131997,0.03,1,190702,190276,426
21156041,5.51828,19.2703,424,50079,0.0106399,0.03,1,190704,190280,424
21158961,12.3037,5.45406,436,50121,0.026128,0.01,1,190718,190282,436
21161881,4.06073,13.0908,423,50163,0.0292256,0.01,1,190720,190297,423
21164801,36.8121,4.21816,466,50205,0.0298451,0.05,1,190765,190299,466
21167721,33.7624,35.2436,456,50247,0.045969,0.03,1,190798,190342,456
21170641,58.7525,34.2487,487,50289,0.0491938,0.05,1,190863,190376,487
21173561,13.3505,58.0497,425,50331,0.0498388,0.07,1,190865,190440,425
21176481,18.6701,27.6099,425,50373,0.0819678,0.07,1,190885,190460,425
21179401,18.134,19.922,425,50415,0.0563936,0.07,1,190903,190478,425
21182321,33.2268,32.7844,426,50457,0.0672787,0.09,1,190940,190514,426
21185241,31.4454,31.3569,426,50499,0.0854557,0.09,1,190971,190545,426
21188161,19.0891,19.0714,426,50541,0.0890912,0.09,1,190987,190561,426
21191081,16.6178,16.6143,426,50583,0.0578182,0.09,1,191003,190577,426
21194001,22.5236,20.9229,428,50625,0.0995636,0.09,1,191027,190599,428
21196921,6.10471,5.78457,428,50667,0.107913,0.01,1,191029,190601,428
21199841,73.2209,77.9569,422,50709,0.0215825,0.01,1,191119,190697,422
21202761,18.6442,19.5914,422,50751,0.00431651,0.01,1,191124,190702,422
21205681,5.32884,5.51828,422,50793,0.0088633,0.03,1,191126,190704,422
21208601,12.2658,12.3037,422,50834,0.00977266,0.03,1,191140,190718,422
21211521,4.05315,4.06073,422,50875,0.00995453,0.03,1,191142,190720,422
21214441,37.6106,36.8121,423,50916,0.0419909,0.05,1,191188,190765,423
21217361,34.7221,33.7624,424,50957,0.0323982,0.05,1,191222,190798,424
21220281,58.9444,58.7525,424,50998,0.0304796,0.05,1,191287,190863,424
21223201,13.3889,13.3505,424,51039,0.0300959,0.09,1,191289,190865,424
21226121,18.6778,18.6701,424,51080,0.0620192,0.05,1,191309,190885,424
21229041,18.1356,18.134,424,51121,0.0844038,0.07,1,191327,190903,424
21231961,32.4271,33.2268,423,51162,0.104881,0.09,1,191363,190940,423
21234881,32.0854,31.4454,424,51203,0.124976,0.09,1,191395,190971,424
21237801,19.2171,19.0891,424,51244,0.112995,0.05,1,191411,190987,424
21240721,17.4434,16.6178,425,51285,0.126599,0.11,1,191428,191003,425
21243641,24.2887,22.5236,427,51326,0.12932,0.11,1,191454,191027,427
21246561,6.45774,6.10471,427,51367,0.129864,0,1,191456,191029,427
21249481,69.2915,73.2209,422,51408,0.0499728,0,1,191541,191119,422
21252401,17.8583,18.6442,422,51449,0.0179946,0.01,1,191546,191124,422
21255321,5.17166,5.32884,422,51490,0.0115989,0.01,1,191548,191126,422
21258241,12.2343,12.2658,422,51531,0.0103198,0.01,1,191562,191140,422
21261161,4.04687,4.05315,422,51572,0.010064,0.05,1,191564,191142,422
21264081,37.6094,37.6106,422,51613,0.0100128,0.03,1,191610,191188,422
21267001,34.7219,34.7221,422,51654,0.0260026,0.03,1,191644,191222,422
21269921,59.7444,58.9444,423,51695,0.0452005,0.03,1,191710,191287,423
21272841,13.5489,13.3889,423,51736,0.0650401,0.07,1,191712,191289,423
21275761,18.7098,18.6778,423,51777,0.069008,0.07,1,191732,191309,423
21278681,18.942,3.73556,442,51818,0.0858016,0.09,1,191751,191309,442
21281601,32.5884,15.1471,460,51859,0.0891603,0.11,1,191787,191327,460
21284521,32.9177,31.8294,457,51900,0.105832,0.13,1,191820,191363,457
21287441,20.1835,31.9659,442,51941,0.0931664,0.11,1,191837,191395,442
21290361,18.4367,19.1932,444,51982,0.0906333,0.13,1,191855,191411,444
21293281,24.4873,17.4386,453,52023,0.106127,0.13,1,191881,191428,453
21296201,6.49747,24.2877,429,52063,0.109225,0.13,1,191883,191454,429
21299121,64.4995,6.45755,506,52103,0.0618451,0.03,1,191962,191456,506
21302041,16.8999,69.2915,426,52143,0.068369,0.01,1,191967,191541,426
21304961,4.97998,17.8583,423,52183,0.0696738,0.01,1,191969,191546,423
21307881,12.196,5.17166,435,52223,0.0379348,0.01,1,191983,191548,435
21310801,4.0392,12.2343,423,52263,0.031587,0.01,1,191985,191562,423
21313721,37.6078,4.04687,467,52303,0.0303174,0.01,1,192031,191564,467
21316641,34.7216,37.6094,455,52343,0.0140635,0.03,1,192065,191610,455
21319561,62.1443,34.7219,490,52383,0.0428127,0.05,1,192134,191644,490
21322481,14.0289,59.7444,426,52423,0.0485625,0.07,1,192136,191710,426
21325401,18.8058,13.5489,444,52463,0.0497125,0.07,1,192156,191712,444
21328321,19.7612,18.7098,444,52503,0.0499425,0.09,1,192176,191732,444
21331241,32.7522,18.942,461,52543,0.0499885,0.09,1,192212,191751,461
21334161,33.7504,32.5884,459,52583,0.0819977,0.11,1,192246,191787,459
21337081,19.5501,32.9177,442,52623,0.0883995,0.09,1,192262,191820,442
21340001,18.31,20.1835,443,52663,0.0896799,0.09,1,192280,191837,443
21342921,25.262,18.4367,452,52703,0.105936,0.11,1,192307,191855,452
21345841,6.6524,24.4873,428,52743,0.109187,0.11,1,192309,191881,428
21348761,62.1305,6.49747,502,52783,0.125837,0.05,1,192385,191883,502
21351681,15.6261,64.4995,427,52823,0.145167,0.07,1,192389,191962,427
21354601,4.72522,16.8999,424,52863,0.149034,0.07,1,192391,191967,424
21357521,11.345,4.97998,435,52903,0.133807,0.03,1,192404,191969,435
21360441,3.86901,12.196,423,52943,0.162761,0.03,1,192406,191983,423
21363361,38.3738,4.0392,468,52983,0.0885523,0.03,1,192453,191985,468
21366281,34.8748,37.6078,456,53023,0.0417105,0.01,1,192487,192031,456
21369201,62.975,34.7216,492,53063,0.0643421,0.05,1,192557,192065,492
21372121,14.195,62.1443,425,53103,0.0688684,0.05,1,192559,192134,425
21375041,18.839,14.0289,443,53143,0.0857737,0.05,1,192579,192136,443
21377961,19.7678,18.8058,443,53183,0.0891547,0.05,1,192599,192156,443
21380881,33.5536,19.7612,460,53223,0.0738309,0.05,1,192636,192176,460
21383801,8.31071,32.7522,426,53263,0.0707662,0.09,1,192638,192212,426
21386721,28.8621,33.7504,426,53303,0.0701532,0.09,1,192672,192246,426
21389641,18.5724,19.5501,426,53342,0.102031,0.09,1,192688,192262,426
21392561,18.1145,18.31,426,53381,0.108406,0.11,1,192706,192280,426
21395481,26.0229,25.262,427,53420,0.109681,0.11,1,192734,192307,427
21398401,6.80458,6.6524,427,53459,0.109936,0.13,1,192736,192309,427
21401321,63.7609,62.1305,429,53498,0.125987,0.15,1,192814,192385,429
21404241,15.9522,15.6261,429,53537,0.161197,0.15,1,192818,192389,429
21407161,4.79044,4.72522,429,53576,0.136239,0.13,1,192820,192391,429
21410081,10.5581,11.345,428,53615,0.163248,0.17,1,192832,192404,428
21413001,3.71162,3.86901,428,53654,0.16865,0.07,1,192834,192406,428
21415921,35.9423,38.3738,425,53693,0.16973,0.03,1,192878,192453,425
21418841,32.7885,34.8748,423,53732,0.169946,0.07,1,192910,192487,423
21421761,64.9577,62.975,426,53771,0.121989,0.07,1,192983,192557,426
21424681,14.5915,14.195,426,53810,0.112398,0.09,1,192985,192559,426
21427601,18.9183,18.839,426,53849,0.14248,0.09,1,193005,192579,426
21430521,19.7837,19.7678,426,53888,0.148496,0.07,1,193025,192599,426
21433441,32.7567,33.5536,425,53927,0.149699,0.07,1,193061,192636,425
21436361,8.15135,8.31071,425,53966,0.14994,0.07,1,193063,192638,425
21439281,28.8303,28.8621,425,54005,0.149988,0.11,1,193097,192672,425
21442201,18.5661,18.5724,425,54044,0.149998,0.11,1,193113,192688,425
21445121,18.1132,18.1145,425,54083,0.182,0.11,1,193131,192706,425
21448041,26.0226,26.0229,425,54122,0.1564,0.11,1,193159,192734,425
21450961,6.80453,6.80458,425,54161,0.15128,0.13,1,193161,192736,425
21453881,66.1609,63.7609,428,54200,0.198256,0.17,1,193242,192814,428
21456801,16.4322,15.9522,428,54239,0.223651,0.13,1,193246,192818,428
21459721,4.88644,4.79044,428,54278,0.22873,0.17,1,193248,192820,428
21462641,10.5773,10.5581,428,54317,0.261746,0.17,1,193260,192832,428
21465561,3.71546,3.71162,428,54356,0.236349,0.17,1,193262,192834,428
21468481,35.9431,35.9423,428,54395,0.24727,0.17,1,193306,192878,428
21471401,32.7886,32.7885,428,54434,0.281454,0.11,1,193338,192910,428
21474321,64.1577,64.9577,427,54473,0.256291,0.11,1,193410,192983,427
21477241,14.4315,14.5915,427,54512,0.251258,0.15,1,193412,192985,427
21480161,18.8863,18.9183,427,54551,0.266252,0.15,1,193432,193005,427
21483081,19.7773,19.7837,427,54590,0.28525,0.15,1,193452,193025,427
21486001,32.7555,32.7567,427,54629,0.33705,0.15,1,193488,193061,427
21488921,8.15109,8.15135,427,54668,0.34741,0.15,1,193490,193063,427
21491841,29.6302,28.8303,428,54706,0.333482,0.15,1,193525,193097,428
21494761,18.726,5.76605,444,54744,0.330696,0.15,1,193541,193097,444
21497681,18.1452,13.9532,446,54782,0.330139,0.19,1,193559,193113,446
21500601,26.029,17.1906,456,54820,0.330028,0.15,1,193587,193131,456
21503521,6.80581,25.8381,430,54858,0.330006,0.15,1,193589,193159,430
21506441,69.3612,6.76763,513,54896,0.330001,0.21,1,193674,193161,513
21509361,17.0722,66.1535,436,54934,0.33,0.23,1,193678,193242,436
21512281,5.01445,16.4307,434,54972,0.33,0.23,1,193680,193246,434
21515201,10.6029,4.88614,444,55010,0.33,0.27,1,193692,193248,444
21518121,3.72058,10.5772,434,55048,0.33,0.23,1,193694,193260,434
21521041,36.7441,3.71545,477,55086,0.314,0.25,1,193739,193262,477
21523961,32.9488,35.9431,465,55124,0.3108,0.29,1,193771,193306,465
21526881,64.1898,32.7886,505,55162,0.31016,0.25,1,193843,193338,505
21529801,14.438,64.1577,435,55200,0.310032,0.25,1,193845,193410,435
21532721,20.4876,14.4315,455,55238,0.278006,0.27,1,193867,193412,455
21535641,20.0975,18.8863,455,55276,0.303601,0.29,1,193887,193432,455
21538561,33.6195,19.7773,472,55314,0.32472,0.35,1,193924,193452,472
21541481,8.3239,32.7555,438,55352,0.328944,0.35,1,193926,193488,438
21544401,30.4648,8.15109,472,55390,0.329789,0.33,1,193962,193490,472
21547321,18.893,29.6302,453,55428,0.329958,0.33,1,193978,193525,453
21550241,18.1786,18.726,455,55466,0.345992,0.33,1,193996,193541,455
21553161,26.0357,18.1452,465,55504,0.365198,0.33,1,194024,193559,465
21556081,6.80714,26.029,439,55542,0.36904,0.33,1,194026,193587,439
21559001,69.3614,6.80581,522,55580,0.369808,0.33,1,194111,193589,522
21561921,17.0723,69.3612,441,55618,0.369962,0.33,1,194115,193674,441
21564841,5.01446,17.0722,439,55656,0.369992,0.33,1,194117,193678,439
21567761,10.6029,5.01445,449,55694,0.369998,0.33,1,194129,193680,449
21570681,3.72058,10.6029,439,55732,0.37,0.33,1,194131,193692,439
21573601,35.9441,3.72058,481,55770,0.402,0.31,1,194175,193694,481
21576521,32.7888,36.7441,468,55808,0.4244,0.31,1,194207,193739,468
21579441,64.1578,32.9488,508,55846,0.42888,0.31,1,194279,193771,508
21582361,14.4316,64.1898,438,55884,0.429776,0.31,1,194281,193843,438
21585281,20.4863,14.438,458,55922,0.429955,0.27,1,194303,193845,458
21588201,20.0973,20.4876,456,55960,0.445991,0.31,1,194323,193867,456
21591121,34.4195,20.0975,474,55998,0.481198,0.33,1,194361,193887,474
21594041,8.48389,33.6195,439,56036,0.48824,0.33,1,194363,193924,439
21596961,30.4968,8.3239,473,56074,0.489648,0.33,1,194399,193926,473
21599881,19.6994,30.4648,454,56112,0.50593,0.33,1,194416,193962,454
21602801,18.3399,18.893,456,56149,0.477186,0.35,1,194434,193978,456
21605721,5.26797,18.1786,440,56186,0.471437,0.37,1,194436,193996,440
21608641,23.4536,26.0357,440,56223,0.502287,0.37,1,194464,194024,440
21611561,6.29072,6.80714,440,56260,0.508457,0.37,1,194466,194026,440
21614481,69.2581,69.3614,440,56297,0.493691,0.37,1,194551,194111,440
21617401,17.0516,17.0723,440,56334,0.490738,0.37,1,194555,194115,440
21620321,5.01033,5.01446,440,56371,0.490148,0.37,1,194557,194117,440
21623241,12.2021,10.6029,442,56408,0.49003,0.37,1,194571,194129,442
21626161,4.04041,3.72058,442,56445,0.490006,0.41,1,194573,194131,442
21629081,36.0081,35.9441,442,56482,0.538001,0.43,1,194617,194175,442
21632001,33.6016,32.7888,443,56519,0.5636,0.43,1,194650,194207,443
21634921,64.3203,64.1578,443,56556,0.56872,0.43,1,194722,194279,443
21637841,14.4641,14.4316,443,56593,0.569744,0.43,1,194724,194281,443
21640761,21.2928,20.4863,444,56630,0.553949,0.45,1,194747,194303,444
21643681,20.2586,20.0973,444,56667,0.55079,0.49,1,194767,194323,444
21646601,36.0517,34.4195,446,56704,0.550158,0.49,1,194807,194361,446
21649521,8.81034,8.48389,446,56741,0.550032,0.49,1,194809,194363,446
21652441,30.5621,30.4968,446,56778,0.550006,0.51,1,194845,194399,446
21655361,18.9124,19.6994,445,56815,0.518001,0.47,1,194861,194416,445
21658281,18.1825,18.3399,445,56852,0.5436,0.47,1,194879,194434,445
21661201,5.2365,5.26797,445,56889,0.54872,0.51,1,194881,194436,445
21664121,23.4473,23.4536,445,56926,0.517744,0.51,1,194909,194464,445
21667041,6.28946,6.29072,445,56963,0.511549,0.49,1,194911,194466,445
21669961,68.4579,69.2581,444,57000,0.55831,0.49,1,194995,194551,444
21672881,16.8916,17.0516,444,57037,0.567662,0.49,1,194999,194555,444
21675801,4.97832,5.01033,444,57074,0.569532,0.49,1,195001,194557,444
21678721,13.7957,12.2021,446,57111,0.569906,0.49,1,195017,194571,446
21681641,4.35913,4.04041,446,57148,0.569981,0.55,1,195019,194573,446
21684561,36.8718,36.0081,447,57185,0.617996,0.57,1,195064,194617,447
21687481,34.5744,33.6016,448,57222,0.659599,0.57,1,195098,194650,448
21690401,64.5149,64.3203,448,57259,0.65192,0.57,1,195170,194722,448
21693321,14.503,14.4641,448,57296,0.650384,0.55,1,195172,194724,448
21696241,20.5006,21.2928,447,57333,0.650077,0.55,1,195194,194747,447
21699161,20.1001,20.2586,447,57370,0.650015,0.55,1,195214,194767,447
21702081,36.02,36.0517,447,57407,0.698003,0.55,1,195254,194807,447
21705001,8.804,8.81034,447,57444,0.707601,0.55,1,195256,194809,447
21707921,30.5608,30.5621,447,57481,0.72552,0.51,1,195292,194845,447
21710841,18.9122,18.9124,447,57518,0.697104,0.55,1,195308,194861,447
21713761,18.1824,18.1825,447,57555,0.691421,0.55,1,195326,194879,447
21716681,5.23649,5.2365,447,57592,0.690284,0.51,1,195328,194881,447
21719601,23.4473,23.4473,447,57629,0.690057,0.51,1,195356,194909,447
21722521,6.28946,4.68946,449,57665,0.690011,0.51,1,195358,194909,449
21725441,70.0579,2.53789,533,57701,0.738002,0.57,1,195444,194911,533
21728361,17.2116,67.7076,453,57737,0.7476,0.57,1,195448,194995,453
21731281,5.04232,16.7415,451,57773,0.74952,0.57,1,195450,194999,451
21734201,13.8085,4.9483,465,57809,0.749904,0.57,1,195466,195001,465
21737121,4.36169,13.7897,451,57845,0.749981,0.57,1,195468,195017,451
21740041,39.2723,4.35793,497,57881,0.717996,0.63,1,195516,195019,497
21742961,35.8545,36.8716,487,57917,0.727599,0.67,1,195551,195064,487
21745881,64.7709,34.5743,525,57953,0.72952,0.65,1,195623,195098,525
21748801,14.5542,64.5149,455,57989,0.729904,0.65,1,195625,195170,455
21751721,20.5108,14.503,475,58025,0.729981,0.65,1,195647,195172,475
21754641,20.1022,20.5006,473,58061,0.729996,0.65,1,195667,195194,473
21757561,37.6204,20.1001,495,58097,0.697999,0.71,1,195709,195214,495
21760481,9.12409,36.02,457,58133,0.6916,0.71,1,195711,195254,457
21763401,30.6248,8.804,491,58169,0.69032,0.73,1,195747,195256,491
21766321,18.925,30.5608,471,58205,0.690064,0.69,1,195763,195292,471
21769241,18.185,18.9122,473,58241,0.690013,0.69,1,195781,195308,473
21772161,5.237,18.1824,457,58277,0.690003,0.69,1,195783,195326,457
21775081,23.4474,5.23649,483,58313,0.690001,0.69,1,195811,195328,483
21778001,6.28948,23.4473,457,58349,0.69,0.69,1,195813,195356,457
21780921,72.4579,6.28946,544,58385,0.722,0.75,1,195902,195358,544
21783841,17.6916,70.0579,462,58421,0.7284,0.75,1,195906,195444,462
21786761,5.13832,17.2116,460,58457,0.72968,0.75,1,195908,195448,460
21789681,13.8277,5.04232,474,58493,0.745936,0.75,1,195924,195450,474
21792601,4.36553,13.8085,460,58529,0.749187,0.75,1,195926,195466,460
21795521,39.2731,4.36169,506,58565,0.781837,0.71,2,195974,195468,506
21798441,35.0546,39.2723,492,58601,0.772367,0.73,2,196008,195516,492
21801361,64.6109,35.8545,529,58637,0.786473,0.73,2,196080,195551,529
21804281,14.5222,64.7709,459,58673,0.789295,0.73,2,196082,195623,459
21807201,20.5044,14.5542,479,58709,0.805859,0.73,2,196104,195625,479
21810121,20.1009,20.5108,477,58745,0.809172,0.73,2,196124,195647,477
21813041,36.0202,20.1022,497,58781,0.809834,0.69,2,196164,195667,497
21815961,8.80404,37.6204,457,58817,0.809967,0.69,2,196166,195709,457
21818881,30.5608,9.12409,491,58853,0.825993,0.69,2,196202,195711,491
21821801,18.9122,30.6248,471,58889,0.829199,0.69,2,196218,195747,471
21824721,18.1824,18.925,473,58925,0.82984,0.69,2,196236,195763,473
21827641,5.23649,18.185,457,58961,0.829968,0.69,2,196238,195781,457
21830561,23.4473,5.237,483,58997,0.829994,0.69,2,196266,195783,483
21833481,6.28946,23.4474,457,59033,0.829999,0.69,2,196268,195811,457
21836401,74.0579,6.28948,546,59069,0.846,0.73,2,196359,195813,546
21839321,16.4116,72.4579,459,59105,0.8492,0.73,2,196361,195902,459
21842241,6.48232,17.6916,459,59141,0.84984,0.73,2,196365,195906,459
21845161,2.89646,5.13832,459,59177,0.849968,0.75,2,196367,195908,459
21848081,13.3793,13.8277,459,59213,0.881994,0.75,2,196383,195924,459
21851001,4.27586,4.36553,459,59248,0.888399,0.79,2,196385,195926,459
21853921,40.0552,39.2731,460,59283,0.87368,0.77,2,196434,195974,460
21856841,35.211,35.0546,460,59318,0.886736,0.79,2,196468,196008,460
21859761,65.4422,64.6109,461,59353,0.921347,0.79,2,196541,196080,461
21862681,14.6884,14.5222,461,59388,0.928269,0.81,2,196543,196082,461
21865601,21.3377,20.5044,462,59423,0.945654,0.81,2,196566,196104,462
21868521,20.2675,20.1009,462,59458,0.949131,0.81,2,196586,196124,462
21871441,36.0535,36.0202,462,59493,0.949826,0.81,2,196626,196164,462
21874361,8.8107,8.80404,462,59528,0.949965,0.83,2,196628,196166,462
22143001,15,12,491,62696,0.85,1,2,198767,198276,491
22145921,13.4,14.4,489,62729,0.906,1,2,198780,198291,489
22148841,17.88,12.48,496,62762,0.8612,1,2,198799,198303,496
22151761,17.176,8.896,505,62795,0.88424,1,2,198816,198311,505
22154681,17.8352,30.5792,487,62828,0.840848,1,2,198834,198347,487
22157601,65.167,70.9158,483,62861,0.65617,1,1,198911,198428,483
22160521,25.0334,23.7832,486,62894,0.571234,1,1,198926,198440,486
22163441,19.4067,15.9566,490,62927,0.538247,1,1,198944,198454,490
22166361,17.4813,19.1913,487,62960,0.491649,1,1,198961,198474,487
22169281,27.4963,34.2383,479,62993,0.38633,1,1,198991,198512,479
22172201,30.2993,26.0477,486,63026,0.245266,1,1,199022,198536,486
22175121,18.8599,19.6095,484,63059,0.185053,1,1,199038,198554,484
22178041,18.172,18.3219,484,63092,0.157011,1,1,199056,198572,484
22180961,15.6344,15.6644,484,63125,0.119402,1,1,199071,198587,484
22183881,15.1269,12.7329,487,63158,0.0958804,1,1,199086,198599,487
22186801,15.0254,16.9466,484,63191,0.219176,0.97,1,199101,198617,484
22189721,11.8051,13.7893,482,63224,0.195835,1,1,199112,198630,482
22192641,52.761,62.7579,470,63257,0.039167,1,1,199175,198705,470
22195561,28.1522,26.9516,474,63290,0.0318334,0.93,1,199197,198723,474
22198481,14.4304,17.3903,470,63323,0.0303667,0.82,1,199208,198738,470
22201401,12.4861,14.6781,468,63356,0.254073,0.85,1,199220,198752,468
22204321,13.6972,14.9356,467,63389,0.298815,0.92,1,199234,198767,467
22207241,10.7394,13.3871,464,63422,0.275763,0.85,1,199244,198780,464
22210161,18.1479,17.8774,465,63455,0.271153,0.85,1,199264,198799,465
22213081,15.6296,3.57548,480,63488,0.254231,0.89,1,199279,198799,480
22216001,15.9259,14.3151,479,63521,0.250846,0.83,1,199295,198816,479
22218921,51.9852,17.263,522,63554,0.202169,0.61,1,199356,198834,522
22221841,19.997,65.0526,457,63587,0.224434,0.55,1,199368,198911,457
22224761,17.5994,25.0105,459,63620,0.212887,0.53,1,199385,198926,459
22227681,16.3199,19.4021,457,63653,0.210577,0.48,1,199401,198944,457
22230601,23.264,17.4804,465,63686,0.194115,0.36,1,199426,198961,465
22233521,23.8528,27.4961,459,63719,0.142823,0.21,1,199450,198991,459
22236441,15.1706,30.2992,441,63752,0.116565,0.17,1,199463,199022,441
22239361,16.6341,18.8598,442,63785,0.0633129,0.15,1,199480,199038,442
22242281,13.7268,18.172,437,63818,0.0366626,0.11,1,199493,199056,437
22245201,20.3454,15.6344,444,63851,0.0313325,0.09,1,199515,199071,444
22248121,16.0691,15.1269,444,63884,0.0302665,0.25,1,199530,199086,444
22251041,8.81381,15.0254,436,63917,0.0460533,0.19,1,199537,199101,436
22253961,50.5628,11.8051,486,63950,0.0172107,0,1,199598,199112,486
22256881,26.1126,52.761,443,63983,0.0434421,0.03,1,199618,199175,443
22259801,24.4225,28.1522,445,64016,0.0646884,0.03,1,199642,199197,445
22262721,16.0845,14.4304,448,64049,0.0369377,0.31,1,199656,199208,448
22265641,12.8169,12.4861,448,64082,0.0633875,0.31,1,199668,199220,448
22268561,11.3634,13.6972,445,64115,0.0846775,0.27,1,199679,199234,445
22271481,15.8727,10.7394,452,64148,0.0729355,0.27,1,199696,199244,452
22274401,17.5745,18.1479,450,64181,0.0705871,0.25,1,199714,199264,450
22277321,13.1149,15.6296,447,64214,0.0701174,0.25,1,199726,199279,447
22280241,52.223,15.9259,493,64247,0.102023,0.19,1,199788,199295,493
22283161,20.0446,51.9852,444,64280,0.108405,0.23,1,199800,199356,444
22286081,16.8089,19.997,448,64313,0.125681,0.21,1,199816,199368,448
22289001,16.1618,17.5994,447,64346,0.129136,0.21,1,199832,199385,447
22291921,22.4324,16.3199,455,64379,0.145827,0.19,1,199856,199401,455
22294841,19.6865,23.264,449,64412,0.165165,0.13,1,199875,199426,449
22297761,13.5373,23.8528,437,64445,0.169033,0.11,1,199887,199450,437
22300681,13.9075,15.1706,438,64478,0.169807,0.05,1,199901,199463,438
22303601,13.1815,16.6341,434,64511,0.153961,0.03,1,199914,199480,434
22306521,20.2363,13.7268,443,64544,0.0707923,0.03,1,199936,199493,443
22309441,16.8473,20.3454,437,64577,0.0541585,0.03,1,199952,199515,437
22312361,8.16945,16.0691,428,64610,0.0668317,0.05,1,199958,199530,428
22315281,50.4339,8.81381,482,64642,0.0373663,0.01,1,200019,199537,482
22318201,26.0868,50.5628,441,64674,0.0314733,0.05,1,200039,199598,441
22321121,25.2174,26.1126,446,64706,0.0622947,0.07,1,200064,199618,446
22324041,17.8435,24.4225,438,64738,0.0684589,0.03,1,200080,199642,438
22326961,13.1687,16.0845,436,64770,0.0856918,0.07,1,200092,199656,436
22329881,12.2337,12.8169,436,64802,0.0891384,0.09,1,200104,199668,436
22332801,15.2467,11.3634,441,64834,0.0898277,0.07,1,200120,199679,441
22335721,17.4493,15.8727,442,64866,0.105966,0.07,1,200138,199696,442
22338641,13.8899,17.5745,437,64898,0.0931931,0.07,1,200151,199714,437
22341561,4.37797,13.1149,427,64930,0.122639,0.11,1,200153,199726,427
22344481,50.4756,52.223,427,64962,0.112528,0.11,1,200215,199788,427
22347401,19.6951,20.0446,427,64994,0.110506,0.13,1,200227,199800,427
22350321,17.539,16.8089,428,65026,0.126101,0.13,1,200244,199816,428
22353241,16.3078,16.1618,428,65058,0.12922,0.15,1,200260,199832,428
22356161,23.2616,22.4324,429,65090,0.145844,0.17,1,200285,199856,429
22359081,20.6523,19.6865,430,65122,0.149169,0.17,1,200305,199875,430
22362001,13.7305,13.5373,430,65154,0.117834,0.17,1,200317,199887,430
22364921,12.3461,13.9075,428,65186,0.111567,0.15,1,200329,199901,428
22367841,10.4692,13.1815,425,65218,0.110313,0.05,1,200339,199914,425
22370761,18.8938,20.2363,424,65250,0.126063,0.05,1,200360,199936,424
22373681,17.3788,16.8473,425,65282,0.145213,0.07,1,200377,199952,425
22376601,8.27575,8.16945,425,65314,0.117043,0.03,1,200383,199958,425
22379521,48.8552,50.4339,423,65346,0.0314085,0.03,1,200442,200019,423
22382441,25.771,26.0868,423,65378,0.0062817,0.07,1,200462,200039,423
22385361,26.7542,25.2174,425,65410,0.00925634,0.07,1,200489,200064,425
22388281,18.9508,17.8435,426,65442,0.0258513,0.09,1,200506,200080,426
22391201,13.3902,13.1687,426,65474,0.0451703,0.09,1,200518,200092,426
22394121,12.278,12.2337,426,65506,0.0490341,0.09,1,200530,200104,426
22397041,16.0556,15.2467,427,65538,0.0338068,0.11,1,200547,200120,427
22399961,17.6111,17.4493,427,65570,0.0467614,0.09,1,200565,200138,427
22402881,13.1222,13.8899,426,65602,0.0493523,0.13,1,200577,200151,426
22405801,4.22444,4.37797,426,65634,0.0178705,0.11,1,200579,200153,426
22408721,51.2449,50.4756,427,65666,0.0435741,0.11,1,200642,200215,427
22411641,19.849,19.6951,427,65698,0.0647148,0.13,1,200654,200227,427
22414561,16.7698,17.539,426,65730,0.052943,0.13,1,200670,200244,426
22417481,16.154,16.3078,426,65762,0.0505886,0.15,1,200686,200260,426
22420401,24.0308,23.2616,427,65794,0.0981177,0.15,1,200712,200285,427
22423321,20.8062,20.6523,427,65826,0.0756235,0.11,1,200732,200305,427
22426241,13.7612,13.7305,427,65858,0.0711247,0.11,1,200744,200317,427
22429161,12.3522,12.3461,427,65890,0.0862249,0.11,1,200756,200329,427
22432081,10.4704,10.4692,427,65922,0.089245,0.13,1,200766,200339,427
22435001,19.6941,18.8938,428,65954,0.121849,0.15,1,200788,200360,428
22437921,16.7388,17.3788,427,65986,0.12837,0.11,1,200804,200377,427
22440841,8.14776,8.27575,427,66018,0.129674,0.01,1,200810,200383,427
22443761,44.8296,48.8552,422,66050,0.129935,0,1,200864,200442,422
22446681,24.9659,25.771,422,66082,0.065987,0.01,1,200884,200462,422
22449601,26.5932,26.7542,422,66114,0.0371974,0.03,1,200911,200489,422
22452521,18.9186,18.9508,422,66146,0.0314395,0.05,1,200928,200506,422
22455441,13.3837,13.3902,422,66178,0.0462879,0.05,1,200940,200518,422
22458361,12.2767,12.278,422,66210,0.0492576,0.03,1,200952,200530,422
22461281,16.0553,16.0556,422,66242,0.0498515,0.05,1,200969,200547,422
22464201,17.6111,17.6111,422,66274,0.0659703,0.05,1,200987,200565,422
22467121,13.1222,13.1222,422,66306,0.0691941,0.01,1,200999,200577,422
22470041,4.22444,4.22444,422,66338,0.0378388,0.05,1,201001,200579,422
22472961,52.0449,51.2449,423,66370,0.0475678,0.07,1,201065,200642,423
22475881,20.009,19.849,423,66402,0.0815136,0.07,1,201077,200654,423
22478801,16.8018,3.9698,439,66434,0.0563027,0.05,1,201093,200654,439
22481721,16.1604,13.594,439,66466,0.0512605,0.05,1,201109,200670,439
22484641,24.8321,15.5188,450,66498,0.0662521,0.11,1,201136,200686,450
22487561,20.9664,23.9038,444,66530,0.0692504,0.07,1,201156,200712,444
22490481,14.5933,20.7808,437,66562,0.0538501,0.07,1,201169,200732,437
22493401,12.5187,13.7562,437,66594,0.05077,0.09,1,201181,200744,437
22496321,10.5037,12.3512,435,66626,0.050154,0.09,1,201191,200756,435
22499241,19.7007,10.4702,447,66657,0.0500308,0.13,1,201213,200766,447
22502161,17.5401,19.694,442,66688,0.0660062,0.13,1,201230,200788,442
22505081,8.30803,16.7388,432,66719,0.0852012,0.13,1,201236,200804,432
22508001,44.0616,8.14776,479,66750,0.0730402,0.13,1,201289,200810,479
22510921,23.2123,44.8296,443,66781,0.070608,0.05,1,201307,200864,443
22513841,24.6425,24.9659,448,66812,0.0541216,0.03,1,201332,200884,448
22516761,18.5285,26.5932,438,66843,0.0508243,0.03,1,201349,200911,438
22519681,13.3057,18.9186,433,66874,0.0181649,0.05,1,201361,200928,433
22522601,13.0611,13.3837,434,66905,0.011633,0.05,1,201374,200940,434
22525521,16.2122,12.2767,439,66936,0.0263266,0.05,1,201391,200952,439
22528441,17.6424,16.0553,440,66967,0.0612653,0.07,1,201409,200969,440
22531361,13.9285,17.6111,435,66998,0.0522531,0.07,1,201422,200987,435
22534281,4.3857,13.1222,425,67029,0.0824506,0.03,1,201424,200999,425
22537201,52.0771,4.22444,487,67060,0.0884901,0.05,1,201488,201001,487
22540121,20.0154,52.0449,435,67091,0.089698,0.09,1,201500,201065,435
22543041,16.8031,20.009,439,67122,0.0899396,0.05,1,201516,201077,439
22545961,16.1606,16.8018,439,67153,0.105988,0.05,1,201532,201093,439
22548881,25.6321,16.1604,451,67184,0.125198,0.07,1,201560,201109,451
22551801,21.1264,24.8321,444,67215,0.12904,0.07,1,201580,201136,444
22554721,13.8253,20.9664,436,67246,0.145808,0.05,1,201592,201156,436
22557641,12.3651,14.5933,435,67277,0.149162,0.05,1,201604,201169,435
22560561,10.473,12.5187,433,67308,0.149832,0.05,1,201614,201181,433
22563481,19.6946,10.5037,445,67339,0.165966,0.05,1,201636,201191,445
22566401,17.5389,19.7007,440,67370,0.153193,0.07,1,201653,201213,440
22569321,8.30778,17.5401,429,67401,0.182639,0.09,1,201659,201230,429
22572241,44.8616,8.30803,477,67432,0.204528,0.07,1,201713,201236,477
22575161,23.3723,44.0616,442,67463,0.224906,0.07,1,201731,201289,442
22578081,22.2745,23.2123,446,67494,0.228981,0.05,1,201753,201307,446
22581001,18.0549,24.6425,438,67525,0.213796,0.05,1,201770,201332,438
22583921,14.011,18.5285,434,67556,0.194759,0.01,1,201783,201349,434
22586841,14.0022,13.3057,436,67587,0.190952,0.01,1,201797,201361,436
22589761,17.2004,13.0611,441,67618,0.19019,0.03,1,201815,201374,441
22592681,17.8401,16.2122,442,67649,0.190038,0.07,1,201833,201391,442
22595601,14.768,17.6424,438,67680,0.206008,0.05,1,201847,201409,438
22598521,4.5536,13.9285,427,67711,0.209202,0.09,1,201849,201422,427
22601441,52.1107,4.3857,489,67742,0.24184,0.09,1,201913,201424,489
22604361,20.0221,52.0771,437,67773,0.248368,0.09,1,201925,201488,437
22607281,17.6044,20.0154,442,67804,0.265674,0.09,1,201942,201500,442
22610201,16.3209,16.8031,442,67835,0.237135,0.11,1,201958,201516,442
22613121,4.86418,16.1606,428,67866,0.231427,0.13,1,201960,201532,428
22616041,23.3728,25.6321,428,67897,0.230285,0.13,1,201988,201560,428
22618961,21.4746,21.1264,429,67928,0.246057,0.15,1,202009,201580,429
22621881,13.8949,13.8253,429,67959,0.249211,0.15,1,202021,201592,429
22624801,12.379,12.3651,429,67990,0.249842,0.15,1,202033,201604,429
22627721,11.2758,10.473,430,68021,0.233968,0.17,1,202044,201614,430
22630641,19.8552,19.6946,430,68052,0.230794,0.15,1,202066,201636,430
22633561,18.371,17.5389,431,68083,0.230159,0.19,1,202084,201653,431
22636481,8.47421,8.30778,431,68114,0.230032,0.21,1,202090,201659,431
22639401,46.4948,44.8616,433,68145,0.278006,0.23,1,202146,201713,433
22642321,23.699,23.3723,433,68176,0.255601,0.23,1,202164,201731,433
22645241,22.3398,22.2745,433,68207,0.25112,0.21,1,202186,201753,433
22648161,17.268,18.0549,432,68238,0.250224,0.19,1,202202,201770,432
22651081,13.0536,14.011,431,68269,0.282045,0.19,1,202214,201783,431
22654001,13.8107,14.0022,431,68300,0.288409,0.19,1,202228,201797,431
22656921,17.1621,17.2004,431,68331,0.289682,0.19,1,202246,201815,431
22659841,18.6324,17.8401,432,68362,0.273936,0.21,1,202265,201833,432
22662761,15.7265,14.768,433,68393,0.254787,0.21,1,202280,201847,433
22665681,4.7453,4.5536,433,68424,0.250957,0.25,1,202282,201849,433
22668601,52.9491,52.1107,434,68455,0.202191,0.25,1,202347,201913,434
22671521,20.1898,20.0221,434,68486,0.224438,0.27,1,202359,201925,434
22674441,16.838,17.6044,433,68517,0.196888,0.23,1,202375,201942,433
22677361,16.1676,16.3209,433,68548,0.191378,0.23,1,202391,201958,433
22680281,4.83352,4.86418,433,68579,0.222276,0.23,1,202393,201960,433
22683201,23.3667,23.3728,433,68610,0.228455,0.25,1,202421,201988,433
22686121,20.6733,21.4746,432,68641,0.213691,0.25,1,202441,202009,432
22689041,13.7347,13.8949,432,68672,0.226738,0.25,1,202453,202021,432
22691961,12.3469,12.379,432,68703,0.229348,0.23,1,202465,202033,432
22694881,12.0694,11.2758,433,68734,0.22987,0.23,1,202477,202044,433
22697801,20.0139,19.8552,433,68765,0.293974,0.23,1,202499,202066,433
22700721,19.2028,18.371,434,68795,0.290795,0.23,1,202518,202084,434
22703641,8.64055,8.47421,434,68825,0.290159,0.29,1,202524,202090,434
22706561,46.5281,46.4948,434,68855,0.306032,0.25,1,202580,202146,434
22709481,23.7056,23.699,434,68885,0.277206,0.25,1,202598,202164,434
22712401,22.3411,22.3398,434,68915,0.303441,0.25,1,202620,202186,434
22715321,17.2682,17.268,434,68945,0.308688,0.29,1,202636,202202,434
22718241,13.0536,13.0536,434,68975,0.309738,0.29,1,202648,202214,434
22721161,13.8107,13.8107,434,69005,0.325948,0.29,1,202662,202228,434
22724081,17.1621,17.1621,434,69035,0.329189,0.27,1,202680,202246,434
22727001,17.8324,18.6324,433,69065,0.329838,0.25,1,202698,202265,433
22729921,14.7665,15.7265,432,69095,0.297968,0.25,1,202712,202280,432
22732841,4.5533,4.7453,432,69125,0.323594,0.19,1,202714,202282,432
22735761,52.1107,52.9491,431,69155,0.328719,0.23,1,202778,202347,431
22738681,20.0221,20.1898,431,69185,0.377744,0.19,1,202790,202359,431
22741601,16.8044,16.838,431,69215,0.355549,0.19,1,202806,202375,431
22744521,16.1609,16.1676,431,69245,0.35111,0.23,1,202822,202391,431
22747441,4.83218,4.83352,431,69275,0.382222,0.23,1,202824,202393,431
22750361,23.3664,23.3667,431,69305,0.388444,0.23,1,202852,202421,431
22753281,21.4733,4.67334,452,69335,0.341689,0.21,1,202873,202421,452
22756201,13.8947,16.9347,444,69365,0.364338,0.23,1,202885,202441,444
22759121,12.3789,12.9869,444,69395,0.368868,0.23,1,202897,202453,444
22762041,12.8758,12.1974,445,69425,0.353774,0.23,1,202910,202465,445
22764961,20.9752,12.0395,456,69455,0.366755,0.31,1,202933,202477,456
22767881,18.595,20.0079,452,69485,0.369351,0.29,1,202951,202499,452
22770801,8.51901,19.2016,439,69515,0.36987,0.29,1,202957,202518,439
22773721,47.3038,8.64032,490,69545,0.353974,0.31,1,203014,202524,490
22776641,23.8608,46.5281,452,69575,0.350795,0.27,1,203032,202580,452
22779561,22.3722,23.7056,456,69605,0.366159,0.31,1,203054,202598,456
22782481,17.2744,22.3411,450,69635,0.369232,0.31,1,203070,202620,450
22785401,13.0549,17.2682,446,69665,0.369846,0.31,1,203082,202636,446
22788321,14.611,13.0536,449,69695,0.385969,0.33,1,203097,202648,449
22791241,17.3222,13.8107,453,69725,0.389194,0.33,1,203115,202662,453
22794161,17.8644,17.1621,453,69755,0.389839,0.33,1,203133,202680,453
22797081,14.7729,17.8324,449,69785,0.389968,0.29,1,203147,202698,449
22800001,4.55458,14.7665,437,69815,0.389994,0.33,1,203149,202712,437
22802921,54.5109,4.5533,502,69845,0.437999,0.33,1,203216,202714,502
22805841,20.5022,52.1107,450,69875,0.4476,0.39,1,203228,202778,450
22808761,16.9004,20.0221,454,69905,0.44952,0.35,1,203244,202790,454
22811681,16.1801,16.8044,454,69935,0.449904,0.35,1,203260,202806,454
22814601,4.83602,16.1609,440,69965,0.449981,0.39,1,203262,202822,440
22817521,23.3672,4.83218,466,69995,0.449996,0.39,1,203290,202824,466
22820441,22.2734,23.3664,460,70025,0.449999,0.33,1,203312,202852,460
22823361,14.0547,21.4733,451,70055,0.45,0.37,1,203324,202873,451
22826281,12.4109,13.8947,451,70085,0.482,0.37,1,203336,202885,451
22829201,13.6822,12.3789,453,70115,0.4884,0.35,1,203350,202897,453
22832121,20.3364,12.8758,462,70145,0.48968,0.37,1,203372,202910,462
22835041,18.4673,20.9752,457,70175,0.489936,0.37,1,203390,202933,457
22837961,8.49346,18.595,445,70205,0.505987,0.37,1,203396,202951,445
22840881,46.4987,8.51901,495,70235,0.525197,0.35,1,203452,202957,495
22843801,24.4997,47.3038,457,70265,0.56104,0.35,1,203471,203014,457
22846721,22.4999,23.8608,461,70295,0.568208,0.37,1,203493,203032,461
22849641,17.3,22.3722,455,70325,0.569642,0.37,1,203509,203054,455
22852561,13.06,17.2744,451,70355,0.569928,0.37,1,203521,203070,451
22855481,15.412,13.0549,455,70385,0.569986,0.39,1,203537,203082,455
22858401,17.4824,14.611,458,70415,0.569997,0.39,1,203555,203097,458
22861321,17.8965,17.3222,458,70445,0.585999,0.39,1,203573,203115,458
22864241,14.7793,17.8644,454,70475,0.5892,0.39,1,203587,203133,454
22867161,4.55586,14.7729,442,70505,0.58984,0.39,1,203589,203147,442
22870081,56.9112,4.55458,510,70535,0.589968,0.45,1,203659,203149,510
22873001,20.9822,54.5109,455,70565,0.589994,0.45,1,203671,203216,455
22875921,16.9964,20.5022,459,70595,0.621999,0.45,1,203687,203228,459
22878841,16.1993,16.9004,459,70625,0.6284,0.45,1,203703,203244,459
22881761,4.83986,16.1801,445,70655,0.62968,0.45,1,203705,203260,445
22884681,23.368,4.83602,471,70685,0.645936,0.45,1,203733,203262,471
22887601,22.2736,23.3672,465,70715,0.649187,0.45,1,203755,203290,465
22890521,14.8547,22.2734,456,70745,0.665837,0.45,1,203768,203312,456
22893441,4.57094,14.0547,446,70775,0.669167,0.49,1,203770,203324,446
22896361,10.5142,12.4109,446,70805,0.669834,0.49,1,203782,203336,446
22899281,13.3028,13.6822,446,70835,0.669967,0.49,1,203796,203350,446
22902201,20.2606,20.3364,446,70865,0.637993,0.49,1,203818,203372,446
22905121,19.2521,18.4673,447,70895,0.647599,0.51,1,203837,203390,447
22908041,9.45042,8.49346,448,70925,0.63352,0.53,1,203844,203396,448
22910961,46.6901,46.4987,448,70955,0.630704,0.57,1,203900,203452,448
22913881,26.138,24.4997,450,70985,0.646141,0.57,1,203921,203471,450
22916801,22.8276,22.4999,450,71015,0.649228,0.57,1,203943,203493,450
22919721,17.3655,17.3,450,71045,0.649846,0.57,1,203959,203509,450
22922641,13.0731,13.06,450,71075,0.697969,0.57,1,203971,203521,450
22925561,15.4146,15.412,450,71104,0.675594,0.57,1,203987,203537,450
22928481,17.4829,17.4824,450,71133,0.703119,0.59,1,204005,203555,450
22931401,18.6966,17.8965,451,71162,0.692624,0.59,1,204024,203573,451
22934321,14.9393,14.7793,451,71191,0.658525,0.59,1,204038,203587,451
22937241,4.58786,4.55586,451,71220,0.651705,0.59,1,204040,203589,451
22940161,56.9176,56.9112,451,71249,0.650341,0.59,1,204110,203659,451
22943081,22.5835,20.9822,453,71278,0.650068,0.63,1,204124,203671,453
22946001,17.3167,16.9964,453,71307,0.618014,0.63,1,204140,203687,453
22948921,17.0633,16.1993,454,71336,0.627603,0.63,1,204157,203703,454
22951841,5.01267,4.83986,454,71365,0.629521,0.65,1,204159,203705,454
22954761,23.4025,23.368,454,71394,0.629904,0.65,1,204187,203733,454
22957681,22.2805,22.2736,454,71423,0.629981,0.67,1,204209,203755,454
22960601,14.0561,14.8547,453,71452,0.597996,0.67,1,204221,203768,453
22963521,4.41122,4.57094,453,71481,0.591599,0.67,1,204223,203770,453
22966441,10.4822,10.5142,453,71510,0.59032,0.67,1,204235,203782,453
22969361,13.2964,13.3028,453,71539,0.590064,0.63,1,204249,203796,453
22972281,20.2593,20.2606,453,71568,0.654013,0.65,1,204271,203818,453
22975201,18.4519,19.2521,452,71597,0.666803,0.63,1,204289,203837,452
22978121,10.0904,9.45042,453,71626,0.637361,0.63,1,204297,203844,453
22981041,46.8181,46.6901,453,71655,0.679472,0.65,1,204353,203900,453
22983961,26.9636,26.138,454,71684,0.687894,0.65,1,204375,203921,454
22986881,22.9927,22.8276,454,71713,0.689579,0.65,1,204397,203943,454
22989801,18.1985,17.3655,455,71742,0.689916,0.71,1,204414,203959,455
22992721,13.2397,13.0731,455,71771,0.689983,0.67,1,204426,203971,455
22995641,15.4479,15.4146,455,71800,0.705997,0.71,1,204442,203987,455
22998561,17.4896,17.4829,455,71829,0.709199,0.69,1,204460,204005,455
23001481,17.8979,18.6966,454,71858,0.70984,0.65,1,204478,204024,454
23004401,14.7796,14.9393,454,71887,0.677968,0.65,1,204492,204038,454
23007321,4.55592,4.58786,454,71916,0.703594,0.65,1,204494,204040,454
23010241,56.9112,56.9176,454,71945,0.724719,0.65,1,204564,204110,454
23013161,20.9822,22.5835,452,71974,0.728944,0.61,1,204576,204124,452
23016081,16.9964,17.3167,452,72003,0.697789,0.63,1,204592,204140,452
23019001,16.1993,17.0633,451,72032,0.707558,0.63,1,204608,204157,451
23021921,4.83986,5.01267,451,72061,0.741512,0.63,1,204610,204159,451
23024841,23.368,23.4025,451,72090,0.748302,0.63,1,204638,204187,451
23027761,22.2736,22.2805,451,72119,0.78166,0.59,2,204660,204209,451
23030681,14.0547,14.0561,451,72148,0.756332,0.59,2,204672,204221,451
23033601,4.41094,4.41122,451,72177,0.751266,0.59,2,204674,204223,451
23036521,10.4822,10.4822,451,72206,0.750253,0.59,2,204686,204235,451
23039441,13.2964,13.2964,451,72235,0.750051,0.59,2,204700,204249,451
23042361,21.0593,2.65929,474,72264,0.76601,0.67,2,204723,204249,474
23045281,18.6119,18.1319,470,72293,0.769202,0.67,2,204741,204271,470
23048201,10.1224,18.0264,460,72322,0.76984,0.63,2,204749,204289,460
23051121,47.6245,10.0053,509,72351,0.785968,0.69,2,204806,204297,509
23054041,27.1249,46.8011,475,72380,0.789194,0.69,2,204828,204353,475
23056961,23.825,26.9602,476,72409,0.805839,0.69,2,204851,204375,476
23059881,17.565,22.992,470,72438,0.777168,0.69,2,204867,204397,470
23062801,13.913,18.1984,466,72467,0.755434,0.69,2,204880,204414,466
23065721,15.5826,13.2397,470,72496,0.751087,0.71,2,204896,204426,470
23068641,17.5165,15.4479,472,72525,0.750217,0.71,2,204914,204442,472
23071561,17.9033,17.4896,472,72554,0.750044,0.71,2,204932,204460,472
23074481,14.7807,17.8979,468,72583,0.766009,0.67,2,204946,204478,468
23077401,4.55613,14.7796,456,72612,0.769202,0.71,2,204948,204492,456
23080321,57.7112,4.55592,525,72641,0.78584,0.73,2,205019,204494,525
23083241,21.1422,56.9112,467,72670,0.789168,0.73,2,205031,204564,467
23086161,17.0284,20.9822,471,72699,0.789834,0.69,2,205047,204576,471
23089081,17.0057,16.9964,472,72728,0.805967,0.71,2,205064,204592,472
23092001,5.00114,16.1993,458,72757,0.809193,0.75,2,205066,204608,458
23094921,24.2002,4.83986,485,72786,0.793839,0.75,2,205095,204610,485
23097841,23.24,23.368,480,72815,0.838768,0.79,2,205118,204638,480
23100761,14.248,22.2736,470,72844,0.847754,0.75,2,205130,204660,470
23103681,4.4496,14.0547,460,72873,0.849551,0.75,2,205132,204672,460
23106601,10.4899,4.41094,470,72902,0.84991,0.75,2,205144,204674,470
23109521,13.298,10.4822,472,72931,0.849982,0.75,2,205158,204686,472
23112441,21.8596,13.2964,482,72960,0.849996,0.77,2,205182,204700,482
23115361,18.7719,21.0593,477,72989,0.849999,0.77,2,205200,204723,477
23118281,10.1544,18.6119,467,73018,0.85,0.77,2,205208,204741,467
23121201,48.4309,10.1224,517,73047,0.882,0.79,2,205266,204749,517
23124121,27.2862,47.6245,482,73076,0.9044,0.79,2,205288,204806,482
23127041,23.0572,27.1249,482,73105,0.90888,0.81,2,205310,204828,482
23129961,17.4114,23.825,475,73134,0.909776,0.77,2,205326,204851,475
23132881,13.0823,17.565,471,73163,0.909955,0.75,2,205338,204867,471
23135801,15.4165,13.913,474,73192,0.925991,0.75,2,205354,204880,474
23138721,17.4833,15.5826,476,73221,0.929198,0.75,2,205372,204896,476
23141641,18.6967,17.5165,477,73250,0.91384,0.75,2,205391,204914,477
23144561,14.9393,17.9033,473,73279,0.942768,0.77,2,205405,204932,473
23556281,16,14,485,77196,0.91,1,2,208051,207566,485
23559201,14.4,11.6,488,77223,0.91,1,2,208065,207577,488
23562121,20.48,33.52,471,77250,0.894,1,2,208087,207616,471
23565041,30.496,17.904,490,77277,0.7788,1,2,208120,207630,490
23567961,22.8992,24.3808,485,77304,0.69176,1,1,208141,207656,485
23570881,18.1798,14.4762,490,77331,0.642352,1,1,208158,207668,490
23573801,14.836,20.4952,482,77358,0.60047,1,1,208172,207690,482
23576721,12.5672,13.699,482,77385,0.608094,1,1,208184,207702,482
23579641,13.7134,18.7398,476,77412,0.577619,1,1,208198,207722,476
23582561,28.3427,19.748,488,77439,0.507524,1,1,208230,207742,488
23585481,20.0685,15.9496,491,77466,0.493505,1,1,208248,207757,491
23588401,16.8137,15.1899,492,77493,0.442701,1,1,208264,207772,492
23591321,15.3627,26.238,478,77520,0.36854,1,1,208279,207801,478
23594241,32.6725,34.8476,478,77547,0.273708,1,1,208316,207838,478
23597161,26.5345,27.7695,477,77574,0.142742,1,1,208341,207864,477
23600081,20.5069,18.3539,480,77601,0.100548,1,1,208360,207880,480
23603001,17.7014,22.8708,473,77628,0.0281097,1,1,208377,207904,473
23605921,17.9403,18.1742,474,77655,0.00562193,1,1,208395,207921,474
23608841,18.7881,17.2348,476,77682,0.00912439,0.98,1,208414,207938,476
23611761,14.9576,16.247,474,77709,0.00982488,0.95,1,208428,207954,474
23614681,13.3915,14.4494,473,77736,0.00996498,0.93,1,208441,207968,473
23617601,13.0783,13.2899,473,77763,0.009993,1,1,208454,207981,473
23620521,11.4157,12.258,472,77790,0.0259986,0.97,1,208465,207993,472
23623441,11.0831,13.6516,469,77817,0.0291997,0.96,1,208476,208007,469
23626361,12.6166,13.9303,468,77844,0.0138399,0.94,1,208489,208021,468
23629281,12.9233,13.9861,467,77871,0.010768,0.91,1,208502,208035,467
23632201,15.3847,15.5972,467,77898,0.298154,0.91,1,208518,208051,467
23635121,13.4769,14.3194,466,77925,0.339631,0.89,1,208531,208065,466
23638041,17.8954,20.4639,463,77952,0.315926,0.75,1,208550,208087,463
23640961,22.7791,30.4928,454,77979,0.247185,0.67,1,208574,208120,454
23643881,20.5558,22.8986,453,78006,0.153437,0.63,1,208594,208141,453
23646801,16.1112,18.1797,451,78033,0.102687,0.59,1,208609,208158,451
23649721,12.8222,14.8359,449,78060,0.0925375,0.59,1,208621,208172,449
23652641,12.1644,2.96719,461,78087,0.0745075,0.61,1,208633,208172,461
23655561,12.8329,10.1934,462,78114,0.0389015,0.57,1,208646,208184,462
23658481,26.5666,13.2387,478,78141,0.0157803,0.49,1,208676,208198,478
23661401,17.3133,28.2477,461,78168,0.00315606,0.49,1,208691,208230,461
23664321,12.2627,20.0495,454,78195,0.0246312,0.43,1,208702,208248,454
23667241,11.2525,16.8099,449,78222,0.0769262,0.35,1,208713,208264,449
23670161,27.8505,15.362,466,78249,0.0873853,0.25,1,208745,208279,466
23673081,21.5701,32.6724,449,78276,0.057477,0.11,1,208765,208316,449
23676001,17.114,26.5345,440,78303,0.0834954,0.09,1,208781,208341,440
23678921,17.0228,20.5069,438,78330,0.0566991,0.01,1,208798,208360,438
23681841,17.8046,17.7014,439,78357,0.0113398,0,1,208816,208377,439
23684761,18.7609,17.9403,440,78384,0.010268,0.01,1,208835,208395,440
23687681,14.9522,18.7881,435,78411,0.0260536,0.01,1,208849,208414,435
23690601,13.3904,14.9576,434,78438,0.0292107,0.01,1,208862,208428,434
23693521,13.0781,13.3915,434,78465,0.00584214,0.01,1,208875,208441,434
23696441,11.4156,13.0783,432,78492,0.0251684,0.03,1,208886,208454,432
23699361,11.0831,11.4157,432,78519,0.0450337,0.03,1,208897,208465,432
23702281,12.6166,11.0831,434,78546,0.00900674,0.01,1,208910,208476,434
23705201,26.5233,12.6166,451,78573,0.00980135,0.01,1,208940,208489,451
23708121,18.1047,12.9233,454,78600,0.0259603,0.37,1,208956,208502,454
23711041,12.4209,15.3847,449,78627,0.0451921,0.35,1,208967,208518,449
23713961,15.2842,13.4769,452,78654,0.0650384,0.31,1,208983,208531,452
23716881,18.2568,17.8954,452,78681,0.0530077,0.23,1,209002,208550,452
23719801,17.2514,22.7791,445,78708,0.0666015,0.13,1,209019,208574,445
23722721,15.4503,20.5558,440,78735,0.0533203,0.09,1,209034,208594,440
23725641,11.8901,16.1112,436,78762,0.0666641,0.09,1,209045,208609,436
23728561,10.378,12.8222,434,78789,0.0693328,0.07,1,209055,208621,434
23731481,12.4756,12.1644,435,78816,0.0218666,0.03,1,209068,208633,435
23734401,26.4951,12.8329,452,78843,0.0123733,0.01,1,209098,208646,452
23737321,16.499,26.5666,436,78870,0.0584747,0,1,209112,208676,436
23740241,14.4998,17.3133,435,78897,0.0356949,0.03,1,209126,208691,435
23743161,9.29996,12.2627,432,78924,0.047139,0.09,1,209134,208702,432
23746081,30.66,11.2525,457,78951,0.0334278,0.09,1,209170,208713,457
23749001,20.532,27.8505,443,78977,0.0306856,0.05,1,209188,208745,443
23751921,16.9064,21.5701,439,79003,0.0301371,0.09,1,209204,208765,439
23754841,16.9813,17.114,440,79029,0.0140274,0.05,1,209221,208781,440
23757761,16.1963,17.0228,439,79055,0.00280548,0,1,209237,208798,439
23760681,18.4393,17.8046,440,79081,0.0085611,0.01,1,209256,208816,440
23763601,14.8878,18.7609,435,79107,0.00171222,0.03,1,209270,208835,435
23766521,13.3776,14.9522,434,79133,0.0243424,0.03,1,209283,208849,434
23769441,13.0755,13.3904,434,79159,0.0128685,0,1,209296,208862,434
23772361,12.2151,13.0781,433,79185,0.0105737,0.03,1,209308,208875,433
23775281,10.443,11.4156,432,79211,0.0261147,0.05,1,209318,208886,432
23778201,12.4886,11.0831,434,79237,0.0132229,0,1,209331,208897,434
23781121,27.2977,12.6166,452,79263,0.0426446,0.01,1,209362,208910,452
23784041,18.2595,26.5233,438,79289,0.0485289,0.03,1,209378,208940,438
23786961,14.0519,18.1047,435,79315,0.0657058,0.05,1,209391,208956,435
23789881,15.6104,12.4209,440,79341,0.0531412,0.07,1,209407,208967,440
23792801,17.5221,15.2842,442,79367,0.0506282,0.05,1,209425,208983,442
23795721,17.9044,18.2568,441,79393,0.0501256,0.07,1,209443,209002,441
23798641,14.7809,17.2514,438,79419,0.0500251,0.05,1,209457,209019,438
23801561,12.5562,15.4503,435,79445,0.066005,0.07,1,209469,209034,435
23804481,8.91124,11.8901,432,79471,0.069201,0.07,1,209477,209045,432
23807401,11.3822,10.378,434,79497,0.0698402,0.01,1,209489,209055,434
23810321,3.87645,12.4756,423,79523,0.069968,0.01,1,209491,209068,423
23813241,25.5753,26.4951,424,79549,0.0139936,0.07,1,209522,209098,424
23816161,15.5151,16.499,423,79575,0.0267987,0.03,1,209535,209112,423
23819081,15.103,14.4998,424,79601,0.0453597,0.05,1,209550,209126,424
23822001,9.4206,9.29996,424,79627,0.081072,0.03,1,209558,209134,424
23824921,29.8841,30.66,423,79653,0.0402144,0.03,1,209593,209170,423
23827841,20.3768,20.532,423,79679,0.0320429,0.03,1,209611,209188,423
23830761,16.8754,16.9064,423,79705,0.0624086,0.01,1,209627,209204,423
23833681,16.9751,16.9813,423,79731,0.0524817,0,1,209644,209221,423
23836601,15.395,16.1963,422,79757,0.0104963,0.01,1,209659,209237,422
23839521,19.079,18.4393,423,79783,0.0100993,0,1,209679,209256,423
23842441,14.2158,14.8878,422,79809,0.0260199,0.03,1,209692,209270,422
23845361,14.0432,13.3776,423,79835,0.013204,0.01,1,209706,209283,423
23848281,12.4086,13.0755,422,79861,0.0106408,0.01,1,209718,209296,422
23851201,12.8817,12.2151,423,79887,0.00212816,0.03,1,209731,209308,423
23854121,10.5763,10.443,423,79913,0.000425632,0.01,1,209741,209318,423
23857041,11.7153,12.4886,422,79939,0.00808513,0.05,1,209753,209331,422
23859961,28.7431,27.2977,424,79965,0.00961703,0.05,1,209786,209362,424
23862881,18.5486,18.2595,424,79991,0.0259234,0.07,1,209802,209378,424
23865801,14.1097,14.0519,424,80017,0.0451847,0.05,1,209815,209391,424
23868721,15.6219,15.6104,424,80043,0.0170369,0.05,1,209831,209407,424
23871641,17.5244,17.5221,424,80069,0.0114074,0.05,1,209849,209425,424
23874561,17.9049,17.9044,424,80095,0.0102815,0.05,1,209867,209443,424
23877481,15.581,14.7809,425,80121,0.0260563,0.07,1,209882,209457,425
23880401,12.7162,12.5562,425,80147,0.0292113,0.07,1,209894,209469,425
23883321,8.94324,8.91124,425,80173,0.0298423,0.07,1,209902,209477,425
23886241,9.78865,11.3822,423,80199,0.0299684,0.07,1,209912,209489,423
23889161,3.55773,3.87645,423,80225,0.0299937,0,1,209914,209491,423
23892081,24.7115,25.5753,422,80251,0.0299987,0.03,1,209944,209522,422
23895001,16.1423,15.5151,423,80277,0.0139997,0.05,1,209958,209535,423
23897921,16.0285,15.103,424,80303,0.0587999,0.09,1,209974,209550,424
23900841,9.60569,9.4206,424,80329,0.08376,0.03,1,209982,209558,424
23903761,29.1211,29.8841,423,80355,0.136752,0.03,1,210016,209593,423
23906681,20.2242,20.3768,423,80381,0.14735,0.07,1,210034,209611,423
23909601,16.8448,16.8754,423,80407,0.14947,0.05,1,210050,209627,423
23912521,16.169,16.9751,422,80433,0.149894,0,1,210066,209644,422
23915441,15.2338,15.395,422,80459,0.101979,0.01,1,210081,209659,422
23918361,19.0468,19.079,422,80485,0.0283958,0.03,1,210101,209679,422
23921281,14.2094,14.2158,422,80511,0.0296792,0.01,1,210114,209692,422
23924201,14.0419,14.0432,422,80537,0.0459358,0.01,1,210128,209706,422
23927121,12.4084,12.4086,422,80563,0.0171872,0,1,210140,209718,422
23930041,12.8817,12.8817,422,80589,0.0274374,0,1,210153,209731,422
23932961,10.5763,10.5763,422,80615,0.0134875,0.01,1,210163,209741,422
23935881,11.7153,11.7153,422,80641,0.0106975,0.01,1,210175,209753,422
23938801,29.5431,28.7431,423,80667,0.0261395,0.03,1,210209,209786,423
23941721,18.7086,18.5486,423,80693,0.0452279,0.05,1,210225,209802,423
23944641,13.3417,14.1097,422,80719,0.0170456,0.01,1,210237,209815,422
23947561,15.4683,15.6219,422,80745,0.0434091,0.01,1,210253,209831,422
23950481,17.4937,17.5244,422,80771,0.0326818,0.01,1,210271,209849,422
23953401,17.8987,17.9049,422,80797,0.0305364,0.03,1,210289,209867,422
23956321,16.3797,15.581,423,80823,0.0301073,0.03,1,210305,209882,423
23959241,12.8759,12.7162,423,80849,0.0300215,0.03,1,210317,209894,423
23962161,8.97519,8.94324,423,80875,0.0300043,0.03,1,210325,209902,423
23965081,9.79504,9.78865,423,80901,0.0300009,0.03,1,210335,209912,423
23968001,3.55901,3.55773,423,80927,0.0300002,0.03,1,210337,209914,423
23970921,23.9118,24.7115,422,80953,0.03,0.01,1,210366,209944,422
23973841,15.9824,16.1423,422,80979,0.014,0.01,1,210380,209958,422
23976761,16.7965,3.22846,439,81005,0.0428,0.07,1,210397,209958,439
23979681,9.75929,13.4457,431,81031,0.04856,0.09,1,210405,209974,431
23982601,31.5519,9.08914,460,81057,0.033712,0.15,1,210442,209982,460
23985521,20.7104,29.0178,444,81083,0.0307424,0.15,1,210460,210016,444
23988441,16.9421,20.2036,442,81109,0.0301485,0.15,1,210476,210034,442
23991361,16.1884,16.8407,442,81135,0.0300297,0.15,1,210492,210050,442
23994281,11.2377,16.1681,436,81161,0.0300059,0.09,1,210502,210066,436
23997201,18.2475,15.2336,441,81187,0.0300012,0.01,1,210522,210081,441
24000121,14.0495,19.0467,434,81213,0.00600024,0.03,1,210535,210101,434
24003041,14.0099,14.2093,435,81239,0.0252,0.05,1,210549,210114,435
24005961,12.402,14.0419,433,81265,0.01304,0.01,1,210561,210128,433
24008881,12.8804,12.4084,434,81291,0.002608,0.03,1,210574,210140,434
24011801,10.5761,12.8817,431,81317,0.0245216,0.01,1,210584,210153,431
24014721,11.7152,10.5763,433,81343,0.0289043,0.01,1,210596,210163,433
24017641,29.543,11.7153,455,81369,0.0457809,0.03,1,210630,210175,455
24020561,18.7086,29.5431,437,81395,0.0331562,0.05,1,210646,210209,437
24023481,13.3417,18.7086,433,81421,0.0306312,0.01,1,210658,210225,433
24026401,16.2683,13.3417,438,81447,0.0621262,0.05,1,210675,210237,438
24029321,17.6537,15.4683,440,81473,0.0684252,0.03,1,210693,210253,440
24032241,17.9307,17.4937,440,81499,0.069685,0.03,1,210711,210271,440
24035161,16.3861,17.8987,438,81525,0.069937,0.03,1,210727,210289,438
24038081,12.8772,16.3797,434,81551,0.0699874,0.03,1,210739,210305,434
24041001,8.97545,12.8759,430,81577,0.0699975,0.03,1,210747,210317,430
24043921,10.5951,8.97519,433,81603,0.0859995,0.03,1,210758,210325,433
24046841,3.71902,9.79504,425,81629,0.0571999,0.03,1,210760,210335,425
24049761,22.3438,3.55901,450,81655,0.03544,0.03,1,210787,210337,450
24052681,15.6688,23.9118,435,81681,0.015088,0.01,1,210801,210366,435
24055601,18.3338,15.9824,440,81707,0.0430176,0.05,1,210820,210380,440
24058521,10.0668,16.7965,431,81733,0.0486035,0.05,1,210828,210397,431
24061441,30.8134,9.75929,459,81759,0.0657207,0.03,1,210864,210405,459
24064361,20.5627,31.5519,440,81785,0.101144,0.03,1,210882,210442,440
24067281,16.9125,20.7104,438,81811,0.108229,0.03,1,210898,210460,438
24070201,16.1825,16.9421,438,81837,0.141646,0.03,1,210914,210476,438
24073121,11.2365,16.1884,432,81863,0.148329,0.03,1,210924,210492,432
24076041,17.4473,11.2377,441,81889,0.165666,0.03,1,210943,210502,441
24078961,14.6895,18.2475,435,81915,0.105133,0,1,210957,210522,435
24081881,13.3379,14.0495,435,81941,0.109027,0.03,1,210970,210535,435
24084801,12.2676,14.0099,433,81967,0.0778053,0.01,1,210982,210549,433
24087721,13.6535,12.402,435,81993,0.0155611,0,1,210996,210561,435
24090641,10.7307,12.8804,432,82018,0.0271122,0.03,1,211006,210574,432
24093561,10.9461,10.5761,433,82043,0.0454224,0.03,1,211017,210584,433
24096481,29.3892,11.7152,455,82068,0.0330845,0.05,1,211051,210596,455
24099401,19.4778,29.543,438,82093,0.0306169,0.03,1,211068,210630,438
24102321,13.4956,18.7086,434,82118,0.0301234,0.03,1,211080,210646,434
24105241,17.8991,13.3417,441,82143,0.0460247,0.07,1,211099,210658,441
24108161,17.9798,16.2683,442,82168,0.0492049,0.07,1,211117,210675,442
24111081,17.996,17.6537,442,82193,0.065841,0.07,1,211135,210693,442
24114001,16.3992,17.9307,440,82218,0.0691682,0.07,1,211151,210711,440
24116921,12.8798,16.3861,436,82243,0.0698336,0.07,1,211163,210727,436
24119841,8.97597,12.8772,432,82268,0.0699667,0.07,1,211171,210739,432
24122761,9.79519,8.97545,434,82293,0.0699933,0.09,1,211181,210747,434
24125681,3.55904,10.5951,425,82318,0.0699987,0.05,1,211183,210758,425
24128601,20.7118,3.71902,448,82343,0.0859997,0.03,1,211208,210760,448
24131521,16.1424,22.3438,436,82368,0.0731999,0.01,1,211223,210787,436
24134441,19.2285,15.6688,442,82393,0.03864,0.05,1,211243,210801,442
24137361,10.2457,18.3338,431,82418,0.031728,0.05,1,211251,210820,431
24140281,31.6491,10.0668,460,82443,0.0463456,0.07,1,211288,210828,460
24143201,7.92983,30.8134,426,82468,0.0492691,0.11,1,211290,210864,426
24146121,16.786,20.5627,427,82493,0.0338538,0.11,1,211309,210882,427
24149041,16.1572,16.9125,427,82518,0.0627708,0.15,1,211325,210898,427
24151961,17.6314,16.1825,429,82543,0.100554,0.15,1,211343,210914,429
24154881,11.5263,11.2365,429,82568,0.0761108,0.17,1,211353,210924,429
24157801,16.7053,17.4473,428,82593,0.103222,0.09,1,211371,210943,428
24160721,12.9411,14.6895,426,82618,0.108644,0.11,1,211383,210957,426
24163641,12.1882,13.3379,425,82643,0.0777289,0.07,1,211395,210970,425
24166561,9.63764,12.2676,422,82668,0.0875458,0,1,211404,210982,422
24169481,13.9275,13.6535,423,82693,0.0415092,0.03,1,211419,210996,423
24172401,10.7855,10.7307,423,82718,0.00830183,0.05,1,211429,211006,423
24175321,10.1571,10.9461,422,82743,0.00966037,0.03,1,211439,211017,422
24178241,30.0314,29.3892,423,82768,0.00993207,0.03,1,211474,211051,423
24181161,19.6063,19.4778,423,82793,0.00998641,0.03,1,211491,211068,423
24184081,13.5213,13.4956,423,82818,0.00999728,0.05,1,211503,211080,423
24187001,18.7043,17.8991,424,82843,0.00999946,0.05,1,211523,211099,424
24189921,18.9408,17.9798,425,82868,0.0259999,0.07,1,211542,211117,425
24192841,18.1882,17.996,425,82893,0.0292,0.07,1,211560,211135,425
24195761,16.4376,16.3992,425,82918,0.06184,0.07,1,211576,211151,425
24198681,12.8875,12.8798,425,82943,0.036368,0.07,1,211588,211163,425
24201601,8.97751,8.97597,425,82968,0.0312736,0.07,1,211596,211171,425
24204521,9.7955,9.79519,425,82993,0.0302547,0.07,1,211606,211181,425
24207441,3.5591,3.55904,425,83018,0.0620509,0.09,1,211608,211183,425
24210361,19.9118,20.7118,424,83043,0.0364102,0.07,1,211632,211208,424
24213281,15.1824,16.1424,423,83068,0.031282,0.03,1,211646,211223,423
24216201,19.0365,19.2285,423,83093,0.0302564,0.03,1,211666,211243,423
24219121,11.0073,10.2457,424,83118,0.0460513,0.05,1,211675,211251,424
24222041,31.8015,31.6491,424,83143,0.0652103,0.05,1,211712,211288,424
24224961,7.96029,7.92983,424,83168,0.069042,0.03,1,211714,211290,424
24227881,15.9921,16.786,423,83193,0.0698084,0.07,1,211732,211309,423
24230801,15.9984,16.1572,423,83218,0.0699617,0.11,1,211748,211325,423
24233721,19.1997,17.6314,425,83243,0.101992,0.07,1,211768,211343,425
24236641,11.8399,11.5263,425,83268,0.0763985,0.11,1,211778,211353,425
24239561,16.768,16.7053,425,83293,0.10328,0.11,1,211796,211371,425
24242481,12.9536,12.9411,425,83318,0.156656,0.07,1,211808,211383,425
24245401,12.1907,12.1882,425,83343,0.135331,0.09,1,211820,211395,425
24248321,8.83814,9.63764,424,83368,0.163066,0.03,1,211828,211404,424
24251241,12.1676,13.9275,422,83393,0.152613,0,1,211841,211419,422
24254161,10.4335,10.7855,422,83418,0.0545226,0.01,1,211851,211429,422
24257081,10.0867,10.1571,422,83443,0.0349045,0.01,1,211861,211439,422
24260001,30.0173,30.0314,422,83468,0.0149809,0.01,1,211896,211474,422
24262921,19.6035,19.6063,422,83493,0.0269962,0.01,1,211913,211491,422
24265841,13.5207,13.5213,422,83518,0.0133992,0.01,1,211925,211503,422
24268761,18.7041,18.7043,422,83543,0.0266798,0.03,1,211945,211523,422
24271681,18.9408,18.9408,422,83568,0.045336,0.03,1,211964,211542,422
24274601,18.9882,18.1882,423,83593,0.0170672,0.07,1,211983,211560,423
24277521,16.5976,16.4376,423,83618,0.0274134,0.03,1,211999,211576,423
24280441,12.9195,12.8875,423,83643,0.0294827,0.03,1,212011,211588,423
24283361,8.98391,8.97751,423,83668,0.0298965,0.03,1,212019,211596,423
24286281,9.79678,9.7955,423,83693,0.0299793,0.07,1,212029,211606,423
24289201,3.55936,3.5591,423,83718,0.0299959,0.03,1,212031,211608,423
24292121,19.9119,19.9118,423,83743,0.0299992,0.03,1,212055,211632,423
24295041,15.1824,15.1824,423,83768,0.0299998,0.03,1,212069,211646,423
24297961,19.0365,19.0365,423,83793,0.03,0.05,1,212089,211666,423
24300881,10.2073,11.0073,422,83818,0.062,0.07,1,212097,211675,422
24303801,32.4415,31.8015,423,83843,0.1004,0.07,1,212135,211712,423
24306721,8.08829,7.96029,423,83868,0.10808,0.07,1,212137,211714,423
24309641,16.0177,15.9921,423,83893,0.109616,0.07,1,212155,211732,423
24312561,16.8035,15.9984,424,83918,0.0939232,0.07,1,212172,211748,424
24315481,19.3607,3.19968,444,83943,0.0907846,0.11,1,212192,211748,444
24318401,12.6721,16.6399,435,83968,0.106157,0.07,1,212203,211768,435
24321321,18.5344,11.328,445,83993,0.0772314,0.11,1,212223,211778,445
24324241,13.3069,16.6656,439,84018,0.0714463,0.17,1,212235,211796,439
24327161,12.2614,12.9331,439,84043,0.0702893,0.13,1,212247,211808,439
24330081,8.85228,12.1866,435,84068,0.0700578,0.17,1,212255,211820,435
24333001,8.17046,8.83732,435,84093,0.0700116,0.15,1,212263,211828,435
24335921,9.63409,12.1675,432,84118,0.0700023,0.03,1,212273,211841,432
24338841,9.92682,10.4335,432,84143,0.0700005,0.03,1,212283,211851,432
24341761,29.1854,10.0867,456,84168,0.0380001,0.01,1,212317,211861,456
24344681,19.4371,30.0173,438,84193,0.0476,0.03,1,212334,211896,438
24347601,14.2874,19.6035,434,84218,0.04952,0.01,1,212347,211913,434
24350521,18.8575,13.5207,442,84243,0.033904,0.03,1,212367,211925,442
24353441,18.1715,18.7041,440,84268,0.0307808,0.05,1,212385,211945,440
24356361,18.8343,18.9408,440,84293,0.0141562,0.01,1,212404,211964,440
24359281,17.3669,18.9882,438,84318,0.0428312,0.03,1,212421,211983,438
24362201,13.0734,16.5976,434,84343,0.0645662,0.03,1,212433,211999,434
24365121,9.01467,12.9195,430,84368,0.0689132,0.03,1,212441,212011,430
24368041,9.80293,8.98391,432,84393,0.0697826,0.03,1,212451,212019,432
24370961,3.56059,9.79678,424,84418,0.0699565,0.03,1,212453,212029,424
24373881,19.9121,3.55936,446,84443,0.0699913,0.03,1,212477,212031,446
24376801,15.1824,19.9119,436,84468,0.0699983,0.03,1,212491,212055,436
24379721,19.0365,15.1824,442,84493,0.0699997,0.03,1,212511,212069,442
24382641,10.2073,19.0365,430,84518,0.0699999,0.07,1,212519,212089,430
24385561,34.0415,10.2073,462,84543,0.07,0.11,1,212559,212097,462
24388481,8.40829,32.4415,426,84568,0.07,0.11,1,212561,212135,426
24391401,16.0817,8.08829,442,84593,0.07,0.11,1,212579,212137,442
24394321,17.6163,16.0177,442,84618,0.07,0.09,1,212597,212155,442
24397241,19.5233,16.8035,445,84643,0.07,0.09,1,212617,212172,445
24400161,13.5047,19.3607,437,84668,0.07,0.11,1,212629,212192,437
24403081,17.1009,12.6721,444,84693,0.102,0.07,1,212647,212203,444
24406001,13.0202,18.5344,436,84718,0.1244,0.07,1,212659,212223,436
24408921,12.204,13.3069,436,84743,0.12888,0.07,1,212671,212235,436
24411841,8.84081,12.2614,432,84768,0.129776,0.07,1,212679,212247,432
24414761,8.16816,8.85228,432,84793,0.145955,0.07,1,212687,212255,432
24417681,9.63363,8.17046,434,84818,0.149191,0.07,1,212697,212263,434
24420601,9.92673,9.63409,434,84843,0.149838,0.07,1,212707,212273,434
24423521,27.5853,9.92682,456,84868,0.149968,0.03,1,212739,212283,456
24426441,19.1171,29.1854,439,84893,0.133994,0.05,1,212756,212317,439
24429361,14.2234,19.4371,435,84918,0.162799,0.05,1,212769,212334,435
24432281,18.8447,14.2874,442,84943,0.13656,0.03,1,212789,212347,442
24435201,18.1689,18.8575,440,84968,0.131312,0.03,1,212807,212367,440
24438121,18.8338,18.1715,441,84993,0.162262,0.01,1,212826,212385,441
24441041,18.9668,18.8343,441,85018,0.152452,0.05,1,212845,212404,441
24443961,13.3934,17.3669,436,85043,0.15049,0.07,1,212857,212421,436
24446881,9.07867,13.0734,432,85068,0.150098,0.07,1,212865,212433,432
24449801,9.81573,9.01467,434,85093,0.16602,0.07,1,212875,212441,434
24452721,3.56315,9.80293,426,85118,0.169204,0.07,1,212877,212451,426
24455641,19.9126,3.56059,448,85143,0.169841,0.07,1,212901,212453,448
24458561,15.1825,19.9121,438,85168,0.169968,0.07,1,212915,212477,438
24461481,19.0365,15.1824,444,85193,0.169994,0.07,1,212935,212491,444
24464401,10.2073,19.0365,432,85218,0.169999,0.07,1,212943,212511,432
24467321,34.0415,10.2073,464,85243,0.17,0.07,1,212983,212519,464
24470241,8.40829,34.0415,426,85268,0.17,0.07,1,212985,212559,426
24473161,16.0817,8.40829,442,85292,0.186,0.07,1,213003,212561,442
24476081,17.6163,16.0817,442,85316,0.1892,0.07,1,213021,212579,442
24479001,19.5233,17.6163,444,85340,0.18984,0.07,1,213041,212597,444
24481921,13.5047,19.5233,436,85364,0.205968,0.07,1,213053,212617,436
24484841,4.30093,13.5047,426,85388,0.209194,0.11,1,213055,212629,426
24487761,16.8602,17.1009,428,85412,0.209839,0.13,1,213075,212647,428
24490681,12.972,13.0202,428,85436,0.209968,0.13,1,213087,212659,428
24493601,12.1944,12.204,428,85460,0.209994,0.13,1,213099,212671,428
24496521,9.63888,8.84081,429,85484,0.193999,0.15,1,213108,212679,429
24499441,8.32778,8.16816,429,85508,0.2228,0.15,1,213116,212687,429
24502361,9.66556,9.63363,429,85532,0.19656,0.15,1,213126,212697,429
24505281,9.93311,9.92673,429,85556,0.191312,0.15,1,213136,212707,429
24508201,27.5866,27.5853,429,85580,0.190262,0.13,1,213168,212739,429
24511121,18.3173,19.1171,428,85604,0.190052,0.17,1,213184,212756,428
24514041,14.0635,14.2234,428,85628,0.206011,0.13,1,213197,212769,428
24516961,18.8127,18.8447,428,85652,0.241202,0.13,1,213217,212789,428
24519881,18.9625,18.1689,429,85676,0.23224,0.17,1,213236,212807,429
24522801,18.1925,18.8338,428,85700,0.230448,0.15,1,213254,212826,428
24525721,19.6385,18.9668,429,85724,0.26209,0.15,1,213274,212845,429
24528641,13.5277,13.3934,429,85748,0.236418,0.15,1,213286,212857,429
24531561,9.90554,9.07867,430,85772,0.247284,0.17,1,213295,212865,430
24534481,9.98111,9.81573,430,85796,0.217457,0.17,1,213305,212875,430
24537401,3.59622,3.56315,430,85820,0.243491,0.17,1,213307,212877,430
24540321,19.9192,19.9126,430,85844,0.232698,0.17,1,213331,212901,430
24543241,15.1838,15.1825,430,85868,0.23054,0.17,1,213345,212915,430
24546161,19.0368,19.0365,430,85892,0.230108,0.17,1,213365,212935,430
24549081,10.2074,10.2073,430,85916,0.262022,0.17,1,213373,212943,430
24552001,34.8415,34.0415,431,85940,0.252404,0.17,1,213414,212983,431
24554921,8.56829,8.40829,431,85964,0.250481,0.19,1,213416,212985,431
24557841,16.1137,16.0817,431,85988,0.250096,0.19,1,213434,213003,431
24560761,17.6227,17.6163,431,86012,0.250019,0.19,1,213452,213021,431
24563681,20.3245,19.5233,432,86036,0.234004,0.21,1,213473,213041,432
24566601,13.6649,13.5047,432,86060,0.262801,0.21,1,213485,213053,432
24569521,4.33298,4.30093,432,86084,0.26856,0.21,1,213487,213055,432
24572441,15.2666,16.8602,430,86108,0.237712,0.21,1,213505,213075,430
24575361,12.6533,12.972,430,86132,0.263542,0.21,1,213517,213087,430
24578281,12.1307,12.1944,430,86156,0.252708,0.19,1,213529,213099,430
24581201,10.4261,9.63888,431,86180,0.282542,0.23,1,213539,213108,431
24584121,8.48523,8.32778,431,86204,0.288508,0.19,1,213547,213116,431
24587041,9.69705,9.66556,431,86228,0.289702,0.19,1,213557,213126,431
24589961,9.93941,9.93311,431,86252,0.30594,0.19,1,213567,213136,431
24592881,27.5879,27.5866,431,86276,0.309188,0.19,1,213599,213168,431
24595801,18.3176,18.3173,431,86300,0.341838,0.21,1,213615,213184,431
24598721,14.8635,14.0635,432,86324,0.316368,0.25,1,213629,213197,432
24601641,18.9727,18.8127,432,86348,0.327273,0.23,1,213649,213217,432
24604561,19.7945,18.9625,433,86372,0.329455,0.23,1,213669,213236,433
24607481,18.3589,18.1925,433,86396,0.345891,0.27,1,213687,213254,433
24610401,19.6718,19.6385,433,86420,0.381178,0.23,1,213707,213274,433
24613321,13.5344,13.5277,433,86444,0.356236,0.25,1,213719,213286,433
24616241,9.10687,9.90554,432,86468,0.351247,0.21,1,213727,213295,432
24619161,10.6214,9.98111,433,86492,0.366249,0.25,1,213738,213305,433
24622081,3.72427,3.59622,433,86516,0.36925,0.23,1,213740,213307,433
24625001,19.9449,19.9192,433,86540,0.33785,0.23,1,213764,213331,433
24627921,15.189,15.1838,433,86564,0.34757,0.23,1,213778,213345,433
24630841,19.0378,19.0368,433,86588,0.349514,0.27,1,213798,213365,433
24633761,10.2076,10.2074,433,86612,0.381903,0.25,1,213806,213373,433
24636681,34.0415,34.8415,432,86636,0.388381,0.25,1,213846,213414,432
24639601,8.4083,8.56829,432,86660,0.389676,0.25,1,213848,213416,432
24642521,16.0817,16.1137,432,86684,0.389935,0.25,1,213866,213434,432
24645441,17.6163,17.6227,432,86708,0.405987,0.23,1,213884,213452,432
24648361,21.1233,20.3245,433,86732,0.409197,0.27,1,213906,213473,433
24651281,13.8247,13.6649,433,86756,0.409839,0.27,1,213918,213485,433
24654201,4.36493,4.33298,433,86780,0.409968,0.23,1,213920,213487,433
24657121,15.273,15.2666,433,86804,0.377994,0.27,1,213938,213505,433
24660041,12.6546,12.6533,433,86828,0.419599,0.27,1,213950,213517,433
24662961,13.7309,2.53066,447,86852,0.39592,0.25,1,213964,213517,447
24665881,10.7462,10.1061,445,86876,0.423184,0.29,1,213974,213529,445
24668801,8.54924,10.0212,443,86900,0.428637,0.29,1,213982,213539,443
24671721,10.5098,8.40425,446,86924,0.445727,0.29,1,213993,213547,446
24674641,10.102,9.68085,446,86948,0.417145,0.31,1,214003,213557,446
24677561,27.6204,9.93617,468,86972,0.411429,0.31,1,214035,213567,468
24680481,18.3241,27.5872,452,86996,0.410286,0.35,1,214051,213599,452
24683401,15.6648,18.3174,451,87020,0.394057,0.31,1,214066,213615,451
24686321,19.133,14.8635,457,87044,0.390811,0.33,1,214086,213629,457
24689241,19.8266,18.9727,457,87068,0.390162,0.33,1,214106,213649,457
24692161,19.1653,19.7945,456,87092,0.374032,0.35,1,214125,213669,456
24695081,19.8331,18.3589,458,87116,0.370807,0.39,1,214145,213687,458
24698001,13.5666,19.6718,450,87140,0.370161,0.35,1,214157,213707,450
24700921,9.11332,13.5344,446,87164,0.370032,0.35,1,214165,213719,446
24703841,9.82266,9.10687,448,87188,0.370006,0.37,1,214175,213727,448
24706761,3.56453,10.6214,439,87212,0.370001,0.37,1,214177,213738,439
24709681,20.7129,3.72427,462,87236,0.386,0.33,1,214202,213740,462
24712601,15.3426,19.9449,452,87260,0.3892,0.35,1,214216,213764,452
24715521,19.0685,15.189,458,87284,0.40584,0.35,1,214236,213778,458
24718441,10.2137,19.0378,446,87308,0.409168,0.39,1,214244,213798,446
24721361,34.0427,10.2076,478,87332,0.409834,0.39,1,214284,213806,478
24724281,8.40855,34.0415,440,87356,0.409967,0.39,1,214286,213846,440
24727201,16.0817,8.4083,456,87380,0.409993,0.39,1,214304,213848,456
24730121,18.4163,16.0817,457,87404,0.425999,0.41,1,214323,213866,457
24733041,21.2833,17.6163,461,87428,0.4292,0.41,1,214345,213884,461
24735961,13.8567,21.1233,451,87452,0.42984,0.41,1,214357,213906,451
24738881,4.37133,13.8247,441,87476,0.429968,0.41,1,214359,213918,441
24741801,16.0743,4.36493,458,87500,0.413994,0.37,1,214378,213920,458
24744721,12.8149,15.273,452,87524,0.410799,0.43,1,214390,213938,452
24747641,15.363,12.6546,456,87548,0.41016,0.39,1,214406,213950,456
24750561,11.0726,13.7309,452,87572,0.410032,0.43,1,214416,213964,452
24753481,8.61452,10.7462,450,87596,0.410006,0.43,1,214424,213974,450
24756401,9.7229,8.54924,452,87620,0.442001,0.45,1,214434,213982,452
24759321,9.94458,10.5098,451,87644,0.4644,0.41,1,214444,213993,451
24762241,27.5889,10.102,473,87668,0.48488,0.41,1,214476,214003,473
24765161,18.3178,27.6204,457,87692,0.488976,0.41,1,214492,214035,457
24768081,14.8636,18.3241,455,87716,0.489795,0.39,1,214506,214051,455
24771001,18.9727,15.6648,460,87740,0.489959,0.39,1,214526,214066,460
24773921,19.7945,19.133,460,87764,0.489992,0.39,1,214546,214086,460
24776841,18.3589,19.8266,458,87788,0.489998,0.37,1,214564,214106,458
24779761,19.6718,19.1653,459,87812,0.506,0.37,1,214584,214125,459
24782681,13.5344,19.8331,451,87836,0.5092,0.37,1,214596,214145,451
24785601,9.10687,13.5666,447,87860,0.50984,0.37,1,214604,214157,447
24788521,9.82137,9.11332,449,87884,0.525968,0.37,1,214614,214165,449
24791441,3.56427,9.82266,441,87908,0.529194,0.37,1,214616,214175,441
24794361,21.5129,3.56453,465,87932,0.529839,0.39,1,214642,214177,465
24797281,16.3026,20.7129,455,87956,0.545968,0.39,1,214657,214202,455
24800201,19.2605,15.3426,461,87980,0.549194,0.41,1,214677,214216,461
24803121,10.2521,19.0685,449,88004,0.549839,0.41,1,214685,214236,449
24806041,34.0504,10.2137,481,88028,0.565968,0.41,1,214725,214244,481
24808961,8.41008,34.0427,443,88052,0.569194,0.41,1,214727,214284,443
24811881,16.082,8.40855,459,88076,0.569839,0.41,1,214745,214286,459
24814801,19.2164,16.0817,461,88100,0.569968,0.43,1,214765,214304,461
24817721,21.4433,18.4163,464,88124,0.569994,0.43,1,214787,214323,464
24820641,13.8887,21.2833,454,88148,0.569999,0.43,1,214799,214345,454
24823561,4.37773,13.8567,444,88172,0.57,0.43,1,214801,214357,444
24826481,15.2755,4.37133,460,88196,0.586,0.41,1,214819,214359,460
24829401,12.6551,16.0743,453,88220,0.5892,0.41,1,214831,214378,453
24832321,15.331,12.8149,457,88244,0.58984,0.41,1,214847,214390,457
24835241,11.0662,15.363,451,88268,0.589968,0.41,1,214857,214406,451
24838161,10.2132,11.0726,451,88292,0.589994,0.41,1,214867,214416,451
24841081,3.64265,8.61452,445,88316,0.589999,0.45,1,214869,214424,445
24844001,8.72853,9.7229,445,88340,0.558,0.47,1,214879,214434,445
24846921,9.74571,9.94458,445,88364,0.5676,0.49,1,214889,214444,445
24849841,28.3491,27.5889,446,88388,0.58552,0.49,1,214922,214476,446
24852761,18.4698,18.3178,446,88412,0.589104,0.49,1,214938,214492,446
24855681,14.894,14.8636,446,88436,0.621821,0.49,1,214952,214506,446
24858601,18.9788,18.9727,446,88460,0.628364,0.49,1,214972,214526,446
24861521,19.7958,19.7945,446,88484,0.629673,0.49,1,214992,214546,446
24864441,19.1592,18.3589,447,88508,0.613935,0.51,1,215011,214564,447
24867361,19.8318,19.6718,447,88532,0.642787,0.51,1,215031,214584,447
24870281,14.3664,13.5344,448,88556,0.632557,0.51,1,215044,214596,448
24873201,9.27327,9.10687,448,88580,0.630511,0.53,1,215052,214604,448
24876121,9.85465,9.82137,448,88604,0.630102,0.53,1,215062,214614,448
24879041,3.57093,3.56427,448,88628,0.662021,0.53,1,215064,214616,448
24881961,21.5142,21.5129,448,88652,0.636404,0.55,1,215090,214642,448
24884881,17.1028,16.3026,449,88676,0.631281,0.55,1,215106,214657,449
24887801,19.4206,19.2605,449,88700,0.630256,0.55,1,215126,214677,449
24890721,10.2841,10.2521,449,88724,0.662051,0.57,1,215134,214685,449
24893641,34.8568,34.0504,450,88748,0.63641,0.57,1,215175,214725,450
24896561,8.57136,8.41008,450,88772,0.631282,0.57,1,215177,214727,450
24899481,16.1143,16.082,450,88796,0.662256,0.57,1,215195,214745,450
24902401,19.2229,19.2164,450,88820,0.668451,0.57,1,215215,214765,450
24905321,21.4446,21.4433,450,88843,0.63769,0.57,1,215237,214787,450
24908241,14.6889,13.8887,451,88866,0.647538,0.57,1,215250,214799,451
24911161,4.53778,4.37773,451,88889,0.649508,0.59,1,215252,214801,451
24914081,15.3076,15.2755,451,88912,0.649902,0.59,1,215270,214819,451
24917001,12.6615,12.6551,451,88935,0.64998,0.59,1,215282,214831,451
24919921,15.3323,15.331,451,88958,0.649996,0.59,1,215298,214847,451
24922841,11.0665,11.0662,451,88981,0.617999,0.59,1,215308,214857,451
24925761,8.61329,10.2132,449,89004,0.6116,0.59,1,215316,214867,449
24928681,3.32266,3.64265,449,89027,0.61032,0.55,1,215318,214869,449
24931601,9.46453,8.72853,450,89050,0.626064,0.57,1,215329,214879,450
24934521,9.89291,9.74571,450,89073,0.629213,0.59,1,215339,214889,450
24937441,29.1786,28.3491,451,89096,0.677843,0.59,1,215373,214922,451
24940361,18.6357,18.4698,451,89119,0.719568,0.63,1,215389,214938,451
24943281,14.9271,14.894,451,89142,0.711914,0.63,1,215403,214952,451
24946201,18.9854,18.9788,451,89165,0.710383,0.63,1,215423,214972,451
24949121,19.7971,19.7958,451,89188,0.710077,0.61,1,215443,214992,451
24952041,19.9594,19.1592,452,89211,0.710015,0.65,1,215463,215011,452
24954961,19.9919,19.8318,452,89234,0.742003,0.63,1,215483,215031,452
24957881,15.1984,14.3664,453,89257,0.764401,0.63,2,215497,215044,453
24960801,9.43968,9.27327,453,89280,0.73688,0.63,1,215505,215052,453
24963721,9.88793,9.85465,453,89303,0.731376,0.67,1,215515,215062,453
24966641,3.57759,3.57093,453,89326,0.730275,0.63,1,215517,215064,453
24969561,21.5155,21.5142,453,89349,0.762055,0.63,2,215543,215090,453
24972481,17.1031,17.1028,453,89372,0.784411,0.63,2,215559,215106,453
24975401,19.4206,19.4206,453,89395,0.756882,0.67,2,215579,215126,453
24978321,11.0841,10.2841,454,89418,0.767376,0.63,2,215588,215134,454
24981241,34.2168,34.8568,453,89441,0.769475,0.63,2,215628,215175,453
24984161,8.44336,8.57136,453,89464,0.769895,0.67,2,215630,215177,453
24987081,16.0887,16.1143,453,89487,0.785979,0.67,2,215648,215195,453
24990001,19.2177,19.2229,453,89510,0.789196,0.63,2,215668,215215,453
24992921,21.4435,21.4446,453,89533,0.789839,0.65,2,215690,215237,453
24995841,13.8887,14.6889,452,89556,0.789968,0.65,2,215702,215250,452
24998761,4.37774,4.53778,452,89579,0.789994,0.65,2,215704,215252,452
25001681,15.2755,15.3076,452,89602,0.757999,0.65,2,215722,215270,452
25004601,12.6551,12.6615,452,89625,0.7836,0.65,2,215734,215282,452
25007521,15.331,15.3323,452,89648,0.80472,0.61,2,215750,215298,452
25010441,11.0662,11.0665,452,89671,0.776944,0.61,2,215760,215308,452
25013361,8.61324,8.61329,452,89694,0.771389,0.61,2,215768,215316,452
25016281,3.32265,3.32266,452,89717,0.770278,0.63,2,215770,215318,452
25019201,10.2645,9.46453,453,89740,0.770056,0.63,2,215782,215329,453
25022121,10.8529,1.89291,464,89763,0.786011,0.63,2,215793,215329,464
25025041,30.1706,8.37858,489,89786,0.789202,0.69,2,215828,215339,489
25027961,19.6341,28.8757,472,89809,0.80584,0.73,2,215845,215373,472
25030881,15.1268,18.5751,470,89832,0.809168,0.71,2,215859,215389,470
25033801,19.0254,14.915,476,89855,0.809834,0.71,2,215879,215403,476
25036721,19.8051,18.983,476,89878,0.809967,0.71,2,215899,215423,476
25039641,19.961,19.7966,476,89901,0.809993,0.71,2,215919,215443,476
25042561,19.9922,19.9593,476,89924,0.809999,0.75,2,215939,215463,476
25045481,15.9984,19.9919,471,89947,0.794,0.77,2,215954,215483,471
25048401,9.59969,15.1984,465,89970,0.7908,0.73,2,215962,215497,465
25051321,9.91994,9.43967,467,89993,0.79016,0.73,2,215972,215505,467
25054241,3.58399,9.88793,459,90016,0.790032,0.73,2,215974,215515,459
25057161,22.3168,3.57759,484,90039,0.806006,0.77,2,216001,215517,484
25060081,17.2634,21.5155,474,90062,0.777201,0.79,2,216017,215543,474
25063001,19.4527,17.1031,478,90085,0.78744,0.75,2,216037,215559,478
25065921,10.2905,19.4206,466,90108,0.789488,0.77,2,216045,215579,466
25068841,34.0581,11.0841,497,90131,0.789898,0.77,2,216085,215588,497
25071761,8.41162,34.2168,459,90154,0.78998,0.77,2,216087,215628,459
25074681,16.8823,8.44336,476,90177,0.821996,0.79,2,216106,215630,476
25077601,19.3765,16.0887,478,90200,0.828399,0.79,2,216126,215648,478
25080521,21.4753,19.2177,480,90223,0.82968,0.79,2,216148,215668,480
25083441,13.8951,21.4435,470,90246,0.829936,0.79,2,216160,215690,470
25086361,4.37901,13.8887,460,90269,0.829987,0.79,2,216162,215702,460
25089281,15.2758,4.37774,476,90292,0.829997,0.75,2,216180,215704,476
25092201,13.4552,15.2755,471,90315,0.813999,0.79,2,216193,215722,471
25095121,15.491,12.6551,475,90338,0.8428,0.81,2,216209,215734,475
25098041,11.0982,15.331,469,90361,0.84856,0.77,2,216219,215750,469
25100961,8.61964,11.0662,467,90384,0.849712,0.77,2,216227,215760,467
25103881,3.32393,8.61324,461,90407,0.849942,0.77,2,216229,215768,461
25106801,10.2648,3.32265,471,90430,0.849988,0.77,2,216241,215770,471
25109721,11.653,10.2645,471,90453,0.849998,0.79,2,216253,215782,471
25112641,30.3306,10.8529,495,90476,0.85,0.79,2,216288,215793,495
25115561,20.4661,30.1706,478,90499,0.85,0.81,2,216306,215828,478
25118481,15.2932,19.6341,475,90522,0.866,0.81,2,216320,215845,475
25121401,19.0586,15.1268,481,90545,0.9012,0.81,2,216340,215859,481
25124321,19.8117,19.0254,481,90568,0.90824,0.81,2,216360,215879,481
25127241,19.9623,19.8051,481,90591,0.909648,0.81,2,216380,215899,481
25130161,19.9925,19.961,481,90614,0.90993,0.81,2,216400,215919,481
25133081,15.1985,19.9922,475,90637,0.909986,0.79,2,216414,215939,475
25136001,9.4397,15.9984,468,90660,0.909997,0.79,2,216422,215954,468
25138921,9.88794,9.59969,470,90683,0.909999,0.79,2,216432,215962,470
25141841,3.57759,9.91994,462,90706,0.91,0.79,2,216434,215972,462
25144761,21.5155,3.58399,486,90729,0.926,0.81,2,216460,215974,486
25147681,17.1031,22.3168,475,90752,0.9292,0.77,2,216476,216001,475
25150601,20.2206,17.2634,480,90775,0.91384,0.79,2,216497,216017,480
25153521,10.4441,19.4527,468,90798,0.910768,0.79,2,216505,216037,468
25156441,34.8888,10.2905,501,90821,0.910154,0.79,2,216546,216045,501
25159361,8.57776,34.0581,463,90844,0.910031,0.79,2,216548,216085,463
25162281,17.7156,8.41162,481,90867,0.942006,0.83,2,216568,216087,481
25165201,19.5431,16.8823,482,90890,0.948401,0.83,2,216588,216106,482
25614881,22,17,485,94356,0.91,1,2,218928,218443,485
25617801,14,13.8,484,94378,0.862,0.99,2,218940,218456,484
25620721,19.6,23.56,479,94400,0.8364,1,2,218961,218482,479
25623641,23.12,23.912,479,94422,0.86328,1,2,218985,218506,479
25626561,18.224,14.3824,484,94444,0.852656,1,2,219002,218518,484
25629481,14.0448,15.6765,481,94466,0.834531,1,2,219015,218534,481
25632401,10.009,15.9353,474,94488,0.846906,1,2,219024,218550,474
25635321,10.8018,13.5871,472,94510,0.865381,0.91,2,219035,218563,472
25638241,10.1604,10.7174,472,94532,0.837076,1,2,219045,218573,472
25641161,8.43207,7.74348,473,94554,0.863415,0.92,2,219053,218580,473
25644081,3.28641,3.1487,473,94576,0.836683,0.96,2,219055,218582,473
25647001,7.05728,7.02974,473,94598,0.831337,0.93,2,219063,218590,473
25649921,9.41146,7.80595,475,94620,0.830267,1,2,219073,218598,475
25652841,12.2823,12.7612,474,94642,0.846053,1,2,219086,218612,474
25655761,16.0565,15.3522,475,94664,0.833211,1,2,219103,218628,475
25658681,13.6113,16.6704,471,94686,0.814642,1,2,219116,218645,471
25661601,18.7223,14.5341,477,94708,0.858928,0.97,2,219136,218659,477
25664521,24.5445,25.3068,475,94730,0.835786,1,2,219162,218687,475
25667441,19.3089,17.0614,478,94752,0.847157,1,2,219180,218702,478
25670361,11.8618,13.0123,476,94774,0.849431,1,2,219190,218714,476
25673281,15.9724,17.8025,474,94796,0.897886,1,2,219207,218733,474
25676201,14.3945,15.5605,473,94818,0.907577,1,2,219221,218748,473
25679121,18.0789,15.9121,476,94840,0.893515,1,2,219240,218764,476
25682041,10.8158,15.1824,470,94862,0.906703,0.94,2,219249,218779,470
25684961,10.1632,11.0365,470,94884,0.877341,1,2,219259,218789,470
25687881,14.0326,14.2073,470,94906,0.903468,0.98,2,219274,218804,470
25690801,14.8065,16.4415,468,94928,0.940694,0.95,2,219289,218821,468
25693721,11.7613,12.8883,467,94950,0.932139,0.95,2,219300,218833,467
25696641,14.3523,16.9777,464,94972,0.946428,0.94,2,219315,218851,464
25699561,16.4705,18.5955,462,94994,0.933286,0.93,2,219332,218870,462
25702481,17.6941,18.1191,462,95016,0.930657,0.89,2,219350,218888,462
25705401,17.9388,18.0238,462,95038,0.930131,0.91,2,219368,218906,462
25708321,22.7878,21.2048,464,95060,0.946026,0.85,2,219392,218928,464
26169681,10,12,481,98462,0.85,1,2,221682,221201,481
26172601,22,12.8,493,98483,0.834,1,2,221707,221214,493
26175521,20.4,16.96,495,98504,0.8148,1,2,221727,221232,495
26178441,20.08,3.392,515,98525,0.77896,1,2,221747,221232,515
26181361,13.616,17.4784,506,98546,0.787792,1,2,221759,221253,506
26184281,12.3232,19.4957,498,98567,0.725558,1,1,221771,221273,498
26187201,15.2646,17.4991,497,98588,0.713112,1,1,221787,221290,497
26190121,14.2529,15.4998,496,98609,0.678622,1,1,221801,221305,496
26193041,22.0506,14.3,506,98630,0.639724,1,1,221825,221319,506
26195961,18.0101,25.26,495,98651,0.647945,1,1,221842,221347,495
26198881,16.402,18.652,494,98672,0.633589,1,1,221858,221364,494
26201801,15.2804,16.5304,493,98693,0.646718,1,1,221873,221380,493
26204721,13.4561,12.9061,494,98714,0.649344,1,1,221886,221392,494
26207641,11.4912,11.3812,494,98735,0.633869,1,1,221897,221403,494
26210561,9.49824,11.8762,491,98756,0.582774,1,1,221906,221415,491
26274801,19,20,478,99218,0.91,0.77,2,222205,221727,478
26277721,11.8,20,468,99239,0.878,0.79,2,222215,221747,468
26280641,10.36,13.6,466,99260,0.8716,0.71,2,222225,221759,466
26283561,13.272,12.32,468,99281,0.90232,0.71,2,222239,221771,468
26286481,11.4544,15.264,463,99302,0.924464,0.67,2,222250,221787,463
26289401,23.0909,14.2528,475,99323,0.896893,0.63,2,222276,221801,475
26292321,17.4182,22.0506,467,99344,0.875379,0.65,2,222292,221825,467
26295241,17.0836,18.0101,467,99365,0.823076,0.63,2,222309,221842,467
26298161,16.2167,16.402,467,99386,0.780615,0.65,2,222325,221858,467
26301081,12.8433,15.2804,464,99407,0.756123,0.65,2,222337,221873,464
26304001,10.5687,13.4561,461,99428,0.719225,0.63,1,222347,221886,461
26306921,23.7137,11.4912,477,99449,0.695845,0.57,1,222374,221897,477
26309841,11.1427,9.49824,476,99470,0.691169,1,1,222382,221906,476
26312761,10.2285,8.29965,478,99491,0.690234,1,1,222392,221914,478
26315681,13.2457,8.85993,483,99512,0.690047,1,1,222406,221923,483
26318601,13.0491,5.77199,491,99533,0.706009,1,1,222419,221928,491
26321521,7.40983,11.5544,484,99554,0.709202,1,1,222425,221941,484
26324441,15.882,11.1109,491,99575,0.75784,1,2,222443,221952,491
26327361,15.9764,15.0222,491,99596,0.735568,1,1,222459,221968,491
26330281,14.3953,15.8044,489,99617,0.731114,0.95,1,222473,221984,489
26333201,11.6791,14.3609,486,99638,0.714223,1,1,222484,221998,486
26336121,14.3358,11.6722,490,99659,0.726845,1,1,222499,222009,490
26339041,10.8672,19.1344,479,99680,0.729369,1,1,222509,222030,479
26341961,18.9734,13.4269,488,99701,0.713874,1,1,222530,222042,488
26344881,17.3947,15.4854,489,99722,0.726775,1,1,222547,222058,489
26347801,14.6789,15.0971,488,99743,0.697355,1,1,222561,222073,488
26350721,10.9358,15.0194,483,99764,0.739471,1,1,222571,222088,483
26353641,6.98716,11.8039,478,99785,0.747894,0.92,1,222577,222099,478
26356561,14.1974,7.96078,487,99806,0.749579,0.96,1,222593,222106,487
26359481,10.8395,15.9922,479,99827,0.749916,0.99,1,222603,222124,479
26362401,8.5679,11.9984,476,99848,0.749983,0.96,1,222611,222135,476
26365321,19.3136,9.59969,489,99869,0.749997,0.95,1,222633,222144,489
26368241,18.2627,20.3199,484,99890,0.749999,0.93,1,222651,222167,484
26371161,18.0525,19.264,483,99911,0.75,0.91,1,222669,222186,483
26374081,11.6105,19.0528,474,99932,0.75,0.87,1,222679,222205,474
26377001,11.1221,11.8106,475,99953,0.782,0.87,2,222690,222215,475
26379921,3.82442,10.3621,467,99974,0.7564,0.91,2,222692,222225,467
26382841,11.9649,13.2724,467,99995,0.78328,0.93,2,222706,222239,467
26385761,10.393,11.4545,466,100016,0.756656,0.89,2,222716,222250,466
26388681,22.0786,23.0909,465,100037,0.783331,0.87,2,222741,222276,465
26391601,15.6157,17.4182,463,100058,0.820666,0.81,2,222755,222292,463
26394521,14.3231,17.0836,460,100079,0.828133,0.77,2,222769,222309,460
26397441,14.8646,16.2167,459,100100,0.813627,0.75,2,222784,222325,459
26400361,10.9729,12.8433,457,100121,0.778725,0.71,2,222794,222337,457
26403281,10.1946,10.5687,457,100142,0.787745,0.69,2,222804,222347,457
26406201,22.8389,23.7137,456,100163,0.789549,0.69,2,222830,222374,456
26409121,10.9678,11.1427,456,100184,0.82191,0.69,2,222838,222382,456
26412041,8.59356,10.2285,454,100205,0.796382,0.69,2,222846,222392,454
26414961,14.5187,13.2457,456,100226,0.807276,0.71,2,222862,222406,456
26417881,14.1037,13.0491,457,100247,0.809455,0.71,2,222876,222419,457
26420801,7.62075,7.40983,457,100268,0.841891,0.77,2,222882,222425,457
26423721,15.1241,15.882,456,100289,0.864378,0.73,2,222899,222443,456
26426641,15.8248,15.9764,456,100310,0.836876,0.73,2,222915,222459,456
26429561,14.365,14.3953,456,100331,0.863375,0.71,2,222929,222473,456
26432481,12.473,11.6791,457,100352,0.836675,0.73,2,222941,222484,457
26435401,15.2946,14.3358,458,100373,0.863335,0.73,2,222957,222499,458
26438321,9.45892,10.8672,456,100394,0.868667,0.71,2,222965,222509,456
26441241,21.0918,18.9734,459,100415,0.837733,0.73,2,222989,222530,459
26444161,17.0184,17.3947,458,100436,0.879547,0.69,2,223005,222547,458
26447081,15.4037,14.6789,459,100457,0.871909,0.75,2,223020,222561,459
26450001,11.0807,10.9358,459,100478,0.838382,0.75,2,223030,222571,459
26452921,7.01615,6.98716,459,100499,0.863676,0.75,2,223036,222577,459
26455841,14.2032,14.1974,459,100520,0.836735,0.75,2,223052,222593,459
26458761,10.8406,10.8395,459,100541,0.831347,0.75,2,223062,222603,459
26461681,8.56813,8.5679,459,100562,0.830269,0.75,2,223070,222611,459
26464601,19.3136,19.3136,459,100583,0.830054,0.75,2,223092,222633,459
26467521,18.2627,18.2627,459,100604,0.830011,0.75,2,223110,222651,459
26470441,18.0525,18.0525,459,100625,0.830002,0.75,2,223128,222669,459
26473361,12.4105,11.6105,460,100646,0.846,0.79,2,223139,222679,460
26476281,10.4821,11.1221,459,100667,0.8172,0.75,2,223149,222690,459
26479201,3.69642,3.82442,459,100688,0.84344,0.79,2,223151,222692,459
26482121,11.9393,11.9649,459,100709,0.848688,0.75,2,223165,222706,459
26485041,10.3879,10.393,459,100730,0.817738,0.79,2,223175,222716,459
26487961,23.6776,22.0786,461,100751,0.859547,0.83,2,223202,222741,461
26490881,15.9355,15.6157,461,100772,0.899909,0.83,2,223216,222755,461
26493801,14.3871,14.3231,461,100793,0.923982,0.81,2,223230,222769,461
26496721,14.0774,14.8646,460,100814,0.928796,0.77,2,223244,222784,460
26499641,11.6155,10.9729,461,100835,0.913759,0.79,2,223255,222794,461
26502561,10.3231,10.1946,461,100856,0.910752,0.79,2,223265,222804,461
27071961,17,18,502,104787,0.8,1,2,225970,225468,502
27074881,16.2,18,500,104807,0.76,1,2,225986,225486,500
27077801,17.64,15.6,503,104827,0.72,1,1,226004,225501,503
27080721,16.328,13.52,506,104847,0.664,1,1,226020,225514,506
27083641,16.0656,9.104,514,104867,0.6528,1,1,226036,225522,514
27086561,9.61312,11.4208,510,104887,0.65056,1,1,226044,225534,510
27089481,7.52262,13.4842,503,104907,0.626112,1,1,226051,225548,503
27092401,13.5045,16.2968,501,104927,0.525222,1,1,226066,225565,501
27095321,11.5009,14.4594,498,104947,0.505044,1,1,226077,225579,498
27098241,14.3002,14.0919,499,104967,0.445009,1,1,226092,225593,499
27101161,14.86,14.0184,500,104987,0.401002,1,1,226107,225607,500
27104081,14.972,13.2037,502,105007,0.3442,1,1,226122,225620,502
27107001,13.3944,13.0407,502,105027,0.33284,1,1,226135,225633,502
27109921,13.0789,9.00815,507,105047,0.282568,1,1,226148,225641,507
27112841,9.81578,11.4016,504,105067,0.240514,1,1,226157,225653,504
27115761,8.36316,11.0803,501,105087,0.200103,1,1,226165,225664,501
27118681,6.47263,7.01607,501,105107,0.176021,1,1,226171,225670,501
27121601,9.29453,11.8032,498,105127,0.139204,0.99,1,226181,225683,498
27124521,13.0589,15.1606,496,105147,0.387841,1,1,226195,225699,496
27127441,14.6118,11.8321,500,105167,0.325568,1,1,226210,225710,500
27130361,15.7224,20.7664,493,105187,0.329114,1,1,226226,225733,493
27133281,12.7445,20.1533,485,105207,0.313823,1,1,226238,225753,485
27136201,14.5489,13.6307,488,105227,0.262765,1,1,226253,225765,488
27139121,22.1098,14.7261,497,105247,0.140553,1,1,226277,225780,497
27142041,14.822,14.9452,495,105267,0.132111,0.93,1,226290,225795,495
27144961,14.1644,16.589,492,105287,0.0664221,0.96,1,226304,225812,492
27147881,10.8329,14.5178,488,105307,0.0372844,0.97,1,226314,225826,488
27150801,11.7666,13.3036,487,105327,0.0314569,1,1,226326,225839,487
27153721,14.3533,10.6607,492,105347,0.0782914,1,1,226341,225849,492
27156641,13.2707,15.7321,488,105367,0.0396583,1,1,226354,225866,488
27159561,12.2541,13.5464,487,105387,0.0319317,1,1,226366,225879,487
27162481,11.2508,13.1093,485,105407,0.0463863,1,1,226377,225892,485
27165401,12.6502,13.0219,485,105427,0.0172773,0.89,1,226390,225905,485
27168321,8.93003,15.4044,477,105447,0.0434555,0.96,1,226398,225921,477
27171241,15.386,11.8809,483,105467,0.0646911,0.82,1,226415,225932,483
27174161,15.0772,19.1762,477,105487,0.0209382,0.8,1,226430,225953,477
27177081,13.4154,17.4352,473,105507,0.0281876,0.75,1,226443,225970,473
27180001,15.4831,16.287,473,105527,0.0616375,0.71,1,226459,225986,473
27182921,14.2966,17.6574,469,105547,0.0363275,0.65,1,226473,226004,469
27185841,14.0593,16.3315,467,105567,0.0632655,0.65,1,226487,226020,467
27188761,7.61186,16.0663,457,105587,0.0366531,0.65,1,226493,226036,457
27191681,4.72237,9.61326,453,105607,0.0313306,0.62,1,226497,226044,453
27194601,12.1445,7.52265,460,105627,0.0462661,0.5,1,226511,226051,460
27197521,11.2289,13.5045,456,105647,0.0652532,0.5,1,226522,226066,456
27200441,12.6458,11.5009,458,105667,0.0530506,0.43,1,226535,226077,458
27203361,12.1292,14.3002,455,105687,0.0186101,0.39,1,226547,226092,455
27206281,12.8258,14.86,453,105707,0.027722,0.33,1,226560,226107,453
27209201,10.5652,14.972,448,105727,0.0135444,0.33,1,226570,226122,448
27212121,10.113,13.3944,445,105747,0.00270888,0.27,1,226580,226135,445
27215041,6.02261,13.0789,437,105767,0.000541776,0.23,1,226585,226148,437
27217961,7.60452,9.81578,436,105787,0.0561084,0.19,1,226593,226157,436
27220881,5.5209,8.36316,433,105807,0.0832217,0.17,1,226598,226165,433
27223801,2.70418,6.47263,429,105827,0.0566443,0.13,1,226600,226171,429
27226721,18.1408,9.29453,441,105847,0.0353289,0.45,1,226622,226181,441
27229641,11.6282,13.0589,437,105867,0.0630658,0.31,1,226632,226195,437
27232561,15.1256,14.6118,438,105887,0.0686131,0.33,1,226648,226210,438
27235481,15.0251,15.7224,437,105907,0.0217226,0.31,1,226663,226226,437
27238401,11.005,12.7445,435,105927,0.0123445,0.25,1,226673,226238,435
27241321,11.801,14.5489,432,105947,0.0424689,0.11,1,226685,226253,432
27244241,17.5602,22.1098,427,105967,0.0324938,0.13,1,226704,226277,427
27247161,11.512,14.822,424,105987,0.0304988,0.05,1,226714,226290,424
27250081,12.7024,14.1644,423,106007,0.0460998,0.03,1,226727,226304,423
27253001,10.5405,10.8329,423,106027,0.0172199,0.03,1,226737,226314,423
27255921,11.7081,11.7666,423,106047,0.011444,0.09,1,226749,226326,423
27258841,15.1416,14.3533,424,106067,0.0422888,0.03,1,226765,226341,424
27261761,12.6283,13.2707,423,106087,0.0484578,0.03,1,226777,226354,423
27264681,12.1257,12.2541,423,106107,0.0816915,0.05,1,226789,226366,423
27267601,11.2251,11.2508,423,106127,0.0723383,0.01,1,226800,226377,423
27270521,13.445,12.6502,424,106147,0.0704677,0.05,1,226814,226390,424
27273441,7.48901,8.93003,422,106167,0.0380935,0.07,1,226820,226398,422
27276361,17.4978,15.386,425,106187,0.0316187,0.01,1,226840,226415,425
27279281,14.6996,15.0772,424,106207,0.0783237,0.03,1,226854,226430,424
27282201,14.1399,13.4154,425,106227,0.0876647,0.07,1,226868,226443,425
27285121,14.028,15.4831,423,106247,0.057533,0.03,1,226882,226459,423
27288041,15.6056,14.2966,425,106267,0.0835066,0.07,1,226898,226473,425
27290961,12.7211,14.0593,423,106287,0.0887013,0.03,1,226910,226487,423
27293881,9.74422,7.61186,426,106307,0.0737403,0.03,1,226919,226493,426
27296801,3.54884,4.72237,424,106327,0.0707481,0.05,1,226921,226497,424
27299721,11.9098,12.1445,424,106347,0.0701496,0.07,1,226935,226511,424
27302641,10.382,11.2289,423,106367,0.0380299,0.05,1,226945,226522,423
27305561,11.6764,12.6458,422,106387,0.063606,0.01,1,226957,226535,422
27308481,11.9353,12.1292,422,106407,0.0687212,0.03,1,226969,226547,422
27311401,12.7871,12.8258,422,106427,0.0377442,0.01,1,226982,226560,422
27314321,10.5574,10.5652,422,106447,0.0155488,0,1,226992,226570,422
27317241,11.7115,10.113,424,106467,0.0431098,0,1,227004,226580,424
27320161,7.1423,6.02261,425,106487,0.032622,0.07,1,227010,226585,425
27323081,6.22846,7.60452,423,106507,0.0465244,0.09,1,227016,226593,423
27326001,4.44569,5.5209,422,106527,0.0173049,0.05,1,227020,226598,422
27328921,2.48914,2.70418,422,106547,0.011461,0.03,1,227022,226600,422
27331841,20.4978,18.1408,425,106567,0.0582922,0.07,1,227047,226622,425
27334761,10.4996,11.6282,423,106587,0.0676584,0.07,1,227055,226632,423
27337681,14.8999,15.1256,423,106606,0.0535317,0.01,1,227071,226648,423
27340601,14.18,15.0251,422,106625,0.0827063,0.01,1,227085,226663,422
27343521,10.836,11.005,422,106644,0.0885413,0.05,1,227095,226673,422
27346441,11.7672,11.801,422,106663,0.0897083,0.03,1,227107,226685,422
27349361,18.3534,17.5602,423,106682,0.121942,0.03,1,227127,226704,423
27352281,11.6707,11.512,423,106701,0.112388,0.05,1,227137,226714,423
27355201,11.9341,12.7024,422,106720,0.110478,0.01,1,227149,226727,422
27358121,10.3868,10.5405,422,106739,0.110096,0.01,1,227159,226737,422
27361041,11.6774,11.7081,422,106758,0.110019,0.05,1,227171,226749,422
27363961,16.7355,15.1416,424,106777,0.0780038,0.05,1,227189,226765,424
27366881,12.9471,12.6283,424,106796,0.0716008,0.09,1,227201,226777,424
27369801,12.1894,12.1257,424,106815,0.11832,0.07,1,227213,226789,424
27372721,9.63788,11.2251,422,106834,0.127664,0.07,1,227222,226800,422
27375641,13.9276,13.445,423,106853,0.113533,0.03,1,227237,226814,423
27378561,7.58552,7.48901,423,106872,0.110707,0.03,1,227243,226820,423
27381481,17.5171,17.4978,423,106891,0.126141,0.09,1,227263,226840,423
27384401,15.5034,14.6996,424,106910,0.145228,0.09,1,227278,226854,424
27387321,14.3007,14.1399,424,106929,0.117046,0.05,1,227292,226868,424
27390241,14.0601,14.028,424,106948,0.143409,0.09,1,227306,226882,424
27393161,15.612,15.6056,424,106967,0.148682,0.09,1,227322,226898,424
27396081,12.7224,12.7211,424,106986,0.133736,0.07,1,227334,226910,424
27399001,8.94448,9.74422,423,107005,0.130747,0.07,1,227342,226919,423
27401921,3.3889,3.54884,423,107024,0.130149,0.07,1,227344,226921,423
27404841,11.8778,11.9098,423,107043,0.16203,0.03,1,227358,226935,423
27407761,10.3756,10.382,423,107062,0.136406,0.07,1,227368,226945,423
27410681,11.6751,11.6764,423,107081,0.131281,0.07,1,227380,226957,423
27413601,11.135,11.9353,422,107100,0.146256,0.03,1,227391,226969,422
27416521,12.627,12.7871,422,107119,0.133251,0.01,1,227404,226982,422
27419441,10.5254,10.5574,422,107138,0.0986503,0.05,1,227414,226992,422
27422361,11.7051,11.7115,422,107157,0.05973,0.03,1,227426,227004,422
27425281,7.14102,7.1423,422,107176,0.051946,0.05,1,227432,227010,422
27428201,6.2282,6.22846,422,107195,0.0183892,0.01,1,227438,227016,422
27431121,4.44564,4.44569,422,107214,0.0116778,0.01,1,227442,227020,422
27434041,2.48913,2.48914,422,107233,0.0103356,0.07,1,227444,227022,422
27436961,21.2978,20.4978,423,107252,0.0420671,0.07,1,227470,227047,423
27439881,10.6596,4.09957,431,107271,0.0164134,0.07,1,227478,227047,431
27442801,16.5319,7.21991,441,107290,0.0432827,0.05,1,227496,227055,441
27445721,14.5064,14.244,439,107309,0.0486565,0.09,1,227510,227071,439
27448641,10.9013,14.0488,435,107328,0.0497313,0.09,1,227520,227085,435
27451561,11.7803,10.8098,437,107347,0.0499463,0.09,1,227532,227095,437
27454481,19.1561,11.762,446,107366,0.0339893,0.13,1,227553,227107,446
27457401,11.8312,18.3524,436,107385,0.0307979,0.11,1,227563,227127,436
27460321,11.9662,11.6705,438,107404,0.0301596,0.11,1,227575,227137,438
27463241,10.3932,11.9341,436,107423,0.0300319,0.11,1,227585,227149,436
27466161,10.0786,10.3868,436,107442,0.0300064,0.11,1,227595,227159,436
27469081,16.4157,11.6774,442,107461,0.0300013,0.07,1,227613,227171,442
27472001,13.6831,16.7355,437,107480,0.0140003,0.07,1,227626,227189,437
27474921,13.1366,12.9471,438,107499,0.0108001,0.13,1,227639,227201,438
27477841,9.02733,12.1894,434,107518,0.04216,0.13,1,227647,227213,434
27480761,14.6055,9.63788,441,107537,0.048432,0.11,1,227663,227222,441
27483681,7.72109,13.9276,432,107556,0.0496864,0.11,1,227669,227237,432
27486601,18.3442,7.58552,447,107575,0.0819373,0.13,1,227690,227243,447
27489521,14.8688,17.5171,441,107594,0.0883875,0.15,1,227704,227263,441
27492441,14.1738,15.5034,440,107613,0.0896775,0.11,1,227718,227278,440
27495361,14.0348,14.3007,440,107632,0.0899355,0.15,1,227732,227292,440
27498281,15.607,14.0601,442,107651,0.105987,0.15,1,227748,227306,442
27501201,13.5214,15.612,439,107670,0.109197,0.13,1,227761,227322,439
27504121,9.10428,12.7224,435,107689,0.109839,0.13,1,227769,227334,435
27507041,3.42086,8.94448,429,107708,0.109968,0.13,1,227771,227342,429
27509961,11.8842,3.3889,441,107727,0.109994,0.17,1,227785,227344,441
27512881,10.3768,11.8778,437,107746,0.109999,0.13,1,227795,227358,437
27515801,11.6754,10.3756,439,107765,0.11,0.13,1,227807,227368,439
27518721,10.3351,11.6751,437,107784,0.11,0.15,1,227817,227380,437
27521641,11.667,11.135,438,107803,0.11,0.13,1,227829,227391,438
27524561,8.7334,12.627,433,107822,0.11,0.09,1,227837,227404,433
27527481,9.74668,10.5254,433,107841,0.11,0.05,1,227847,227414,433
27530401,6.74934,11.7051,427,107860,0.11,0.05,1,227853,227426,427
27533321,6.14987,7.14102,427,107879,0.11,0.01,1,227859,227432,427
27536241,4.42997,6.2282,425,107898,0.11,0.01,1,227863,227438,425
27539161,2.48599,4.44564,423,107917,0.11,0.01,1,227865,227442,423
27542081,21.2972,2.48913,447,107936,0.078,0.05,1,227891,227444,447
27545001,11.4594,21.2978,430,107955,0.0876,0.01,1,227900,227470,430
27547921,17.4919,10.6596,441,107974,0.04152,0.05,1,227919,227478,441
27550841,14.6984,16.5319,437,107993,0.032304,0.05,1,227933,227496,437
27553761,10.9397,14.5064,433,108012,0.0304608,0.05,1,227943,227510,433
27556681,11.7879,10.9013,435,108031,0.0460922,0.05,1,227955,227520,435
27559601,18.3576,11.7803,443,108050,0.0652184,0.03,1,227975,227532,443
27562521,11.6715,19.1561,432,108069,0.0850437,0.03,1,227985,227553,432
27565441,11.9343,11.8312,434,108088,0.0890087,0.03,1,227997,227563,434
27568361,10.3869,11.9662,432,108107,0.0898018,0.03,1,228007,227575,432
27571281,10.0774,10.3932,432,108126,0.0899604,0.03,1,228017,227585,432
27574201,16.4155,10.0786,440,108145,0.0899921,0.03,1,228035,227595,440
27577121,13.6831,16.4157,435,108164,0.105998,0.01,1,228048,227613,435
27580041,13.9366,13.6831,436,108183,0.0771997,0.01,1,228062,227626,436
27582961,9.18732,13.1366,431,108202,0.0714399,0.05,1,228070,227639,431
27585881,14.6375,9.02733,439,108221,0.086288,0.05,1,228086,227647,439
27588801,7.72749,14.6055,429,108240,0.0892576,0.05,1,228092,227663,429
27591721,19.9455,7.72109,446,108259,0.0898515,0.09,1,228115,227669,446
27594641,15.1891,18.3442,439,108278,0.10597,0.09,1,228129,227690,439
27597561,14.2378,14.8688,439,108297,0.109194,0.09,1,228143,227704,439
27600481,14.0476,14.1738,439,108316,0.109839,0.09,1,228157,227718,439
27603401,16.4095,14.0348,442,108335,0.125968,0.11,1,228174,227732,442
27606321,13.6819,15.607,439,108354,0.145194,0.11,1,228187,227748,439
27609241,9.13638,13.5214,434,108373,0.149039,0.11,1,228195,227761,434
27612161,3.42728,9.10428,428,108392,0.149808,0.11,1,228197,227769,428
27615081,11.8855,3.42086,440,108411,0.149962,0.11,1,228211,227771,440
27618001,10.3771,11.8842,436,108430,0.149992,0.11,1,228221,227785,436
27620921,11.6754,10.3768,438,108449,0.149998,0.11,1,228233,227795,438
27623841,10.3351,11.6754,436,108468,0.15,0.11,1,228243,227807,436
27626761,11.667,10.3351,438,108487,0.15,0.11,1,228255,227817,438
27629681,8.7334,11.667,434,108506,0.15,0.11,1,228263,227829,434
27632601,9.74668,8.7334,436,108525,0.15,0.11,1,228273,227837,436
27635521,6.74934,9.74668,432,108544,0.15,0.11,1,228279,227847,432
27638441,6.14987,6.74934,432,108563,0.15,0.11,1,228285,227853,432
27641361,2.82997,6.14987,428,108582,0.15,0.11,1,228287,227859,428
27644281,2.16599,4.42997,426,108601,0.15,0.11,1,228289,227863,426
27647201,21.2332,2.48599,450,108620,0.15,0.07,1,228315,227865,450
27650121,10.6466,21.2972,432,108639,0.15,0.09,1,228323,227891,432
27653041,16.5293,11.4594,441,108658,0.15,0.03,1,228341,227900,441
27655961,14.5059,17.4919,436,108677,0.15,0.03,1,228355,227919,436
27658881,11.7012,14.6984,433,108696,0.166,0.03,1,228366,227933,433
27661801,11.9402,10.9397,435,108715,0.1692,0.05,1,228378,227943,435
27664721,3.98805,11.7879,425,108734,0.16984,0.07,1,228380,227955,425
27667641,17.5976,18.3576,426,108753,0.201968,0.09,1,228401,227975,426
27670561,11.5195,11.6715,426,108772,0.176394,0.09,1,228411,227985,426
27673481,11.9039,11.9343,426,108791,0.171279,0.09,1,228423,227997,426
27676401,10.3808,10.3869,426,108810,0.170256,0.09,1,228433,228007,426
27679321,10.0762,10.0774,426,108829,0.170051,0.09,1,228443,228017,426
27682241,16.4152,16.4155,426,108848,0.20201,0.11,1,228461,228035,426
27685161,12.883,13.6831,425,108867,0.208402,0.07,1,228473,228048,425
27688081,13.7766,13.9366,425,108886,0.20968,0.07,1,228487,228062,425
27691001,9.95532,9.18732,426,108905,0.193936,0.09,1,228496,228070,426
27693921,14.7911,14.6375,426,108924,0.222787,0.09,1,228512,228086,426
27696841,8.55821,7.72749,427,108943,0.212557,0.09,1,228519,228092,427
27699761,20.1116,19.9455,427,108962,0.194511,0.11,1,228542,228115,427
27702681,15.2223,15.1891,427,108981,0.190902,0.11,1,228556,228129,427
27705601,14.2445,14.2378,427,109000,0.19018,0.11,1,228570,228143,427
27708521,14.0489,14.0476,427,109019,0.174036,0.13,1,228584,228157,427
27711441,18.8098,16.4095,430,109038,0.202807,0.15,1,228604,228174,430
27714361,13.362,13.6819,429,109057,0.224561,0.15,1,228616,228187,429
27717281,9.07239,9.13638,429,109076,0.212912,0.15,1,228624,228195,429
27720201,3.41448,3.42728,429,109095,0.210582,0.15,1,228626,228197,429
27723121,11.8829,11.8855,429,109114,0.242116,0.15,1,228640,228211,429
27726041,10.3766,10.3771,429,109133,0.216423,0.15,1,228650,228221,429
27728961,11.6753,11.6754,429,109152,0.243285,0.15,1,228662,228233,429
27731881,10.3351,10.3351,429,109171,0.216657,0.15,1,228672,228243,429
27734801,11.667,11.667,429,109190,0.243331,0.15,1,228684,228255,429
27737721,8.7334,8.7334,429,109209,0.216666,0.15,1,228692,228263,429
27740641,9.74668,9.74668,429,109228,0.211333,0.15,1,228702,228273,429
27743561,6.74934,6.74934,429,109247,0.242267,0.15,1,228708,228279,429
27746481,6.14987,6.14987,429,109266,0.248453,0.15,1,228714,228285,429
27749401,2.82997,2.82997,429,109285,0.249691,0.15,1,228716,228287,429
27752321,2.16599,2.16599,429,109304,0.217938,0.15,1,228718,228289,429
27755241,21.2332,21.2332,429,109323,0.243588,0.15,1,228744,228315,429
27758161,10.6466,10.6466,429,109342,0.216718,0.15,1,228752,228323,429
27761081,16.5293,16.5293,429,109361,0.211344,0.15,1,228770,228341,429
27764001,14.5059,14.5059,429,109380,0.242269,0.17,1,228784,228355,429
27766921,12.5012,11.7012,430,109399,0.248454,0.17,1,228796,228366,430
27769841,12.9002,11.9402,431,109418,0.233691,0.17,1,228809,228378,431
27772761,4.18005,3.98805,431,109437,0.230738,0.21,1,228811,228380,431
27775681,16.836,17.5976,430,109456,0.262148,0.17,1,228831,228401,430
27778601,11.3672,11.5195,430,109475,0.23643,0.17,1,228841,228411,430
27781521,11.8734,11.9039,430,109494,0.247286,0.17,1,228853,228423,430
27784441,10.3747,10.3808,430,109513,0.249457,0.17,1,228863,228433,430
27787361,10.0749,10.0762,430,109532,0.265891,0.21,1,228873,228443,430
27790281,16.415,16.4152,430,109551,0.285178,0.21,1,228891,228461,430
27793201,12.883,12.883,430,109570,0.289036,0.21,1,228903,228473,430
27796121,13.7766,13.7766,430,109589,0.289807,0.19,1,228917,228487,430
27799041,10.7553,9.95532,431,109608,0.289961,0.23,1,228927,228496,431
27801961,14.9511,14.7911,431,109627,0.321992,0.21,1,228943,228512,431
27804881,7.79021,8.55821,430,109646,0.296398,0.19,1,228949,228519,430
27807801,19.158,20.1116,429,109665,0.29128,0.19,1,228971,228542,429
27810721,15.0316,15.2223,429,109684,0.338256,0.19,1,228985,228556,429
27813641,14.2063,14.2445,429,109703,0.315651,0.17,1,228999,228570,429
27816561,14.8413,14.0489,430,109722,0.34313,0.21,1,229014,228584,430
27819481,19.7683,18.8098,431,109741,0.380626,0.23,1,229035,228604,431
27822401,14.3537,13.362,432,109760,0.388125,0.21,1,229048,228616,432
27825321,9.27073,9.07239,432,109779,0.357625,0.21,1,229056,228624,432
27828241,3.45415,3.41448,432,109798,0.351525,0.25,1,229058,228626,432
27831161,11.8908,11.8829,432,109817,0.382305,0.21,1,229072,228640,432
27834081,10.3782,10.3766,432,109836,0.356461,0.25,1,229082,228650,432
27837001,11.6756,11.6753,432,109855,0.351292,0.21,1,229094,228662,432
27839921,10.3351,10.3351,432,109874,0.350258,0.25,1,229104,228672,432
27842841,11.667,11.667,432,109893,0.350052,0.21,1,229116,228684,432
27845761,8.73341,8.7334,432,109912,0.35001,0.21,1,229124,228692,432
27848681,9.74668,9.74668,432,109931,0.350002,0.25,1,229134,228702,432
27851601,6.74934,6.74934,432,109950,0.382,0.25,1,229140,228708,432
27854521,6.14987,6.14987,432,109969,0.3564,0.25,1,229146,228714,432
27857441,2.82997,2.82997,432,109988,0.38328,0.21,1,229148,228716,432
27860361,2.16599,2.16599,432,110007,0.356656,0.25,1,229150,228718,432
27863281,21.2332,21.2332,432,110026,0.383331,0.21,1,229176,228744,432
27866201,10.6466,10.6466,432,110045,0.388666,0.21,1,229184,228752,432
27869121,16.5293,16.5293,432,110064,0.389733,0.25,1,229202,228770,432
27872041,14.5059,14.5059,432,110083,0.357947,0.25,1,229216,228784,432
27874961,12.5012,12.5012,432,110102,0.383589,0.23,1,229228,228796,432
27877881,13.7002,12.9002,433,110121,0.388718,0.23,1,229242,228809,433
27880801,4.34005,4.18005,433,110140,0.357744,0.27,1,229244,228811,433
27883721,16.868,16.836,433,110159,0.383549,0.23,1,229264,228831,433
27886641,12.1736,11.3672,434,110178,0.37271,0.25,1,229275,228841,434
27889561,12.0347,11.8734,434,110197,0.386542,0.25,1,229287,228853,434
27892481,10.4069,2.37469,444,110216,0.357308,0.25,1,229297,228853,444
27895401,10.0814,8.47494,444,110235,0.351462,0.27,1,229307,228863,444
27898321,17.2163,9.69499,453,110254,0.366292,0.29,1,229326,228873,453
27901241,13.0433,16.339,447,110273,0.369258,0.29,1,229338,228891,447
27904161,13.8087,12.8678,449,110292,0.369852,0.29,1,229352,228903,449
27907081,10.7617,13.7736,445,110311,0.36997,0.29,1,229362,228917,445
27910001,14.9523,10.7547,451,110330,0.369994,0.33,1,229378,228927,451
27912921,7.79047,14.9509,441,110349,0.369999,0.29,1,229384,228943,441
27915841,19.9581,7.79019,458,110368,0.386,0.29,1,229407,228949,458
27918761,15.1916,19.158,450,110387,0.3572,0.35,1,229421,228971,450
27921681,15.0383,15.0316,451,110406,0.33544,0.31,1,229436,228985,451
27924601,15.8077,14.2063,453,110425,0.363088,0.35,1,229452,228999,453
27927521,20.7615,14.8413,460,110444,0.400618,0.39,1,229474,229014,460
27930441,13.7523,19.7683,451,110463,0.408124,0.39,1,229486,229035,451
27933361,9.15046,14.3537,446,110482,0.409625,0.35,1,229494,229048,446
27936281,3.43009,9.27073,440,110501,0.409925,0.35,1,229496,229056,440
27939201,11.886,3.45415,452,110520,0.409985,0.39,1,229510,229058,452
27942121,10.3772,11.8908,448,110539,0.409997,0.35,1,229520,229072,448
27945041,11.6754,10.3782,450,110558,0.409999,0.35,1,229532,229082,450
27947961,10.3351,11.6756,448,110577,0.41,0.35,1,229542,229094,448
27950881,11.667,10.3351,450,110596,0.41,0.35,1,229554,229104,450
27953801,8.7334,11.667,446,110615,0.41,0.35,1,229562,229116,446
27956721,9.74668,8.73341,448,110634,0.41,0.35,1,229572,229124,448
27959641,6.74934,9.74668,444,110653,0.41,0.39,1,229578,229134,444
27962561,6.14987,6.74934,444,110672,0.41,0.35,1,229584,229140,444
27965481,2.82997,6.14987,440,110691,0.41,0.39,1,229586,229146,440
27968401,2.16599,2.82997,440,110710,0.41,0.35,1,229588,229148,440
27971321,21.2332,2.16599,464,110729,0.41,0.39,1,229614,229150,464
27974241,10.6466,21.2332,446,110748,0.426,0.39,1,229622,229176,446
27977161,16.5293,10.6466,456,110767,0.4292,0.39,1,229640,229184,456
27980081,14.5059,16.5293,452,110786,0.42984,0.35,1,229654,229202,452
27983001,12.5012,14.5059,450,110805,0.429968,0.39,1,229666,229216,450
27985921,13.7002,12.5012,452,110824,0.429994,0.39,1,229680,229228,452
27988841,4.34005,13.7002,440,110843,0.429999,0.35,1,229682,229242,440
27991761,16.868,4.34005,458,110862,0.43,0.39,1,229702,229244,458
27994681,12.1736,16.868,449,110881,0.446,0.37,1,229713,229264,449
27997601,12.0347,12.1736,450,110900,0.4172,0.39,1,229725,229275,450
28000521,10.4069,12.0347,448,110919,0.41144,0.35,1,229735,229287,448
28003441,10.0814,10.4069,448,110938,0.410288,0.35,1,229745,229297,448
28006361,18.0163,10.0814,458,110957,0.426058,0.37,1,229765,229307,458
28009281,13.2033,17.2163,451,110976,0.445212,0.37,1,229777,229326,451
28012201,13.8407,13.0433,453,110995,0.465042,0.37,1,229791,229338,453
28015121,10.7681,13.8087,449,111014,0.469008,0.37,1,229801,229352,449
28018041,14.9536,10.7617,455,111033,0.469802,0.37,1,229817,229362,455
28020961,7.79073,14.9523,445,111052,0.46996,0.37,1,229823,229378,445
28023881,19.1581,7.79047,461,111071,0.469992,0.39,1,229845,229384,461
28026801,15.0316,19.9581,452,111090,0.469998,0.35,1,229859,229407,452
28029721,15.8063,15.1916,454,111109,0.47,0.33,1,229875,229421,454
28032641,15.9613,15.0383,455,111128,0.486,0.37,1,229891,229436,455
28035561,22.3923,15.8077,463,111147,0.4892,0.41,1,229915,229452,463
28038481,14.0785,20.7615,453,111166,0.48984,0.41,1,229927,229474,453
28041401,9.21569,13.7523,449,111185,0.489968,0.41,1,229935,229486,449
28044321,3.44314,9.15046,443,111204,0.489994,0.41,1,229937,229494,443
28047241,11.8886,3.43009,455,111223,0.505999,0.41,1,229951,229496,455
28050161,10.3777,11.886,451,111242,0.5092,0.41,1,229961,229510,451
28053081,11.6755,10.3772,453,111261,0.50984,0.41,1,229973,229520,453
28056001,10.3351,11.6754,451,111280,0.509968,0.41,1,229983,229532,451
28058921,11.667,10.3351,453,111299,0.509994,0.41,1,229995,229542,453
28061841,8.7334,11.667,449,111318,0.525999,0.41,1,230003,229554,449
28064761,9.74668,8.7334,451,111337,0.5292,0.41,1,230013,229562,451
28067681,6.74934,9.74668,447,111356,0.52984,0.41,1,230019,229572,447
28070601,6.14987,6.74934,447,111375,0.529968,0.41,1,230025,229578,447
28073521,2.82997,6.14987,443,111394,0.529994,0.41,1,230027,229584,443
28076441,2.16599,2.82997,443,111413,0.529999,0.41,1,230029,229586,443
28079361,22.0332,2.16599,468,111432,0.514,0.41,1,230056,229588,468
28082281,10.8066,21.2332,450,111451,0.5428,0.43,1,230064,229614,450
28085201,16.5613,10.6466,460,111470,0.54856,0.43,1,230082,229622,460
28088121,14.5123,16.5293,456,111489,0.549712,0.43,1,230096,229640,456
28091041,12.5025,14.5059,454,111508,0.549942,0.43,1,230108,229654,454
28093961,13.7005,12.5012,456,111527,0.549989,0.43,1,230122,229666,456
28096881,4.3401,13.7002,444,111546,0.549998,0.43,1,230124,229680,444
28099801,16.868,4.34005,462,111565,0.55,0.43,1,230144,229682,462
28102721,11.3736,16.868,452,111584,0.55,0.45,1,230154,229702,452
28105641,11.8747,12.1736,453,111603,0.55,0.41,1,230166,229713,453
28108561,10.3749,12.0347,451,111622,0.55,0.41,1,230176,229725,451
28111481,10.875,10.4069,452,111641,0.566,0.41,1,230187,229735,452
28114401,18.175,10.0814,462,111660,0.5692,0.43,1,230207,229745,462
28117321,5.235,18.0163,444,111679,0.56984,0.45,1,230209,229765,444
28120241,10.647,13.2033,444,111698,0.601968,0.47,1,230221,229777,444
28123161,14.1294,13.8407,445,111717,0.608394,0.47,1,230236,229791,445
28126081,10.8259,10.7681,445,111736,0.577679,0.47,1,230246,229801,445
28129001,14.9652,14.9536,445,111755,0.603536,0.47,1,230262,229817,445
28131921,7.79304,7.79073,445,111774,0.608707,0.47,1,230268,229823,445
28134841,19.1586,19.1581,445,111793,0.577741,0.47,1,230290,229845,445
28137761,15.0317,15.0316,445,111812,0.571548,0.47,1,230304,229859,445
28140681,16.6063,15.8063,446,111831,0.58631,0.49,1,230321,229875,446
28143601,16.9213,15.9613,447,111850,0.605262,0.49,1,230338,229891,447
28146521,21.7843,22.3923,446,111869,0.609052,0.49,1,230361,229915,446
28149441,13.9569,14.0785,446,111888,0.60981,0.49,1,230373,229927,446
28152361,9.99137,9.21569,447,111907,0.593962,0.49,1,230382,229935,447
28155281,3.59827,3.44314,447,111926,0.590792,0.51,1,230384,229937,447
28158201,11.9197,11.8886,447,111945,0.606158,0.51,1,230398,229951,447
28161121,10.3839,10.3777,447,111964,0.577232,0.51,1,230408,229961,447
28164041,11.6768,11.6755,447,111983,0.603446,0.51,1,230420,229973,447
28166961,10.3354,10.3351,447,112002,0.576689,0.51,1,230430,229983,447
28169881,12.4671,11.667,448,112021,0.587338,0.53,1,230443,229995,448
28172801,8.89341,8.7334,448,112040,0.589468,0.53,1,230451,230003,448
28175721,9.77868,9.74668,448,112059,0.589894,0.53,1,230461,230013,448
28178641,6.75574,6.74934,448,112078,0.621979,0.53,1,230467,230019,448
28181561,6.15115,6.14987,448,112097,0.628396,0.53,1,230473,230025,448
28184481,2.83023,2.82997,448,112116,0.629679,0.53,1,230475,230027,448
28187401,2.16605,2.16599,448,112135,0.597936,0.51,1,230477,230029,448
28190321,22.8332,22.0332,449,112154,0.591587,0.55,1,230505,230056,449
28193241,10.9666,10.8066,449,112173,0.590317,0.55,1,230513,230064,449
28196161,16.5933,16.5613,449,112192,0.590063,0.55,1,230531,230082,449
28199081,14.5187,14.5123,449,112210,0.622013,0.55,1,230545,230096,449
28202001,12.5037,12.5025,449,112228,0.644403,0.55,1,230557,230108,449
28204921,13.7007,13.7005,449,112246,0.61688,0.55,1,230571,230122,449
28207841,4.34015,4.3401,449,112264,0.643376,0.55,1,230573,230124,449
28210761,16.868,16.868,449,112282,0.648675,0.55,1,230593,230144,449
28213681,11.3736,11.3736,449,112300,0.617735,0.55,1,230603,230154,449
28216601,11.8747,11.8747,449,112318,0.611547,0.55,1,230615,230166,449
28219521,10.3749,10.3749,449,112336,0.610309,0.57,1,230625,230176,449
28222441,11.675,10.875,450,112354,0.610062,0.57,1,230637,230187,450
28225361,18.335,18.175,450,112372,0.626012,0.57,1,230657,230207,450
28228281,5.267,5.235,450,112390,0.629202,0.61,1,230659,230209,450
28231201,11.4534,10.647,451,112408,0.64584,0.61,1,230672,230221,451
28234121,13.4907,14.1294,450,112426,0.665168,0.57,1,230686,230236,450
28237041,10.6981,10.8259,450,112444,0.669034,0.61,1,230696,230246,450
28239961,14.9396,14.9652,450,112462,0.701807,0.61,1,230712,230262,450
28242881,7.78793,7.79304,450,112480,0.676361,0.57,1,230718,230268,450
28245801,19.1576,19.1586,450,112498,0.687272,0.57,1,230740,230290,450
28248721,15.0315,15.0317,450,112516,0.721454,0.59,1,230754,230304,450
28251641,17.4063,16.6063,451,112534,0.728291,0.61,1,230772,230321,451
28254561,16.2813,16.9213,450,112552,0.697658,0.61,1,230788,230338,450
28257481,21.6563,21.7843,450,112570,0.691532,0.61,1,230811,230361,450
28260401,13.9313,13.9569,450,112588,0.722306,0.59,1,230823,230373,450
28263321,9.18625,9.99137,449,112606,0.712461,0.59,1,230831,230382,449
28266241,3.43725,3.59827,449,112624,0.710492,0.61,1,230833,230384,449
28269161,12.6874,11.9197,450,112642,0.758098,0.57,2,230848,230398,450
28272081,10.5375,10.3839,450,112660,0.73562,0.61,1,230858,230408,450
28275001,11.7075,11.6768,450,112678,0.731124,0.57,1,230870,230420,450
28277921,10.3415,10.3354,450,112696,0.730225,0.59,1,230880,230430,450
28280841,13.2683,12.4671,451,112714,0.762045,0.59,2,230894,230443,451
28283761,9.05366,8.89341,451,112732,0.736409,0.59,1,230902,230451,451
28286681,9.81073,9.77868,451,112750,0.731282,0.63,1,230912,230461,451
28289601,6.76215,6.75574,451,112768,0.762256,0.63,2,230918,230467,451
28292521,6.15243,6.15115,451,112786,0.752451,0.63,2,230924,230473,451
28295441,2.83049,2.83023,451,112804,0.79849,0.59,2,230926,230475,451
28298361,2.1661,2.16605,451,112822,0.775698,0.59,2,230928,230477,451
28301281,22.8332,22.8332,451,112840,0.77114,0.59,2,230956,230505,451
28304201,10.9666,10.9666,451,112858,0.802228,0.59,2,230964,230513,451
28307121,16.5933,16.5933,451,112876,0.776446,0.63,2,230982,230531,451
28310041,15.3187,14.5187,452,112894,0.787289,0.65,2,230997,230545,452
28312961,12.6637,12.5037,452,112912,0.789458,0.61,2,231009,230557,452
28315881,13.7327,13.7007,452,112930,0.789892,0.65,2,231023,230571,452
28318801,4.34655,4.34015,452,112948,0.757978,0.65,2,231025,230573,452
28321721,16.8693,16.868,452,112966,0.783596,0.61,2,231045,230593,452
28324641,11.3739,11.3736,452,112984,0.756719,0.61,2,231055,230603,452
28327561,11.8748,11.8747,452,113002,0.751344,0.61,2,231067,230615,452
28330481,10.375,10.3749,452,113020,0.750269,0.61,2,231077,230625,452
28333401,11.675,11.675,452,113038,0.750054,0.63,2,231089,230637,452
28336321,19.135,18.335,453,113056,0.734011,0.63,1,231110,230657,453
28339241,5.427,5.267,453,113074,0.730802,0.65,1,231112,230659,453
28342161,12.2854,11.4534,454,113092,0.73016,0.65,1,231126,230672,454
28345081,13.6571,2.29068,468,113110,0.730032,0.67,1,231140,230672,468
28348001,10.7314,11.6581,464,113128,0.730006,0.67,1,231150,230686,464
28350921,14.9463,10.3316,470,113146,0.730001,0.71,1,231166,230696,470
28353841,7.78926,14.8663,460,113164,0.746,0.67,1,231172,230712,460
28356761,19.9579,7.77327,477,113182,0.7652,0.69,2,231195,230718,477
28359681,15.1916,19.1547,469,113200,0.76904,0.73,2,231209,230740,469
28362601,17.4383,15.0309,473,113218,0.769808,0.73,2,231227,230754,473
28365521,17.0877,17.4062,472,113236,0.785962,0.69,2,231244,230772,472
28368441,21.0175,16.2812,478,113254,0.773192,0.69,2,231266,230788,478
28371361,14.6035,21.6562,468,113272,0.754638,0.73,2,231279,230811,468
28374281,9.3207,13.9312,464,113290,0.782928,0.71,2,231287,230823,464
28377201,3.46414,9.18625,458,113308,0.788585,0.71,2,231289,230831,458
28380121,13.4928,3.43725,472,113326,0.789717,0.77,2,231305,230833,472
28383041,10.6986,12.6874,467,113344,0.789943,0.73,2,231315,230848,467
28385961,11.7397,10.5375,469,113362,0.805989,0.73,2,231327,230858,469
28388881,10.3479,11.7075,467,113380,0.809198,0.73,2,231337,230870,467
28391801,13.2696,10.3415,471,113398,0.80984,0.77,2,231351,230880,471
28394721,9.05392,13.2683,465,113416,0.809968,0.73,2,231359,230894,465
28397641,10.6108,9.05366,468,113434,0.825994,0.73,2,231370,230902,468
28400561,7.72216,9.81073,465,113452,0.813199,0.77,2,231377,230912,465
28403481,6.34443,6.76215,465,113470,0.77864,0.75,2,231383,230918,465
28406401,2.86889,6.15243,461,113488,0.803728,0.81,2,231385,230924,461
28409321,2.17378,2.83049,461,113506,0.808746,0.77,2,231387,230926,461
28412241,22.8348,2.1661,487,113524,0.809749,0.77,2,231415,230928,487
28415161,10.967,22.8332,467,113542,0.80995,0.81,2,231423,230956,467
28418081,16.5934,10.9666,477,113560,0.80999,0.77,2,231441,230964,477
28421001,14.5187,16.5933,473,113578,0.809998,0.79,2,231455,230982,473
28423921,12.5037,15.3187,470,113596,0.81,0.79,2,231467,230997,470
28426841,13.7007,12.6637,472,113614,0.81,0.79,2,231481,231009,472
28429761,4.34015,13.7327,460,113632,0.81,0.75,2,231483,231023,460
28432681,16.868,4.34655,478,113650,0.826,0.79,2,231503,231025,478
28435601,11.3736,16.8693,468,113668,0.8292,0.75,2,231513,231045,468
28438521,11.8747,11.3739,470,113686,0.82984,0.75,2,231525,231055,470
28441441,10.3749,11.8748,468,113704,0.829968,0.75,2,231535,231067,468
28444361,11.675,10.375,470,113722,0.829994,0.75,2,231547,231077,470
28447281,18.335,11.675,478,113740,0.829999,0.73,2,231567,231089,478
28450201,5.267,19.135,459,113758,0.83,0.73,2,231569,231110,459
28453121,12.2534,5.427,471,113776,0.83,0.73,2,231583,231112,471
28456041,13.6507,12.2854,471,113794,0.83,0.73,2,231597,231126,471
28458961,10.7301,13.6571,467,113812,0.83,0.73,2,231607,231140,467
28461881,15.746,10.7314,474,113830,0.814,0.73,2,231624,231150,474
28464801,7.94921,14.9463,464,113848,0.8108,0.75,2,231630,231166,464
28467721,20.7898,7.78926,482,113866,0.81016,0.77,2,231654,231172,482
28470641,15.358,19.9579,473,113884,0.826032,0.77,2,231668,231195,473
28473561,17.4716,15.1916,477,113902,0.861206,0.77,2,231686,231209,477
28476481,17.0943,17.4383,476,113920,0.884241,0.79,2,231703,231227,476
28479401,21.0189,17.0877,481,113938,0.872848,0.77,2,231725,231244,481
28482321,15.4038,21.0175,473,113956,0.87057,0.75,2,231739,231266,473
28485241,9.48075,14.6035,468,113974,0.870114,0.79,2,231747,231279,468
28488161,3.49615,9.3207,462,113992,0.870023,0.79,2,231749,231287,462
28491081,13.4992,3.46414,476,114010,0.870004,0.79,2,231765,231289,476
28494001,11.4998,13.4928,471,114028,0.902001,0.79,2,231776,231305,471
28496921,11.9,10.6986,473,114046,0.8924,0.81,2,231788,231315,473
28499841,10.38,11.7397,471,114064,0.89048,0.81,2,231798,231327,471
28502761,13.276,10.3479,475,114082,0.890096,0.81,2,231812,231337,475
28505681,9.0552,13.2696,469,114100,0.890019,0.81,2,231820,231351,469
28508601,9.81104,9.05392,471,114118,0.890004,0.83,2,231830,231359,471
28511521,8.36221,10.6108,468,114136,0.890001,0.81,2,231838,231370,468
28514441,6.47244,7.72216,467,114154,0.906,0.77,2,231844,231377,467
28517361,2.89449,6.34443,463,114172,0.9092,0.81,2,231846,231383,463
28520281,2.1789,2.86889,463,114190,0.90984,0.81,2,231848,231385,463
28523201,22.8358,2.17378,489,114208,0.909968,0.81,2,231876,231387,489
28526121,10.9672,22.8348,469,114226,0.909994,0.81,2,231884,231415,469
28529041,16.5934,10.967,479,114244,0.925999,0.81,2,231902,231423,479
28531961,14.5187,16.5934,475,114262,0.9292,0.81,2,231916,231441,475
28534881,12.5037,14.5187,473,114280,0.92984,0.81,2,231928,231455,473
28537801,14.5007,12.5037,476,114298,0.945968,0.81,2,231943,231467,476
28540721,4.50015,13.7007,464,114316,0.949194,0.81,2,231945,231481,464
29348201,2,0,462,57886,0.89,0.81,2,235797,235335,462
29351121,2,0,464,57922,0.89,0.81,2,235799,235335,464
29354041,2,0,466,57958,0.922,0.81,2,235801,235335,466
29356961,2,0,468,57994,0.8964,0.81,2,235803,235335,468
29359881,2,0,470,58030,0.89128,0.81,2,235805,235335,470
29362801,20.4,0,495,58066,0.906256,0.81,2,235830,235335,495
29365721,17.68,0,512,58102,0.893251,0.81,2,235847,235335,512
29368641,10.736,0,521,58138,0.90665,0.81,2,235856,235335,521
29371561,3.7472,0,523,58174,0.90933,0.81,2,235858,235335,523
29374481,2.34944,0,525,58210,0.877866,0.81,2,235860,235335,525
29377401,5.26989,0,531,58246,0.887573,0.81,2,235866,235335,531
29380321,12.254,0,545,58282,0.921515,0.81,2,235880,235335,545
29383241,4.0508,0,547,58318,0.896303,0.81,2,235882,235335,547
29386161,2.41016,0,549,58354,0.859261,1,2,235884,235335,549
29389081,2.08203,9.6,539,58390,0.851852,1,2,235886,235347,539
29392001,2.01641,1.92,541,58426,0.88237,1,2,235888,235347,541
29394921,2.00328,13.184,527,58462,0.888474,1,2,235890,235363,527
29396381,161.201,17.0368,710,58498,0.921695,0.87,2,236091,235381,710
29399301,166.64,333.007,466,58534,0.928339,0.93,2,236259,235793,466
29402221,34.928,68.2015,466,58570,0.929668,0.89,2,236261,235795,466
29943881,27,50,481,34084,0.53,1,1,242409,241928,481
29946801,65.4,59.6,494,34146,0.594,1,1,242484,241990,494
29949721,36.28,42.32,485,34208,0.5668,1,1,242513,242028,485
29952641,23.256,8.464,505,34270,0.52136,1,1,242533,242028,505
29955561,19.0512,28.0928,490,34332,0.504272,1,1,242551,242061,490
29958481,27.8102,20.0186,502,34394,0.364854,1,1,242581,242079,502
29961401,36.762,18.4037,523,34455,0.360971,0.95,1,242620,242097,523
29964321,28.9524,37.2807,508,34516,0.352194,1,1,242647,242139,508
29967241,24.1905,40.2561,490,34577,0.350439,1,1,242670,242180,490
29970161,17.6381,24.0512,486,34638,0.302088,0.93,1,242686,242200,486
29973081,117.128,19.2102,610,34699,0.0604176,0.55,1,242828,242218,610
29976001,57.0255,135.042,488,34760,0.0520835,0.53,1,242870,242382,488
29978921,61.0051,48.6084,523,34821,0.0664167,0.61,1,242932,242409,523
29981841,34.601,69.7217,476,34882,0.0372833,0.56,1,242960,242484,476
29984761,21.3202,37.1443,465,34943,0.0314567,0.51,1,242978,242513,465
29987681,15.464,23.4289,459,35004,0.0622913,0.5,1,242992,242533,459
29990601,22.2928,19.0858,465,35064,0.0524583,0.33,1,243016,242551,465
29993521,42.0586,27.8172,482,35124,0.0504917,0.36,1,243063,242581,482
29996441,28.4117,36.7634,468,35184,0.0500983,0.35,1,243088,242620,468
29999361,20.8823,28.9527,460,35244,0.0340197,0.35,1,243107,242647,460
30002281,14.5765,24.1905,450,35304,0.0788039,0.29,1,243120,242670,450
30005201,106.115,17.6381,563,35364,0.0557608,0,1,243249,242686,563
30008121,55.6231,117.128,464,35424,0.0191522,0.05,1,243292,242828,464
30011041,60.7246,57.0255,484,35484,0.0278304,0.07,1,243354,242870,484
30013961,34.5449,61.0051,450,35544,0.0295661,0.03,1,243382,242932,450
30016881,22.909,34.601,442,35603,0.0299132,0.03,1,243402,242960,442
30019801,14.1818,21.3202,436,35662,0.0299826,0.07,1,243414,242978,436
30022721,4.43636,15.464,424,35721,0.0299965,0.05,1,243416,242992,424
30025641,18.4873,22.2928,422,35780,0.0299993,0.05,1,243438,243016,422
30028561,41.2975,42.0586,422,35839,0.0299999,0.05,1,243485,243063,422
30031481,29.8595,28.4117,424,35898,0.03,0.03,1,243512,243088,424
30034401,21.9719,20.8823,425,35957,0.03,0.09,1,243532,243107,425
30037321,13.9944,14.5765,424,36016,0.03,0.05,1,243544,243120,424
30040241,105.999,106.115,424,36075,0.078,0.01,1,243673,243249,424
30043161,54.7998,55.6231,423,36134,0.0876,0.03,1,243715,243292,423
30046081,60.56,60.7246,423,36192,0.07352,0.03,1,243777,243354,423
30049001,34.512,34.5449,423,36250,0.070704,0.03,1,243805,243382,423
30051921,22.9024,22.909,423,36308,0.0701408,0.03,1,243825,243402,423
30054841,14.1805,14.1818,423,36366,0.0380282,0.03,1,243837,243414,423
30057761,4.4361,4.43636,423,36424,0.0636056,0.03,1,243839,243416,423
30060681,17.6872,18.4873,422,36482,0.0527211,0.03,1,243860,243438,422
30063601,42.7374,41.2975,424,36540,0.0345442,0.03,1,243909,243485,424
30066521,29.3475,29.8595,423,36598,0.0629088,0.03,1,243935,243512,423
30069441,21.8695,21.9719,423,36656,0.0685818,0.03,1,243955,243532,423
30072361,13.9739,13.9944,423,36714,0.0537164,0.09,1,243967,243544,423
30075281,106.795,105.999,424,36772,0.0667433,0.09,1,244097,243673,424
30078201,54.959,54.7998,424,36829,0.0533486,0.07,1,244139,243715,424
30081121,59.7918,60.56,423,36886,0.0506697,0.07,1,244200,243777,423
30084041,34.3584,34.512,423,36943,0.0821339,0.07,1,244228,243805,423
30086961,22.8717,22.9024,423,37000,0.0564268,0.03,1,244248,243825,423
30089881,14.1743,14.1805,423,37057,0.0832854,0.07,1,244260,243837,423
30092801,4.43487,4.4361,423,37114,0.0886571,0.05,1,244262,243839,423
30095721,16.887,17.6872,422,37171,0.0897314,0.05,1,244282,243860,422
30098641,42.5774,3.53744,471,37228,0.0419463,0.03,1,244331,243860,471
30101561,29.3155,39.9075,448,37285,0.0483893,0.07,1,244357,243909,448
30104481,22.6631,28.7815,443,37342,0.0336779,0.07,1,244378,243935,443
30107401,14.1326,21.7563,435,37399,0.0627356,0.05,1,244390,243955,435
30110321,106.027,13.9513,552,37455,0.100547,0.07,1,244519,243967,552
30113241,54.0053,106.79,463,37511,0.108109,0.05,1,244560,244097,463
30116161,61.2011,54.9581,484,37567,0.157622,0.05,1,244623,244139,484
30119081,34.6402,59.7916,451,37623,0.183524,0.09,1,244651,244200,451
30122001,22.928,34.3583,443,37679,0.188705,0.05,1,244671,244228,443
30124921,14.1856,22.8717,435,37735,0.189741,0.09,1,244683,244248,435
30127841,4.43712,14.1743,425,37791,0.189948,0.09,1,244685,244260,425
30130761,16.8874,4.43487,443,37847,0.18999,0.09,1,244705,244262,443
30133681,41.7775,16.887,471,37903,0.189998,0.03,1,244753,244282,471
30136601,29.9555,42.5774,449,37959,0.174,0.05,1,244780,244331,449
30139521,23.5911,29.3155,445,38015,0.1868,0.03,1,244802,244357,445
30142441,14.3182,22.6631,436,38071,0.18936,0.07,1,244814,244378,436
30145361,108.464,14.1326,556,38126,0.205872,0.11,1,244946,244390,556
30148281,53.6927,106.027,467,38181,0.241174,0.11,1,244986,244519,467
30151201,63.5385,54.0053,492,38236,0.296235,0.17,1,245052,244560,492
30154121,35.9077,61.2011,458,38291,0.307247,0.19,1,245081,244623,458
30157041,23.1815,34.6402,450,38346,0.309449,0.19,1,245101,244651,450
30159961,14.2363,22.928,442,38401,0.30989,0.19,1,245113,244671,442
30162881,4.44726,14.1856,432,38456,0.309978,0.19,1,245115,244683,432
30165801,16.8895,4.43712,450,38511,0.309996,0.19,1,245135,244685,450
30168721,41.7779,16.8874,478,38566,0.309999,0.19,1,245183,244705,478
30171641,29.1556,41.7775,456,38621,0.31,0.17,1,245209,244753,456
30174561,7.43112,29.9555,431,38676,0.31,0.19,1,245211,244780,431
30177481,19.0862,23.5911,431,38731,0.31,0.19,1,245233,244802,431
30180401,14.2172,14.3182,432,38786,0.326,0.21,1,245246,244814,432
30183321,110.043,108.464,434,38840,0.3292,0.25,1,245380,244946,434
30186241,54.8087,53.6927,435,38894,0.34584,0.31,1,245421,244986,435
30189161,66.1617,63.5385,438,38948,0.381168,0.31,1,245490,245052,438
30192081,35.6323,35.9077,437,39002,0.388234,0.31,1,245518,245081,437
30195001,23.1265,23.1815,437,39056,0.389647,0.31,1,245538,245101,437
30197921,14.2253,14.2363,437,39110,0.357929,0.31,1,245550,245113,437
30200841,4.44506,4.44726,437,39164,0.383586,0.31,1,245552,245115,437
30203761,16.889,16.8895,437,39218,0.372717,0.31,1,245572,245135,437
30206681,41.7778,41.7779,437,39272,0.402543,0.31,1,245620,245183,437
30209601,29.1556,29.1556,437,39326,0.408509,0.31,1,245646,245209,437
30212521,7.43111,7.43112,437,39380,0.409702,0.31,1,245648,245211,437
30215441,19.0862,19.0862,437,39434,0.42594,0.33,1,245670,245233,437
30218361,13.4172,14.2172,436,39488,0.397188,0.33,1,245682,245246,436
30221281,111.483,110.043,438,39541,0.407438,0.35,1,245818,245380,438
30224201,54.2967,54.8087,437,39594,0.425488,0.39,1,245858,245421,437
30227121,67.6593,66.1617,439,39647,0.397097,0.39,1,245929,245490,439
30230041,35.9319,35.6323,439,39700,0.42342,0.39,1,245957,245518,439
30232961,23.1864,23.1265,439,39753,0.444684,0.35,1,245977,245538,439
30235881,14.2373,14.2253,439,39806,0.448937,0.39,1,245989,245550,439
30238801,4.44745,4.44506,439,39859,0.449787,0.37,1,245991,245552,439
30241721,17.6895,16.889,440,39912,0.465957,0.41,1,246012,245572,440
30244641,41.9379,41.7778,440,39965,0.469192,0.41,1,246060,245620,440
30247561,29.1876,29.1556,440,40018,0.469838,0.41,1,246086,245646,440
30250481,7.43752,7.43111,440,40071,0.437968,0.41,1,246088,245648,440
30253401,19.0875,1.48622,462,40124,0.431594,0.43,1,246110,245648,462
30256321,13.4175,17.8972,452,40177,0.430319,0.39,1,246122,245670,452
30259241,112.283,13.1794,577,40230,0.462064,0.41,1,246259,245682,577
30262161,55.2567,111.436,482,40282,0.468413,0.43,1,246300,245818,482
30265081,66.2513,54.2872,511,40334,0.501683,0.39,1,246369,245858,511
30268001,36.4503,67.6574,469,40386,0.508336,0.43,1,246398,245929,469
30270921,23.2901,35.9315,461,40438,0.557667,0.45,1,246418,245957,461
30273841,14.258,23.1863,453,40490,0.567533,0.45,1,246430,245977,453
30276761,4.4516,14.2373,443,40542,0.569507,0.45,1,246432,245989,443
30279681,18.4903,4.44745,463,40594,0.569901,0.47,1,246454,245991,463
30282601,42.0981,17.6895,490,40646,0.58598,0.47,1,246502,246012,490
30285521,29.2196,41.9379,468,40698,0.589196,0.47,1,246528,246060,468
30288441,7.44392,29.1876,444,40750,0.589839,0.43,1,246530,246086,444
30291361,19.0888,7.43752,464,40802,0.589968,0.43,1,246552,246088,464
30294281,13.4178,19.0875,454,40854,0.589994,0.43,1,246564,246110,454
30297201,113.884,13.4175,581,40906,0.605999,0.47,1,246703,246122,581
30300121,55.5767,112.283,485,40958,0.6252,0.47,1,246744,246259,485
30303041,67.9153,55.2567,515,41010,0.64504,0.51,1,246815,246300,515
30305961,38.3831,66.2513,477,41061,0.681008,0.51,1,246846,246369,477
30308881,24.4766,36.4503,469,41112,0.704202,0.57,1,246867,246398,469
30311801,14.4953,23.2901,461,41163,0.72484,0.57,1,246879,246418,461
30314721,4.49906,14.258,451,41214,0.728968,0.57,1,246881,246430,451
30317641,18.4998,4.4516,471,41265,0.729794,0.57,1,246903,246432,471
30320561,42.9,18.4903,498,41316,0.713959,0.59,1,246952,246454,498
30323481,29.38,42.0981,476,41367,0.710792,0.59,1,246978,246502,476
30326401,7.476,29.2196,452,41418,0.710158,0.59,1,246980,246528,452
30329321,19.0952,7.44392,472,41469,0.710032,0.59,1,247002,246530,472
30332241,13.419,19.0888,462,41520,0.710006,0.59,1,247014,246552,462
30335161,4.28381,13.4178,452,41571,0.710001,0.61,1,247016,246564,452
30338081,112.057,113.884,452,41622,0.71,0.63,1,247155,246703,452
30341001,56.0114,55.5767,453,41673,0.71,0.65,1,247197,246744,453
30343921,69.6023,67.9153,455,41724,0.742,0.69,1,247270,246815,455
30346841,39.5205,38.3831,456,41775,0.7324,0.71,1,247302,246846,456
30349761,26.3041,24.4766,458,41826,0.76248,0.73,2,247325,246867,458
30352681,14.8608,14.4953,458,41876,0.736496,0.73,1,247337,246879,458
30355601,4.57216,4.49906,458,41926,0.763299,0.73,2,247339,246881,458
30358521,18.5144,18.4998,458,41976,0.75266,0.71,2,247361,246903,458
30361441,42.1029,42.9,457,42026,0.782532,0.71,2,247409,246952,457
30364361,29.2206,29.38,457,42076,0.804506,0.71,2,247435,246978,457
30367281,7.44412,7.476,457,42126,0.808901,0.71,2,247437,246980,457
30370201,19.0888,19.0952,457,42176,0.80978,0.71,2,247459,247002,457
30373121,13.4178,13.419,457,42226,0.777956,0.71,2,247471,247014,457
30376041,4.28355,4.28381,457,42276,0.803591,0.71,2,247473,247016,457
30378961,112.057,112.057,457,42326,0.792718,0.71,2,247612,247155,457
30381881,56.0113,56.0114,457,42376,0.838544,0.75,2,247654,247197,457
30384801,70.4023,69.6023,458,42426,0.847709,0.73,2,247728,247270,458
30387721,40.4805,39.5205,459,42476,0.833542,0.77,2,247761,247302,459
30390641,25.6961,26.3041,458,42526,0.846708,0.73,2,247783,247325,458
30393561,14.7392,14.8608,458,42576,0.817342,0.77,2,247795,247337,458
30396481,4.54784,4.57216,458,42626,0.843468,0.75,2,247797,247339,458
30399401,19.3096,18.5144,459,42676,0.832694,0.79,2,247820,247361,459
30402321,42.2619,42.1029,459,42725,0.846539,0.81,2,247868,247409,459
30405241,30.0524,29.2206,460,42774,0.865308,0.81,2,247895,247435,460
30408161,7.61048,7.44412,460,42823,0.837062,0.81,2,247897,247437,460
30411081,19.1221,19.0888,460,42872,0.863412,0.77,2,247919,247459,460
30414001,13.4244,13.4178,460,42921,0.868682,0.81,2,247931,247471,460
30416921,4.28488,4.28355,460,42970,0.869736,0.79,2,247933,247473,460
30419841,113.657,112.057,462,43019,0.853947,0.79,2,248074,247612,462
30422761,57.1314,22.4113,505,43068,0.850789,0.85,2,248117,247612,505
30425681,69.0263,38.0823,535,43117,0.850158,0.85,2,248189,247654,535
30428601,39.4053,66.8165,493,43166,0.866032,0.83,2,248221,247728,493
30431521,26.2811,39.7633,483,43215,0.885206,0.85,2,248244,247761,483
30434441,14.8562,25.5527,473,43264,0.889041,0.81,2,248256,247783,473
30437361,4.57124,14.7105,463,43313,0.889808,0.85,2,248258,247795,463
30440281,19.3142,4.54211,484,43362,0.921962,0.83,2,248281,247797,484
30618401,17,56,492,46235,0.69,1,1,250249,249757,492
30621321,19.4,31.2,487,46281,0.666,1,1,250269,249782,487
30624241,14.28,14.24,490,46327,0.7332,1,1,250282,249792,490
30627161,13.256,14.848,488,46373,0.68264,1,1,250295,249807,488
30630081,19.4512,14.1696,495,46418,0.624528,0.99,1,250316,249821,495
30633001,103.09,16.4339,602,46463,0.660906,1,1,250440,249838,602
30635921,40.618,107.287,497,46508,0.716181,1,1,250465,249968,497
30638841,72.9236,46.2574,547,46553,0.535236,0.94,1,250546,249999,547
30641761,30.5847,70.0515,491,46598,0.515047,1,1,250566,250075,491
30644681,15.7169,30.8103,482,46643,0.543009,1,1,250578,250096,482
30647601,21.5434,15.7621,493,46688,0.500602,0.95,1,250601,250108,493
30650521,13.9087,22.3524,481,46733,0.50812,0.98,1,250613,250132,481
30653441,14.7817,16.4705,481,46778,0.493624,0.93,1,250628,250147,481
30656361,11.7563,16.0941,476,46823,0.538725,0.91,1,250639,250163,476
30659281,41.5513,13.6188,512,46868,0.563745,0.73,1,250688,250176,512
30662201,22.7103,47.5238,474,46913,0.536749,0.69,1,250706,250232,474
30665121,19.7421,23.1048,476,46958,0.51535,0.66,1,250725,250249,476
30668041,11.1484,20.621,465,47003,0.51107,0.75,1,250734,250269,465
30670961,13.4297,14.5242,466,47048,0.526214,0.67,1,250748,250282,466
30673881,15.4859,13.3048,469,47093,0.529243,0.61,1,250764,250295,469
30676801,108.697,19.461,580,47138,0.369849,0.67,1,250896,250316,580
30679721,41.7394,103.092,481,47183,0.28997,0.73,1,250921,250440,481
30682641,63.5479,40.6184,525,47228,0.289994,0.49,1,250990,250465,525
30685561,30.3096,72.9237,466,47273,0.321999,0.51,1,251012,250546,466
30688481,14.0619,30.5847,456,47318,0.3284,0.55,1,251022,250566,456
30691401,22.0124,15.7169,468,47363,0.32968,0.49,1,251046,250578,468
30694321,6.00248,21.5434,447,47408,0.329936,0.51,1,251048,250601,447
30697241,9.2005,13.9087,445,47452,0.329987,0.49,1,251058,250613,445
30700161,16.2401,14.7817,448,47496,0.329997,0.55,1,251076,250628,448
30703081,11.248,11.7563,447,47540,0.329999,0.57,1,251086,250639,447
30706001,42.2496,41.5513,448,47584,0.362,0.53,1,251136,250688,448
30708921,22.8499,22.7103,448,47628,0.3684,0.51,1,251154,250706,448
30711841,19.77,19.7421,448,47672,0.40168,0.51,1,251173,250725,448
30714761,10.354,11.1484,447,47716,0.376336,0.53,1,251181,250734,447
30717681,14.0708,13.4297,448,47760,0.387267,0.53,1,251196,250748,448
30720601,14.0142,15.4859,446,47804,0.389453,0.33,1,251210,250764,446
30723521,102.003,108.697,438,47848,0.437891,0.27,1,251334,250896,438
30726441,39.6006,41.7394,437,47892,0.431578,0.29,1,251358,250921,437
30729361,62.3201,63.5479,436,47936,0.430316,0.33,1,251426,250990,436
30732281,31.664,30.3096,438,47980,0.430063,0.33,1,251450,251012,438
30735201,14.3328,14.0619,438,48024,0.430013,0.33,1,251460,251022,438
30738121,22.0666,22.0124,438,48068,0.478003,0.33,1,251484,251046,438
30741041,6.01331,6.00248,438,48112,0.487601,0.33,1,251486,251048,438
30743961,9.20266,9.2005,438,48156,0.45752,0.33,1,251496,251058,438
30746881,16.2405,16.2401,438,48200,0.499504,0.33,1,251514,251076,438
30749801,11.2481,11.248,438,48244,0.475901,0.37,1,251524,251086,438
30752721,43.8496,42.2496,440,48288,0.47118,0.37,1,251576,251136,440
30755641,23.1699,22.8499,440,48332,0.502236,0.41,1,251594,251154,440
30758561,19.834,19.77,440,48376,0.492447,0.37,1,251613,251173,440
30761481,10.3668,10.354,440,48420,0.458489,0.39,1,251621,251181,440
30764401,13.2734,14.0708,439,48464,0.451698,0.39,1,251635,251196,439
30767321,13.8547,14.0142,439,48507,0.48234,0.45,1,251649,251210,439
30770241,104.371,102.003,442,48550,0.488468,0.43,1,251776,251334,442
30773161,40.8742,39.6006,443,48593,0.505694,0.43,1,251801,251358,443
30776081,62.5748,62.3201,443,48636,0.509139,0.43,1,251869,251426,443
30779001,31.715,31.664,443,48679,0.509828,0.43,1,251893,251450,443
30781921,15.143,14.3328,444,48722,0.493966,0.49,1,251904,251460,444
30784841,22.2286,22.0666,444,48765,0.458793,0.49,1,251928,251484,444
30787761,6.04572,6.01331,444,48808,0.451759,0.45,1,251930,251486,444
30790681,9.20914,9.20266,444,48851,0.450352,0.45,1,251940,251496,444
30793601,16.2418,1.84053,462,48894,0.45007,0.51,1,251958,251496,462
30796521,11.2484,14.7681,454,48937,0.450014,0.47,1,251968,251514,454
30799441,43.8497,10.9536,496,48980,0.466003,0.47,1,252020,251524,496
30802361,23.1699,43.7907,462,49023,0.469201,0.51,1,252038,251576,462
30805281,19.034,23.1581,462,49066,0.48584,0.49,1,252056,251594,462
30808201,10.2068,19.8316,451,49109,0.489168,0.45,1,252064,251613,451
30811121,13.2414,10.3663,457,49152,0.489834,0.45,1,252078,251621,457
30814041,13.8483,13.2733,457,49195,0.489967,0.49,1,252092,251635,457
30816961,104.37,13.8547,570,49238,0.569993,0.49,1,252219,251649,570
30819881,41.6739,104.371,469,49281,0.585999,0.51,1,252245,251776,469
30822801,62.7348,40.8742,512,49324,0.6052,0.51,1,252313,251801,512
30825721,31.747,62.5748,468,49367,0.60904,0.51,1,252337,251869,468
30828641,14.3494,31.715,454,49410,0.609808,0.49,1,252347,251893,454
30831561,22.0699,15.143,467,49453,0.609962,0.45,1,252371,251904,467
30834481,6.01398,22.2286,445,49496,0.609992,0.45,1,252373,251928,445
30837401,9.2028,6.04572,453,49539,0.609998,0.45,1,252383,251930,453
30840321,16.2406,9.20914,461,49582,0.61,0.45,1,252401,251940,461
30843241,11.2481,16.2418,453,49624,0.61,0.45,1,252411,251958,453
30846161,44.6496,11.2484,496,49666,0.626,0.47,1,252464,251968,496
30849081,24.1299,43.8497,463,49708,0.6132,0.47,1,252483,252020,463
30852001,19.226,23.1699,463,49750,0.64264,0.49,1,252501,252038,463
30854921,10.2452,19.034,453,49792,0.648528,0.49,1,252509,252056,453
30857841,13.249,10.2068,459,49834,0.649706,0.49,1,252523,252064,459
30860761,14.6498,13.2414,460,49876,0.633941,0.49,1,252538,252078,460
30863681,107.73,13.8483,577,49918,0.694788,0.59,1,252669,252092,577
30866601,42.346,104.37,476,49960,0.706958,0.59,1,252695,252219,476
30869521,63.6692,41.6739,519,50002,0.693392,0.61,1,252764,252245,519
30872441,31.9338,62.7348,475,50044,0.690678,0.61,1,252788,252313,475
30875361,14.3868,31.747,461,50086,0.690136,0.61,1,252798,252337,461
30878281,22.0774,14.3494,475,50128,0.690027,0.61,1,252822,252347,475
30881201,6.01547,22.0699,453,50170,0.690005,0.61,1,252824,252371,453
30884121,9.20309,6.01398,461,50212,0.690001,0.61,1,252834,252373,461
30887041,16.2406,9.2028,469,50254,0.69,0.61,1,252852,252383,469
30889961,11.2481,16.2406,461,50296,0.69,0.61,1,252862,252401,461
30892881,3.84962,11.2481,453,50338,0.69,0.63,1,252864,252411,453
30895801,43.1699,44.6496,453,50380,0.706,0.61,1,252917,252464,453
30898721,24.634,24.1299,454,50422,0.7252,0.65,1,252937,252483,454
30901641,19.3268,19.226,454,50464,0.72904,0.65,1,252955,252501,454
30904561,10.2654,10.2452,454,50506,0.745808,0.65,1,252963,252509,454
30907481,13.2531,13.249,454,50548,0.781162,0.63,2,252977,252523,454
30910401,15.4506,14.6498,455,50590,0.788232,0.71,2,252993,252538,455
30913321,109.49,107.73,457,50632,0.821647,0.71,2,253126,252669,457
30916241,42.698,42.346,457,50674,0.796329,0.69,2,253152,252695,457
30919161,62.9396,63.6692,456,50716,0.807266,0.69,2,253220,252764,456
30922081,31.7879,31.9338,456,50758,0.825453,0.69,2,253244,252788,456
30925001,14.3576,14.3868,456,50799,0.829091,0.69,2,253254,252798,456
30927921,22.0715,22.0774,456,50840,0.861818,0.69,2,253278,252822,456
30930841,6.0143,6.01547,456,50881,0.868364,0.69,2,253280,252824,456
30933761,9.20286,9.20309,456,50922,0.837673,0.69,2,253290,252834,456
30936681,16.2406,16.2406,456,50963,0.863535,0.69,2,253308,252852,456
30939601,11.2481,11.2481,456,51004,0.836707,0.69,2,253318,252862,456
30942521,3.84962,3.84962,456,51045,0.863341,0.71,2,253320,252864,456
30945441,43.9699,43.1699,457,51086,0.852668,0.73,2,253374,252917,457
30948361,25.594,24.634,458,51127,0.882534,0.73,2,253395,252937,458
30951281,20.3188,19.3268,459,51168,0.904507,0.75,2,253414,252955,459
30954201,10.4638,10.2654,459,51209,0.876901,0.79,2,253422,252963,459
30957121,13.2928,13.2531,459,51250,0.87138,0.79,2,253436,252977,459
30960041,15.4586,15.4506,459,51291,0.870276,0.83,2,253452,252993,459
30962961,111.092,109.49,461,51332,0.870055,0.79,2,253587,253126,461
30965881,43.0183,42.698,461,51373,0.870011,0.81,2,253613,253152,461
30968801,63.8037,62.9396,462,51414,0.886002,0.83,2,253682,253220,462
30971721,32.7607,31.7879,463,51455,0.9052,0.83,2,253707,253244,463
30974641,14.5521,14.3576,463,51496,0.87704,0.87,2,253717,253254,463
30977561,22.1104,22.0715,463,51537,0.871408,0.87,2,253741,253278,463
30980481,6.02209,6.0143,463,51578,0.870282,0.83,2,253743,253280,463
30983401,9.20442,9.20286,463,51619,0.870056,0.87,2,253753,253290,463
30986321,16.2409,16.2406,463,51660,0.902011,0.83,2,253771,253308,463
30989241,11.2482,11.2481,463,51701,0.876402,0.87,2,253781,253318,463
30992161,3.84964,3.84962,463,51742,0.87128,0.85,2,253783,253320,463
30995081,44.7699,43.9699,464,51783,0.886256,0.85,2,253838,253374,464
30998001,26.554,8.79398,486,51824,0.857251,0.89,2,253860,253374,486
31000921,19.7108,18.5588,483,51865,0.86745,0.91,2,253878,253395,483
31003841,10.3422,18.9118,472,51906,0.86949,0.87,2,253886,253414,472
31006761,13.2684,10.1824,478,51947,0.869898,0.87,2,253900,253422,478
31009681,15.4537,13.2365,480,51988,0.86998,0.87,2,253916,253436,480
31012601,109.491,15.4473,597,52029,0.917996,0.87,2,254049,253452,597
31278321,88,17,555,55586,0.67,1,1,256523,255968,555
31281241,32,71.4,488,55624,0.63,1,1,256541,256053,488
31284161,21.6,29.48,488,55662,0.59,1,1,256560,256072,488
31287081,25.12,20.296,496,55700,0.534,1,1,256586,256090,496
31290001,19.424,19.2592,495,55738,0.5788,1,1,256604,256109,495
31292921,12.6848,18.2518,488,55776,0.58776,0.93,1,256615,256127,488
31295841,16.937,14.8504,492,55814,0.541552,1,1,256633,256141,492
31298761,16.9874,21.3701,486,55852,0.46831,1,1,256650,256164,486
31301681,16.9975,14.674,490,55890,0.421662,1,1,256667,256177,490
31304601,18.5995,13.3348,496,55928,0.412332,1,1,256686,256190,496
31307521,22.1199,21.867,495,55966,0.378466,0.93,1,256709,256214,495
31310441,14.824,18.7734,490,56004,0.371693,0.88,1,256722,256232,490
31313361,16.5648,16.5547,491,56042,0.322339,0.98,1,256739,256248,491
31316281,10.513,18.5109,481,56080,0.296468,0.98,1,256748,256267,481
31319201,12.5026,13.3022,482,56118,0.307294,1,1,256761,256279,482
31322121,8.10052,12.2604,477,56155,0.293459,0.99,1,256768,256291,477
31325041,3.2201,10.4521,469,56192,0.258692,0.71,1,256770,256301,469
31327961,84.644,94.8904,458,56229,0.555738,0.67,1,256875,256417,458
31330881,32.1288,33.3781,459,56266,0.631148,0.67,1,256894,256435,459
31333801,72.8258,77.0756,454,56303,0.63023,0.62,1,256977,256523,454
31336721,25.7652,29.8151,450,56340,0.630046,0.58,1,256991,256541,450
31339641,21.153,21.163,451,56377,0.678009,0.52,1,257011,256560,451
31342561,25.0306,25.0326,451,56414,0.671602,0.59,1,257037,256586,451
31345481,18.6061,19.4065,450,56451,0.65432,0.59,1,257054,256604,450
31348401,9.32122,12.6813,446,56488,0.634864,0.53,1,257061,256615,446
31351321,15.4642,16.9363,445,56525,0.614973,0.45,1,257078,256633,445
31354241,15.8928,16.9873,444,56562,0.610995,0.41,1,257094,256650,444
31357161,16.7786,16.9975,444,56599,0.562199,0.41,1,257111,256667,444
31360081,17.7557,18.5995,443,56636,0.56844,0.37,1,257129,256686,443
31363001,18.7511,22.1199,439,56673,0.569688,0.37,1,257148,256709,439
31365921,13.3502,14.824,438,56710,0.569938,0.31,1,257160,256722,438
31368841,14.67,16.5648,436,56747,0.553988,0.29,1,257175,256739,436
31371761,8.53401,10.513,434,56784,0.534797,0.31,1,257182,256748,434
31374681,12.9068,12.5026,435,56821,0.46696,0.29,1,257196,256761,435
31377601,8.98136,8.10052,436,56858,0.453392,0.25,1,257204,256768,436
31380521,4.99627,3.2201,438,56895,0.418678,0.63,1,257208,256770,438
31383441,96.9993,84.644,453,56932,0.443736,0.65,1,257328,256875,453
31386361,33.7999,32.1288,452,56969,0.464747,0.63,1,257346,256894,452
31389281,73.96,72.8258,453,57006,0.452949,0.63,1,257430,256977,453
31392201,26.792,25.7652,454,57043,0.48259,0.69,1,257445,256991,454
31395121,21.3584,21.153,454,57080,0.456518,0.67,1,257465,257011,454
31398041,24.2717,25.0306,453,57117,0.467304,0.65,1,257490,257037,453
31400961,17.6543,18.6061,452,57154,0.469461,0.63,1,257506,257054,452
31403881,8.33087,9.32122,451,57191,0.469892,0.61,1,257512,257061,451
31406801,14.4662,15.4642,450,57228,0.469978,0.61,1,257528,257078,450
31409721,15.6932,15.8928,450,57265,0.469996,0.55,1,257544,257094,450
31412641,16.7386,16.7786,450,57302,0.453999,0.57,1,257561,257111,450
31415561,16.9477,17.7557,449,57339,0.4668,0.57,1,257578,257129,449
31418481,17.7895,18.7511,448,57376,0.50136,0.57,1,257596,257148,448
31421401,13.1579,13.3502,448,57413,0.476272,0.55,1,257608,257160,448
31424321,12.2316,14.67,445,57450,0.471254,0.53,1,257620,257175,445
31427241,7.24632,8.53401,444,57487,0.502251,0.45,1,257626,257182,444
31430161,11.0493,12.9068,442,57524,0.50845,0.45,1,257638,257196,442
31433081,8.60985,8.98136,442,57561,0.50969,0.41,1,257646,257204,442
31436001,4.92197,4.99627,442,57598,0.509938,0.45,1,257650,257208,442
31438921,96.9844,96.9993,442,57635,0.525988,0.45,1,257770,257328,442
31441841,33.7969,19.3998,460,57671,0.513198,0.47,1,257788,257328,460
31444761,75.5594,18.28,528,57707,0.52664,0.45,1,257874,257346,528
31447681,26.3119,70.856,458,57743,0.529328,0.49,1,257888,257430,458
31450601,19.6624,26.1712,461,57779,0.529866,0.45,1,257906,257445,461
31453521,24.7325,21.2342,467,57815,0.545973,0.47,1,257932,257465,467
31456441,17.7465,24.2468,458,57851,0.549195,0.47,1,257948,257490,458
31459361,8.3493,17.6494,448,57887,0.549839,0.47,1,257954,257506,448
31462281,14.4699,8.32987,458,57923,0.565968,0.47,1,257970,257512,458
31465201,15.694,14.466,458,57959,0.569194,0.47,1,257986,257528,458
31468121,17.5388,15.6932,460,57995,0.569839,0.45,1,258004,257544,460
31471041,17.9078,16.7386,461,58031,0.569968,0.47,1,258022,257561,461
31473961,17.9816,16.9477,462,58067,0.585994,0.51,1,258040,257578,462
31476881,13.1963,17.7895,456,58103,0.589199,0.47,1,258052,257596,456
31479801,12.2393,13.1579,456,58139,0.58984,0.47,1,258064,257608,456
31482721,7.24785,12.2316,450,58175,0.589968,0.51,1,258070,257620,450
31485641,11.0496,7.24632,456,58211,0.589994,0.51,1,258082,257626,456
31488561,8.60991,11.0493,452,58247,0.589999,0.51,1,258090,257638,452
31491481,4.12198,8.60985,447,58283,0.606,0.51,1,258093,257646,447
31494401,98.4244,4.92197,565,58319,0.5932,0.53,1,258215,257650,565
31497321,34.8849,96.9844,464,58355,0.57464,0.51,1,258234,257770,464
31500241,76.577,33.7969,533,58391,0.586928,0.53,1,258321,257788,533
31503161,26.5154,75.5594,461,58427,0.605386,0.53,1,258335,257874,461
31506081,19.7031,26.3119,465,58463,0.625077,0.53,1,258353,257888,465
31509001,25.5406,19.6624,474,58499,0.661015,0.55,1,258380,257906,474
31511921,18.7081,24.7325,465,58535,0.652203,0.55,1,258397,257932,465
31514841,8.54162,17.7465,455,58571,0.650441,0.55,1,258403,257948,455
31517761,14.5083,8.3493,465,58607,0.682088,0.57,1,258419,257954,465
31520681,15.7017,14.4699,465,58643,0.688418,0.57,1,258435,257970,465
31523601,17.5403,15.694,467,58679,0.689684,0.57,1,258453,257986,467
31526521,18.7081,17.5388,468,58715,0.705937,0.57,1,258472,258004,468
31529441,18.1416,17.9078,468,58751,0.677187,0.59,1,258490,258022,468
31532361,13.2283,17.9816,462,58787,0.671437,0.59,1,258502,258040,462
31535281,12.2457,13.1963,462,58823,0.670287,0.59,1,258514,258052,462
31538201,7.24913,12.2393,456,58859,0.670058,0.59,1,258520,258064,456
31541121,11.0498,7.24785,462,58895,0.670012,0.59,1,258532,258070,462
31544041,8.60997,11.0496,458,58931,0.670002,0.59,1,258540,258082,458
31546961,3.32199,8.60991,452,58967,0.67,0.61,1,258542,258090,452
31549881,99.0644,4.12198,572,59003,0.67,0.59,1,258665,258093,572
31552801,34.2129,98.4244,468,59039,0.67,0.57,1,258683,258215,468
31555721,77.2426,34.8849,537,59075,0.686,0.59,1,258771,258234,537
31558641,17.0485,76.577,452,59111,0.6892,0.61,1,258773,258321,452
31561561,15.4097,26.5154,453,59147,0.70584,0.63,1,258788,258335,453
31564481,17.4819,19.7031,453,59183,0.709168,0.67,1,258806,258353,453
31567401,26.6964,25.5406,455,59219,0.741834,0.65,1,258835,258380,455
31570321,19.7393,18.7081,456,59254,0.716367,0.65,1,258853,258397,456
31573241,8.74786,8.54162,456,59289,0.711273,0.69,1,258859,258403,456
31576161,14.5496,14.5083,456,59324,0.710255,0.69,1,258875,258419,456
31579081,15.7099,15.7017,456,59359,0.758051,0.69,2,258891,258435,456
31582001,17.542,17.5403,456,59394,0.75161,0.71,2,258909,258453,456
31584921,17.9084,18.7081,455,59429,0.750322,0.67,2,258927,258472,455
31587841,17.9817,18.1416,455,59464,0.782064,0.67,2,258945,258490,455
31590761,13.1963,13.2283,455,59499,0.804413,0.67,2,258957,258502,455
31593681,12.2393,12.2457,455,59534,0.808883,0.67,2,258969,258514,455
31596601,7.24785,7.24913,455,59569,0.777777,0.67,2,258975,258520,455
31599521,11.0496,11.0498,455,59604,0.771555,0.67,2,258987,258532,455
31602441,8.60991,8.60997,455,59639,0.802311,0.67,2,258995,258540,455
31605361,3.32198,3.32199,455,59674,0.776462,0.67,2,258997,258542,455
31608281,99.0644,99.0644,455,59709,0.835292,0.67,2,259120,258665,455
31611201,34.2129,34.2129,455,59744,0.847058,0.69,2,259138,258683,455
31614121,78.0426,77.2426,456,59779,0.833412,0.69,2,259227,258771,456
31617041,17.2085,17.0485,456,59814,0.798682,0.71,2,259229,258773,456
31619961,16.2417,15.4097,457,59849,0.791736,0.71,2,259245,258788,457
31622881,18.4483,17.4819,458,59884,0.838347,0.75,2,259264,258806,458
31625801,26.0897,26.6964,457,59919,0.879669,0.71,2,259292,258835,457
31628721,19.6179,19.7393,457,59954,0.855934,0.71,2,259310,258853,457
31631641,8.72359,8.74786,457,59989,0.851187,0.71,2,259316,258859,457
31634561,15.3447,14.5496,458,60024,0.882237,0.77,2,259333,258875,458
31637481,16.6689,15.7099,459,60059,0.872447,0.75,2,259350,258891,459
31640401,17.7338,17.542,459,60094,0.870489,0.75,2,259368,258909,459
31643321,17.9468,17.9084,459,60129,0.838098,0.79,2,259386,258927,459
31646241,17.9894,17.9817,459,60164,0.86362,0.81,2,259404,258945,459
31649161,13.9979,13.1963,460,60199,0.852724,0.81,2,259417,258957,460
31652081,12.3996,12.2393,460,60234,0.850545,0.77,2,259429,258969,460
31655001,7.27991,7.24785,460,60269,0.882109,0.77,2,259435,258975,460
31657921,11.056,11.0496,460,60304,0.888422,0.81,2,259447,258987,460
31660841,8.6112,8.60991,460,60339,0.889684,0.77,2,259455,258995,460
31663761,3.32224,3.32198,460,60374,0.857937,0.85,2,259457,258997,460
31666681,100.664,99.0644,462,60409,0.915587,0.85,2,259582,259120,462
31669601,34.5329,34.2129,462,60444,0.895118,0.83,2,259600,259138,462
31672521,77.3066,78.0426,461,60479,0.891024,0.79,2,259688,259227,461
31675441,17.0613,17.2085,461,60514,0.890205,0.79,2,259690,259229,461
31678361,16.2123,16.2417,461,60549,0.890041,0.79,2,259706,259245,461
31681281,20.0425,3.24834,482,60584,0.890008,0.85,2,259727,259245,482
31684201,26.4085,15.8497,491,60619,0.906002,0.89,2,259755,259264,491
31687121,19.6817,25.5699,481,60654,0.9092,0.85,2,259773,259292,481
31690041,9.53634,19.514,470,60689,0.92584,0.85,2,259780,259310,470
31692961,14.7073,8.7028,480,60724,0.929168,0.89,2,259796,259316,480
31695881,15.7415,15.3406,479,60759,0.929834,0.87,2,259812,259333,479
31698801,17.5483,16.6681,480,60794,0.929967,0.87,2,259830,259350,480
31701721,17.9097,17.7336,480,60829,0.929993,0.83,2,259848,259368,480
31996641,10,15,492,64220,0.89,1,2,262178,261686,492
31999561,18.8,13.4,500,64253,0.842,1,2,262199,261699,500
32002481,16.56,17.08,498,64286,0.8164,1,2,262215,261717,498
32005401,16.112,17.816,496,64319,0.77928,1,2,262231,261735,496
32008321,16.0224,15.5632,497,64352,0.739856,1,1,262247,261750,497
32011241,14.4045,15.1126,496,64385,0.699971,1,1,262261,261765,496
32014161,13.2809,16.6225,492,64418,0.659994,1,1,262274,261782,492
32017081,10.6562,12.9245,490,64451,0.619999,1,1,262284,261794,490
32020001,10.9312,11.3849,490,64484,0.596,1,1,262295,261805,490
32022921,15.7862,11.077,496,64517,0.5592,1,1,262312,261816,496
32025841,14.3572,13.4154,496,64550,0.45584,1,1,262326,261830,496
32028761,75.6715,13.8831,573,64583,0.115168,1,1,262417,261844,573
32031681,29.5343,74.7766,501,64616,0.0310336,1,1,262435,261934,501
32034601,73.9069,39.7553,555,64648,0.0462067,1,1,262520,261965,555
32037521,26.7814,68.7511,494,64680,0.0172413,1,1,262535,262041,494
32040441,16.5563,25.7502,493,64712,0.00344827,1,1,262549,262056,493
32043361,24.9113,24.35,496,64744,0.24869,1,1,262576,262080,496
32046281,19.3823,24.07,490,64776,0.297738,1,1,262594,262104,490
32049201,15.8765,19.214,487,64808,0.307548,1,1,262609,262122,487
32052121,13.5753,16.6428,484,64840,0.533509,0.94,1,262622,262138,484
32055041,12.3151,16.9286,479,64872,0.578702,0.96,1,262634,262155,479
32057961,8.86301,13.7857,474,64904,0.58774,0.89,1,262642,262168,474
32060881,3.3726,10.7571,466,64936,0.589548,0.83,1,262644,262178,466
32063801,14.2745,18.9514,462,64968,0.62191,0.81,1,262661,262199,462
32066721,14.0549,16.5903,460,65000,0.628382,0.77,1,262675,262215,460
32069641,15.611,16.1181,460,65032,0.661676,0.73,1,262691,262231,460
32072561,14.3222,16.0236,458,65064,0.636335,0.69,1,262705,262247,458
32075481,11.6644,14.4047,455,65096,0.647267,0.65,1,262716,262261,455
32078401,10.3329,13.2809,452,65128,0.617453,0.61,1,262726,262274,452
32081321,8.46658,10.6562,450,65160,0.675491,0.59,1,262734,262284,450
32084241,9.69332,10.9312,449,65192,0.623098,0.55,1,262744,262295,449
32087161,10.7387,15.7862,443,65224,0.67662,0.43,1,262755,262312,443
32090081,10.9477,14.3572,440,65256,0.687324,0.03,1,262766,262326,440
32093001,62.9895,75.6715,425,65288,0.593465,0.01,1,262842,262417,425
32095921,26.1979,29.5343,424,65320,0.510693,0.05,1,262859,262435,424
32098841,72.4396,73.9069,423,65352,0.126139,0.01,1,262943,262520,423
32101761,26.4879,26.7814,423,65384,0.0652277,0,1,262958,262535,423
32104681,29.2976,16.5563,439,65416,0.0690455,0.31,1,262988,262549,439
32107601,27.4595,24.9113,439,65448,0.0218091,0.31,1,263015,262576,439
32110521,19.0919,19.3823,438,65480,0.00436182,0.31,1,263032,262594,438
32113441,15.0184,15.8765,437,65512,0.00887236,0.59,1,263046,262609,437
32116361,24.6037,13.5753,451,65544,0.00177447,0.59,1,263073,262622,451
32119281,14.5207,12.3151,451,65576,0.0403549,0.59,1,263085,262634,451
32122201,10.1041,8.86301,452,65608,0.032071,0.59,1,263094,262642,452
32125121,3.62083,3.3726,452,65640,0.0304142,0.63,1,263096,262644,452
32128041,15.1242,14.2745,453,65672,0.0620828,0.63,1,263114,262661,453
32130961,14.2248,14.0549,453,65704,0.0524166,0.67,1,263128,262675,453
32133881,15.645,15.611,453,65736,0.0984833,0.63,1,263144,262691,453
32136801,14.329,14.3222,453,65768,0.0756967,0.65,1,263158,262705,453
32139721,10.8658,11.6644,452,65800,0.0711393,0.61,1,263168,262716,452
32142641,11.7732,10.3329,454,65832,0.0702279,0.69,1,263180,262726,454
32145561,7.15463,8.46658,452,65864,0.0700456,0.61,1,263186,262734,452
32148481,11.8309,9.69332,455,65896,0.0860091,0.69,1,263199,262744,455
32151401,11.1662,10.7387,455,65928,0.105202,0.69,1,263210,262755,455
32154321,10.2332,10.9477,454,65960,0.0770404,0.57,1,263220,262766,454
32157241,58.0466,62.9895,448,65992,0.0234081,0.49,1,263290,262842,448
32160161,21.2093,26.1979,443,66024,0.0446816,0.03,1,263302,262859,443
32163081,54.6419,72.4396,422,66056,0.0329363,0.05,1,263365,262943,422
32166001,22.9284,26.4879,422,66088,0.0145873,0.07,1,263380,262958,422
32168921,29.3857,29.2976,423,66120,0.0109175,0.01,1,263411,262988,423
32171841,26.6771,27.4595,422,66152,0.0581835,0,1,263437,263015,422
32174761,18.9354,19.0919,422,66184,0.0116367,0.01,1,263454,263032,422
32177681,14.9871,15.0184,422,66216,0.0423273,0,1,263468,263046,422
32180601,24.5974,24.6037,422,66248,0.0324655,0.05,1,263495,263073,422
32183521,14.5195,14.5207,422,66280,0.0144931,0.03,1,263507,263085,422
32186441,10.9039,10.1041,423,66312,0.0108986,0.03,1,263517,263094,423
32189361,3.78078,3.62083,423,66344,0.0421797,0.07,1,263519,263096,423
32192281,15.1562,15.1242,423,66376,0.0324359,0.07,1,263537,263114,423
32195201,15.0312,3.02483,438,66408,0.0464872,0.05,1,263552,263114,438
32198121,15.8062,11.805,440,66440,0.0172974,0.11,1,263568,263128,440
32201041,14.3612,15.161,438,66472,0.0274595,0.07,1,263582,263144,438
32203961,10.8722,14.2322,434,66504,0.0294919,0.07,1,263592,263158,434
32206881,11.7745,10.8464,436,66536,0.0298984,0.07,1,263604,263168,436
32209801,7.15489,11.7693,430,66568,0.0299797,0.07,1,263610,263180,430
32212721,12.631,7.15386,438,66600,0.0299959,0.09,1,263624,263186,438
32215641,10.5262,11.8308,435,66632,0.0459992,0.11,1,263634,263199,435
32218561,10.1052,11.1662,434,66663,0.0491998,0.07,1,263644,263210,434
32221481,55.621,10.2332,491,66694,0.04984,0.01,1,263711,263220,491
32224401,20.7242,58.0466,433,66725,0.033968,0.05,1,263723,263290,433
32227321,54.5448,21.2093,484,66756,0.0067936,0.03,1,263786,263302,484
32230241,22.909,54.6419,436,66787,0.0253587,0.01,1,263801,263365,436
32233161,29.3818,22.9284,452,66818,0.0290717,0.01,1,263832,263380,452
32236081,26.6764,29.3857,447,66849,0.0458143,0.07,1,263858,263411,447
32239001,18.9353,26.6771,438,66880,0.00916287,0,1,263875,263437,438
32241921,14.9871,18.9354,435,66911,0.00983257,0.05,1,263889,263454,435
32244841,24.5974,14.9871,448,66942,0.0419665,0.03,1,263916,263468,448
32247761,14.5195,24.5974,433,66973,0.0323933,0.01,1,263928,263495,433
32250681,11.7039,14.5195,432,67004,0.0464787,0.01,1,263939,263507,432
32253601,3.94078,10.9039,424,67035,0.0492957,0.05,1,263941,263517,424
32256521,15.1882,3.78078,440,67066,0.0338591,0.03,1,263959,263519,440
32259441,14.2376,15.1562,436,67097,0.0307718,0.05,1,263973,263537,436
32262361,16.4475,15.0312,438,67128,0.0461544,0.01,1,263990,263552,438
32265281,14.4895,15.8062,436,67159,0.0492309,0.03,1,264004,263568,436
32268201,10.8979,14.3612,432,67190,0.0498462,0.03,1,264014,263582,432
32271121,11.7796,10.8722,434,67221,0.0659692,0.03,1,264026,263592,434
32274041,7.15592,11.7745,428,67252,0.0691938,0.03,1,264032,263604,428
32276961,13.4312,7.15489,437,67283,0.0858388,0.03,1,264047,263610,437
32279881,10.6862,12.631,433,67314,0.0571678,0.05,1,264057,263624,433
32282801,10.1372,10.5262,433,67345,0.0514335,0.05,1,264067,263634,433
32285721,54.8274,10.1052,489,67376,0.0502867,0.05,1,264133,263644,489
32288641,20.5655,55.621,434,67407,0.0500573,0.03,1,264145,263711,434
32291561,53.7131,20.7242,484,67438,0.0180115,0,1,264207,263723,484
32294481,22.7426,54.5448,436,67469,0.00360229,0.03,1,264222,263786,436
32297401,30.9485,22.909,454,67500,0.0247205,0.03,1,264255,263801,454
32300321,25.3897,29.3818,447,67531,0.0289441,0.05,1,264279,263832,447
32303241,18.6779,26.6764,438,67562,0.0137888,0,1,264296,263858,438
32306161,15.7356,18.9353,436,67593,0.0107578,0.01,1,264311,263875,436
32309081,24.7471,14.9871,449,67624,0.00215155,0.05,1,264338,263889,449
32312001,14.5494,24.5974,434,67655,0.00843031,0.03,1,264350,263916,434
32314921,11.7099,14.5195,433,67686,0.0416861,0.05,1,264361,263928,433
32317841,3.94198,11.7039,424,67717,0.0163372,0.05,1,264363,263939,424
32320761,15.1884,3.94078,440,67748,0.0272674,0.03,1,264381,263941,440
32323681,15.8377,15.1882,438,67779,0.0454535,0.03,1,264397,263959,438
32326601,15.9675,14.2376,440,67810,0.0650907,0.05,1,264413,263973,440
32329521,14.3935,16.4475,437,67841,0.0690181,0.05,1,264427,263990,437
32332441,4.4787,14.4895,425,67872,0.0698036,0.05,1,264429,264004,425
32335361,8.89574,10.8979,425,67903,0.0699607,0.07,1,264439,264014,425
32338281,11.3791,11.7796,425,67934,0.0699921,0.07,1,264451,264026,425
32341201,7.07583,7.15592,425,67965,0.101998,0.09,1,264457,264032,425
32344121,12.6152,13.4312,424,67996,0.1084,0.05,1,264471,264047,424
32347041,10.523,10.6862,424,68027,0.0776799,0.05,1,264481,264057,424
32349961,10.1046,10.1372,424,68058,0.071536,0.05,1,264491,264067,424
32352881,54.8209,54.8274,424,68089,0.0863072,0.05,1,264557,264133,424
32355801,19.7642,20.5655,423,68120,0.137261,0.01,1,264568,264145,423
32358721,52.7528,53.7131,422,68151,0.0994523,0,1,264629,264207,422
32361641,22.5506,22.7426,422,68182,0.0438905,0.03,1,264644,264222,422
32364561,30.9101,30.9485,422,68213,0.0327781,0.03,1,264677,264255,422
32367481,26.182,25.3897,423,68244,0.0145556,0.01,1,264702,264279,423
32370401,18.0364,18.6779,422,68275,0.0109111,0.01,1,264718,264296,422
32373321,15.6073,15.7356,422,68306,0.0261822,0,1,264733,264311,422
32376241,24.7215,24.7471,422,68337,0.0292364,0.01,1,264760,264338,422
32379161,15.3443,14.5494,423,68368,0.0458473,0.05,1,264773,264350,423
32382081,11.0689,11.7099,422,68399,0.0171695,0.01,1,264783,264361,422
32385001,3.81377,3.94198,422,68430,0.0114339,0.03,1,264785,264363,422
32387921,16.7628,15.1884,424,68461,0.0262868,0.05,1,264805,264381,424
32390841,16.9526,15.8377,425,68492,0.0612574,0.07,1,264822,264397,425
32393761,16.1905,15.9675,425,68523,0.0682515,0.07,1,264838,264413,425
32396681,14.4381,14.3935,425,68554,0.0376503,0.07,1,264852,264427,425
32399601,4.48762,4.4787,425,68585,0.0315301,0.07,1,264854,264429,425
32402521,8.89752,8.89574,425,68616,0.030306,0.07,1,264864,264439,425
32405441,11.3795,11.3791,425,68647,0.0460612,0.11,1,264876,264451,425
32408361,7.0759,7.07583,425,68678,0.0492122,0.11,1,264882,264457,425
32411281,12.6152,12.6152,425,68709,0.0498424,0.07,1,264896,264471,425
32414201,10.523,10.523,425,68740,0.0499685,0.07,1,264906,264481,425
32417121,10.1046,10.1046,425,68771,0.0499937,0.09,1,264916,264491,425
32420041,57.2209,54.8209,428,68801,0.0659987,0.15,1,264985,264557,428
32422961,19.4442,19.7642,427,68831,0.0371997,0.09,1,264995,264568,427
32425881,48.6888,52.7528,422,68861,0.11144,0.03,1,265051,264629,422
32428801,21.7378,22.5506,422,68891,0.078288,0.03,1,265066,264644,422
32431721,30.7476,30.9101,422,68921,0.0396576,0.01,1,265099,264677,422
32434641,26.1495,26.182,422,68951,0.0479315,0.01,1,265124,264702,422
32437561,18.0299,18.0364,422,68981,0.0175863,0.03,1,265140,264718,422
32440481,17.206,15.6073,424,69011,0.0275173,0.03,1,265157,264733,424
32443401,24.2412,24.7215,423,69041,0.0615035,0.05,1,265183,264760,423
32446321,14.4482,15.3443,422,69071,0.0363007,0.01,1,265195,264773,422
32449241,10.8896,11.0689,422,69101,0.0472601,0.01,1,265205,264783,422
32452161,3.77793,3.81377,422,69131,0.081452,0.03,1,265207,264785,422
32455081,17.5556,16.7628,423,69161,0.0402904,0.07,1,265228,264805,423
32458001,17.1111,16.9526,423,69191,0.0640581,0.07,1,265245,264822,423
32460921,16.2222,16.1905,423,69221,0.0368116,0.03,1,265261,264838,423
32463841,14.4444,14.4381,423,69251,0.0793623,0.03,1,265275,264852,423
32466761,4.48889,4.48762,423,69281,0.0558725,0.03,1,265277,264854,423
32469681,8.89778,8.89752,423,69311,0.0511745,0.03,1,265287,264864,423
32472601,11.3796,1.7795,435,69341,0.0502349,0.05,1,265299,264864,435
32475521,7.07591,9.9559,429,69371,0.050047,0.05,1,265305,264876,429
32478441,12.6152,6.79118,437,69401,0.0500094,0.05,1,265319,264882,437
32481361,10.523,12.5582,433,69431,0.0500019,0.05,1,265329,264896,433
32484281,10.1046,10.5116,433,69461,0.0500004,0.05,1,265339,264906,433
32487201,56.4209,10.1023,491,69491,0.0660001,0.07,1,265407,264916,491
32490121,19.2842,57.2205,432,69521,0.0692,0.03,1,265417,264985,432
32493041,51.0568,19.4441,481,69551,0.13384,0.13,1,265476,264995,481
32495961,19.8114,48.6888,437,69581,0.146768,0.07,1,265488,265051,437
32498881,30.3623,21.7378,455,69611,0.0693536,0.03,1,265521,265066,455
32501801,25.2725,30.7476,446,69641,0.0538707,0.05,1,265545,265099,446
32504721,17.8545,26.1495,437,69671,0.0507741,0.01,1,265561,265124,437
32507641,17.9709,18.0299,439,69701,0.0341548,0.03,1,265579,265140,439
32510561,24.3942,17.206,448,69731,0.030831,0.07,1,265605,265157,448
32513481,15.2788,24.2412,435,69761,0.0301662,0.03,1,265618,265183,435
32516401,11.0558,14.4482,433,69791,0.0300332,0.05,1,265628,265195,433
32519321,3.81115,10.8896,425,69821,0.0300066,0.09,1,265630,265205,425
32522241,16.7622,3.77793,443,69851,0.0300013,0.03,1,265650,265207,443
32525161,16.9524,17.5556,439,69881,0.0140003,0.07,1,265667,265228,439
32528081,16.9905,17.1111,439,69911,0.0108001,0.03,1,265684,265245,439
32531001,14.5981,16.2222,437,69941,0.01016,0.09,1,265698,265261,437
32533921,4.51962,14.4444,425,69971,0.010032,0.05,1,265700,265275,425
32536841,8.90392,4.48889,433,70001,0.0260064,0.05,1,265710,265277,433
32539761,11.3808,8.89778,435,70031,0.0292013,0.05,1,265722,265287,435
32542681,7.07616,11.3796,429,70061,0.0298403,0.05,1,265728,265299,429
32545601,12.6152,7.07591,437,70091,0.0459681,0.05,1,265742,265305,437
32548521,10.523,12.6152,433,70121,0.0491936,0.05,1,265752,265319,433
32551441,10.1046,10.523,433,70151,0.0498387,0.05,1,265762,265329,433
32554361,57.2209,10.1046,492,70181,0.0339677,0.07,1,265831,265339,492
32557281,19.4442,56.4209,434,70211,0.0307935,0.07,1,265841,265407,434
32560201,54.2888,19.2842,487,70241,0.0781587,0.15,1,265904,265417,487
32563121,20.4578,51.0568,440,70271,0.0876317,0.15,1,265916,265476,440
32566041,26.4916,19.8114,456,70301,0.0895263,0.05,1,265944,265488,456
32568961,24.4983,30.3623,447,70331,0.0899053,0.05,1,265968,265521,447
32571881,16.8997,25.2725,438,70361,0.0739811,0.05,1,265983,265545,438
32574801,17.7799,17.8545,440,70391,0.0707962,0.03,1,266001,265561,440
32577721,25.156,17.9709,449,70421,0.0541592,0.03,1,266028,265579,449
32580641,14.6312,24.3942,435,70451,0.0508318,0.03,1,266040,265605,435
32583561,10.9262,15.2788,432,70481,0.0501664,0.03,1,266050,265618,432
32586481,3.78525,11.0558,424,70511,0.0500333,0.03,1,266052,265628,424
32589401,16.757,3.81115,442,70541,0.0500067,0.03,1,266072,265630,442
32592321,16.9514,16.7622,439,70571,0.0500013,0.01,1,266089,265650,439
32595241,16.1903,16.9524,438,70601,0.0660003,0.01,1,266105,265667,438
32598161,15.2381,16.9905,436,70631,0.0532001,0.01,1,266120,265684,436
32601081,4.64761,14.5981,424,70661,0.08264,0.01,1,266122,265698,424
32604001,8.92952,4.51962,432,70691,0.056528,0.03,1,266132,265700,432
32606921,11.3859,8.90392,434,70721,0.0513056,0.03,1,266144,265710,434
32609841,7.07718,11.3808,428,70751,0.0502611,0.03,1,266150,265722,428
32612761,3.01544,7.07616,424,70781,0.0500522,0.05,1,266152,265728,424
32615681,11.8031,12.6152,424,70811,0.0980104,0.05,1,266166,265742,424
32618601,10.3606,10.523,424,70841,0.0756021,0.05,1,266176,265752,424
32621521,10.0721,10.1046,424,70871,0.0711204,0.03,1,266186,265762,424
32624441,56.4144,57.2209,423,70901,0.0702241,0.03,1,266254,265831,423
32627361,19.2829,19.4442,423,70931,0.0700448,0.09,1,266264,265841,423
32630281,56.6566,54.2888,426,70961,0.102009,0.09,1,266330,265904,426
32633201,20.9313,20.4578,426,70991,0.172402,0.09,1,266342,265916,426
32636121,26.5863,26.4916,426,71021,0.18648,0.09,1,266370,265944,426
32639041,24.5173,24.4983,426,71051,0.157296,0.07,1,266394,265968,426
32641961,16.1035,16.8997,425,71081,0.151459,0.07,1,266408,265983,425
32644881,17.6207,17.7799,425,71110,0.150292,0.05,1,266426,266001,425
32647801,24.3241,25.156,424,71139,0.150058,0.05,1,266452,266028,424
32650721,14.4648,14.6312,424,71168,0.198012,0.05,1,266464,266040,424
32653641,10.893,10.9262,424,71197,0.175602,0.05,1,266474,266050,424
32656561,3.77859,3.78525,424,71226,0.17112,0.05,1,266476,266052,424
32659481,17.5557,16.757,425,71255,0.202224,0.05,1,266497,266072,425
32662401,17.1111,16.9514,425,71284,0.224445,0.07,1,266514,266089,425
32665321,16.2222,16.1903,425,71313,0.260889,0.05,1,266530,266105,425
32668241,14.4444,15.2381,424,71342,0.236178,0.09,1,266544,266120,424
32671161,4.48889,4.64761,424,71371,0.231236,0.05,1,266546,266122,424
32674081,8.89778,8.92952,424,71400,0.230247,0.05,1,266556,266132,424
32677001,11.3796,11.3859,424,71429,0.230049,0.05,1,266568,266144,424
32679921,7.07591,7.07718,424,71458,0.23001,0.05,1,266574,266150,424
32682841,3.01518,3.01544,424,71487,0.262002,0.11,1,266576,266152,424
32685761,12.603,11.8031,425,71516,0.2524,0.07,1,266591,266166,425
32688681,10.5206,10.3606,425,71545,0.25048,0.07,1,266601,266176,425
32691601,10.1041,10.0721,425,71574,0.266096,0.07,1,266611,266186,425
32694521,56.4208,56.4144,425,71603,0.269219,0.07,1,266679,266254,425
32697441,19.2842,19.2829,425,71632,0.269844,0.11,1,266689,266264,425
32700361,59.8568,56.6566,429,71661,0.253969,0.19,1,266759,266330,429
32703281,21.5714,20.9313,429,71690,0.298794,0.19,1,266771,266342,429
32706201,26.7143,26.5863,429,71719,0.275759,0.15,1,266799,266370,429
32709121,24.5429,24.5173,429,71748,0.303152,0.15,1,266823,266394,429
32712041,16.1086,16.1035,429,71777,0.30863,0.15,1,266837,266408,429
32714961,17.6217,17.6207,429,71806,0.309726,0.15,1,266855,266426,429
32717881,25.1243,24.3241,430,71835,0.293945,0.21,1,266882,266452,430
32720801,14.6249,14.4648,430,71864,0.290789,0.17,1,266894,266464,430
32723721,10.925,10.893,430,71893,0.290158,0.17,1,266904,266474,430
32726641,3.78499,3.77859,430,71922,0.322032,0.21,1,266906,266476,430
32729561,19.157,17.5557,432,71951,0.328406,0.23,1,266929,266497,432
32732481,18.2314,17.1111,433,71980,0.329681,0.27,1,266947,266514,433
32735401,16.4463,16.2222,433,72009,0.329936,0.23,1,266963,266530,433
32738321,14.4893,14.4444,433,72038,0.361987,0.23,1,266977,266544,433
32741241,4.49785,4.48889,433,72067,0.336397,0.23,1,266979,266546,433
32744161,8.89957,8.89778,433,72096,0.347279,0.23,1,266989,266556,433
32747081,11.3799,11.3796,433,72125,0.381456,0.23,1,267001,266568,433
32750001,7.07598,7.07591,433,72154,0.356291,0.27,1,267007,266574,433
32752921,3.0152,3.01518,433,72183,0.351258,0.25,1,267009,266576,433
32755841,13.403,12.603,434,72212,0.350252,0.25,1,267025,266591,434
32758761,10.6806,2.52061,444,72241,0.35005,0.25,1,267035,266591,444
32761681,10.1361,8.50412,444,72270,0.36601,0.27,1,267045,266601,444
32764601,56.4272,9.70082,502,72299,0.369202,0.27,1,267113,266611,502
32767521,19.2854,56.3402,444,72328,0.36984,0.27,1,267123,266679,444
32770441,59.8571,19.268,504,72357,0.337968,0.25,1,267193,266689,504
32773361,21.5714,59.8536,446,72386,0.331594,0.31,1,267205,266759,446
32776281,26.7143,21.5707,462,72415,0.346319,0.27,1,267233,266771,462
32779201,24.5429,26.7141,458,72444,0.381264,0.31,1,267257,266799,458
32782121,16.1086,24.5428,448,72473,0.388253,0.31,1,267271,266823,448
32785041,17.6217,16.1086,452,72502,0.389651,0.31,1,267289,266837,452
32787961,25.9243,17.6217,462,72531,0.38993,0.29,1,267317,266855,462
32790881,14.7849,25.1243,447,72560,0.389986,0.29,1,267329,266882,447
32793801,10.957,14.6249,445,72589,0.389997,0.29,1,267339,266894,445
32796721,3.79139,10.925,437,72618,0.389999,0.33,1,267341,266904,437
32799641,20.7583,3.78499,460,72647,0.422,0.33,1,267366,266906,460
32802561,18.5517,19.157,455,72676,0.4284,0.33,1,267384,266929,455
32805481,16.5103,18.2314,453,72705,0.42968,0.33,1,267400,266947,453
32808401,15.3021,16.4463,452,72734,0.461936,0.37,1,267415,266963,452
32811321,4.66041,14.4893,440,72763,0.436387,0.33,1,267417,266977,440
32814241,8.93208,4.49785,448,72792,0.431277,0.35,1,267427,266979,448
32817161,11.3864,8.89957,450,72821,0.430256,0.39,1,267439,266989,450
32820081,7.07728,11.3799,444,72850,0.430051,0.35,1,267445,267001,444
32823001,3.01546,7.07598,440,72879,0.43001,0.35,1,267447,267007,440
32825921,13.4031,3.0152,454,72908,0.430002,0.35,1,267463,267009,454
32828841,11.4806,13.403,449,72937,0.446,0.35,1,267474,267025,449
32831761,10.2961,10.6806,449,72966,0.4172,0.37,1,267484,267035,449
32834681,56.4592,10.1361,507,72995,0.41144,0.37,1,267552,267045,507
32837601,19.2918,56.4272,449,73024,0.410288,0.37,1,267562,267113,449
32840521,58.2584,19.2854,507,73053,0.442058,0.33,1,267630,267123,507
32843441,21.2517,59.8571,449,73082,0.448412,0.33,1,267642,267193,449
32846361,27.4503,21.5714,466,73111,0.465682,0.35,1,267671,267205,466
32849281,26.2901,26.7143,464,73140,0.485136,0.39,1,267697,267233,464
32852201,16.458,24.5429,454,73169,0.489027,0.39,1,267711,267257,454
32855121,17.6916,16.1086,458,73198,0.489805,0.39,1,267729,267271,458
32858041,25.9383,17.6217,468,73227,0.489961,0.39,1,267757,267289,468
32860961,14.7877,25.9243,452,73256,0.489992,0.39,1,267769,267317,452
32863881,11.7575,14.7849,451,73285,0.505998,0.39,1,267780,267329,451
32866801,3.95151,10.957,443,73314,0.4772,0.39,1,267782,267339,443
32869721,21.5903,3.79139,467,73343,0.47144,0.43,1,267808,267341,467
32872641,18.7181,20.7583,460,73372,0.470288,0.43,1,267826,267366,460
32875561,17.3436,18.5517,459,73401,0.486058,0.43,1,267843,267384,459
32878481,14.6687,16.5103,457,73430,0.457212,0.47,1,267857,267400,457
32881401,4.53374,15.3021,444,73459,0.451442,0.43,1,267859,267415,444
32884321,8.90675,4.66041,452,73488,0.450288,0.43,1,267869,267417,452
32887241,11.3814,8.93208,454,73517,0.450058,0.43,1,267881,267427,454
32890161,7.07627,11.3864,448,73545,0.450012,0.43,1,267887,267439,448
32893081,3.01525,7.07728,444,73573,0.450002,0.43,1,267889,267445,444
32896001,13.4031,3.01546,458,73601,0.45,0.43,1,267905,267447,458
32898921,10.6806,13.4031,452,73629,0.466,0.45,1,267915,267463,452
32901841,10.1361,11.4806,451,73657,0.4692,0.41,1,267925,267474,451
32904761,56.4272,10.2961,509,73685,0.48584,0.41,1,267993,267484,509
32907681,12.8854,56.4592,443,73713,0.489168,0.41,1,267995,267552,443
32910601,10.5771,19.2918,443,73741,0.489834,0.45,1,268005,267562,443
32913521,57.3154,58.2584,444,73769,0.505967,0.45,1,268074,267630,444
32916441,21.0631,21.2517,444,73797,0.509193,0.47,1,268086,267642,444
32919361,29.0126,27.4503,446,73825,0.493839,0.49,1,268117,267671,446
32922281,26.6025,26.2901,446,73853,0.506768,0.49,1,268143,267697,446
32925201,16.5205,16.458,446,73881,0.525354,0.49,1,268157,267711,446
32928121,17.7041,17.6916,446,73909,0.545071,0.49,1,268175,267729,446
32931041,25.9408,25.9383,446,73937,0.565014,0.49,1,268203,267757,446
32933961,14.7882,14.7877,446,73965,0.601003,0.51,1,268215,267769,446
32936881,10.9576,11.7575,445,73993,0.576201,0.47,1,268225,267780,445
32939801,3.79153,3.95151,445,74021,0.57124,0.47,1,268227,267782,445
32942721,21.5583,21.5903,445,74049,0.602248,0.47,1,268253,267808,445
32945641,18.7117,18.7181,445,74077,0.64045,0.49,1,268271,267826,445
32948561,16.5423,17.3436,444,74105,0.64809,0.45,1,268287,267843,444
32951481,14.5085,14.6687,444,74133,0.633618,0.45,1,268301,267857,444
32954401,4.50169,4.53374,444,74161,0.662724,0.45,1,268303,267859,444
32957321,8.90034,8.90675,444,74189,0.636545,0.45,1,268313,267869,444
32960241,11.3801,11.3814,444,74217,0.631309,0.45,1,268325,267881,444
32963161,7.07601,7.07627,444,74245,0.662262,0.45,1,268331,267887,444
32966081,3.0152,3.01525,444,74273,0.668452,0.45,1,268333,267889,444
32969001,14.203,13.4031,445,74301,0.653691,0.47,1,268350,267905,445
32971921,10.8406,10.6806,445,74329,0.650738,0.47,1,268360,267915,445
32974841,10.1681,10.1361,445,74357,0.650148,0.49,1,268370,267925,445
32977761,57.2336,56.4272,446,74385,0.65003,0.49,1,268439,267993,446
32980681,13.0467,12.8854,446,74413,0.650006,0.49,1,268441,267995,446
32983601,10.6093,10.5771,446,74441,0.650001,0.51,1,268451,268005,446
32986521,56.5219,57.3154,445,74469,0.698,0.51,1,268519,268074,445
32989441,20.9044,21.0631,445,74497,0.7076,0.49,1,268531,268086,445
32992361,29.7809,29.0126,446,74525,0.70952,0.51,1,268563,268117,446
32995281,28.3562,26.6025,448,74553,0.693904,0.53,1,268591,268143,448
32998201,17.6712,16.5205,449,74581,0.674781,0.55,1,268606,268157,449
33001121,18.7342,17.7041,450,74609,0.686956,0.57,1,268625,268175,450
33004041,26.1468,25.9408,450,74637,0.705391,0.61,1,268653,268203,450
33006961,14.8294,14.7882,450,74665,0.685078,0.57,1,268665,268215,450
33009881,10.9659,10.9576,450,74693,0.673016,0.57,1,268675,268225,450
33012801,3.79317,3.79153,450,74721,0.702603,0.61,1,268677,268227,450
33015721,23.1586,21.5583,452,74749,0.676521,0.65,1,268705,268253,452
33018641,19.0317,18.7117,452,74777,0.703304,0.65,1,268723,268271,452
33021561,17.4063,16.5423,453,74805,0.692661,0.63,1,268740,268287,453
33024481,14.6813,14.5085,453,74833,0.722532,0.67,1,268754,268301,453
33027401,4.53625,4.50169,453,74861,0.696506,0.63,1,268756,268303,453
33030321,8.90725,8.90034,453,74889,0.691301,0.63,1,268766,268313,453
33033241,11.3815,11.3801,453,74917,0.72226,0.67,1,268778,268325,453
33036161,7.07629,7.07601,453,74945,0.696452,0.67,1,268784,268331,453
33039081,3.01526,3.0152,453,74973,0.69129,0.65,1,268786,268333,453
33042001,15.0031,14.203,454,75001,0.690258,0.65,1,268804,268350,454
33044921,11.0006,10.8406,454,75029,0.690052,0.65,1,268814,268360,454
33047841,10.2001,10.1681,454,75057,0.69001,0.65,1,268824,268370,454
33050761,57.24,57.2336,454,75085,0.770002,0.65,2,268893,268439,454
33053681,13.048,13.0467,454,75113,0.786,0.65,2,268895,268441,454
33056601,10.6096,10.6093,454,75141,0.7572,0.65,2,268905,268451,454
33059521,56.5219,2.12187,522,75169,0.75144,0.71,2,268973,268451,522
33062441,20.9044,54.8244,466,75197,0.750288,0.71,2,268985,268519,466
33065361,29.7809,20.5649,486,75225,0.750058,0.71,2,269017,268531,486
33068281,27.5562,29.713,481,75253,0.734012,0.69,1,269044,268563,481
33071201,18.3112,28.3426,469,75281,0.730802,0.67,1,269060,268591,469
33074121,18.8622,17.6685,473,75309,0.76216,0.69,2,269079,268606,473
33077041,26.1724,18.7337,482,75337,0.752432,0.71,2,269107,268625,482
33079961,14.8345,26.1467,466,75365,0.750486,0.68,2,269119,268653,466
33082881,10.9669,14.8293,464,75393,0.782097,0.67,2,269129,268665,464
33085801,3.79338,10.9659,456,75421,0.788419,0.71,2,269131,268675,456
33088721,23.1587,3.79317,482,75449,0.805684,0.67,2,269159,268677,482
33091641,19.0317,23.1586,472,75477,0.809137,0.71,2,269177,268705,472
33094561,18.2063,19.0317,472,75505,0.809827,0.69,2,269195,268723,472
33097481,14.8413,17.4063,469,75533,0.809965,0.73,2,269209,268740,469
33100401,4.56825,14.6813,457,75561,0.809993,0.69,2,269211,268754,457
33103321,8.91365,4.53625,465,75589,0.809999,0.69,2,269221,268756,465
33106241,11.3827,8.90725,467,75617,0.826,0.73,2,269233,268766,467
33109161,7.07655,11.3815,461,75645,0.8292,0.69,2,269239,268778,461
33112081,3.01531,7.07629,457,75673,0.82984,0.69,2,269241,268784,457
33115001,15.0031,3.01526,473,75701,0.829968,0.69,2,269259,268786,473
33117921,11.0006,15.0031,465,75729,0.829994,0.69,2,269269,268804,465
33120841,11.0001,11.0006,466,75757,0.845999,0.69,2,269280,268814,466
33123761,59,10.2001,527,75785,0.8492,0.79,2,269351,268824,527
33126681,13.4,57.24,460,75813,0.84984,0.79,2,269353,268893,460
33129601,10.68,13.048,468,75841,0.849968,0.75,2,269363,268895,468
33132521,56.536,10.6096,526,75869,0.849994,0.75,2,269431,268905,526
33135441,20.9072,56.5219,470,75897,0.849999,0.75,2,269443,268973,470
33138361,29.7814,20.9044,490,75925,0.866,0.75,2,269475,268985,490
33141281,26.7563,29.7809,484,75953,0.8692,0.73,2,269501,269017,484
33144201,18.1513,27.5562,473,75981,0.86984,0.73,2,269517,269044,473
33147121,19.6303,18.3112,477,76009,0.917968,0.77,2,269537,269060,477
33150041,26.326,18.8622,486,76037,0.895594,0.75,2,269565,269079,486
33152961,16.4652,26.1724,472,76065,0.891119,0.75,2,269579,269107,472
33155881,11.293,14.8345,470,76093,0.890224,0.79,2,269589,269119,470
33158801,3.85861,10.9669,462,76121,0.890045,0.79,2,269591,269129,462
33161721,23.9717,3.79338,489,76149,0.874009,0.81,2,269620,269131,489
33164641,19.1943,23.1587,479,76176,0.870802,0.81,2,269638,269159,479
33167561,18.2389,19.0317,479,76203,0.87016,0.81,2,269656,269177,479
33170481,14.8478,18.2063,475,76230,0.870032,0.81,2,269670,269195,475
33173401,4.56955,14.8413,463,76257,0.870006,0.81,2,269672,269209,463
33176321,9.71391,4.56825,472,76284,0.886001,0.81,2,269683,269211,472
33179241,11.5428,8.91365,474,76311,0.8572,0.83,2,269695,269221,474
33182161,7.10856,11.3827,468,76338,0.85144,0.83,2,269701,269233,468
33185081,3.02171,7.07655,464,76365,0.850288,0.83,2,269703,269239,464
33188001,15.0043,3.01531,480,76392,0.850058,0.83,2,269721,269241,480
33190921,11.0009,15.0031,472,76419,0.850012,0.83,2,269731,269259,472
33193841,10.2002,11.0006,472,76446,0.850002,0.85,2,269741,269269,472
33196761,60.44,11.0001,534,76473,0.834,0.85,2,269814,269280,534
33199681,13.688,59,465,76500,0.8308,0.85,2,269816,269351,465
33202601,10.7376,13.4,473,76527,0.83016,0.85,2,269826,269353,473
33205521,56.5475,10.68,531,76554,0.846032,0.85,2,269894,269363,531
33208441,20.9095,56.536,475,76581,0.849206,0.85,2,269906,269431,475
33211361,5.7819,20.9072,465,76608,0.849841,0.87,2,269908,269443,465
33214281,26.7564,29.7814,465,76635,0.897968,0.87,2,269940,269475,465
33217201,26.1513,26.7563,465,76662,0.875594,0.87,2,269966,269501,465
33220121,18.8303,18.1513,466,76689,0.887119,0.93,2,269983,269517,466
33223041,19.7661,19.6303,466,76716,0.889424,0.89,2,270003,269537,466
33225961,26.3532,26.326,466,76743,0.921885,0.89,2,270031,269565,466
33555921,11,12,485,79763,0.93,1,2,272051,271566,485
33558841,13.4,12,487,79789,0.93,1,2,272065,271578,487
33561761,13.88,10.4,491,79815,0.93,1,2,272079,271588,491
33564681,13.976,10.88,494,79841,0.93,1,2,272093,271599,494
33567601,13.9952,10.976,497,79867,0.914,1,2,272107,271610,497
33570521,12.399,13.3952,495,79893,0.8468,1,2,272119,271624,495
33573441,8.87981,10.679,493,79919,0.84936,1,2,272127,271634,493
33576361,6.57596,10.9358,488,79945,0.817872,0.98,2,272133,271645,488
33579281,30.9152,36.5872,482,79971,0.747574,1,1,272170,271688,482
33582201,21.383,16.1174,490,79997,0.653515,1,1,272189,271699,490
33585121,15.4766,16.0235,488,80023,0.618703,1,1,272203,271715,488
33588041,43.8953,47.2047,484,80049,0.595741,1,1,272254,271770,484
33672721,11,7,478,80803,0.75,1,2,272750,272272,478
33675641,27,27,477,80829,0.734,1,1,272781,272304,477
33678561,21.4,19.8,479,80855,0.7308,1,1,272801,272322,479
33681481,15.48,15.16,479,80881,0.76216,1,2,272815,272336,479
33684401,20.696,19.832,480,80907,0.752432,1,2,272837,272357,480
33687321,15.3392,15.9664,479,80933,0.718486,1,1,272851,272372,479
33690241,13.4678,13.5933,479,80959,0.727697,1,1,272864,272385,479
33693161,25.8936,28.3187,476,80985,0.777539,1,2,272893,272417,476
33696081,13.9787,5.66373,487,81011,0.739508,1,1,272904,272417,487
33699001,17.9957,11.5327,493,81037,0.731902,1,1,272923,272430,493
33701921,15.5991,15.9065,491,81063,0.71438,1,1,272938,272447,491
33704841,16.7198,16.7813,491,81089,0.694876,1,1,272955,272464,491
33707761,14.544,18.5563,486,81115,0.754975,1,2,272969,272483,486
33710681,14.9088,13.3113,489,81141,0.718995,1,1,272984,272495,489
33713601,8.58176,12.2623,484,81167,0.727799,1,1,272991,272507,484
33716521,10.5164,9.65245,486,81193,0.74556,1,1,273002,272516,486
33719441,13.3033,13.1305,486,81219,0.749112,0.95,1,273016,272530,486
33722361,12.2607,13.8261,484,81245,0.749822,0.92,1,273028,272544,484
33725281,12.0521,13.1652,483,81271,0.765965,0.91,2,273040,272557,483
33728201,10.4104,13.033,480,81297,0.769193,0.98,2,273050,272570,480
33731121,6.88209,11.4066,475,81323,0.769839,0.97,2,273056,272581,475
33734041,4.57642,7.88132,472,81349,0.769968,1,2,273060,272588,472
33736961,26.5153,5.57626,499,81375,0.785994,0.95,2,273092,272593,499
33739881,18.1031,25.9153,484,81401,0.821199,0.95,2,273108,272624,484
33742801,13.2206,17.9831,480,81427,0.84424,0.95,2,273120,272640,480
33745721,53.8441,14.7966,530,81453,0.848848,0.75,2,273184,272654,530
33748641,20.3688,62.1593,468,81479,0.84977,0.73,2,273196,272728,468
33751561,13.6738,21.2319,469,81505,0.849954,0.75,2,273208,272739,469
33754481,26.7348,13.0464,488,81531,0.881991,0.73,2,273238,272750,488
33757401,21.347,27.4093,477,81557,0.888398,0.73,2,273258,272781,477
33760321,15.4694,21.4819,471,81583,0.88968,0.77,2,273272,272801,471
33763241,19.8939,15.4964,478,81609,0.873936,0.75,2,273293,272815,478
33766161,15.1788,20.6993,470,81635,0.870787,0.71,2,273307,272837,470
33769081,12.6358,15.3399,468,81661,0.870157,0.73,2,273319,272851,468
33772001,26.5272,13.468,485,81687,0.870031,0.79,2,273349,272864,485
33774921,15.7054,25.8936,469,81713,0.854006,0.73,2,273362,272893,469
33777841,19.1411,13.9787,478,81739,0.850801,0.73,2,273382,272904,478
33780761,15.0282,17.9957,473,81765,0.86616,0.71,2,273396,272923,473
33783681,17.4056,15.5991,476,81791,0.869232,0.69,2,273414,272938,476
33786601,11.4811,16.7198,469,81817,0.869846,0.77,2,273424,272955,469
33789521,15.0962,14.544,471,81843,0.885969,0.71,2,273440,272969,471
33792441,9.41925,14.9088,464,81869,0.889194,0.73,2,273448,272984,464
33795361,11.4838,8.58176,469,81895,0.889839,0.75,2,273460,272991,469
33798281,13.4968,10.5164,472,81921,0.889968,0.75,2,273474,273002,472
33801201,13.0994,13.3033,471,81947,0.905994,0.75,2,273487,273016,471
33804121,12.2199,12.2607,471,81973,0.877199,0.77,2,273499,273028,471
33807041,10.444,12.0521,469,81999,0.87144,0.77,2,273509,273040,469
33809961,7.68879,10.4104,466,82024,0.886288,0.77,2,273516,273050,466
33812881,4.73776,6.88209,464,82049,0.889258,0.77,2,273520,273056,464
33815801,28.1476,4.57642,494,82074,0.889852,0.79,2,273554,273060,494
33818721,19.2295,26.5153,479,82099,0.87397,0.83,2,273571,273092,479
33821641,13.4459,18.1031,475,82124,0.838794,0.85,2,273583,273108,475
33824561,53.8892,13.2206,527,82149,0.831759,0.85,2,273647,273120,527
33827481,20.3778,53.8441,475,82174,0.830352,0.85,2,273659,273184,475
33830401,14.4756,20.3688,476,82199,0.84607,0.85,2,273672,273196,476
33833321,27.6951,13.6738,495,82224,0.833214,0.89,2,273703,273208,495
33836241,21.539,26.7348,485,82249,0.830643,0.89,2,273723,273238,485
33839161,15.5078,21.347,479,82274,0.830129,0.89,2,273737,273258,479
33842081,19.1016,15.4694,485,82299,0.830026,0.87,2,273757,273272,485
33845001,15.0203,19.8939,478,82324,0.830005,0.87,2,273771,273293,478
33847921,12.6041,15.1788,476,82349,0.846001,0.87,2,273783,273307,476
33850841,26.5208,12.6358,494,82374,0.8652,0.87,2,273813,273319,494
33853761,14.9042,26.5272,476,82399,0.86904,0.85,2,273825,273349,476
33856681,18.9808,15.7054,483,82424,0.885808,0.85,2,273845,273362,483
33859601,5.39617,19.1411,465,82449,0.889162,0.87,2,273847,273382,465
33862521,12.2792,15.0282,465,82474,0.921832,0.87,2,273861,273396,465
33865441,16.8558,17.4056,465,82499,0.928366,0.87,2,273879,273414,465
33868361,12.1712,11.4811,466,82524,0.913673,0.89,2,273890,273424,466
33871281,15.2342,15.0962,466,82549,0.942735,0.89,2,273906,273440,466
33874201,9.44685,9.41925,466,82574,0.916547,0.89,2,273914,273448,466
33877121,11.4894,11.4838,466,82599,0.943309,0.89,2,273926,273460,466
33880041,13.4979,13.4968,466,82624,0.948662,0.91,2,273940,273474,466
33882961,12.2996,13.0994,465,82649,0.949732,0.87,2,273952,273487,465
33885881,12.0599,12.2199,465,82674,0.949946,0.87,2,273964,273499,465
33888801,10.412,10.444,465,82699,0.917989,0.89,2,273974,273509,465
34131161,12,13,489,84774,0.89,1,2,275382,274893,489
34134081,11.2,12.2,488,84799,0.89,1,2,275393,274905,488
34137001,9.44,8.84,489,84824,0.826,1,2,275402,274913,489
34139921,10.688,9.768,490,84849,0.8452,1,2,275413,274923,490
34142841,17.3376,9.1536,500,84874,0.75304,1,2,275432,274932,500
34145761,13.0675,21.0307,488,84899,0.750608,1,2,275444,274956,488
34148681,14.6135,17.0061,487,84924,0.718122,1,1,275459,274972,487
34151601,59.7227,14.6012,544,84949,0.607624,1,1,275530,274986,544
34154521,22.3445,55.7202,491,84974,0.585525,1,1,275543,275052,491
34157441,13.2689,23.944,486,84999,0.621105,1,1,275554,275068,486
34160361,21.0538,12.7888,499,85024,0.612221,1,1,275577,275078,499
34163281,29.0108,27.3578,499,85049,0.642444,1,1,275608,275109,499
34166201,13.8022,25.4716,484,85074,0.648489,1,1,275618,275134,484
34169121,21.1604,14.6943,495,85099,0.633698,1,1,275641,275146,495
34172041,16.2321,17.3389,492,85124,0.67874,1,1,275656,275164,492
34174961,14.4464,15.4678,491,85149,0.687748,1,1,275670,275179,491
34177881,18.0893,14.2936,496,85174,0.67355,1,1,275689,275193,496
34180801,21.2179,22.8587,493,85199,0.68671,0.97,1,275711,275218,493
34183721,14.6436,22.1717,484,85224,0.689342,0.95,1,275724,275240,484
34186641,10.9287,15.6343,480,85249,0.689868,1,1,275734,275254,480
34189561,11.7857,11.9269,481,85274,0.689974,0.95,1,275746,275265,481
34192481,12.7571,11.9854,482,85298,0.705995,0.99,1,275759,275277,482
34195401,13.7514,12.7971,483,85322,0.693199,1,1,275773,275290,483
34198321,16.3503,14.5594,485,85346,0.70664,0.97,1,275790,275305,485
34201241,15.2701,18.1119,481,85370,0.693328,0.95,1,275805,275324,481
34204161,4.65401,14.8224,469,85394,0.690666,0.95,1,275807,275338,469
34207081,6.5308,10.1645,467,85418,0.706133,0.91,1,275814,275347,467
34210001,8.50616,10.0329,466,85442,0.725227,0.91,1,275823,275357,466
34212921,12.1012,12.4066,466,85466,0.713045,0.89,1,275836,275370,466
34215841,11.2202,12.0813,465,85490,0.726609,0.89,1,275847,275382,465
34218761,9.44405,11.2163,463,85514,0.713322,0.81,1,275856,275393,463
34221681,9.08881,9.44325,463,85538,0.726664,0.85,1,275865,275402,463
34224601,9.01776,10.6887,461,85562,0.713333,0.73,1,275874,275413,461
34227521,13.8036,17.3377,457,85586,0.726667,0.75,1,275889,275432,457
34230441,11.5607,13.0675,456,85610,0.713333,0.71,1,275900,275444,456
34233361,12.7121,14.6135,454,85634,0.742667,0.58,1,275913,275459,454
34236281,56.1424,59.7227,450,85658,0.764533,0.58,2,275980,275530,450
34239201,22.4285,22.3445,451,85682,0.736907,0.63,1,275994,275543,451
34242121,14.8857,13.2689,453,85706,0.715381,0.61,1,276007,275554,453
34245041,20.5771,21.0538,452,85730,0.743076,0.65,1,276029,275577,452
34247961,30.5154,29.0108,454,85754,0.764615,0.65,2,276062,275608,454
34250881,14.1031,13.8022,454,85778,0.736923,0.63,1,276072,275618,454
34253801,20.4206,21.1604,453,85802,0.731385,0.69,1,276094,275641,453
34256721,16.8841,16.2321,454,85826,0.762277,0.69,2,276110,275656,454
34259641,14.5768,14.4464,454,85850,0.800455,0.67,2,276124,275670,454
34262561,19.7154,18.0893,456,85874,0.792091,0.69,2,276145,275689,456
34265481,22.3431,21.2179,457,85898,0.774418,0.69,2,276168,275711,457
34268401,14.0686,14.6436,456,85922,0.770884,0.69,2,276180,275724,456
34271321,10.8137,10.9287,456,85946,0.770177,0.69,2,276190,275734,456
34274241,11.7627,11.7857,456,85970,0.802035,0.71,2,276202,275746,456
34277161,11.9525,12.7571,455,85994,0.808407,0.69,2,276214,275759,455
34280081,14.3905,13.7514,456,86018,0.825681,0.71,2,276229,275773,456
34283001,17.2781,16.3503,457,86042,0.797136,0.69,2,276247,275790,457
34285921,14.6556,15.2701,456,86066,0.823427,0.69,2,276261,275805,456
34288841,4.53112,4.65401,456,86090,0.796685,0.71,2,276263,275807,456
34291761,7.30622,6.5308,457,86114,0.791337,0.73,2,276271,275814,457
34294681,7.86124,8.50616,456,86138,0.822267,0.71,2,276279,275823,456
34297601,12.7722,12.1012,457,86162,0.812454,0.73,2,276293,275836,457
34300521,10.5544,11.2202,456,86186,0.810491,0.71,2,276303,275847,456
34303441,10.1109,9.44405,457,86210,0.810098,0.73,2,276313,275856,457
34306361,8.42218,9.08881,456,86234,0.84202,0.71,2,276321,275865,456
34309281,9.68444,9.01776,457,86258,0.816404,0.73,2,276331,275874,457
34312201,13.1369,13.8036,456,86282,0.843281,0.71,2,276345,275889,456
34315121,13.0274,11.5607,458,86306,0.832656,0.75,2,276358,275900,458
34318041,12.2055,12.7121,457,86330,0.830531,0.77,2,276370,275913,457
34320961,56.8411,56.1424,458,86354,0.846106,0.73,2,276438,275980,458
34323881,22.5682,22.4285,458,86378,0.849221,0.71,2,276452,275994,458
34326801,14.1136,14.8857,457,86402,0.849844,0.75,2,276464,276007,457
34329721,20.4227,20.5771,457,86426,0.881969,0.77,2,276486,276029,457
34332641,31.2845,30.5154,458,86450,0.872394,0.73,2,276520,276062,458
34335561,14.2569,14.1031,458,86474,0.870479,0.73,2,276530,276072,458
34338481,20.4514,20.4206,458,86498,0.870096,0.77,2,276552,276094,458
34341401,17.6903,16.8841,459,86522,0.886019,0.81,2,276569,276110,459
34344321,15.5381,14.5768,460,86546,0.873204,0.79,2,276584,276124,460
34347241,19.1076,19.7154,459,86570,0.870641,0.77,2,276604,276145,459
34350161,23.0215,22.3431,460,86594,0.870128,0.77,2,276628,276168,460
34353081,14.2043,14.0686,460,86618,0.870026,0.77,2,276640,276180,460
34356001,10.8409,10.8137,460,86642,0.870005,0.81,2,276650,276190,460
34358921,11.7682,11.7627,460,86666,0.886001,0.81,2,276662,276202,460
34361841,11.9536,11.9525,460,86690,0.8892,0.83,2,276674,276214,460
34364761,15.1907,14.3905,461,86714,0.88984,0.79,2,276690,276229,461
34367681,17.4381,17.2781,461,86738,0.889968,0.83,2,276708,276247,461
34370601,14.6876,14.6556,461,86762,0.905994,0.79,2,276722,276261,461
34373521,4.53753,4.53112,461,86786,0.909199,0.79,2,276724,276263,461
34376441,7.30751,7.30622,461,86810,0.90984,0.83,2,276732,276271,461
34379361,7.8615,7.86124,461,86834,0.909968,0.83,2,276740,276279,461
34382281,12.7723,1.57225,475,86858,0.909994,0.81,2,276754,276279,475
34385201,10.5545,11.5144,471,86882,0.909999,0.81,2,276764,276293,471
34388121,10.1109,10.3029,471,86906,0.91,0.81,2,276774,276303,471
34391041,8.42218,10.0606,469,86930,0.91,0.85,2,276782,276313,469
34393961,9.68444,8.41212,471,86954,0.91,0.81,2,276792,276321,471
34396881,13.1369,9.68242,475,86978,0.91,0.85,2,276806,276331,475
34399801,13.8274,13.1365,475,87002,0.926,0.83,2,276820,276345,475
34402721,12.3655,13.0273,474,87026,0.9292,0.83,2,276832,276358,474
34461121,8,2,474,87506,0.95,0.91,2,277198,276724,474
34796921,18,11,505,90206,0.91,1,2,279067,278562,505
34799841,17.2,12.6,509,90229,0.894,1,2,279084,278575,509
34802761,10.64,19.32,497,90252,0.8428,1,2,279093,278596,497
34805681,8.528,14.264,492,90275,0.84856,1,2,279101,278609,492
34808601,10.5056,12.4528,491,90298,0.833712,1,2,279112,278621,491
34811521,9.30112,11.2906,489,90321,0.830742,1,2,279121,278632,489
34814441,7.46022,10.2581,486,90344,0.814148,0.92,2,279128,278642,486
34817361,10.292,10.0516,487,90367,0.82683,0.92,2,279139,278652,487
34820281,6.85841,10.0103,483,90390,0.797366,0.97,2,279145,278662,483
34823201,10.9717,10.0021,485,90413,0.791473,1,2,279157,278672,485
34826121,8.59434,6.80041,487,90436,0.790295,1,2,279165,278678,487
34829041,10.5189,9.36008,488,90459,0.774059,1,2,279176,278688,488
34831961,12.5038,8.27202,493,90482,0.786812,1,2,279189,278696,493
34834881,6.50075,3.2544,496,90505,0.773362,1,2,279194,278698,496
34837801,11.7002,16.6509,489,90528,0.802673,1,2,279207,278718,489
34840721,41.54,13.7302,525,90551,0.872535,1,2,279256,278731,525
34843641,19.508,49.946,480,90574,0.854507,1,2,279270,278790,480
34846561,13.5016,18.7892,481,90597,0.882901,1,2,279282,278801,481
34849481,17.9003,13.3578,488,90620,0.84058,1,2,279301,278813,488
34852401,37.1801,15.4716,514,90643,0.832116,0.99,2,279343,278829,514
34855321,21.836,35.0943,492,90666,0.878423,1,2,279361,278869,492
34858241,14.7672,27.0189,480,90689,0.903685,1,2,279374,278894,480
34861161,13.3534,15.0038,481,90712,0.892737,1,2,279387,278906,481
34864081,21.8707,15.0008,490,90735,0.858547,1,2,279411,278921,490
34867001,17.9741,16.6002,490,90758,0.835709,0.93,2,279428,278938,490
34869921,30.7948,16.92,507,90781,0.863142,0.95,2,279462,278955,507
34872841,18.959,35.384,483,90804,0.836628,0.88,2,279478,278995,483
34875761,12.5918,19.8768,478,90827,0.847326,0.97,2,279489,279011,478
34878681,8.11836,13.5754,473,90850,0.833465,0.91,2,279496,279023,473
34881601,13.6237,10.7151,478,90873,0.814693,0.93,2,279511,279033,478
34884521,15.5247,14.943,478,90896,0.810939,0.91,2,279527,279049,478
34887441,17.5049,17.3886,478,90919,0.826188,0.89,2,279545,279067,478
34890361,10.701,17.0777,470,90942,0.845237,0.83,2,279554,279084,470
34893281,8.5402,10.6155,469,90965,0.817047,0.85,2,279562,279093,469
34896201,10.508,8.52311,472,90988,0.82741,0.83,2,279573,279101,472
34899121,8.50161,10.5046,469,91011,0.829482,0.83,2,279581,279112,469
34902041,8.10032,9.30092,468,91034,0.829896,0.81,2,279589,279121,468
34904961,9.62006,7.46018,471,91057,0.845979,0.83,2,279599,279128,471
34907881,6.72401,10.292,466,91080,0.849196,0.79,2,279605,279139,466
34910801,9.3448,6.85841,470,91103,0.849839,0.79,2,279615,279145,470
34913721,8.26896,10.9717,466,91126,0.849968,0.79,2,279623,279157,466
34916641,12.8538,8.59434,472,91149,0.849994,0.77,2,279637,279165,472
34919561,12.1708,10.5189,473,91172,0.849999,0.79,2,279649,279176,473
34922481,5.63415,12.5038,464,91195,0.866,0.77,2,279653,279189,464
34925401,2.72683,6.50075,461,91218,0.8692,0.81,2,279655,279194,461
34928321,11.7454,11.7002,462,91241,0.90184,0.89,2,279669,279207,462
34931241,43.1491,41.54,464,91264,0.892368,0.85,2,279720,279256,464
34934161,19.8298,19.508,464,91287,0.858474,0.89,2,279734,279270,464
34937081,15.166,13.5016,466,91310,0.883695,0.83,2,279748,279282,466
34940001,15.8332,17.9003,463,91333,0.856739,0.83,2,279764,279301,463
34942921,39.1666,37.1801,466,91356,0.867348,0.89,2,279809,279343,466
34945841,22.2333,21.836,466,91379,0.90147,0.91,2,279827,279361,466
34948761,14.0467,14.7672,465,91402,0.924294,0.89,2,279839,279374,465
34951681,14.0093,13.3534,466,91425,0.928859,0.85,2,279853,279387,466
34954601,20.4019,21.8707,464,91448,0.929772,0.83,2,279875,279411,464
34957521,16.8804,17.9741,463,91471,0.929954,0.87,2,279891,279428,463
34960441,30.5761,30.7948,463,91494,0.929991,0.83,2,279925,279462,463
34963361,18.9152,18.959,463,91517,0.945998,0.85,2,279941,279478,463
34966281,11.783,12.5918,462,91540,0.9172,0.83,2,279951,279489,462
34969201,8.75661,8.11836,463,91563,0.94344,0.81,2,279959,279496,463
34972121,12.9513,13.6237,462,91586,0.948688,0.81,2,279973,279511,462
35674381,18,29,485,46082,0.13,1,1,283651,283166,485
35677301,22.8,24.2,486,46128,0.066,1,1,283675,283189,486
35680221,38.96,37.64,488,46174,0.0372,0.88,1,283718,283230,488
35683141,28.592,31.528,484,46220,0.01544,0.95,1,283744,283260,484
35686061,40.9184,42.3056,483,46266,0.027088,0.83,1,283788,283305,483
35688981,28.1837,38.0611,471,46312,0.0614176,0.55,1,283813,283342,471
35691901,38.4367,53.2122,455,46358,0.0682835,0.41,1,283854,283399,455
35694821,32.4873,38.6424,451,46403,0.0376567,0.25,1,283885,283434,451
35697741,28.0975,34.1285,445,46448,0.0795313,0.17,1,283912,283467,445
35700661,27.2195,30.8257,442,46493,0.119906,0.09,1,283939,283497,442
35701121,19.0439,26.1651,434,46538,0.127981,0.02,1,283956,283522,434
35704041,68.6088,77.233,425,46538,0.0255962,0.02,1,284037,283612,425
35706961,15.3218,15.4466,427,46583,0.00511925,0.02,1,284039,283612,427
35709881,4.66435,3.08932,429,46628,0.0250239,0.02,1,284041,283612,429
35712801,2.53287,0.617864,431,46673,0.0450048,0.13,1,284043,283612,431
35715721,10.9066,16.9236,423,46718,0.065001,0.13,1,284056,283633,423
35718641,17.3813,3.38471,442,46763,0.0690002,0.13,1,284075,283633,442
35721561,21.0763,15.0769,446,46808,0.0218,0.05,1,284097,283651,446
35724481,38.6153,22.2154,465,46853,0.01236,0.03,1,284140,283675,465
35727401,28.5231,38.8431,448,46898,0.002472,0.01,1,284166,283718,448
35730321,40.9046,28.5686,466,46943,0.0244944,0.03,1,284210,283744,466
35733241,28.1809,40.9137,447,46988,0.0448989,0.07,1,284235,283788,447
35736161,38.4362,28.1827,463,47033,0.0489798,0.07,1,284276,283813,463
35739081,32.4872,38.4365,453,47078,0.065796,0.03,1,284307,283854,453
35742001,29.6974,32.4873,451,47123,0.0851592,0.09,1,284336,283885,451
35744921,29.1395,28.0975,453,47168,0.121032,0.13,1,284365,283912,453
35747841,81.0279,27.2195,520,47213,0.0242064,0,1,284459,283939,520
35750761,18.6056,83.8439,425,47258,0.00484127,0,1,284462,284037,425
35753681,5.32112,18.3688,425,47303,0.0409683,0.03,1,284464,284039,425
35756601,2.66422,5.27376,425,47348,0.0481936,0.05,1,284466,284041,425
35759521,10.1328,2.65475,435,47393,0.0336387,0.07,1,284478,284043,435
35762441,3.62657,10.931,424,47437,0.0307277,0.07,1,284480,284056,424
35765361,15.9253,17.3862,424,47481,0.0461455,0.01,1,284499,284075,424
35768281,20.7851,21.0772,424,47525,0.0172291,0.01,1,284521,284097,424
35771201,37.757,38.6154,423,47569,0.00344582,0,1,284563,284140,423
35774121,28.3514,28.5231,423,47613,0.0246892,0.03,1,284589,284166,423
35777041,40.0703,40.9046,422,47657,0.0129378,0.05,1,284632,284210,422
35779961,29.6141,28.1809,424,47701,0.0105876,0.05,1,284659,284235,424
35782881,38.7228,38.4362,424,47745,0.0421175,0.07,1,284700,284276,424
35785801,33.3446,32.4872,425,47789,0.0484235,0.09,1,284732,284307,425
35788721,30.6689,29.6974,426,47833,0.0176847,0.13,1,284762,284336,426
35791641,29.3338,29.1395,426,47877,0.0755369,0,1,284791,284365,426
35794561,77.8668,81.0279,422,47921,0.0711074,0,1,284881,284459,422
35797481,18.7734,18.6056,423,47965,0.0382215,0.05,1,284885,284462,423
35800401,5.35467,5.32112,423,48009,0.0316443,0.05,1,284887,284464,423
35803321,2.67093,2.66422,423,48053,0.0303289,0.03,1,284889,284466,423
35806241,10.1342,10.1328,423,48097,0.0460658,0.03,1,284901,284478,423
35809161,3.62684,3.62657,423,48141,0.0652132,0.05,1,284903,284480,423
35812081,15.1254,15.9253,422,48185,0.101043,0.01,1,284921,284499,422
35815001,20.6251,20.7851,422,48229,0.0762085,0,1,284943,284521,422
35817921,37.725,37.757,422,48273,0.0392417,0.03,1,284985,284563,422
35820841,28.345,28.3514,422,48317,0.0318483,0.01,1,285011,284589,422
35823761,40.069,40.0703,422,48361,0.0303697,0.01,1,285054,284632,422
35826681,29.6138,29.6141,422,48405,0.0140739,0.05,1,285081,284659,422
35829601,38.7228,38.7228,422,48449,0.0428148,0.05,1,285122,284700,422
35832521,33.3446,33.3446,422,48492,0.048563,0.01,1,285154,284732,422
35835441,31.4689,30.6689,423,48535,0.0337126,0.09,1,285185,284762,423
35838361,30.2938,29.3338,424,48578,0.0467425,0.07,1,285215,284791,424
35841281,76.4588,77.8668,422,48621,0.0333485,0.03,1,285303,284881,422
35844201,18.4918,18.7734,422,48664,0.0306697,0.03,1,285307,284885,422
35847121,5.29835,5.35467,422,48707,0.0301339,0.03,1,285309,284887,422
35850041,2.65967,2.67093,422,48750,0.0300268,0.05,1,285311,284889,422
35852961,11.7319,10.1342,424,48793,0.0460054,0.07,1,285325,284901,424
35855881,3.94639,3.62684,424,48836,0.0492011,0.07,1,285327,284903,424
35858801,15.1893,0.725367,442,48879,0.0178402,0.11,1,285345,284903,442
35861721,18.2379,14.5451,443,48922,0.043568,0.07,1,285364,284921,443
35864641,37.2476,20.509,463,48965,0.0327136,0.03,1,285406,284943,463
35867561,28.2495,37.7018,447,49008,0.0305427,0.03,1,285432,284985,447
35870481,40.0499,28.3404,464,49051,0.0141085,0.03,1,285475,285011,464
35873401,29.61,40.0681,448,49094,0.0108217,0.01,1,285502,285054,448
35876321,38.722,29.6136,462,49137,0.0421643,0.05,1,285543,285081,462
35879241,33.3444,38.7227,453,49180,0.0484329,0.05,1,285575,285122,453
35882161,31.4689,33.3445,452,49223,0.0656866,0.03,1,285606,285154,452
35885081,30.2938,31.4689,451,49266,0.0371373,0.05,1,285636,285185,451
35888001,76.4588,30.2938,509,49309,0.111427,0.03,1,285724,285215,509
35890921,18.4918,76.4588,425,49352,0.126285,0.03,1,285728,285303,425
35893841,5.29835,18.4918,423,49395,0.129257,0.03,1,285730,285307,423
35896761,2.65967,5.29835,423,49438,0.129851,0.03,1,285732,285309,423
35899681,11.7319,2.65967,435,49481,0.0979703,0.05,1,285746,285311,435
35902601,3.94639,11.7319,423,49524,0.0915941,0.05,1,285748,285325,423
35905521,15.9893,3.94639,440,49567,0.0903188,0.01,1,285767,285327,440
35908441,17.5979,15.1893,440,49610,0.106064,0.05,1,285785,285345,440
35911361,37.1196,18.2379,463,49652,0.0212128,0.03,1,285827,285364,463
35914281,28.2239,37.2476,447,49694,0.0282426,0.03,1,285853,285406,447
35917201,40.0448,28.2495,464,49736,0.0296485,0.01,1,285896,285432,464
35920121,29.609,40.0499,448,49778,0.0139297,0.01,1,285923,285475,448
35923041,40.3218,29.61,464,49820,0.0427859,0.05,1,285966,285502,464
35925961,33.6644,38.722,455,49862,0.0645572,0.05,1,285998,285543,455
35928881,30.7329,33.3444,453,49904,0.0689114,0.07,1,286028,285575,453
35931801,31.7466,31.4689,454,49946,0.0697823,0.03,1,286060,285606,454
35934721,77.5493,30.2938,513,49988,0.101956,0.13,1,286149,285636,513
35937641,18.7099,76.4588,429,50030,0.108391,0.13,1,286153,285724,429
35940561,5.34197,18.4918,427,50072,0.109678,0.13,1,286155,285728,427
35943481,2.66839,5.29835,427,50114,0.109936,0.13,1,286157,285730,427
35946401,12.5337,2.65967,440,50156,0.0939871,0.09,1,286172,285732,440
35949321,4.10674,11.7319,428,50198,0.0907974,0.09,1,286174,285746,428
35952241,15.2213,3.94639,444,50240,0.0901595,0.09,1,286192,285748,444
35955161,18.2443,15.9893,444,50282,0.106032,0.11,1,286211,285767,444
35958081,5.24885,17.5979,428,50324,0.109206,0,1,286213,285785,428
35961001,30.6498,37.1196,423,50366,0.0938413,0.03,1,286250,285827,423
35963921,26.13,28.2239,422,50408,0.0427683,0.03,1,286275,285853,422
35966841,39.626,40.0448,422,50450,0.0165537,0.01,1,286318,285896,422
35969761,30.3252,29.609,423,50492,0.0273107,0.05,1,286346,285923,423
35972681,41.265,40.3218,424,50534,0.0294621,0.07,1,286390,285966,424
35975601,34.653,33.6644,425,50576,0.0458924,0.07,1,286423,285998,425
35978521,30.9306,30.7329,425,50618,0.0171785,0.07,1,286453,286028,425
35981441,33.3861,31.7466,427,50660,0.0114357,0.11,1,286487,286060,427
35984361,77.8772,77.5493,427,50702,0.0102871,0.11,1,286576,286149,427
35987281,18.7754,18.7099,427,50744,0.0100574,0.11,1,286580,286153,427
35990201,5.35509,5.34197,427,50786,0.0100115,0.11,1,286582,286155,427
35993121,2.67102,2.66839,427,50827,0.0100023,0.09,1,286584,286157,427
35996041,11.7342,12.5337,426,50868,0.0580005,0.09,1,286598,286172,426
35998961,3.94684,4.10674,426,50909,0.0676001,0.09,1,286600,286174,426
36001881,15.1894,15.2213,426,50950,0.06952,0.11,1,286618,286192,426
36004801,19.0379,18.2443,427,50991,0.053904,0.11,1,286638,286211,427
36007721,5.40757,5.24885,427,51032,0.0827808,0.09,1,286640,286213,427
36010641,28.2815,30.6498,424,51073,0.120556,0.03,1,286674,286250,424
36013561,24.0563,26.13,422,51114,0.0961112,0.01,1,286697,286275,422
36016481,39.2113,39.626,422,51155,0.0592222,0.03,1,286740,286318,422
36019401,30.2423,30.3252,422,51196,0.0358444,0.03,1,286768,286346,422
36022321,41.2485,41.265,422,51237,0.0311689,0.05,1,286812,286390,422
36025241,34.6497,34.653,422,51278,0.0462338,0.01,1,286845,286423,422
36028161,30.9299,30.9306,422,51319,0.0492468,0.01,1,286875,286453,422
36031081,33.386,33.3861,422,51360,0.0178494,0.01,1,286909,286487,422
36034001,77.8772,77.8772,422,51401,0.0435699,0.01,1,286998,286576,422
36036921,18.7754,18.7754,422,51442,0.048714,0.01,1,287002,286580,422
36039841,5.35509,5.35509,422,51483,0.0177428,0.01,1,287004,286582,422
36042761,2.67102,2.67102,422,51524,0.0115486,0.07,1,287006,286584,422
36045681,12.5342,11.7342,423,51565,0.0583097,0.07,1,287021,286598,423
36048601,4.10684,3.94684,423,51606,0.0676619,0.07,1,287023,286600,423
36051521,15.2214,15.1894,423,51647,0.0535324,0.05,1,287041,286618,423
36054441,19.8443,19.0379,424,51688,0.0667065,0.09,1,287062,286638,424
36057361,5.56885,5.40757,424,51729,0.0693413,0.13,1,287064,286640,424
36060281,29.9138,28.2815,426,51770,0.0698683,0.13,1,287100,286674,426
36063201,20.3828,5.6563,444,51811,0.0379737,0.09,1,287118,286674,444
36066121,38.4766,19.5313,464,51852,0.0315947,0.05,1,287161,286697,464
36069041,30.0953,38.3063,449,51893,0.0303189,0.03,1,287189,286740,449
36071961,41.2191,30.0612,465,51934,0.0140638,0.03,1,287233,286768,465
36074881,34.6438,41.2123,454,51975,0.0268128,0.05,1,287266,286812,454
36077801,30.9288,34.6424,451,52016,0.0293626,0.05,1,287296,286845,451
36080721,33.3858,30.9285,455,52056,0.0298725,0.01,1,287330,286875,455
36083641,77.8772,33.3857,510,52096,0.0619745,0.05,1,287419,286909,510
36086561,18.7754,77.8771,425,52136,0.0683949,0.05,1,287423,286998,425
36089481,5.35509,18.7754,423,52176,0.069679,0.01,1,287425,287002,423
36092401,2.67102,5.35509,423,52216,0.0699358,0.01,1,287427,287004,423
36095321,13.3342,2.67102,437,52256,0.0859872,0.07,1,287443,287006,437
36098241,4.26684,12.5342,424,52296,0.0891974,0.07,1,287445,287021,424
36101161,16.0534,4.10684,441,52336,0.105839,0.05,1,287464,287023,441
36104081,19.2107,15.2214,443,52376,0.109168,0.07,1,287484,287041,443
36107001,5.44213,19.8443,424,52416,0.109834,0.07,1,287486,287062,424
36109921,29.8884,5.56885,458,52456,0.109967,0.07,1,287522,287064,458
36112841,20.3777,29.9138,440,52496,0.125993,0.03,1,287540,287100,440
36115761,38.4755,20.3828,465,52536,0.129199,0.03,1,287583,287118,465
36118681,29.2951,38.4766,449,52576,0.12984,0.03,1,287610,287161,449
36121601,41.059,30.0953,465,52616,0.0659679,0.01,1,287654,287189,465
36124521,35.4118,41.2191,455,52656,0.0371936,0.03,1,287688,287233,455
36127441,31.0824,34.6438,452,52696,0.0314387,0.03,1,287718,287266,452
36130361,33.4165,30.9288,456,52736,0.0462877,0.03,1,287752,287296,456
36133281,79.4833,33.3858,513,52776,0.0812576,0.07,1,287843,287330,513
36136201,19.0967,77.8772,428,52816,0.0882515,0.07,1,287847,287419,428
36139121,5.41933,18.7754,426,52856,0.0896503,0.07,1,287849,287423,426
36142041,2.68387,5.35509,426,52896,0.0899301,0.07,1,287851,287425,426
36144961,14.1368,2.67102,441,52936,0.073986,0.09,1,287868,287427,441
36147881,4.42735,13.3342,427,52976,0.0707972,0.09,1,287870,287443,427
36150801,16.8855,4.26684,445,53016,0.0701594,0.11,1,287890,287445,445
36153721,19.3771,16.0534,446,53056,0.0860319,0.11,1,287910,287464,446
36156641,5.47542,19.2107,428,53096,0.0892064,0.11,1,287912,287484,428
36159561,30.6951,5.44213,463,53136,0.0738413,0.11,1,287949,287486,463
36162481,21.339,29.8884,446,53176,0.0547683,0.13,1,287968,287522,446
36165401,37.8678,20.3777,470,53216,0.0829537,0.13,1,288010,287540,470
36168321,9.17356,38.4755,429,53256,0.0885907,0.13,1,288012,287583,429
36171241,21.0347,29.2951,426,53296,0.0897181,0.05,1,288036,287610,426
36174161,37.8069,41.059,424,53335,0.121944,0.03,1,288078,287654,424
36177081,33.9614,35.4118,423,53374,0.112389,0.03,1,288111,287688,423
36180001,30.7923,31.0824,423,53413,0.0784777,0.05,1,288141,287718,423
36182921,34.1585,33.4165,424,53452,0.0876956,0.09,1,288176,287752,424
36185841,81.2317,79.4833,426,53491,0.0895391,0.09,1,288269,287843,426
36188761,19.4463,19.0967,426,53530,0.0899078,0.09,1,288273,287847,426
36191681,5.48927,5.41933,426,53569,0.0899816,0.09,1,288275,287849,426
36194601,2.69785,2.68387,426,53608,0.0899963,0.07,1,288277,287851,426
36197521,13.3396,14.1368,425,53647,0.121999,0.07,1,288293,287868,425
36200441,4.26791,4.42735,425,53686,0.1284,0.07,1,288295,287870,425
36203361,16.8536,16.8855,425,53725,0.12968,0.09,1,288315,287890,425
36206281,20.1707,19.3771,426,53764,0.081936,0.09,1,288336,287910,426
36209201,5.63414,5.47542,426,53803,0.104387,0.07,1,288338,287912,426
36212121,29.9268,30.6951,425,53842,0.124877,0.05,1,288374,287949,425
36215041,21.9854,21.339,426,53881,0.0969755,0.09,1,288394,287968,426
36217961,37.9971,37.8678,426,53920,0.155395,0.09,1,288436,288010,426
36220881,9.19941,9.17356,426,53959,0.135079,0.09,1,288438,288012,426
36223801,21.0399,21.0347,426,53998,0.147016,0.13,1,288462,288036,426
36226721,37.808,37.8069,426,54037,0.213403,0.11,1,288504,288078,426
36229641,33.1616,33.9614,425,54076,0.226681,0.07,1,288536,288111,425
36232561,30.6323,30.7923,425,54115,0.229336,0.09,1,288566,288141,425
36235481,34.9265,34.1585,426,54154,0.197867,0.09,1,288602,288176,426
36238401,81.3853,81.2317,426,54193,0.239573,0.09,1,288695,288269,426
36241321,19.4771,19.4463,426,54232,0.247915,0.09,1,288699,288273,426
36244241,5.49541,5.48927,426,54271,0.217583,0.09,1,288701,288275,426
36247161,2.69908,2.69785,426,54310,0.211517,0.13,1,288703,288277,426
36250081,13.3398,13.3396,426,54349,0.242303,0.13,1,288719,288293,426
36253001,4.26796,4.26791,426,54388,0.248461,0.13,1,288721,288295,426
36255921,16.8536,16.8536,426,54427,0.249692,0.07,1,288741,288315,426
36258841,20.1707,20.1707,426,54466,0.233938,0.11,1,288762,288336,426
36261761,5.63414,5.63414,426,54505,0.230788,0.13,1,288764,288338,426
36264681,29.9268,29.9268,426,54544,0.262158,0.09,1,288800,288374,426
36267601,21.9854,21.9854,426,54583,0.252432,0.17,1,288820,288394,426
36270521,39.5971,37.9971,428,54622,0.218486,0.13,1,288864,288436,428
36273441,9.51941,9.19941,428,54661,0.211697,0.15,1,288866,288438,428
36276361,21.9039,21.0399,429,54699,0.258339,0.15,1,288891,288462,429
36279281,38.7808,4.20798,472,54737,0.251668,0.23,1,288934,288462,472
36282201,33.3562,34.4416,462,54775,0.250334,0.23,1,288966,288504,462
36285121,30.6712,32.4883,460,54813,0.250067,0.23,1,288996,288536,460
36288041,34.9342,30.4977,466,54851,0.250013,0.19,1,289032,288566,466
36290961,82.1869,34.8995,524,54889,0.250003,0.25,1,289126,288602,524
36293881,19.6374,81.3799,435,54927,0.250001,0.25,1,289130,288695,435
36296801,5.52747,19.476,433,54965,0.266,0.21,1,289132,288699,433
36299721,2.70549,5.4952,433,55003,0.2692,0.21,1,289134,288701,433
36302641,13.3411,2.69904,447,55041,0.26984,0.25,1,289150,288703,447
36305561,4.26822,13.3398,433,55079,0.269968,0.25,1,289152,288719,433
36308481,16.8536,4.26796,451,55117,0.269994,0.25,1,289172,288721,451
36311401,20.9707,16.8536,453,55155,0.269999,0.23,1,289194,288741,453
36314321,5.79415,20.1707,434,55193,0.27,0.23,1,289196,288762,434
36317241,29.9588,5.63414,468,55231,0.286,0.27,1,289232,288764,468
36320161,22.7918,29.9268,453,55269,0.3052,0.25,1,289253,288800,453
36323081,38.1584,21.9854,475,55307,0.32504,0.21,1,289295,288820,475
36326001,9.23167,39.5971,433,55345,0.329008,0.21,1,289297,288864,433
36328921,22.6463,9.51941,457,55383,0.329802,0.27,1,289323,288866,457
36331841,39.7293,21.9039,476,55421,0.37796,0.25,1,289367,288891,476
36334761,33.5459,38.7808,465,55459,0.403592,0.25,1,289399,288934,465
36337681,30.7092,33.3562,463,55497,0.424718,0.25,1,289429,288966,463
