#Ack,ack_ewma(ms),send_ewma(ms),rtt_ratio,cwnd (Bytes),Last Router Ocupation Ack Arriaval(Packets),Last Router Ocupation Packet Sent(Packets),Network Situation,AckArrival(ms),TSInsideAck(ms),RTTAck(ms)
1667961,1240.9,1319.04,656,5840,0.970165,0,2,57661,57005,656
1670881,1114.29,1174.91,718,8760,0.970145,0,2,57889,57171,718
1679641,439.14,297.198,2772,5840,0.986878,0,2,60697,57925,2772
1694241,304.654,362.001,979,14600,0.983597,0,2,62233,61254,979
1714681,246.949,155.255,2491,1460,0.993517,0,2,66517,64026,2491
1733661,223.323,317.392,1051,13140,0.991204,0,2,67969,66918,1051
1735121,250.407,325.718,1107,5840,0.961054,0,2,68409,67302,1107
1735121,222.606,285.003,1135,5840,0.933422,0,2,68437,67302,1135
1735121,223.281,249.378,1363,5840,0.885494,0,2,68665,67302,1363
1735121,250.871,218.205,1807,5840,0.813557,0,2,69109,67302,1807
1735121,231.512,190.93,1903,19588,0.740613,0,1,69205,67302,1903
1735121,213.073,167.064,1987,19588,0.681786,0,1,69289,67302,1987
1743881,216.439,372.056,420,19588,0.625313,0,1,69529,69109,420
1746801,220.884,346.549,504,19588,0.568399,0,1,69781,69277,504
1749721,235.273,345.23,504,19414,0.523599,0,1,70117,69613,504
1752641,250.864,344.076,528,18736,0.481899,0,1,70477,69949,528
1755561,258.506,343.067,504,18197,0.450412,0,1,70789,70285,504
1758481,272.693,342.183,540,17658,0.42286,0,1,71161,70621,540
1761401,277.606,341.411,516,17276,0.403753,0,1,71473,70957,516
1764321,290.905,340.734,564,16894,0.399534,0,2,71857,71293,564
1767241,302.542,340.142,612,16650,0.413342,0,2,72241,71629,612
1770161,314.225,339.625,672,16546,0.437924,0,2,72637,71965,672
1771621,323.946,339.172,728,16546,0.474434,0,2,73029,72301,728
1774541,309.453,317.775,768,16546,0.516379,0,2,73237,72469,768
1776001,318.271,320.053,812,16546,0.568082,0,2,73617,72805,812
1777461,303.988,301.047,848,18006,0.618322,0,2,73821,72973,848
1789141,244.252,108.439,2464,10220,0.919373,0,2,76645,74181,2464
1827101,229.82,340.108,1542,5840,0.990583,0,2,83101,81559,1542
1827101,259.592,297.594,2010,5840,0.96301,0,2,83569,81559,2010
1827101,314.143,260.395,2706,17520,0.933884,0,2,84265,81559,2706
1827101,301.875,227.846,2922,18980,0.913398,0,2,84481,81559,2922
1827101,283.641,199.365,3078,1460,0.905473,0,2,84637,81559,3078
1827101,273.686,174.444,3282,5840,0.903539,0,2,84841,81559,3282
1827101,270.975,152.639,3534,7300,0.909347,0,2,85093,81559,3534
1846081,238.403,498.364,758,10220,0.926844,0,2,85369,84611,758
1854841,221.348,229.927,1442,20383,0.96941,0,2,87901,86459,1442
1875281,252.653,170.717,2336,7300,0.987235,0,2,92377,90041,2336
1897181,298.069,375.938,1088,16060,0.976642,0,2,95397,94309,1088
1898641,290.81,356.946,1104,17520,0.965812,0,2,95637,94533,1104
1898641,257.959,312.328,1132,18980,0.953835,0,2,95665,94533,1132
1898641,270.714,273.287,1492,20440,0.953356,0,2,96025,94533,1492
1898641,262.375,239.126,1696,5840,0.955436,0,2,96229,94533,1696
1898641,247.578,209.235,1840,5840,0.949757,0,2,96373,94533,1840
1898641,236.131,183.081,1996,5840,0.934787,0,2,96529,94533,1996
1898641,229.114,160.196,2176,5840,0.914189,0,2,96709,94533,2176
1908861,242.475,352.171,816,1460,0.901165,0,2,97045,96229,816
1911781,255.666,336.15,940,18992,0.884769,0,2,97393,96453,940
1913241,253.707,350.131,732,18992,0.865423,0,2,97633,96901,732
1913241,248.994,306.365,948,18992,0.853495,0,2,97849,96901,948
1913241,244.87,268.069,1164,18992,0.848058,0,2,98065,96901,1164
1913241,241.261,234.56,1380,18992,0.855801,0,2,98281,96901,1380
1914701,266.103,320.615,897,18992,0.871326,0,2,98721,97824,897
1933681,224.316,107.634,2294,8760,0.985869,0,2,102805,100511,2294
1951201,226.021,276.622,1190,13140,0.991951,0,2,104413,103223,1190
1967261,266.984,308.926,1139,13140,0.984629,0,2,107471,106332,1139
1968721,262.111,294.061,1177,14600,0.97905,0,2,107699,106522,1177
1968721,227.741,225.14,1397,17520,0.97646,0,2,107919,106522,1397
1968721,224.774,196.998,1601,18980,0.973153,0,2,108123,106522,1601
1968721,218.677,172.373,1777,7300,0.972759,0,2,108299,106522,1777
1968721,215.342,150.826,1969,7300,0.972414,0,2,108491,106522,1969
1986241,238.34,284.133,1080,23532,0.97137,0,2,109951,108871,1080
1987701,237.047,272.367,1118,23532,0.937448,0,2,110179,109061,1118
1989161,234.416,262.071,1144,23532,0.901517,0,2,110395,109251,1144
1990621,226.614,253.062,1126,23532,0.867578,0,2,110567,109441,1126
1990621,208.787,221.429,1210,23532,0.84038,0,2,110651,109441,1210
1990621,196.189,193.751,1318,23532,0.811583,0,2,110759,109441,1318
1990621,185.165,169.532,1426,7300,0.788885,0,2,110867,109441,1426
1990621,172.52,148.34,1510,7300,0.766524,0,2,110951,109441,1510
1990621,170.455,129.798,1666,7300,0.744459,0,2,111107,109441,1666
1990621,171.648,113.573,1846,5840,0.722651,0,2,111287,109441,1846
2002301,159.192,264.126,600,5840,0.70607,0,2,111359,110759,600
2005221,173.793,244.611,768,5840,0.689061,0,2,111635,110867,768
2008141,198.569,266.534,720,5840,0.679179,0,2,112007,111287,720
2011061,220.248,276.717,744,25971,0.673031,0,2,112379,111635,744
2013981,239.217,288.628,744,25313,0.682652,0,2,112751,112007,744
2016901,249.815,288.049,784,24737,0.693571,0,2,113075,112291,784
2019821,257.588,287.543,812,24326,0.713124,0,2,113387,112575,812
2022741,267.389,287.1,864,24038,0.740234,0,2,113723,112859,864
2034421,247.966,120.205,2382,8760,0.937704,0,2,116519,114137,2382
2034421,246.97,105.18,2622,8760,0.932991,0,2,116759,114137,2622
2051941,229.968,139.161,2439,10220,0.984003,0,2,119627,117188,2439
2085521,240.446,354.241,998,10220,0.997485,0,2,123899,122901,998
2085521,240.39,309.961,1238,11680,0.965299,0,2,124139,122901,1238
2085521,240.341,271.216,1478,13140,0.927137,0,2,124379,122901,1478
2085521,232.799,237.314,1658,5840,0.884995,0,2,124559,122901,1658
2085521,214.199,207.65,1742,5840,0.83562,0,2,124643,122901,1742
2085521,202.424,181.693,1862,5840,0.784918,0,2,124763,122901,1862
2085521,186.121,158.982,1934,5840,0.745553,0,2,124835,122901,1934
2085521,174.856,139.109,2030,5840,0.708609,0,2,124931,122901,2030
2085521,161.999,121.72,2102,5840,0.668783,0,2,125003,122901,2102
2085521,185.249,106.505,2450,5840,0.626435,0,2,125351,122901,2450
2085521,181.593,93.1922,2606,1460,0.591881,0,2,125507,122901,2606
2085521,179.894,81.5432,2774,5840,0.566646,0,2,125675,122901,2774
2085521,170.907,71.3503,2882,7300,0.537065,0,2,125783,122901,2882
2105961,155.544,372.681,448,8760,0.513682,0,2,125831,125383,448
2105961,152.601,326.096,580,10220,0.493222,0,2,125963,125383,580
2105961,156.026,285.334,760,10220,0.482819,0,2,126143,125383,760
2108881,171.022,304.792,595,10220,0.473716,0,2,126419,125824,595
2111801,185.645,302.318,598,13140,0.473252,0,2,126707,126109,598
2114721,201.439,299.029,634,16060,0.467845,0,2,127019,126385,634
2117641,207.759,296.15,610,18980,0.468115,0,2,127271,126661,610
2120561,219.289,293.631,634,21900,0.46085,0,2,127571,126937,634
2123481,223.378,291.427,610,22089,0.461994,0,2,127823,127213,610
2126401,237.456,289.499,670,21602,0.472995,0,2,128159,127489,670
2129321,243.774,287.812,682,21348,0.49012,0,2,128447,127765,682
2132241,249.302,286.335,694,21158,0.510105,0,2,128735,128041,694
2135161,257.139,285.043,730,21010,0.532592,0,2,129047,128317,730
2138081,262.497,283.913,754,23909,0.562268,0,2,129347,128593,754
2141001,267.185,282.924,778,23909,0.598235,0,2,129647,128869,778
2143921,268.287,282.058,778,23909,0.639705,0,2,129923,129145,778
2174581,242.508,250.161,1188,10220,0.967883,0,2,135779,134591,1188
2199401,204.648,147.716,2317,5840,0.984027,0,2,139883,137566,2317
2199401,275.067,129.251,3085,1460,0.942274,0,2,140651,137566,3085
2206701,267.684,431.595,753,15989,0.89824,0,2,140867,140114,753
2208161,285.223,444.77,624,15989,0.85971,0,2,141275,140651,624
2216921,272.07,417.299,579,15989,0.833496,0,2,141455,140876,579
2218381,293.062,393.262,794,15989,0.813059,0,2,141895,141101,794
2219841,281.929,372.229,773,15899,0.805177,0,2,142099,141326,773
2221301,276.688,353.825,788,15782,0.795779,0,2,142339,141551,788
2222761,276.602,337.722,839,15705,0.795057,0,2,142615,141776,839
2224221,275.027,323.632,878,15705,0.801925,0,2,142879,142001,878
2225681,272.148,311.303,905,15705,0.817934,0,2,143131,142226,905
2227141,268.13,300.515,920,15705,0.834442,0,2,143371,142451,920
2228601,264.614,291.076,935,15705,0.848887,0,2,143611,142676,935
2230061,264.537,282.816,974,15705,0.866526,0,2,143875,142901,974
2247581,228.268,76.2096,2949,10220,0.988262,0,2,148415,145466,2949
2260721,248.075,163.92,2811,1460,0.992298,0,2,151259,148448,2811
2278241,239.32,341.535,1391,5840,0.986543,0,2,152639,151248,1391
2284081,284.872,383.958,1075,17945,0.975985,0,2,153763,152688,1075
2285541,298.763,384.838,1080,18042,0.942737,0,2,154159,153079,1080
2287001,288.418,366.734,1056,18042,0.911145,0,2,154375,153319,1056
2289921,270.866,350.892,964,18030,0.883502,0,2,154523,153559,964
2291381,283.008,367.03,852,17860,0.844314,0,2,154891,154039,852
2292841,274.632,351.152,828,17543,0.800025,0,2,155107,154279,828
2295761,267.803,337.258,808,17227,0.758772,0,2,155327,154519,808
2297221,284.827,355.1,732,16923,0.722675,0,2,155731,154999,732
2298681,276.224,340.713,708,16534,0.681091,0,2,155947,155239,708
2300141,270.196,328.124,696,16156,0.644704,0,2,156175,155479,696
2301601,264.921,317.108,684,15816,0.610366,0,2,156403,155719,684
2303061,261.806,307.47,684,15499,0.580321,0,2,156643,155959,684
2304521,256.08,299.036,660,16959,0.554031,0,2,156859,156199,660
2305981,251.07,291.657,636,17860,0.528527,0,2,157075,156439,636
2307441,249.687,285.199,636,17580,0.503711,0,2,157315,156679,636
2310361,242.976,273.55,640,17337,0.491997,0,2,157511,156871,640
2311821,263.104,287.356,660,18171,0.479247,0,2,157915,157255,660
2314741,250.216,275.436,628,17996,0.470591,0,2,158075,157447,628
2317661,266.939,286.632,647,17794,0.473018,0,2,158459,157812,647
2320581,280.071,294.053,673,17646,0.48264,0,2,158831,158158,673
2322041,294.063,300.546,719,17566,0.51606,0,2,159223,158504,719
2324961,283.305,284.603,754,17566,0.550303,0,2,159431,158677,754
2336641,229.111,112.758,2137,8760,0.900745,0,2,162371,160234,2137
2355621,239.287,144.201,2544,11680,0.982857,0,2,166123,163579,2544
2374601,226.045,403.217,1120,11680,0.991056,0,2,167407,166287,1120
2374601,228.415,352.815,1365,13140,0.987174,0,2,167652,166287,1365
2383361,230.554,212.63,1734,5840,0.992394,0,2,169867,168133,1734
2383361,218.235,186.051,1866,5840,0.982095,0,2,169999,168133,1866
2383361,211.956,162.795,2034,4380,0.960583,0,2,170167,168133,2034
2386281,249.961,359.195,816,4380,0.93176,0,2,170683,169867,816
2393581,236.716,339.421,759,18356,0.91154,0,2,170827,170068,759
2395041,250.127,322.118,902,19769,0.891347,0,2,171171,170269,902
2396501,266.861,333.603,872,19566,0.876179,0,2,171555,170683,872
2397961,259.003,317.028,875,19334,0.865407,0,2,171759,170884,875
2400881,251.128,302.524,870,19131,0.863481,0,2,171955,171085,870
2402341,274.737,314.959,908,18943,0.876796,0,2,172395,171487,908
2424241,217.454,176.216,1908,10220,0.988472,0,2,177175,175267,1908
2424241,220.273,154.189,2148,10220,0.983663,0,2,177415,175267,2148
2444681,246.612,320.484,1128,13140,0.984989,0,2,180135,179007,1128
2460741,261.151,400.922,1109,5840,0.984045,0,2,182899,181790,1109
2460741,258.507,350.806,1349,5840,0.957289,0,2,183139,181790,1349
2462201,279.693,391.706,1099,5840,0.913878,0,2,183567,182468,1099
2465121,285.732,396.617,996,5840,0.863393,0,2,183895,182899,996
2468041,284.515,403.54,820,18798,0.814219,0,2,184171,183351,820
2470961,304.451,421.098,720,18398,0.756192,0,2,184615,183895,720
2472421,318.394,424.96,684,17882,0.697918,0,1,185031,184347,684
2475341,303.095,400.09,654,17378,0.646928,0,1,185227,184573,654
2476801,315.708,406.579,606,16888,0.607312,0,2,185631,185025,606
2478261,304.745,384.007,608,16371,0.580148,0,2,185859,185251,608
2479721,295.152,364.256,610,15932,0.558879,0,2,186087,185477,610
2481181,291.258,346.974,648,17392,0.55027,0,2,186351,185703,648
2482641,286.35,331.852,674,18194,0.545236,0,2,186603,185929,674
2484101,282.057,318.621,700,18000,0.553331,0,2,186855,186155,700
2485561,272.3,301.293,724,17871,0.572915,0,2,187059,186335,724
2487021,266.762,286.131,772,17794,0.590051,0,2,187287,186515,772
2489941,256.417,272.865,776,17794,0.617544,0,2,187471,186695,776
2491401,279.365,283.757,856,18238,0.664101,0,2,187911,187055,856
2501621,229.25,102.497,2434,11680,0.922344,0,2,190651,188217,2434
2501621,230.593,89.685,2674,13140,0.910801,0,2,190891,188217,2674
2516221,232.466,347.235,984,11680,0.949968,0,2,192331,191347,984
2536661,225.515,73.9409,3708,5840,0.993224,0,2,197827,194119,3708
2536661,227.326,64.6982,3948,5840,0.957821,0,2,198067,194119,3948
2536661,227.41,56.611,4176,5840,0.920593,0,2,198295,194119,4176
2536661,282.984,49.5346,4848,17086,0.851769,0,2,198967,194119,4848
2536661,265.611,43.3428,4992,17086,0.781548,0,1,199111,194119,4992
2536661,247.41,37.9249,5112,17086,0.717605,0,1,199231,194119,5112
2536661,235.983,33.1843,5268,17086,0.651654,0,1,199387,194119,5268
2536661,227.485,29.0363,5436,17086,0.588947,0,1,199555,194119,5436
2536661,218.55,25.4067,5592,17086,0.526579,0,1,199711,194119,5592
2536661,212.231,22.2309,5760,1460,0.477006,0,1,199879,194119,5760
2536661,211.202,19.452,5964,5840,0.436131,0,1,200083,194119,5964
2568781,195.302,734.771,306,7300,0.390364,0,1,200167,199861,306
2568781,199.389,642.924,534,8760,0.350319,0,1,200395,199861,534
2571701,222.466,616.559,486,8760,0.322779,0,1,200779,200293,486
2573161,245.157,593.489,458,11680,0.303682,0,1,201183,200725,458
2574621,247.513,546.303,506,13140,0.281971,0,1,201447,200941,506
2576081,245.074,505.015,518,14600,0.270475,0,1,201675,201157,518
2577541,242.939,468.888,530,14855,0.262916,0,1,201903,201373,530
2579001,241.072,437.277,542,14517,0.261301,0,1,202131,201589,542
2580461,240.938,409.617,566,15977,0.259888,0,1,202371,201805,566
2581921,236.321,385.415,554,16964,0.276152,0,2,202575,202021,554
2584841,240.281,364.238,606,16775,0.297883,0,2,202843,202237,606
2587761,258.246,361.709,646,15850,0.326898,0,2,203227,202581,646
2589221,276.465,359.495,706,16782,0.379786,0,2,203631,202925,706
2592141,270.907,338.183,749,16782,0.438563,0,2,203863,203114,749
2606741,238.381,312.441,936,10220,0.904671,0,2,207271,206335,936
2606741,249.919,140.222,2532,13862,0.953467,0,2,208867,206335,2532
2606741,244.613,12.6754,6972,5840,0.992044,0,2,213307,206335,6972
2606741,242.537,11.091,7200,5840,0.988038,0,2,213535,206335,7200
2606741,242.22,9.70458,7440,14740,0.965783,0,2,213775,206335,7440
2650541,222.442,842.492,852,16200,0.938811,0,2,213859,213007,852
2650541,226.137,737.18,1104,16238,0.895209,0,2,214111,213007,1104
2650541,224.87,645.033,1320,16238,0.847058,0,2,214327,213007,1320
2650541,211.761,564.403,1440,16238,0.797426,0,2,214447,213007,1440
2653461,218.291,607.853,792,16238,0.751498,0,2,214711,213919,792
2656381,237.505,588.871,708,19018,0.70881,0,2,215083,214375,708
2659301,249.817,566.512,634,18761,0.666459,0,2,215419,214785,634
2660761,264.589,541.198,638,18416,0.639402,0,2,215787,215149,638
2663681,256.016,496.299,652,18121,0.620726,0,2,215983,215331,652
2666601,275.014,479.761,696,17891,0.624386,0,2,216391,215695,696
2668061,291.137,465.291,736,17750,0.640087,0,2,216795,216059,736
2669521,281.745,429.88,770,17698,0.661327,0,2,217011,216241,770
2672441,274.027,398.895,808,17698,0.684911,0,2,217231,216423,808
2682661,224.251,124.489,2280,7300,0.926969,0,2,220159,217879,2280
2692881,226.219,318.927,840,8760,0.928598,0,2,220399,219559,840
2720621,284.803,778.484,915,16866,0.985112,0,2,228229,227314,915
2732301,273.202,709.673,879,16866,0.963223,0,2,228421,227542,879
2735221,285.552,649.464,1023,18326,0.926571,0,2,228793,227770,1023
2738141,294.858,625.281,927,19786,0.879499,0,2,229153,228226,927
2741061,294.001,598.371,805,19786,0.833312,0,2,229441,228636,805
2743981,296.251,569.075,753,19696,0.795398,0,2,229753,229000,753
2746901,298.219,543.44,701,19427,0.762223,0,2,230065,229364,701
2748361,308.442,521.01,717,19107,0.735695,0,2,230445,229728,717
2749821,295.387,478.634,739,20567,0.719983,0,2,230649,229910,739
2752741,281.463,441.555,741,21499,0.711235,0,2,230833,230092,741
2755661,286.78,431.86,701,21307,0.706081,0,2,231157,230456,701
2758581,289.933,414.128,723,21051,0.716571,0,2,231469,230746,723
2761501,300.191,398.612,805,20874,0.74075,0,2,231841,231036,805
2771721,243.522,123.872,2513,10220,0.944032,0,2,234709,232196,2513
2790701,227.399,166.836,2448,18980,0.994111,0,2,239221,236773,2448
2809681,209.654,127.78,2667,21900,0.995342,0,2,242137,239470,2667
2809681,213.447,111.807,2907,23360,0.982174,0,2,242377,239470,2907
2809681,216.766,97.8313,3147,24820,0.966902,0,2,242617,239470,3147
2812601,213.671,402.477,804,25520,0.93979,0,2,242809,242005,804
2831581,213.962,368.293,891,25520,0.896066,0,2,243025,242134,891
2831581,208.217,322.256,1059,25520,0.855308,0,2,243193,242134,1059
2833041,188.19,314.224,849,25520,0.819644,0,2,243241,242392,849
2835961,175.166,291.071,804,25520,0.785939,0,2,243325,242521,804
2838881,168.27,270.812,795,25520,0.746446,0,2,243445,242650,795
2841801,171.236,269.211,729,25249,0.69939,0,2,243637,242908,729
2844721,178.332,267.809,699,24841,0.653217,0,2,243865,243166,699
2847641,177.04,266.583,609,24389,0.607815,0,1,244033,243424,609
2850561,180.41,265.51,555,23732,0.578088,0,2,244237,243682,555
2853481,187.859,264.572,537,23008,0.557077,0,2,244477,243940,537
2856401,201.877,263.75,579,22329,0.556192,0,2,244777,244198,579
2859321,218.642,263.031,657,21853,0.580418,0,2,245113,244456,657
2862241,227.312,262.402,687,21650,0.624116,0,2,245401,244714,687
2871001,267.375,248.235,1064,21559,0.777164,0,2,246681,245617,1064
2872461,223.67,91.6279,2487,11680,0.914681,0,2,248233,245746,2487
2898741,220.951,392.013,1020,11680,0.986083,0,2,252829,251809,1020
2927941,212.249,380.099,1104,5840,0.980622,0,2,255877,254773,1104
2927941,218.753,291.013,1584,5840,0.958914,0,2,256357,254773,1584
2927941,237.909,254.637,1956,5840,0.9028,0,2,256729,254773,1956
2927941,275.671,222.807,2496,18767,0.8237,0,1,257269,254773,2496
2927941,251.712,194.956,2580,20227,0.756987,0,1,257353,254773,2580
2927941,233.748,170.587,2688,21687,0.691114,0,1,257461,254773,2688
2927941,216.529,149.263,2784,23147,0.630975,0,1,257557,254773,2784
2927941,199.963,130.605,2868,1460,0.580853,0,1,257641,254773,2868
2927941,192.968,114.28,3012,5840,0.536996,0,1,257785,254773,3012
2927941,182.347,99.9948,3120,7300,0.492372,0,1,257893,254773,3120
2948381,173.053,444.37,373,8760,0.457075,0,1,258001,257628,373
2948381,166.422,388.824,493,10220,0.421191,0,1,258121,257628,493
2948381,159.119,340.221,601,10220,0.392292,0,1,258229,257628,601
2951301,175.229,347.193,493,10220,0.372005,0,1,258517,258024,493
2954221,181.825,335.294,469,13140,0.354255,0,1,258745,258276,469
2957141,190.597,324.882,469,16060,0.336223,0,1,258997,258528,469
2960061,201.273,315.772,493,18980,0.325445,0,1,259273,258780,493
2962981,212.114,307.801,529,21574,0.321014,0,1,259561,259032,529
2965901,218.599,300.826,541,21088,0.329638,0,2,259825,259284,541
2968821,227.274,294.722,577,20694,0.344683,0,2,260113,259536,577
2971741,231.865,289.382,589,23382,0.362848,0,2,260377,259788,589
2974661,240.382,284.709,637,23220,0.393742,0,2,260677,260040,637
2977581,237.334,277.371,627,23220,0.428274,0,2,260893,260266,627
2980501,236.167,267.699,655,23173,0.46349,0,2,261121,260466,655
2983421,235.147,259.237,683,23173,0.499303,0,2,261349,260666,683
2986341,237.253,251.832,735,23173,0.543141,0,2,261601,260866,735
2989261,237.597,245.353,775,23173,0.586498,0,2,261841,261066,775
2992181,234.897,239.684,791,23173,0.631936,0,2,262057,261266,791
3009701,213.934,55.6865,4134,13140,0.994822,0,2,269413,265279,4134
3009701,217.193,48.7257,4374,14600,0.979219,0,2,269653,265279,4374
3009701,247.095,21.8679,6030,5840,0.970674,0,2,271309,265279,6030
3009701,246.208,19.1344,6270,24820,0.949339,0,2,271549,265279,6270
3009701,245.432,16.7426,6510,26280,0.936922,0,2,271789,265279,6510
3041821,259.753,776.275,777,27740,0.918557,0,2,272149,271372,777
3046201,240.784,690.74,793,29200,0.912487,0,2,272257,271464,793
3047661,219.686,615.898,773,30660,0.897176,0,2,272329,271556,773
3062261,196.725,550.411,717,32023,0.881279,0,2,272365,271648,717
3065181,185.635,493.109,733,32023,0.874869,0,2,272473,271740,733
3068101,172.93,442.971,725,32023,0.869261,0,2,272557,271832,725
3071021,176.814,399.099,837,32023,0.869353,0,2,272761,271924,837
3073941,172.712,372.212,797,32023,0.869434,0,2,272905,272108,797
3076861,173.623,348.685,793,31960,0.874505,0,2,273085,272292,793
3079781,178.92,328.1,825,31833,0.888942,0,2,273301,272476,825
3110441,221.494,73.5999,3624,11680,0.989702,0,2,280417,276793,3624
3110441,220.807,64.3999,3840,13140,0.989739,0,2,280633,276793,3840
3110441,242.824,33.0313,5196,20440,0.992237,0,2,281989,276793,5196
3116281,204.28,684.596,1095,13140,0.980702,0,2,283261,282166,1095
3116281,208.745,599.022,1335,5840,0.951864,0,2,283501,282166,1335
3116281,212.652,524.144,1575,5840,0.951631,0,2,283741,282166,1575
3116281,207.07,458.626,1743,5840,0.953927,0,2,283909,282166,1743
3125041,376.186,722.548,733,21900,0.925936,0,2,285469,284736,733
3146941,333.663,644.729,669,23360,0.898944,0,2,285505,284836,669
3149861,308.455,576.638,701,24820,0.884076,0,2,285637,284936,701
3160081,277.398,517.058,661,26280,0.874817,0,2,285697,285036,661
3163001,271.224,464.926,789,27740,0.864215,0,2,285925,285136,789
3165921,259.821,431.81,769,30660,0.857438,0,2,286105,285336,769
3168841,255.843,402.834,797,31244,0.856508,0,2,286333,285536,797
3171761,247.863,377.48,789,30952,0.855695,0,2,286525,285736,789
3174681,240.88,355.295,781,30689,0.859983,0,2,286717,285936,781
3177601,234.77,335.883,773,30426,0.866235,0,2,286909,286136,773
3180521,236.924,318.898,825,30163,0.881705,0,2,287161,286336,825
3198041,218.533,98.512,2465,1460,0.977902,0,2,289981,287516,2465
3226501,453.856,470.275,1064,5840,0.989092,0,2,294891,293827,1064
3227961,342.231,217.469,2468,10220,0.992605,0,2,296395,293927,2468
3238181,306.577,319.994,1292,5840,0.976681,0,2,298075,296783,1292
3238181,298.255,279.995,1532,5840,0.963346,0,2,298315,296783,1532
3241101,469.473,570.621,595,1460,0.924178,0,2,299983,299388,595
3245481,488.789,573.668,624,13140,0.924905,0,2,300607,299983,624
3261541,290.784,361.442,948,1460,0.979875,0,2,303583,302635,948
3276141,225.125,127.085,2332,10220,0.993953,0,2,306535,304203,2332
3276141,214.319,7.69596,6940,11680,0.997134,0,2,311143,304203,6940
3276141,218.858,5.15569,7624,5840,0.99183,0,2,311827,304203,7624
3276141,203.501,4.51123,7720,5840,0.986601,0,2,311923,304203,7720
3276141,199.063,3.94733,7888,5840,0.972026,0,2,312091,304203,7888
3322861,355.066,273.368,3810,7300,0.994436,0,2,320335,316525,3810
3322861,340.683,239.197,4050,8760,0.992632,0,2,320575,316525,4050
3322861,216.058,4.35509,10264,19831,0.982366,0,2,326789,316525,10264
3322861,210.051,3.81071,10432,19831,0.97207,0,2,326957,316525,10432
3322861,206.295,3.33437,10612,19831,0.961811,0,2,327137,316525,10612
3322861,201.508,2.91757,10780,19831,0.957835,0,2,327305,316525,10780
3322861,191.319,2.55288,10900,5840,0.949356,0,2,327425,316525,10900
3322861,188.404,2.23377,11068,5840,0.934436,0,2,327593,316525,11068
3322861,190.354,1.95455,11272,5840,0.923882,0,2,327797,316525,11272
3322861,195.06,1.71023,11500,5840,0.914646,0,2,328025,316525,11500
3400241,264.163,339.8,2363,7300,0.975588,0,2,333269,330906,2363
3410461,247.694,224.936,2376,13140,0.987913,0,2,334913,332537,2376
3422141,237.503,370.778,1289,11680,0.985826,0,2,336293,335004,1289
3441121,222.011,322.699,1193,13140,0.995002,0,2,339149,337956,1193
3441121,224.484,126.722,2765,5840,0.996787,0,2,340721,337956,2765
3441121,226.424,110.882,3005,7300,0.993439,0,2,340961,337956,3005
3441121,225.121,97.0218,3221,5840,0.986759,0,2,341177,337956,3221
3455721,222.481,390.894,977,17520,0.974664,0,2,341381,340404,977
3455721,203.671,342.032,1049,18980,0.954081,0,2,341453,340404,1049
3455721,202.212,299.278,1241,18980,0.933571,0,2,341645,340404,1241
3455721,202.435,261.869,1445,18980,0.908125,0,2,341849,340404,1445
3458641,216.131,332.635,929,18980,0.880859,0,2,342161,341232,929
3461561,237.114,345.056,881,18952,0.857002,0,2,342545,341664,881
3463021,259.475,355.924,865,18695,0.839876,0,2,342961,342096,865
3464481,254.041,338.433,865,19824,0.827392,0,2,343177,342312,865
3465941,247.786,323.129,853,19587,0.820218,0,2,343381,342528,853
3467401,242.312,309.738,841,19349,0.821441,0,2,343585,342744,841
3468861,242.023,298.021,865,20809,0.825011,0,2,343825,342960,865
3470321,240.27,287.768,877,21898,0.828134,0,2,344053,343176,877
3471781,235.737,276.297,885,21780,0.843367,0,2,344257,343372,885
3476161,224.111,257.477,869,21661,0.876328,0,2,344633,343764,869
3487841,240.051,119.103,2360,10220,0.962782,0,2,347537,345177,2360
3487841,240.045,104.215,2600,11680,0.966184,0,2,347777,345177,2600
3522881,228.147,324.017,1046,13140,0.992325,0,2,352181,351135,1046
3534561,240.609,404.699,1070,5840,0.982204,0,2,355193,354123,1070
3534561,240.533,354.111,1310,5840,0.946929,0,2,355433,354123,1310
3534561,240.466,309.847,1550,5840,0.904813,0,2,355673,354123,1550
3534561,249.408,271.116,1862,5840,0.852961,0,2,355985,354123,1862
3534561,285.732,237.227,2402,20440,0.797591,0,2,356525,354123,2402
3534561,268.015,207.574,2546,21380,0.749142,0,2,356669,354123,2546
3534561,252.513,181.627,2690,1460,0.706749,0,2,356813,354123,2690
3534561,246.449,158.923,2894,5840,0.674656,0,2,357017,354123,2894
3550621,236.643,460.558,490,7300,0.651574,0,2,357185,356695,490
3550621,229.563,402.988,670,8760,0.633877,0,2,357365,356695,670
3552081,248.367,397.615,690,8760,0.625892,0,2,357745,357055,690
3555001,243.321,370.413,718,10220,0.626406,0,2,357953,357235,718
3556461,261.906,369.111,750,13140,0.641855,0,2,358345,357595,750
3557921,254.668,345.472,774,14600,0.670373,0,2,358549,357775,774
3560841,248.834,324.788,802,16060,0.705327,0,2,358757,357955,802
3571061,234.189,140.407,2098,8760,0.929669,0,2,361493,359395,2098
3571061,236.416,122.857,2350,8760,0.91471,0,2,361745,359395,2350
3571061,230.589,21.6522,5422,17753,0.977468,0,2,364817,359395,5422
3598801,228.927,753.628,1057,10220,0.989902,0,2,366413,365356,1057
3598801,210.29,132.819,3889,13140,0.98947,0,2,369245,365356,3889
3598801,214.003,116.217,4129,5840,0.959536,0,2,369485,365356,4129
3598801,217.253,101.69,4369,5840,0.907094,0,2,369725,365356,4369
3598801,215.596,88.9786,4573,5840,0.852458,0,2,369929,365356,4573
3598801,197.647,77.8563,4645,5840,0.80715,0,2,370001,365356,4645
3630921,372.441,799.124,393,18980,0.752507,0,2,371597,371204,393
3633841,364.886,717.734,557,20440,0.702193,0,2,371909,371352,557
3636761,359.775,665.017,585,23360,0.670669,0,2,372233,371648,585
3639681,352.303,618.89,589,22629,0.645585,0,2,372533,371944,589
3642601,353.265,578.529,653,21919,0.643637,0,2,372893,372240,653
3644061,353.607,543.213,713,21445,0.661933,0,2,373249,372536,713
3646981,327.906,493.811,713,22905,0.685441,0,2,373397,372684,713
3661581,234.954,343.572,900,10220,0.932062,0,2,376517,375617,900
3661581,235.585,300.626,1140,10220,0.935554,0,2,376757,375617,1140
3689321,226.173,157.404,2228,8760,0.988653,0,2,381125,378897,2228
3689321,229.552,31.704,4952,5840,0.990214,0,2,383849,378897,4952
3689321,232.358,27.741,5204,5840,0.960188,0,2,384101,378897,5204
3689321,237.814,24.2733,5480,5840,0.921414,0,2,384377,378897,5480
3714141,379.087,820.114,457,16060,0.852487,0,2,385745,385288,457
3719981,349.701,735.6,457,17520,0.797177,0,2,385889,385432,457
3722901,338.988,661.65,577,18980,0.750029,0,2,386153,385576,577
3725821,335.615,614.944,601,21900,0.712526,0,2,386465,385864,601
3728741,334.163,574.076,637,22406,0.69221,0,2,386789,386152,637
3731661,331.393,538.316,661,21878,0.686934,0,2,387101,386440,661
3734581,333.469,507.027,721,21493,0.693567,0,2,387449,386728,721
3737501,332.285,479.648,757,21290,0.715621,0,2,387773,387016,757
3747721,352.046,400.341,1113,21209,0.828302,0,2,389281,388168,1113
3749181,282.226,246.731,1693,24129,0.898104,0,2,390005,388312,1693
3749181,254.937,144.629,2550,14600,0.93777,0,2,390862,388312,2550
3749181,218.403,49.6959,4122,13140,0.971117,0,2,392434,388312,4122
3749181,213.143,1.54358,9917,5840,0.990353,0,2,398229,388312,9917
3809041,446.148,693.429,2185,5840,0.994185,0,2,404518,402333,2185
3819261,396.332,738.032,996,7300,0.994298,0,2,404986,403990,996
3847661,227.77,186.219,1868,8760,0.977345,0,2,411985,410117,1868
3850581,227.799,329.442,764,10220,0.931427,0,2,412213,411449,764
3859341,226.324,299.761,888,10220,0.876249,0,2,412429,411541,888
3859341,222.034,262.291,1080,10220,0.827967,0,2,412621,411541,1080
3859341,207.779,229.505,1188,11680,0.780721,0,2,412729,411541,1188
3859341,198.307,200.817,1320,13140,0.731881,0,2,412861,411541,1320
3859341,184.019,175.715,1404,13140,0.696646,0,2,412945,411541,1404
3859341,164.016,153.75,1428,14600,0.665815,0,2,412969,411541,1428
3859341,163.014,134.532,1584,16060,0.641339,0,2,413125,411541,1584
3859341,163.638,117.715,1752,5840,0.614921,0,2,413293,411541,1752
3871021,168.683,288.251,474,5840,0.593056,0,2,413497,413023,474
3873941,191.097,274.344,645,5840,0.575174,0,2,413845,413200,645
3876861,204.71,277.051,649,20461,0.572027,0,2,414145,413496,649
3879781,227.122,286.045,684,23381,0.584274,0,2,414529,413845,684
3882701,239.231,287.289,712,23083,0.61249,0,2,414853,414141,712
3884161,258.327,288.378,808,22609,0.659678,0,2,415245,414437,808
3898761,224.982,179.191,2473,18980,0.976929,0,2,420997,418524,2473
3929421,211.566,241.177,2053,5840,0.992931,0,2,426089,424036,2053
3929421,206.12,211.03,2221,5840,0.972565,0,2,426257,424036,2221
3949861,313.855,534.651,489,24820,0.922244,0,2,427325,426836,489
3952781,291.123,483.82,493,26280,0.880714,0,2,427457,426964,493
3955701,275.733,439.342,533,27488,0.854374,0,2,427625,427092,533
3967381,259.266,400.424,549,27488,0.836328,0,2,427769,427220,549
3970301,264.358,366.371,721,27488,0.835537,0,2,428069,427348,721
3973221,265.813,352.575,741,26781,0.847345,0,2,428345,427604,741
4038921,223.989,487.343,1254,5840,0.983499,0,2,439601,438347,1254
4040381,243.49,492.8,1103,5840,0.949311,0,2,439981,438878,1103
4043301,245.054,478.075,984,5840,0.914397,0,2,440237,439253,984
4044761,249.922,456.316,964,19755,0.878848,0,2,440521,439557,964
4046221,260.682,452.276,876,21215,0.852742,0,2,440857,439981,876
4049141,246.597,427.742,768,22675,0.827399,0,2,441005,440237,768
4052061,256.272,412.274,788,23032,0.817724,0,2,441329,440541,788
4054981,260.238,398.74,772,22706,0.816759,0,2,441617,440845,772
4090021,234.001,184.719,1744,11680,0.979308,0,2,447689,445945,1744
4091481,233.982,167.693,2286,16060,0.990832,0,2,450557,448271,2286
4110461,212.748,174.586,2274,5840,0.98914,0,2,452969,450695,2274
4126521,312.155,476.763,690,1460,0.929247,0,2,453977,453287,690
4129441,358.635,503.418,684,18980,0.884341,0,2,454661,453977,684
4132361,358.806,483.24,702,20897,0.855049,0,2,455021,454319,702
4135281,364.955,465.585,768,20421,0.834418,0,2,455429,454661,768
4136741,365.336,450.262,793,20150,0.836365,0,2,455797,455004,793
4139661,344.169,415.479,817,19963,0.83807,0,2,455993,455176,817
4142581,352.148,406.545,881,19844,0.852061,0,2,456401,455520,881
4155721,252.431,151.678,2185,7300,0.966453,0,2,459425,457240,2185
4165941,250.877,324.843,888,7300,0.958146,0,2,459665,458777,888
4165941,261.718,166.615,2268,10220,0.972283,0,2,461045,458777,2268
4182001,233.886,297.571,964,11680,0.986616,0,2,462557,461593,964
4189301,275.636,285.967,1174,16361,0.991885,0,2,464221,463047,1174
4199521,250.329,331.548,996,8760,0.994313,0,2,465797,464801,996
4199521,263.164,194.347,2124,4380,0.994167,0,2,466925,464801,2124
4199521,260.268,170.054,2364,4380,0.954896,0,2,467165,464801,2364
4208281,257.735,381.297,744,17821,0.939284,0,2,467405,466661,744
4211201,287.018,366.635,972,21320,0.933123,0,2,467897,466925,972
4214121,293.141,372.931,891,18918,0.927733,0,2,468233,467342,891
4215581,303.998,370.564,917,18753,0.933016,0,2,468613,467696,917
4238941,229.984,199.639,1584,11680,0.984702,0,2,472877,471293,1584
4238941,231.236,174.684,1824,11680,0.982864,0,2,473117,471293,1824
4238941,232.332,152.849,2064,1460,0.983756,0,2,473357,471293,2064
4250621,207.709,251.16,947,10220,0.99146,0,2,474497,473550,947
4263761,247.371,187.364,1848,10220,0.99453,0,2,477569,475721,1848
4273981,234.246,195.901,1592,5840,0.995352,0,2,479141,477549,1592
4279821,252.926,147.673,2256,10220,0.992914,0,2,480737,478481,2256
4279821,249.81,129.214,2484,1460,0.9888,0,2,480965,478481,2484
4301721,180.254,220.996,948,16060,0.996172,0,2,482609,481661,948
4304641,195.222,222.371,1016,18980,0.9929,0,2,482909,481893,1016
4307561,203.82,231.825,982,21900,0.990038,0,2,483173,482191,982
4323621,208.141,74.3936,2710,16060,0.997406,0,2,486437,483727,2710
4339681,191.754,327.879,1072,14600,0.994109,0,2,487889,486817,1072
4339681,197.785,286.894,1312,16060,0.991095,0,2,488129,486817,1312
4349901,207.791,43.9283,4500,14600,0.993565,0,2,493889,489389,4500
4349901,199.673,17.2505,5916,23360,0.996223,0,2,495305,489389,5916
4365961,209.214,699.094,720,24820,0.984195,0,2,495581,494861,720
4399541,210.062,623.332,843,26280,0.981171,0,2,495797,494954,843
4399541,206.305,545.416,1023,27740,0.972274,0,2,495977,494954,1023
4399541,185.016,477.239,1059,27740,0.96449,0,2,496013,494954,1059
4402461,173.889,447.709,914,27740,0.962679,0,2,496109,495195,914
4422901,227.347,93.6769,2914,7300,0.989964,0,2,499301,496387,2914
4422901,204.928,81.9673,2962,8760,0.989969,0,2,499349,496387,2962
4450641,219.978,317.774,1061,11680,0.99548,0,2,502085,501024,1061
4450641,225.303,42.8785,4349,14600,0.99564,0,2,505373,501024,4349
4456481,244.278,612.744,1185,10220,0.988043,0,2,506957,505772,1185
4456481,258.29,274.996,2805,5840,0.990884,0,2,508577,505772,2805
4497361,192.389,151.556,2050,10220,0.99502,0,2,511361,509311,2050
4548461,219.362,231.261,1584,8760,0.996214,0,2,519233,517649,1584
4552841,274.496,410.436,825,7300,0.990281,0,2,520673,519848,825
4555761,226.614,181.172,1868,17520,0.987433,0,2,522065,520197,1868
4555761,194.005,62.2523,3272,11680,0.981932,0,2,523469,520197,3272
4555761,202.755,54.4708,3536,13140,0.972941,0,2,523733,520197,3536
4571821,507.821,1382.32,763,1460,0.99291,0,2,532005,531242,763
4624381,362.716,501.742,2048,17520,0.996618,0,2,534933,532885,2048
4624381,347.376,439.024,2288,18252,0.993291,0,2,535173,532885,2288
4687161,242.024,256.546,1133,17520,0.976225,0,2,545349,544216,1133
4688621,241.771,249.853,1170,18980,0.959197,0,2,545589,544419,1170
4688621,216.55,218.621,1210,19444,0.948048,0,2,545629,544419,1210
4688621,217.981,191.294,1438,19444,0.948292,0,2,545857,544419,1438
4688621,213.233,167.382,1618,19444,0.943505,0,2,546037,544419,1618
4688621,207.579,146.459,1786,5840,0.939317,0,2,546205,544419,1786
4688621,207.132,128.152,1990,5840,0.945652,0,2,546409,544419,1990
4707601,224.013,143.337,1972,7300,0.987803,0,2,549193,547221,1972
4722201,231.158,121.549,2522,10220,0.988119,0,2,552601,550079,2522
4748481,248.112,292.798,1128,18980,0.996357,0,2,555609,554481,1128
4749941,229.669,126.088,2398,11680,0.992319,0,2,557077,554679,2398
4768921,186.89,341.155,924,13140,0.994484,0,2,558241,557317,924
4787901,142.046,206.714,960,5840,0.984618,0,2,561193,560233,960
4787901,154.29,180.875,1200,5840,0.979041,0,2,561433,560233,1200
4812721,161.806,75.3357,2733,5840,0.991162,0,2,570187,567454,2733
4812721,170.08,65.9187,2961,7300,0.988517,0,2,570415,567454,2961
4862361,174.833,57.304,2788,5840,0.986462,0,2,573481,570693,2788
4898861,152.612,217.665,988,18060,0.980769,0,2,577601,576613,988
4914001,160.536,216.457,996,19520,0.966923,0,2,577817,576821,996
4922761,245.86,26.8259,5897,7300,0.992576,0,2,586253,580356,5897
4922761,243.628,23.4727,6125,8760,0.964754,0,2,586481,580356,6125
4922761,243.174,20.5386,6365,10220,0.94791,0,2,586721,580356,6365
4922761,238.277,17.9713,6569,11680,0.950671,0,2,586925,580356,6569
4922761,229.956,3.61972,9317,19594,0.981314,0,2,589673,580356,9317
4922761,255.223,1.62451,10961,19594,0.986614,0,2,591317,580356,10961
4985541,255.039,988.206,1154,19808,0.992243,0,2,592981,591827,1154
5003061,253.885,443.997,1160,10220,0.988804,0,2,596149,594989,1160
5004521,235.213,186.473,2460,10220,0.993103,0,2,597665,595205,2460
5039561,227.108,126.642,2197,8760,0.99847,0,2,603377,601180,2197
5049781,225.719,302.937,876,1460,0.996161,0,2,603593,602717,876
5055621,212.879,209.402,1347,11680,0.984743,0,2,605009,603662,1347
5073141,238.761,266.995,1173,16060,0.994811,0,2,608149,606976,1173
5093581,216.031,371.313,932,5840,0.987225,0,2,612573,611641,932
5095041,216.027,347.399,968,5840,0.987572,0,2,612789,611821,968
5102341,216.024,333.974,944,5840,0.987875,0,2,613005,612061,944
5105261,204.021,314.727,884,5840,0.988141,0,2,613125,612241,884
5115481,218.331,121.595,2256,7300,0.995111,0,2,615981,613725,2256
5162201,221.863,45.8054,3998,11680,0.994986,0,2,625941,621943,3998
5162201,222.63,40.0797,4226,11680,0.991863,0,2,626169,621943,4226
5208921,254.548,169.193,2290,1460,0.997279,0,2,633321,631031,2290
5232281,251.583,131.474,2444,7300,0.992219,0,2,637833,635389,2444
5255641,238.577,283.147,1092,17520,0.997183,0,2,640721,639629,1092
5257101,234.255,275.503,1074,18881,0.991285,0,2,640925,639851,1074
5258561,234.973,270.19,1081,18881,0.991124,0,2,641165,640084,1081
5284841,220.862,273.039,1445,11680,0.991698,0,2,645381,643936,1445
5302361,267.876,289.079,1104,26713,0.984339,0,2,648581,647477,1104
5303821,264.392,271.444,1196,26713,0.985047,0,2,648821,647625,1196
5319881,208.525,265.841,1097,11680,0.986732,0,2,651609,650512,1097
5346161,180.479,291.763,974,16060,0.997184,0,2,654441,653467,974
5346161,187.919,255.293,1214,17520,0.990036,0,2,654681,653467,1214
5346161,181.986,130.942,2102,8760,0.987389,0,2,655569,653467,2102
5346161,175.737,114.574,2234,8760,0.986466,0,2,655701,653467,2234
5346161,179.27,100.252,2438,1460,0.981907,0,2,655905,653467,2438
5379741,326.884,355.003,1156,26529,0.989614,0,2,660585,659429,1156
5381201,245.228,129.443,2568,8760,0.992681,0,2,662149,659581,2568
5395801,223.337,105.421,2760,5840,0.992621,0,2,665149,662389,2760
5395801,225.42,92.2432,3000,7300,0.991044,0,2,665389,662389,3000
5395801,222.493,47.3123,4092,13140,0.991656,0,2,666481,662389,4092
5395801,238.995,21.2336,5616,5840,0.986255,0,2,668005,662389,5616
5395801,239.121,18.5794,5856,7300,0.984223,0,2,668245,662389,5856
5432301,235.88,436.178,1080,5840,0.99042,0,2,669609,668529,1080
5439601,304.178,441.641,1052,5840,0.991082,0,2,670869,669817,1052
5441061,296.156,410.311,1101,21838,0.985947,0,2,671109,670008,1101
5454201,270.407,216.47,1882,1460,0.993803,0,2,673897,672015,1882
5498001,281.512,350.356,1131,13140,0.996137,0,2,681437,680306,1131
5499461,244.017,170.509,2164,8760,0.985766,0,2,682677,680513,2164
5499461,243.515,149.196,2404,8760,0.961296,0,2,682917,680513,2404
5499461,241.575,130.546,2632,18980,0.952384,0,2,683145,680513,2632
5508221,253.769,406.45,768,19689,0.962294,0,2,683733,682965,768
5528661,278.33,301.85,1119,23936,0.986163,0,2,686273,685154,1119
5581221,199.821,236.043,1206,14600,0.997461,0,2,695505,694299,1206
5581221,201.843,206.538,1422,14600,0.990278,0,2,695721,694299,1422
5598741,185.275,95.1028,2588,1460,0.988077,0,2,699873,697285,2588
5610421,170.038,189.856,1264,14600,0.995165,0,2,701385,700121,1264
5610421,178.783,166.124,1504,14600,0.98577,0,2,701625,700121,1504
5610421,278.349,15.0168,5860,7300,0.991214,0,2,705981,700121,5860
5610421,273.555,13.1397,6100,8760,0.989812,0,2,706221,700121,6100
5610421,198.08,1.77299,8944,5840,0.993625,0,2,709065,700121,8944
5610421,203.32,1.55137,9184,5840,0.980672,0,2,709305,700121,9184
5706781,212.346,294.213,1003,11680,0.977231,0,2,717873,716870,1003
5706781,215.803,257.437,1243,13140,0.970077,0,2,718113,716870,1243
5727221,203.767,119.462,2340,8760,0.994179,0,2,722325,719985,2340
5738901,208.296,302.529,996,1460,0.986157,0,2,722565,721569,996
5738901,210.759,264.713,1224,5840,0.981637,0,2,722793,721569,1224
5753501,204.166,92.8169,2371,14600,0.996853,0,2,726153,723782,2371
5775401,199.129,311.617,1056,14600,0.992669,0,2,727689,726633,1056
5775401,181.82,107.074,2463,1460,0.986231,0,2,729096,726633,2463
5822961,386.597,648.588,714,1460,0.983464,0,2,735294,734580,714
5825881,519.968,489.322,2404,10220,0.982579,0,2,740076,737672,2404
5837561,247.812,151.658,2530,1460,0.989813,0,2,743040,740510,2530
5837561,246.835,132.701,2770,5840,0.988587,0,2,743280,740510,2770
5863841,160.503,281.787,996,20440,0.994873,0,2,744600,743604,996
5884281,218.505,120.124,2686,5840,0.994689,0,2,748968,746282,2686
5884281,221.192,105.109,2926,7300,0.979103,0,2,749208,746282,2926
5884281,222.043,91.9699,3154,8760,0.970465,0,2,749436,746282,3154
5884281,212.288,80.4737,3298,10220,0.960407,0,2,749580,746282,3298
5890121,188.752,368.914,934,11680,0.951606,0,2,749604,748670,934
5891581,168.158,333.3,874,13140,0.948906,0,2,749628,748754,874
5903261,154.638,302.138,850,14600,0.941542,0,2,749688,748838,850
5903261,147.308,264.37,946,16060,0.9326,0,2,749784,748838,946
5906181,136.395,252.324,838,16060,0.922275,0,2,749844,749006,838
5907641,141.845,246.034,816,17520,0.91074,0,2,750024,749208,816
5910561,148.115,243.779,780,18980,0.898148,0,2,750216,749436,780
5913481,155.1,231.307,840,20440,0.882129,0,2,750420,749580,840
5916401,155.213,223.394,828,23360,0.875613,0,2,750576,749748,828
5919321,156.811,216.469,828,26280,0.874911,0,2,750744,749916,828
5922241,152.21,210.411,780,29200,0.884298,0,2,750864,750084,780
5925161,155.684,205.109,792,32120,0.89251,0,2,751044,750252,792
5928081,160.223,200.471,816,35040,0.899697,0,2,751236,750420,816
5948521,175.474,50.7081,2640,13140,0.984638,0,2,754320,751680,2640
5952901,190.328,103.753,2669,1460,0.989177,0,2,757284,754615,2669
5990861,183.13,235.36,1317,14600,0.991746,0,2,758892,757575,1317
5990861,219.14,41.4798,4149,11680,0.996045,0,2,761724,757575,4149
5990861,245.655,24.3147,5289,5840,0.967682,0,2,762864,757575,5289
5998161,352.948,754.025,531,24820,0.907972,0,2,763968,763437,531
6011301,329.83,683.272,511,23157,0.848225,0,2,764136,763625,511
6021521,312.601,621.363,515,23157,0.793447,0,2,764328,763813,515
6024441,315.526,567.193,663,23157,0.758016,0,2,764664,764001,663
6027361,312.085,533.794,651,22551,0.734514,0,2,764952,764301,651
6028821,313.075,504.569,671,21992,0.71895,0,2,765272,764601,671
6031741,298.44,460.248,717,21542,0.715331,0,2,765468,764751,717
6034661,303.135,440.217,753,21246,0.724665,0,2,765804,765051,753
6037581,305.743,422.69,777,21060,0.750332,0,2,766128,765351,777
6049261,259.718,153.624,2355,11680,0.935029,0,2,769044,766689,2355
6059481,281.754,382.639,1089,8760,0.957926,0,2,770556,769467,1089
6082841,207.443,295.734,1021,13140,0.989323,0,2,773532,772511,1021
6090141,180.135,275.904,1186,5840,0.983739,0,2,776532,775346,1186
6090141,190.618,241.416,1450,5840,0.959522,0,2,776796,775346,1450
6101821,378.291,531.364,581,17520,0.910832,0,2,778488,777907,581
6103281,344.505,478.818,578,18980,0.873228,0,2,778596,778018,578
6110581,314.942,432.841,575,20440,0.840324,0,2,778704,778129,575
6113501,287.574,392.611,560,21900,0.819034,0,2,778800,778240,560
6116421,283.127,357.41,701,23360,0.810405,0,2,779052,778351,701
6119341,277.736,340.483,719,26280,0.807854,0,2,779292,778573,719
6122261,271.519,325.673,725,28555,0.810622,0,2,779520,778795,725
6125181,267.579,312.714,743,28081,0.828044,0,2,779760,779017,743
6128101,270.132,301.375,809,27713,0.845789,0,2,780048,779239,809
6155841,208.82,312.757,1078,14600,0.98646,0,2,785916,784838,1078
6174821,209.365,97.7856,3180,29200,0.993269,0,2,790992,787812,3180
6186501,237.194,426.812,882,30660,0.964111,0,2,791424,790542,882
6187961,216.545,381.461,890,32120,0.932347,0,2,791496,790606,890
6189421,190.977,341.778,838,33580,0.909554,0,2,791508,790670,838
6190881,179.105,307.056,870,35040,0.887109,0,2,791604,790734,870
6209861,162.717,276.674,854,36500,0.862471,0,2,791652,790798,854
6212781,146.877,250.09,826,37960,0.840912,0,2,791688,790862,826
6214241,131.517,226.829,786,39420,0.824548,0,2,791712,790926,786
6217161,124.078,206.475,794,40880,0.812729,0,2,791784,790990,794
6220081,119.068,188.666,814,42340,0.797388,0,2,791868,791054,814
6223001,114.685,181.082,770,45260,0.783965,0,2,791952,791182,770
6225921,112.349,174.447,738,46737,0.772219,0,2,792048,791310,738
6228841,114.805,168.641,742,45881,0.761942,0,2,792180,791438,742
6231761,113.955,163.561,722,45624,0.757949,0,2,792288,791566,722
6234681,116.21,159.116,726,44849,0.754455,0,2,792420,791694,726
6237601,113.684,155.226,694,44210,0.751398,0,2,792516,791822,694
6240521,117.474,151.823,710,43434,0.753724,0,2,792660,791950,710
6243441,120.789,148.845,726,42887,0.753258,0,2,792804,792078,726
6246361,120.691,146.24,718,42476,0.770351,0,2,792924,792206,718
6249281,122.104,143.96,722,42066,0.782807,0,2,793056,792334,722
6252201,124.841,141.965,738,41746,0.806206,0,2,793200,792462,738
6271181,136.532,35.1163,2410,15360,0.974979,0,2,795768,793358,2410
6271181,147.966,30.7268,2638,1460,0.969357,0,2,795996,793358,2638
6271181,159.47,26.886,2878,5840,0.970687,0,2,796236,793358,2878
6287241,158.45,220.286,996,17520,0.986187,0,2,797604,796608,996
6308441,403.33,288.577,2482,10220,0.99182,0,2,803622,801140,2482
6315741,406.911,384.922,1680,5840,0.96077,0,2,804822,803142,1680
6318661,440.047,546.807,672,5840,0.924424,0,2,805494,804822,672
6318661,466.041,478.456,1320,1460,0.897621,0,2,806142,804822,1320
6318661,425.786,418.649,1464,5840,0.884168,0,2,806286,804822,1464
6320121,381.563,475.443,663,7300,0.869897,0,2,806358,805695,663
6382901,243.101,305.452,1188,11680,0.995773,0,2,816422,815234,1188
6382901,217.713,267.271,1228,13140,0.995051,0,2,816462,815234,1228
6382901,213.917,119.95,2500,5840,0.981529,0,2,817734,815234,2500
6382901,215.677,104.956,2728,16060,0.930088,0,2,817962,815234,2728
6382901,217.217,91.8366,2956,17520,0.887577,0,2,818190,815234,2956
6385821,242.565,421.357,648,18980,0.82038,0,2,818610,817962,648
6387281,224.245,388.687,584,20440,0.764082,0,2,818706,818122,584
6397501,208.214,360.101,520,21900,0.707322,0,2,818802,818282,520
6401881,201.687,335.089,516,23360,0.657657,0,2,818958,818442,516
6404801,203.476,313.203,572,23761,0.6167,0,2,819174,818602,572
6407721,218.542,314.052,576,22757,0.575862,0,1,819498,818922,576
6410641,228.724,314.796,556,21881,0.545129,0,2,819798,819242,556
6413561,240.634,315.446,560,21060,0.520738,0,2,820122,819562,560
6416481,251.054,316.016,564,20366,0.494396,0,2,820446,819882,564
6419401,260.173,316.514,568,19764,0.473846,0,2,820770,820202,568
6422321,266.651,316.949,560,19235,0.450866,0,1,821082,820522,560
6425241,275.32,317.331,576,21680,0.445757,0,2,821418,820842,576
6428161,278.405,317.664,556,21297,0.441288,0,2,821718,821162,556
6431081,282.604,309.956,612,20914,0.452377,0,2,822030,821418,612
6434001,280.279,303.212,620,20713,0.46958,0,2,822294,821674,620
6436921,284.244,297.31,676,20549,0.499632,0,2,822606,821930,676
6439841,283.213,292.147,696,20549,0.538428,0,2,822882,822186,696
6441301,290.812,287.628,784,20549,0.584875,0,2,823226,822442,784
6452981,223.492,84.8176,2668,13140,0.915588,0,2,826134,823466,2668
6452981,225.555,74.2154,2908,14600,0.91739,0,2,826374,823466,2908
6455901,217.659,65.5229,4146,11680,0.982497,0,2,830778,826632,4146
6455901,226.744,15.0828,6750,5840,0.984721,0,2,833382,826632,6750
6455901,226.901,13.1975,6978,20439,0.945381,0,2,833610,826632,6978
6490941,272.039,857.548,798,21899,0.923458,0,2,834198,833400,798
6492401,250.034,766.854,762,23359,0.896776,0,2,834294,833532,762
6508461,229.279,687.498,714,24377,0.875929,0,2,834378,833664,714
6511381,215.62,618.06,702,24377,0.852688,0,2,834498,833796,702
6520141,202.167,557.303,678,24377,0.837352,0,2,834606,833928,678
6523061,211.396,504.14,822,24377,0.833933,0,2,834882,834060,822
6525981,210.472,474.122,762,24288,0.825941,0,2,835086,834324,762
6528901,224.663,447.857,822,24045,0.831449,0,2,835410,834588,822
6531821,231.08,424.875,834,26899,0.848768,0,2,835686,834852,834
6582921,197.807,275.915,1308,14600,0.997669,0,2,843018,841710,1308
6606281,175.607,221.073,1512,5840,0.997316,0,2,846198,844686,1512
6612121,324.502,464.976,705,1460,0.964452,0,2,847926,847221,705
6617961,367.939,494.979,672,27740,0.960145,0,2,848598,847926,672
6619421,342.947,446.607,732,29200,0.963877,0,2,848766,848034,732
6634021,252.633,119.31,2688,13140,0.986474,0,2,851478,848790,2688
6664681,216.374,108.27,2483,11680,0.991564,0,2,855798,853315,2483
6664681,219.327,94.7363,2723,11680,0.981368,0,2,856038,853315,2723
6685121,222.239,174.03,2034,20440,0.983747,0,2,858750,856716,2034
6685121,224.459,152.276,2274,21900,0.978279,0,2,858990,856716,2274
6685121,197.135,68.3409,3354,10220,0.987752,0,2,860070,856716,3354
6693881,197.993,376.798,1022,11680,0.968033,0,2,860274,859252,1022
6696801,198.744,353.948,1032,13140,0.939529,0,2,860478,859446,1032
6696801,196.401,309.705,1212,14600,0.900838,0,2,860658,859446,1212
6696801,177.851,270.992,1260,16060,0.869483,0,2,860706,859446,1260
6696801,175.119,237.118,1416,17520,0.832048,0,2,860862,859446,1416
6696801,160.729,207.478,1476,17520,0.804292,0,2,860922,859446,1476
6696801,157.138,181.543,1608,18980,0.777505,0,2,861054,859446,1608
6696801,146.496,158.85,1680,20440,0.751567,0,2,861126,859446,1680
6696801,141.684,138.994,1788,21900,0.733871,0,2,861234,859446,1788
6696801,141.973,121.62,1932,23360,0.713387,0,2,861378,859446,1932
6696801,136.227,106.417,2028,24820,0.697964,0,2,861474,859446,2028
6696801,138.698,93.1152,2184,26280,0.676968,0,2,861630,859446,2184
6696801,136.361,81.4758,2304,27740,0.663597,0,2,861750,859446,2304
6696801,135.816,71.2913,2436,28874,0.651898,0,2,861882,859446,2436
6696801,139.839,62.3799,2604,28874,0.64416,0,2,862050,859446,2604
6696801,132.859,54.5824,2688,1460,0.64739,0,2,862134,859446,2688
6696801,132.752,47.7596,2820,5840,0.647717,0,2,862266,859446,2820
6696801,129.658,41.7897,2928,7300,0.658002,0,2,862374,859446,2928
6696801,134.451,36.566,3096,8760,0.664502,0,2,862542,859446,3096
6696801,125.144,31.9952,3156,10220,0.682689,0,2,862602,859446,3156
6733301,115.501,356.246,578,11680,0.698603,0,2,862650,862072,578
6733301,123.564,311.715,758,13140,0.717528,0,2,862830,862072,758
6733301,129.118,272.751,926,13140,0.736587,0,2,862998,862072,926
6733301,126.478,238.657,1034,13140,0.755763,0,2,863106,862072,1034
6733301,131.669,208.825,1202,13140,0.782543,0,2,863274,862072,1202
6765421,196.874,188.821,1272,14600,0.99034,0,2,869202,867930,1272
6772721,192.267,316.556,1332,14600,0.99726,0,2,871890,870558,1332
6772721,222.816,142.069,2808,1460,0.99377,0,2,873366,870558,2808
6772721,225.676,95.1749,3504,8760,0.994577,0,2,874062,870558,3504
6791701,213.966,419.278,948,10220,0.979005,0,2,874194,873246,948
6794621,200.72,390.118,870,5840,0.952879,0,2,874302,873432,870
6796081,208.63,364.604,948,5840,0.915019,0,2,874566,873618,948
6797541,205.052,342.278,942,5840,0.866892,0,2,874746,873804,942
6812141,188.42,322.743,828,5840,0.82228,0,2,874818,873990,828
6817981,179.868,305.65,762,5840,0.778245,0,2,874938,874176,762
6820901,202.384,316.194,732,5840,0.737215,0,2,875298,874566,732
6823821,217.586,323.17,684,20899,0.711313,0,2,875622,874938,684
6826741,236.888,329.024,686,20280,0.696149,0,2,875994,875308,686
6828201,257.777,333.896,722,19741,0.70038,0,2,876398,875676,722
6829661,255.555,315.159,778,21201,0.719083,0,2,876638,875860,778
6831121,249.11,298.764,798,22026,0.745447,0,2,876842,876044,798
6832581,244.972,284.418,830,21867,0.776016,0,2,877058,876228,830
6844261,224.307,92.6308,2544,8760,0.949275,0,2,879985,877441,2544
6857401,237.91,318.469,1189,11680,0.974735,0,2,881497,880308,1189
6879301,213.96,276.801,1440,13140,0.987354,0,2,884437,882997,1440
6880761,215.018,150.437,2220,10220,0.990034,0,2,885961,883741,2220
6889521,225.048,409.14,927,10220,0.984277,0,2,887401,886474,927
6889521,234.417,357.998,1227,5840,0.983743,0,2,887701,886474,1227
6889521,227.615,313.248,1407,5840,0.963275,0,2,887881,886474,1407
6889521,226.163,274.092,1623,5840,0.929115,0,2,888097,886474,1623
6892441,346.393,555.33,287,17520,0.812976,0,1,889285,888998,287
6904121,316.594,503.914,251,18980,0.722604,0,1,889393,889142,251
6907041,315.394,458.925,414,20440,0.641029,0,1,889700,889286,414
6909961,314.97,437.559,438,23360,0.58465,0,1,890012,889574,438
6912881,317.599,418.864,486,22446,0.545319,0,1,890348,889862,486
6915801,318.399,402.506,522,21534,0.530904,0,2,890672,890150,522
6918721,322.099,388.193,582,20824,0.540791,0,2,891020,890438,582
6920181,329.337,375.669,674,23277,0.581942,0,2,891400,890726,674
6934781,218.43,294.734,1020,11680,0.931781,0,2,894416,893396,1020
6958141,237.99,439.302,1070,10220,0.992232,0,2,900116,899046,1070
6958141,234.791,197.157,2462,16997,0.981514,0,2,901508,899046,2462
6958141,235.442,172.512,2702,5840,0.977575,0,2,901748,899046,2702
6958141,236.51,132.08,3182,18809,0.979081,0,2,902228,899046,3182
6975661,269.947,471.07,842,18809,0.972946,0,2,902732,901890,842
6990261,255.703,434.686,818,18809,0.970077,0,2,902888,902070,818
7035521,230.934,181.696,1884,11680,0.992023,0,2,909860,907976,1884
7044281,226.538,193.945,1694,8760,0.98767,0,2,911204,909510,1694
7044281,228.221,169.702,1934,8760,0.986711,0,2,911444,909510,1934
7069101,242.344,288.521,1195,5840,0.993573,0,2,914488,913293,1195
7074941,257.596,290.801,1092,19961,0.989983,0,2,915580,914488,1092
7077861,248.396,282.951,1048,19961,0.983735,0,2,915764,914716,1048
7080781,265.347,293.832,1062,16772,0.974518,0,2,916148,915086,1062
7083701,271.178,303.353,1004,16772,0.971453,0,2,916460,915456,1004
7108521,249.743,177.811,2076,10220,0.992021,0,2,921476,919400,2076
7108521,248.525,155.584,2316,11680,0.991769,0,2,921716,919400,2316
7120201,238.066,137.986,2368,17520,0.997092,0,2,924560,922192,2368
7146481,261.002,319.828,1104,18370,0.996831,0,2,927340,926236,1104
7147941,258.376,304.849,1144,19164,0.989727,0,2,927580,926436,1144
7149401,239.94,130.933,2508,8760,0.989716,0,2,929144,926636,2508
7166921,193.959,122.15,2015,10220,0.997362,0,2,932000,929985,2015
7166921,199.714,106.881,2255,10220,0.986442,0,2,932240,929985,2255
7201961,222.614,116.099,2662,20440,0.989579,0,2,938012,935350,2662
7215101,275.111,353.898,1052,24820,0.988019,0,2,939236,938184,1052
7215101,270.722,309.661,1292,26280,0.978266,0,2,939476,938184,1292
7215101,216.354,93.102,2936,5840,0.988466,0,2,941120,938184,2936
7220941,219.31,377.464,808,7300,0.988657,0,2,941360,940552,808
7258901,152.263,255.751,924,17520,0.99079,0,2,945572,944648,924
7264741,163.23,248.782,964,18980,0.984441,0,2,945812,944848,964
7264741,187.174,97.6959,2380,1460,0.99264,0,2,947228,944848,2380
7295401,204.897,95.3248,2700,5840,0.994866,0,2,953300,950600,2700
7323141,209.281,164.641,2016,17520,0.984689,0,2,957596,955580,2016
7323141,214.621,144.061,2268,1460,0.979103,0,2,957848,955580,2268
7343581,300.262,201.441,2469,5840,0.983717,0,2,960476,958007,2469
7365481,267.316,320.148,1368,11680,0.99213,0,2,964736,963368,1368
7365481,263.901,280.13,1608,11680,0.986864,0,2,964976,963368,1608
7369861,277.757,439.056,769,8760,0.989512,0,2,966500,965731,769
7422421,245.724,136.707,2614,1460,0.983675,0,2,973880,971266,2614
7422421,242.008,119.618,2830,23360,0.976966,0,2,974096,971266,2830
7472061,187.686,87.3085,2585,14600,0.988469,0,2,981074,978489,2585
7476441,193.665,358.231,900,11680,0.993575,0,2,982267,981367,900
7512941,178.182,94.8364,2490,1460,0.9973,0,2,986940,984450,2490
7539221,171.425,75.9083,2642,27740,0.997256,0,2,989964,987322,2642
7566961,187.91,87.9257,2457,1460,0.98713,0,2,992916,990459,2457
7590321,206.987,116.662,2326,14600,0.983263,0,2,995952,993626,2326
7612221,254.569,31.046,5286,17520,0.99488,0,2,1003668,998382,5286
7664781,196.428,164.124,2047,11680,0.989646,0,2,1007868,1005821,2047
7664781,201.875,143.608,2287,13140,0.98094,0,2,1008108,1005821,2287
7680841,180.694,106.508,2467,1460,0.9965,0,2,1010952,1008485,2467
7702741,244.48,39.8661,4521,16060,0.988538,0,2,1015548,1011027,4521
7715881,195.176,572.111,1044,5840,0.982804,0,2,1017164,1016120,1044
7715881,199.279,500.597,1272,5840,0.972453,0,2,1017392,1016120,1272
7715881,199.869,438.023,1476,5840,0.968397,0,2,1017596,1016120,1476
7715881,197.385,383.27,1656,5840,0.971097,0,2,1017776,1016120,1656
7746541,224.512,168.29,2580,20440,0.989597,0,2,1021124,1018544,2580
7746541,238.448,147.253,2916,1460,0.975897,0,2,1021460,1018544,2916
7746541,225.142,128.847,3048,5840,0.97141,0,2,1021592,1018544,3048
7746541,219.499,112.741,3228,7300,0.973734,0,2,1021772,1018544,3228
7809321,220.285,160.233,2613,1460,0.99614,0,2,1030472,1027859,2613
7809321,221.25,140.204,2841,5840,0.994122,0,2,1030700,1027859,2841
7829761,233.528,331.075,1029,23360,0.986112,0,2,1032125,1031096,1029
7831221,232.837,306.316,1124,21914,0.985348,0,2,1032353,1031229,1124
7831221,207.232,268.026,1152,21914,0.98468,0,2,1032381,1031229,1152
7844361,195.158,121.498,2220,8760,0.995137,0,2,1034878,1032658,2220
7844361,199.263,106.311,2448,1460,0.989495,0,2,1035106,1032658,2448
7861881,187.719,173.241,1490,13140,0.995592,0,2,1036738,1035248,1490
7895461,250.458,407.502,1208,16060,0.993594,0,2,1042194,1040986,1208
7895461,218.848,160.024,2544,8760,0.978734,0,2,1043530,1040986,2544
7898381,221.492,353.021,1080,1460,0.973892,0,2,1043770,1042690,1080
7915901,218.649,127.44,2356,10220,0.991649,0,2,1046614,1044258,2356
7915901,236.884,22.46,5428,18980,0.996028,0,2,1049686,1044258,5428
7965541,203.562,98.7952,2858,5840,0.997417,0,2,1055585,1052727,2858
8002041,193.114,96.9918,2778,5840,0.991209,0,2,1061592,1058814,2778
8002041,198.975,84.8679,3018,7300,0.991058,0,2,1061832,1058814,3018
8032701,183.412,228.211,1035,18980,0.990677,0,2,1063164,1062129,1035
8042921,159.863,187.418,1476,23360,0.997006,0,2,1066536,1065060,1476
8047301,158.811,158.674,1634,43800,0.998397,0,2,1069128,1067494,1634
8047301,168.96,138.84,1874,45260,0.991097,0,2,1069368,1067494,1874
8047301,156.769,41.7432,3206,13140,0.996073,0,2,1070700,1067494,3206
8060441,167.173,329.025,1106,14600,0.992814,0,2,1070940,1069834,1106
8060441,196.106,57.9875,3590,10220,0.994983,0,2,1073424,1069834,3590
8060441,190.196,7.82447,6614,13140,0.993073,0,2,1076448,1069834,6614
8060441,193.421,6.84641,6830,14600,0.985189,0,2,1076664,1069834,6830
8060441,227.269,0.808336,10190,28990,0.993251,0,2,1080024,1069834,10190
8060441,219.422,0.31743,11690,5840,0.99485,0,2,1081524,1069834,11690
8188921,204.215,255.27,2496,10220,0.990642,0,2,1084772,1082276,2496
8188921,207.188,223.361,2724,1460,0.989312,0,2,1085000,1082276,2724
8210821,156.516,70.8606,2702,5840,0.99301,0,2,1088108,1085406,2702
8237101,188.053,76.6926,2604,13140,0.993028,0,2,1091288,1088684,2604
8241481,228.256,138.594,2640,1460,0.994846,0,2,1094168,1091528,2640
8277981,200.808,136.918,2056,17520,0.983141,0,2,1097024,1094968,2056
8277981,205.707,119.803,2296,16060,0.983999,0,2,1097264,1094968,2296
8277981,186.348,47.0462,3436,11680,0.967466,0,2,1098404,1094968,3436
8291121,190.054,360.29,1099,13140,0.935283,0,2,1098620,1097521,1099
8291121,190.297,315.254,1291,14600,0.919623,0,2,1098812,1097521,1291
8291121,186.01,275.847,1447,16060,0.90592,0,2,1098968,1097521,1447
8291121,186.759,241.366,1639,17520,0.90143,0,2,1099160,1097521,1639
8291121,184.414,211.196,1807,18980,0.895001,0,2,1099328,1097521,1807
8291121,168.862,184.796,1867,20440,0.884376,0,2,1099388,1097521,1867
8291121,156.754,161.697,1939,21900,0.880079,0,2,1099460,1097521,1939
8291121,146.16,141.485,2011,23360,0.878819,0,2,1099532,1097521,2011
8291121,136.89,123.799,2083,24820,0.875217,0,2,1099604,1097521,2083
8291121,127.279,108.324,2143,26280,0.874565,0,2,1099664,1097521,2143
8291121,124.869,94.7836,2251,27740,0.881494,0,2,1099772,1097521,2251
8291121,127.26,82.9357,2395,29200,0.892557,0,2,1099916,1097521,2395
8291121,130.853,72.5687,2551,1460,0.899738,0,2,1100072,1097521,2551
8337841,225.993,499.946,1380,5840,0.998123,0,2,1106564,1105184,1380
8368501,181.506,96.6774,2676,27740,0.99358,0,2,1111220,1108544,2676
8397701,207.189,5.38134,6176,8760,0.982469,0,2,1117832,1111656,6176
8397701,211.291,4.70867,6416,10220,0.973411,0,2,1118072,1111656,6416
8466321,320.862,425.399,2661,1460,0.99589,0,2,1125612,1122951,2661
8486761,256.007,437.791,885,13140,0.992136,0,2,1127136,1126251,885
8498441,220.79,125.314,2373,1460,0.995037,0,2,1130328,1127955,2373
8514501,228.044,96.4058,3197,10220,0.991735,0,2,1133496,1130299,3197
8578741,216.347,152.898,2617,5840,0.987496,0,2,1146756,1144139,2617
8578741,219.304,133.785,2857,5840,0.977809,0,2,1146996,1144139,2857
8578741,208.437,18.0522,5845,10220,0.987006,0,2,1149984,1144139,5845
8578741,210.883,15.7957,6073,11680,0.98613,0,2,1150212,1144139,6073
8578741,213.84,0.220189,12916,24820,0.998557,0,2,1157055,1144139,12916
8697601,268.297,183.258,2334,7300,0.99873,0,2,1176956,1174622,2334
8712201,239.002,271.505,1201,11680,0.998314,0,2,1178732,1177531,1201
8725341,228.757,214.326,1845,5840,0.988453,0,2,1181648,1179803,1845
8748701,256.386,633.555,1131,10220,0.996137,0,2,1185800,1184669,1131
8763301,252.062,331.53,1103,18444,0.992972,0,2,1188892,1187789,1103
8773521,249.066,275.943,1139,16646,0.99474,0,2,1190608,1189469,1139
8782281,269.15,288.904,1075,20792,0.982302,0,2,1192048,1190973,1075
8792501,257.026,261.736,1121,22193,0.990807,0,2,1193500,1192379,1121
8793961,251.898,253.769,1139,22193,0.981956,0,2,1193716,1192577,1139
8820241,241.248,300.282,1112,18980,0.997501,0,2,1198012,1196900,1112
8821701,220.17,112.408,2524,1460,0.992891,0,2,1199612,1197088,2524
8837761,216.203,111.211,2864,8760,0.996247,0,2,1202384,1199520,2864
8852361,234.973,301.937,1108,14600,0.992066,0,2,1203856,1202748,1108
8853821,235.601,289.695,1144,16060,0.981808,0,2,1204096,1202952,1144
8853821,211.151,253.483,1184,17520,0.979082,0,2,1204136,1202952,1184
8875721,209.183,143.369,2068,13140,0.994983,0,2,1208312,1206244,2068
8884481,225.754,200.798,1649,10220,0.990249,0,2,1209721,1208072,1649
8888861,261.593,182.949,2155,14600,0.995818,0,2,1212397,1210242,2155
8888861,261.019,160.08,2412,1460,0.993841,0,2,1212654,1210242,2412
8909301,233.633,300.839,1086,13140,0.987236,0,2,1213950,1212864,1086
8916601,316.284,320.287,1303,20440,0.993738,0,2,1216566,1215263,1303
8916601,250.224,33.0884,5340,8760,0.998103,0,2,1220603,1215263,5340
8916601,272.326,7.61666,8393,23360,0.994563,0,2,1223656,1215263,8393
8916601,280.583,2.00376,11258,14600,0.99482,0,2,1226521,1215263,11258
8916601,286.063,0.786868,13286,24105,0.996716,0,2,1228549,1215263,13286
9004201,473.134,1549.56,831,10220,0.99849,0,2,1236687,1235856,831
9048001,275.406,278.715,1380,18560,0.998703,0,2,1244353,1242973,1380
9048001,283.983,213.391,2004,18560,0.997757,0,2,1244977,1242973,2004
9062601,333.434,397.415,1246,11680,0.995479,0,2,1247762,1246516,1246
9087421,318.978,593.926,1181,10220,0.995976,0,2,1254102,1252921,1181
9088881,260.474,248.211,2458,8760,0.99592,0,2,1255646,1253188,2458
9104941,278.242,363.747,994,10220,0.997348,0,2,1257902,1256908,994
9113701,291.893,323.097,1070,15757,0.99631,0,2,1259718,1258648,1070
9139981,256.457,120.722,2558,8760,0.9961,0,2,1266194,1263636,2558
9176481,249.502,242.769,1500,10220,0.996092,0,2,1272142,1270642,1500
9215901,241.297,149.733,1944,8760,0.996144,0,2,1279450,1277506,1944
9239261,238.871,257.047,1131,18980,0.994405,0,2,1282566,1281435,1131
9240721,217.905,111.937,2319,7300,0.987803,0,2,1283950,1281631,2319
9250941,220.667,306.82,888,1460,0.988078,0,2,1284190,1283302,888
9258241,200.753,236.096,1151,13140,0.985318,0,2,1285510,1284359,1151
9258241,205.659,206.584,1391,13140,0.985903,0,2,1285750,1284359,1391
9284521,269.226,269.444,1128,24694,0.991848,0,2,1290006,1288878,1128
9285981,264.072,254.514,1206,24694,0.985367,0,2,1290234,1289028,1206
9285981,236.063,222.7,1246,24694,0.985946,0,2,1290274,1289028,1246
9285981,215.556,87.4532,2677,1460,0.991981,0,2,1291705,1289028,2677
9304961,223.331,134.026,2528,1460,0.994837,0,2,1294597,1292069,2528
9319561,211.9,228.995,1377,11680,0.996722,0,2,1296037,1294660,1377
9319561,233.131,102.772,2889,7300,0.987279,0,2,1297549,1294660,2889
9354601,227.623,122.637,2304,8760,0.985798,0,2,1303525,1301221,2304
9407161,210.498,114.763,2219,10220,0.984911,0,2,1312222,1310003,2219
9407161,214.186,100.418,2459,10220,0.984297,0,2,1312462,1310003,2459
9427601,206.979,262.255,982,13140,0.989604,0,2,1314082,1313100,982
9434901,230.093,252.246,1084,18980,0.992656,0,2,1315174,1314090,1084
9436361,254.831,270.215,1116,21014,0.982324,0,2,1315602,1314486,1116
9437821,251.477,261.188,1146,21014,0.983284,0,2,1315830,1314684,1146
9437821,223.543,228.54,1174,21014,0.984123,0,2,1315858,1314684,1174
9437821,221.587,174.976,1606,21014,0.984094,0,2,1316290,1314684,1606
9437821,217.653,133.966,2014,5840,0.984072,0,2,1316698,1314684,2014
9437821,215.946,117.22,2218,5840,0.982313,0,2,1316902,1314684,2218
9437821,212.953,102.567,2410,1460,0.983274,0,2,1317094,1314684,2410
9449501,187.834,290.497,816,5840,0.984115,0,2,1317106,1316290,816
9471401,245.758,249.551,1154,20073,0.996607,0,2,1321218,1320064,1154
9484541,239.061,78.1896,3492,10220,0.994732,0,2,1325470,1321978,3492
9484541,256.843,40.1041,4869,14600,0.986048,0,2,1326847,1321978,4869
9507901,234.866,495.221,1407,11680,0.993271,0,2,1328395,1326988,1407
9513741,277.404,458.477,1133,16060,0.983556,0,2,1329747,1328614,1133
9515201,271.229,428.918,1139,5840,0.973111,0,2,1329975,1328836,1139
9516661,267.325,403.053,1157,5840,0.968972,0,2,1330215,1329058,1157
9573601,230.72,240.451,1197,21900,0.99858,0,2,1339423,1338226,1197
9576521,217.035,299.549,1008,1460,0.996942,0,2,1340875,1339867,1008
9589661,199.658,218.047,1243,13140,0.986449,0,2,1342399,1341156,1243
9589661,204.701,190.791,1483,13140,0.986893,0,2,1342639,1341156,1483
9589661,198.724,146.074,1843,5840,0.988715,0,2,1342999,1341156,1843
9589661,188.884,127.815,1963,5840,0.986376,0,2,1343119,1341156,1963
9589661,184.773,111.838,2119,5840,0.986829,0,2,1343275,1341156,2119
9589661,187.177,97.8583,2323,5840,0.987225,0,2,1343479,1341156,2323
9626161,194.488,75.4691,2771,1460,0.994734,0,2,1349431,1346660,2771
9667041,211.593,249.875,1263,16060,0.989681,0,2,1353811,1352548,1263
9667041,191.763,85.8592,2727,5840,0.995204,0,2,1355275,1352548,2727
9667041,196.293,75.1268,2955,7300,0.984554,0,2,1355503,1352548,2955
9699161,195.619,298.004,768,5840,0.990904,0,2,1358803,1358035,768
9734201,249.26,321.937,1234,11680,0.998031,0,2,1363447,1362213,1234
9734201,217.846,144.484,2362,18980,0.995366,0,2,1364575,1362213,2362
9754641,207.857,315.632,1026,13140,0.994658,0,2,1366219,1365193,1026
9756101,216.975,163.966,2046,8760,0.986352,0,2,1367587,1365541,2046
9775081,211.1,128.4,2214,5840,0.995395,0,2,1370599,1368385,2214
9775081,211.713,112.35,2430,17520,0.987221,0,2,1370815,1368385,2430
9788221,265.042,320.62,1066,21900,0.991259,0,2,1372167,1371101,1066
9791141,225.321,22.6972,4988,16060,0.990721,0,2,1376443,1371455,4988
9843701,212.056,348.069,888,7300,0.997124,0,2,1381111,1380223,888
9851001,250.904,295.49,1144,14600,0.996209,0,2,1382835,1381691,1144
9851001,223.041,258.554,1172,16060,0.992933,0,2,1382863,1381691,1172
9851001,213.349,116.038,2396,8760,0.993078,0,2,1384087,1381691,2396
9851001,213.68,101.533,2612,1460,0.985194,0,2,1384303,1381691,2612
9868521,195.652,242.188,1468,11680,0.991686,0,2,1385575,1384107,1468
9872901,196.074,294.881,996,1460,0.99625,0,2,1387339,1386343,996
9897721,249.896,267.226,1168,5840,0.990387,0,2,1390155,1388987,1168
9907941,207.928,98.2091,2364,13140,0.991018,0,2,1393123,1390759,2364
9919621,210.437,283.933,1008,1460,0.96964,0,2,1393351,1392343,1008
9919621,211.132,248.441,1224,5840,0.964685,0,2,1393567,1392343,1224
9919621,208.741,217.386,1416,7300,0.96785,0,2,1393759,1392343,1416
9940061,207.717,106.118,2283,8760,0.994594,0,2,1397587,1395304,2283
9940061,208.752,92.8532,2499,10220,0.98527,0,2,1397803,1395304,2499
9966341,217.74,321.715,1290,11680,0.990512,0,2,1400827,1399537,1290
9985321,282.386,350.813,1163,25780,0.992504,0,2,1403727,1402564,1163
9988241,226.584,168.449,1955,10220,0.993306,0,2,1405043,1403088,1955
9988241,228.261,147.393,2195,11680,0.987893,0,2,1405283,1403088,2195
9997001,193.382,143.32,1896,16060,0.993996,0,2,1406507,1404611,1896
10018901,170.879,194.244,1595,14600,0.997541,0,2,1408463,1406868,1595
10035201,195.489,20.24,4410,16060,0.99247,0,2,1415037,1410627,4410
10039581,187.467,622.46,1099,13140,0.988986,0,2,1416657,1415558,1099
10096521,371.266,501.545,1176,23857,0.987754,0,2,1422521,1421345,1176
10096521,329.858,438.851,1216,23857,0.973035,0,2,1422561,1421345,1216
10096521,318.626,383.995,1456,23857,0.967656,0,2,1422801,1421345,1456
10096521,301.298,335.996,1636,23857,0.970449,0,2,1422981,1421345,1636
10096521,272.868,257.247,1996,7300,0.976125,0,2,1423341,1421345,1996
10099441,233.402,376.835,828,10220,0.982755,0,2,1423809,1422981,828
10128641,266.027,286.605,1120,23176,0.992963,0,2,1426577,1425457,1120
10147621,225.792,124.238,2863,7300,0.998324,0,2,1430949,1428086,2863
10163681,247.25,297.773,1189,14600,0.990498,0,2,1432529,1431340,1189
10165141,221.688,49.929,3831,11680,0.983535,0,2,1435353,1431522,3831
10165141,223.977,43.6879,4071,11680,0.975593,0,2,1435593,1431522,4071
10165141,234.98,38.2269,4383,11680,0.969894,0,2,1435905,1431522,4383
10197261,262.31,545.212,1110,21751,0.98682,0,2,1438745,1437635,1110
10208941,295.258,441.444,1086,21383,0.98449,0,2,1440305,1439219,1086
10252741,225.12,188.632,1812,11680,0.993639,0,2,1448709,1446897,1812
10252741,226.98,165.053,2052,13140,0.965684,0,2,1448949,1446897,2052
10252741,227.108,144.421,2280,1460,0.948724,0,2,1449177,1446897,2280
10252741,224.219,126.368,2484,5840,0.943883,0,2,1449381,1446897,2484
10260041,208.192,328.822,834,7300,0.942148,0,2,1449477,1448643,834
10260041,207.668,287.72,1038,8760,0.945629,0,2,1449681,1448643,1038
10260041,201.209,251.755,1194,10220,0.951176,0,2,1449837,1448643,1194
10260041,186.558,220.285,1278,11680,0.956029,0,2,1449921,1448643,1278
10274641,199.36,101.313,2232,10220,0.984751,0,2,1452633,1450401,2232
10286321,187.746,149.447,1824,13140,0.98726,0,2,1453989,1452165,1824
10328661,213.008,122.656,2512,10220,0.99867,0,2,1463195,1460683,2512
10346181,224.816,263.586,1206,11680,0.994318,0,2,1464359,1463153,1206
10346181,222.214,230.638,1410,11680,0.988778,0,2,1464563,1463153,1410
10346181,171.592,69.3431,2730,7300,0.991626,0,2,1465883,1463153,2730
10359321,177.143,304.425,996,8760,0.987673,0,2,1466099,1465103,996
10379761,214.829,238.237,1270,23360,0.984147,0,2,1470263,1468993,1270
10403121,218.076,262.149,1082,14600,0.990055,0,2,1473227,1472145,1082
10403121,224.051,102.945,2678,5840,0.983595,0,2,1474823,1472145,2678
10423561,203.686,274.753,960,16060,0.976863,0,2,1476371,1475411,960
10425021,228.725,261.409,1196,17520,0.978505,0,2,1476775,1475579,1196
10425021,186.634,175.124,1488,21900,0.98435,0,2,1477067,1475579,1488
10442541,229.231,7.42609,6516,11680,0.998583,0,2,1484075,1477559,6516
10442541,223.077,6.49783,6696,11680,0.99626,0,2,1484255,1477559,6696
10442541,227.892,0.671282,10932,8760,0.998364,0,2,1488491,1477559,10932
10442541,174.042,0.176598,12528,23360,0.99332,0,2,1490087,1477559,12528
10442541,176.286,0.154523,12720,24820,0.985405,0,2,1490279,1477559,12720
10442541,175.251,0.135208,12888,26280,0.983479,0,2,1490447,1477559,12888
10442541,216.144,0.00321534,18672,25486,0.998357,0,2,1496231,1477559,18672
10575561,828.388,2527.73,891,7300,0.988318,0,2,1503612,1502721,891
10577021,770.84,2252.27,935,10220,0.988528,0,2,1503980,1503045,935
10607681,360.305,581.231,1093,18643,0.994481,0,2,1508029,1506936,1093
10609141,343.767,536.202,1100,18643,0.993921,0,2,1508257,1507157,1100
10628121,280.736,312.096,1191,21881,0.987351,0,2,1511089,1509898,1191
10628121,249.144,273.084,1219,21881,0.980182,0,2,1511117,1509898,1219
10644181,219.787,256.223,1518,11680,0.994007,0,2,1513901,1512383,1518
10654401,251.558,296.269,1065,5840,0.98981,0,2,1515608,1514543,1065
10655861,248.614,286.236,1077,5840,0.979834,0,2,1515836,1514759,1077
10657321,244.537,277.456,1077,5840,0.971105,0,2,1516052,1514975,1077
10658781,263.47,294.899,1056,5840,0.968467,0,2,1516448,1515392,1056
10663161,248.532,277.907,1012,22325,0.974607,0,2,1516848,1515836,1012
10671921,308.856,325.84,1028,22002,0.970489,0,2,1518168,1517140,1028
10673381,317.749,328.36,1062,24334,0.960428,0,2,1518548,1517486,1062
10676301,295.03,308.94,1025,24334,0.959124,0,2,1518684,1517659,1025
10679221,291.152,313.573,943,24334,0.952984,0,2,1518948,1518005,943
10682141,292.258,314.626,921,24147,0.942611,0,2,1519248,1518327,921
10685061,294.725,312.548,935,25240,0.933534,0,2,1519560,1518625,935
10687981,295.385,310.729,937,25529,0.925593,0,2,1519860,1518923,937
10690901,291.462,309.138,903,25373,0.926144,0,2,1520124,1519221,903
10704041,244.113,13.484,6556,13140,0.994494,0,2,1527140,1520584,6556
10704041,256.424,6.91609,7924,20440,0.995926,0,2,1528508,1520584,7924
10739081,296.911,1256.94,739,5840,0.990178,0,2,1531364,1530625,739
10750761,289.797,1128.08,753,5840,0.962656,0,2,1531604,1530851,753
10759521,283.572,1015.32,767,5840,0.951074,0,2,1531844,1531077,767
10762441,284.126,916.652,829,5840,0.94094,0,2,1532132,1531303,829
10765361,274.11,830.321,807,5840,0.929572,0,2,1532336,1531529,807
10766821,284.346,754.781,937,17702,0.927126,0,2,1532692,1531755,937
10768281,275.803,688.683,927,17624,0.927485,0,2,1532908,1531981,927
10769741,272.828,630.848,953,17534,0.932799,0,2,1533160,1532207,953
10771201,268.724,580.242,967,17495,0.932449,0,2,1533400,1532433,967
10772661,263.634,535.961,969,17495,0.939643,0,2,1533628,1532659,969
10774121,257.679,497.216,959,17495,0.943438,0,2,1533844,1532885,959
10775581,258.47,463.314,997,17482,0.946758,0,2,1534108,1533111,997
10777041,256.161,433.65,1011,17482,0.944663,0,2,1534348,1533337,1011
10778501,249.641,407.694,989,17482,0.94283,0,2,1534552,1533563,989
10779961,248.436,384.982,1003,16077,0.943727,0,2,1534792,1533789,1003
10807701,238.772,98.9189,2719,1460,0.983967,0,2,1540724,1538005,2719
10823761,242.256,133.272,2900,7300,0.995521,0,2,1543544,1540644,2900
10823761,240.474,116.613,3128,8760,0.992331,0,2,1543772,1540644,3128
10823761,230.601,59.8118,4232,5840,0.992316,0,2,1544876,1540644,4232
10836901,416.276,696.835,792,1460,0.957027,0,2,1546592,1545800,792
10839821,470.741,708.731,852,16060,0.933648,0,2,1547444,1546592,852
10841281,463.899,672.64,848,18980,0.910692,0,2,1547860,1547012,848
10842741,432.911,614.81,854,20440,0.893106,0,2,1548076,1547222,854
10844201,408.797,564.208,884,21718,0.892718,0,2,1548316,1547432,884
10847121,380.698,519.932,858,21538,0.899878,0,2,1548500,1547642,858
10857341,259.734,157.431,2370,10220,0.962334,0,2,1551356,1548986,2370
10860261,257.267,342.502,972,1460,0.955792,0,2,1551596,1550624,972
10874861,239.803,270.835,1188,13140,0.98014,0,2,1553204,1552016,1188
10888001,278.421,347.648,1174,10220,0.992928,0,2,1556260,1555086,1174
10888001,248.618,304.192,1214,11680,0.990062,0,2,1556300,1555086,1214
10888001,255.351,156.023,2534,7300,0.992403,0,2,1557620,1555086,2534
10904061,253.308,416.65,1101,10220,0.992353,0,2,1558880,1557779,1101
10904061,251.645,364.569,1341,11680,0.984559,0,2,1559120,1557779,1341
10906981,282.791,403.78,1023,5840,0.959428,0,2,1559896,1558873,1023
10908441,286.442,383.307,1095,5840,0.91325,0,2,1560208,1559113,1095
10911361,276.637,358.394,1119,16060,0.867843,0,2,1560416,1559297,1119
10912821,289.557,388.469,900,18980,0.810613,0,2,1560796,1559896,900
10915741,270.362,378.911,724,20440,0.760536,0,2,1560932,1560208,724
10918661,277.067,377.547,680,20804,0.714219,0,2,1561256,1560576,680
10921581,285.934,376.354,660,23105,0.683692,0,2,1561604,1560944,660
10924501,292.192,375.309,628,22534,0.67698,0,2,1561940,1561312,628
10927421,297.668,365.146,670,21962,0.681108,0,2,1562276,1561606,670
10930341,309.959,356.252,772,21550,0.707219,0,2,1562672,1561900,772
10942021,253.152,138.029,2305,11680,0.928855,0,2,1565528,1563223,2305
10942021,251.508,120.776,2545,13140,0.925248,0,2,1565768,1563223,2545
10944941,241.249,165.748,2698,18752,0.981826,0,2,1568864,1566166,2698
10981441,214.527,371.8,972,13140,0.982863,0,2,1570256,1569284,972
10990201,225.696,121.851,2662,5840,0.990298,0,2,1573196,1570534,2662
10994581,223.236,315.636,1092,5840,0.971322,0,2,1573628,1572536,1092
10996041,223.831,300.182,1128,5840,0.936157,0,2,1573856,1572728,1128
10997501,276.853,403.659,648,5840,0.857887,0,2,1574504,1573856,648
10998961,294.746,434.202,420,26280,0.784401,0,1,1574924,1574504,420
11004801,266.903,393.051,387,26280,0.725101,0,2,1574996,1574609,387
11007721,247.04,357.045,390,26280,0.670714,0,1,1575104,1574714,390
11007721,229.66,312.414,498,26280,0.633124,0,2,1575212,1574714,498
11007721,215.952,273.363,618,1460,0.602734,0,2,1575332,1574714,618
11007721,203.958,239.192,738,5840,0.578642,0,2,1575452,1574714,738
11007721,185.964,209.293,798,7300,0.570062,0,2,1575512,1574714,798
11007721,165.718,183.132,822,8760,0.560054,0,2,1575536,1574714,822
11009181,166.003,225.865,465,10220,0.558797,0,2,1575704,1575239,465
11009181,151.253,197.632,513,11680,0.557698,0,2,1575752,1575239,513
11010641,145.846,190.928,477,11680,0.561735,0,2,1575860,1575383,477
11015021,142.616,180.187,492,13140,0.565269,0,2,1575980,1575488,492
11023781,141.289,170.789,519,14600,0.57586,0,2,1576112,1575593,519
11026701,149.128,159.94,639,16060,0.597627,0,2,1576316,1575677,639
11029621,154.487,160.948,663,18980,0.626674,0,2,1576508,1575845,663
11032541,160.676,161.829,699,21900,0.65709,0,2,1576712,1576013,699
11035461,169.091,162.6,759,24820,0.696204,0,2,1576940,1576181,759
11055901,250.977,120.33,2773,1460,0.984314,0,2,1582664,1579891,2773
11088021,223.035,56.6529,3768,8760,0.993914,0,2,1586972,1583204,3768
11090941,225.155,419.446,1049,10220,0.992175,0,2,1587212,1586163,1049
11090941,225.511,367.015,1277,11680,0.989403,0,2,1587440,1586163,1277
11090941,220.282,280.996,1673,5840,0.978137,0,2,1587836,1586163,1673
11090941,222.747,245.872,1913,5840,0.95712,0,2,1588076,1586163,1913
11090941,208.403,215.138,2021,5840,0.93623,0,2,1588184,1586163,2021
11090941,191.353,188.246,2093,5840,0.915451,0,2,1588256,1586163,2093
11104081,320.434,508.715,565,18980,0.87227,0,2,1589480,1588915,565
11118681,301.38,466.875,559,20440,0.834486,0,2,1589648,1589089,559
11121601,308.707,430.266,745,21900,0.801425,0,2,1590008,1589263,745
11124521,307.619,419.983,697,23598,0.779997,0,2,1590308,1589611,697
11127441,308.166,402.235,731,20532,0.778747,0,2,1590620,1589889,731
11130361,305.646,386.706,741,20238,0.782654,0,2,1590908,1590167,741
11131821,316.44,373.117,855,21592,0.806072,0,2,1591300,1590445,855
11168321,223.543,49.4975,3958,13140,0.990037,0,2,1600026,1596068,3958
11168321,265.939,22.2143,5686,18980,0.985529,0,2,1601754,1596068,5686
11168321,262.697,19.4375,5926,20440,0.981088,0,2,1601994,1596068,5926
11232561,623.371,1324.81,657,20440,0.964982,0,2,1616862,1616205,657
11235481,569.45,1187.33,624,17620,0.930609,0,2,1617054,1616430,624
11273441,527.893,1067.04,636,17620,0.903033,0,2,1617291,1616655,636
11274901,516.907,961.785,851,17620,0.866404,0,2,1617731,1616880,851
11276361,479.293,869.687,842,17413,0.839353,0,2,1617947,1617105,842
11277821,447.882,789.101,845,17219,0.820684,0,2,1618175,1617330,845
11279281,420.397,718.588,848,17051,0.806849,0,2,1618403,1617555,848
11280741,393.347,656.89,827,16908,0.797243,0,2,1618607,1617780,827
11282201,372.679,602.903,830,16753,0.796337,0,2,1618835,1618005,830
11283661,359.094,555.666,869,16624,0.800545,0,2,1619099,1618230,869
11285121,344.207,514.332,884,16572,0.816727,0,2,1619339,1618455,884
11298261,222.953,148.78,2028,7300,0.967987,0,2,1622283,1620255,2028
11298261,223.584,130.182,2256,7300,0.961989,0,2,1622511,1620255,2256
11323081,269.751,344.444,1138,17520,0.99,0,2,1625495,1624357,1138
11324541,264.532,318.888,1226,18980,0.98875,0,2,1625723,1624497,1226
11324541,197.464,109.573,2490,17520,0.993634,0,2,1626987,1624497,2490
11324541,192.348,37.6502,3990,13140,0.990313,0,2,1628487,1624497,3990
11324541,197.119,14.7851,5370,5840,0.976196,0,2,1629867,1624497,5370
11324541,200.979,12.9369,5598,5840,0.942921,0,2,1630095,1624497,5598
11324541,204.356,11.3198,5826,5840,0.907556,0,2,1630323,1624497,5826
11330381,277.812,762.405,598,23360,0.870362,0,2,1631115,1630517,598
11343521,255.085,680.229,589,24820,0.840316,0,2,1631211,1630622,589
11362501,238.2,608.326,604,26280,0.819027,0,2,1631331,1630727,604
11365421,233.925,545.41,703,27740,0.802899,0,2,1631535,1630832,703
11368341,233.184,503.484,721,30660,0.783786,0,2,1631763,1631042,721
11371261,231.036,466.798,727,23177,0.777063,0,2,1631979,1631252,727
11374181,230.657,434.698,745,25194,0.78368,0,2,1632207,1631462,745
11377101,228.825,406.611,751,24652,0.79947,0,2,1632423,1631672,751
11390241,236.936,134.578,2474,11680,0.95336,0,2,1635495,1633021,2474
11399001,243.886,179.909,2332,16060,0.984264,0,2,1638387,1636055,2332
11417981,232.346,169.164,2392,18980,0.98558,0,2,1641135,1638743,2392
11434041,194.888,356.501,1140,13140,0.991295,0,2,1642611,1641471,1140
11434041,200.527,311.939,1380,13140,0.986133,0,2,1642851,1641471,1380
11434041,242.173,208.975,2364,5840,0.96946,0,2,1643835,1641471,2364
11438421,321.402,514.353,588,1460,0.897028,0,2,1644711,1644123,588
11444261,339.726,523.559,468,15816,0.813649,0,1,1645179,1644711,468
11450101,321.261,491.114,396,15816,0.743193,0,1,1645371,1644975,396
11451561,336.103,462.725,572,15816,0.674044,0,1,1645811,1645239,572
11453021,328.59,437.884,584,15241,0.616039,0,1,1646087,1645503,584
11454481,317.516,416.149,560,14754,0.565284,0,1,1646327,1645767,560
11455941,307.827,397.13,536,14301,0.523373,0,1,1646567,1646031,536
11457401,303.848,380.489,548,13869,0.491702,0,1,1646843,1646295,548
11458861,298.867,365.928,548,13504,0.468989,0,2,1647107,1646559,548
11460321,300.509,353.187,596,13184,0.464115,0,2,1647419,1646823,596
11461781,300.445,342.038,632,12973,0.477351,0,2,1647719,1647087,632
11463241,300.39,332.284,668,12841,0.521432,0,2,1648019,1647351,668
11477841,291.673,275.339,1093,15694,0.86035,0,2,1651031,1649938,1093
11509961,263.932,294.637,1108,13432,0.985585,0,2,1656971,1655863,1108
11511421,259.441,288.307,1092,13432,0.986136,0,2,1657199,1656107,1092
11518721,257.568,266.726,1132,5840,0.987889,0,2,1658459,1657327,1132
11520181,255.372,257.76,1177,5840,0.951903,0,2,1658699,1657522,1177
11521641,253.451,249.915,1222,5840,0.915415,0,2,1658939,1657717,1222
11521641,226.769,218.676,1262,5840,0.883488,0,2,1658979,1657717,1262
11521641,259.923,191.341,1754,5840,0.844302,0,2,1659471,1657717,1754
11521641,246.933,167.423,1910,17440,0.810014,0,2,1659627,1657717,1910
11521641,237.066,146.496,2078,4380,0.777513,0,2,1659795,1657717,2078
11521641,240.433,128.184,2342,4380,0.739074,0,2,1660059,1657717,2342
11530401,228.379,350.911,576,5840,0.700439,0,2,1660203,1659627,576
11531861,244.331,328.047,764,17483,0.676634,0,2,1660559,1659795,764
11533321,240.79,320.041,716,18943,0.658305,0,2,1660775,1660059,716
11534781,239.191,310.536,700,19936,0.652267,0,2,1661003,1660303,700
11536241,245.292,302.219,744,19470,0.666984,0,2,1661291,1660547,744
11537701,244.631,294.941,740,19536,0.684861,0,2,1661531,1660791,740
11539161,244.052,282.449,785,19226,0.715503,0,2,1661771,1660986,785
11549381,225.775,115.882,2147,7300,0.938947,0,2,1664463,1662316,2147
11549381,227.553,101.397,2387,7300,0.942829,0,2,1664703,1662316,2387
11596101,224.38,159.569,2249,5840,0.971703,0,2,1672527,1670278,2249
11596101,226.332,139.623,2489,5840,0.93399,0,2,1672767,1670278,2489
11596101,223.541,122.17,2693,5840,0.885991,0,2,1672971,1670278,2693
11596101,252.598,106.899,3149,1460,0.821492,0,2,1673427,1670278,3149
11607781,261.523,466.162,492,18980,0.755056,0,1,1673751,1673259,492
11612161,245.333,428.891,456,20440,0.694424,0,1,1673883,1673427,456
11615081,247.666,395.28,560,21900,0.636371,0,1,1674147,1673587,560
11618001,252.708,385.87,528,23615,0.588075,0,1,1674435,1673907,528
11620921,266.12,377.636,568,22520,0.555815,0,2,1674795,1674227,568
11623841,268.855,370.432,536,21662,0.532588,0,2,1675083,1674547,536
11626761,286.248,364.128,624,20323,0.519765,0,2,1675491,1674867,624
11629681,292.467,358.612,640,19810,0.523544,0,2,1675827,1675187,640
11632601,302.408,355.035,682,19403,0.556851,0,2,1676199,1675517,682
11634061,315.107,351.906,756,19138,0.593495,0,2,1676603,1675847,756
11645741,252.982,127.155,2368,10220,0.916873,0,2,1679535,1677167,2368
11645741,251.359,111.26,2608,10220,0.922264,0,2,1679775,1677167,2608
11672021,244.219,204.068,1872,13140,0.988219,0,2,1684227,1682355,1872
11682241,235.509,236.375,1991,5840,0.978877,0,2,1687011,1685020,1991
11682241,236.071,206.828,2231,5840,0.936517,0,2,1687251,1685020,2231
11685161,335.562,524.474,515,16060,0.883203,0,2,1688283,1687768,515
11698301,313.117,478.915,511,17520,0.836552,0,2,1688439,1687928,511
11701221,287.477,439.051,459,18980,0.795733,0,2,1688547,1688088,459
11702681,300.542,404.169,691,20440,0.767517,0,2,1688939,1688248,691
11705601,284.475,373.648,703,21242,0.745327,0,2,1689111,1688408,703
11708521,287.915,366.942,695,20841,0.740911,0,2,1689423,1688728,695
11709981,303.926,361.074,791,20476,0.744547,0,2,1689839,1689048,791
11712901,287.435,335.94,803,20366,0.760229,0,2,1690011,1689208,803
11715821,299.506,333.948,867,20311,0.78645,0,2,1690395,1689528,867
11718741,307.068,332.204,907,20311,0.811894,0,2,1690755,1689848,907
11728961,235.147,117.109,2351,8760,0.955862,0,2,1693479,1691128,2351
11728961,234.253,102.47,2579,10220,0.955129,0,2,1693707,1691128,2579
11740641,211.842,409.71,1155,11680,0.978332,0,2,1695279,1694124,1155
11740641,226.678,183.876,2595,18980,0.987776,0,2,1696719,1694124,2595
11740641,223.685,82.5226,3927,10220,0.975764,0,2,1698051,1694124,3927
11740641,225.725,72.2073,4167,11680,0.976293,0,2,1698291,1694124,4167
11740641,235.91,16.6215,6747,24820,0.980793,0,2,1700871,1694124,6747
11740641,236.421,14.5438,6987,26280,0.959444,0,2,1701111,1694124,6987
11761081,235.369,818.976,765,27740,0.950763,0,2,1701339,1700574,765
11781521,231.448,734.104,829,28719,0.935668,0,2,1701543,1700714,829
11784441,208.517,656.341,765,28719,0.922459,0,2,1701591,1700826,765
11785901,198.952,588.298,785,25799,0.903402,0,2,1701723,1700938,785
11791741,186.083,528.761,769,25799,0.879227,0,2,1701819,1701050,769
11794661,176.323,476.666,765,25799,0.860573,0,2,1701927,1701162,765
11797581,181.282,431.083,869,25799,0.835502,0,2,1702143,1701274,869
11800501,181.122,405.197,825,25507,0.808564,0,2,1702323,1701498,825
11803421,192.982,391.798,803,25131,0.773744,0,2,1702599,1701796,803
11806341,202.109,377.823,789,24756,0.735776,0,2,1702865,1702076,789
11809261,203.845,365.595,725,24381,0.706304,0,2,1703081,1702356,725
11812181,208.365,354.896,685,23901,0.678016,0,2,1703321,1702636,685
11812321,223.944,345.534,738,23359,0.667014,0,2,1703654,1702916,738
11815241,246.701,357.467,703,23025,0.686137,0,2,1704060,1703357,703
11816701,260.364,347.784,779,22649,0.72412,0,2,1704416,1703637,779
11828381,243.264,128.808,2400,10220,0.927745,0,2,1707157,1704757,2400
11828381,242.856,112.707,2640,11680,0.926777,0,2,1707397,1704757,2640
11844441,214.166,67.1579,3512,10220,0.991708,0,2,1711645,1708133,3512
11857581,215.464,46.2543,4472,5840,0.992893,0,2,1715269,1710797,4472
11857581,211.031,40.4725,4652,5840,0.970032,0,2,1715449,1710797,4652
11878021,450.152,820.913,492,21900,0.932528,0,2,1717573,1717081,492
11880941,411.883,732.924,519,23360,0.912212,0,2,1717717,1717198,519
11882401,378.398,655.934,546,24820,0.904435,0,2,1717861,1717315,546
11895541,352.098,588.567,597,26280,0.912631,0,2,1718029,1717432,597
11907221,259.843,173.701,2409,14600,0.957388,0,2,1720729,1718320,2409
11907221,257.363,151.988,2649,14600,0.942715,0,2,1720969,1718320,2649
11907221,255.192,132.99,2889,14600,0.946126,0,2,1721209,1718320,2889
11920361,243.087,80.5501,3843,11680,0.988184,0,2,1725505,1721662,3843
11929121,259.767,591.521,1500,5840,0.974428,0,2,1729213,1727713,1500
11929121,266.296,517.581,1812,5840,0.930124,0,2,1729525,1727713,1812
11929121,257.009,452.883,2004,5840,0.875109,0,2,1729717,1727713,2004
11964161,353.883,723.773,416,1460,0.79947,0,1,1730749,1730333,416
11965621,384.147,685.301,596,17769,0.753286,0,2,1731345,1730749,596
11967081,369.129,627.389,638,17150,0.717876,0,2,1731609,1730971,638
11968541,352.988,576.715,656,16677,0.691891,0,2,1731849,1731193,656
11970001,338.864,532.376,674,18137,0.689155,0,2,1732089,1731415,674
11971461,331.006,493.579,728,18913,0.69426,0,2,1732365,1731637,728
11972921,318.131,459.631,734,18729,0.711228,0,2,1732593,1731859,734
11974381,311.364,424.302,821,18584,0.738574,0,2,1732857,1732036,821
11986061,230.928,128.114,2265,13140,0.947676,0,2,1735717,1733452,2265
11986061,224.703,10.1333,6597,7300,0.994611,0,2,1740049,1733452,6597
12026941,251.705,529.161,1137,13140,0.993486,0,2,1741377,1740240,1137
12028401,250.242,487.391,1182,14600,0.99305,0,2,1741617,1740435,1182
12028401,222.01,191.397,2554,5840,0.986021,0,2,1742989,1740435,2554
12031321,224.259,383.222,1068,5840,0.972768,0,2,1743229,1742161,1068
12031321,226.226,335.319,1308,5840,0.942422,0,2,1743469,1742161,1308
12031321,212.948,293.404,1428,5840,0.905869,0,2,1743589,1742161,1428
12031321,255.329,256.729,1980,5840,0.853886,0,2,1744141,1742161,1980
12031321,241.413,224.638,2124,17547,0.8109,0,2,1744285,1742161,2124
12031321,259.237,196.558,2508,17547,0.775788,0,2,1744669,1742161,2508
12031321,255.332,171.988,2736,17547,0.752564,0,2,1744897,1742161,2736
12031321,253.416,150.49,2976,1460,0.744744,0,2,1745137,1742161,2976
12031321,251.739,131.678,3216,5840,0.752901,0,2,1745377,1742161,3216
12053221,241.271,464.094,593,7300,0.770038,0,2,1745545,1744952,593
12061981,231.253,133.07,2377,8760,0.950722,0,2,1748641,1746264,2377
12073661,246.651,388.253,996,10220,0.975384,0,2,1750225,1749229,996
12073661,244.973,199.138,2208,16060,0.986124,0,2,1751437,1749229,2208
12073661,242.851,174.246,2436,17520,0.980359,0,2,1751665,1749229,2436
12107241,286.384,355.918,1209,10220,0.980471,0,2,1756185,1754976,1209
12108701,280.586,332.428,1281,11680,0.967912,0,2,1756425,1755144,1281
12108701,247.513,290.875,1297,13140,0.959423,0,2,1756441,1755144,1297
12108701,243.574,254.515,1513,14600,0.940745,0,2,1756657,1755144,1513
12108701,235.627,222.701,1693,5840,0.911902,0,2,1756837,1755144,1693
12108701,227.174,194.863,1861,5840,0.876664,0,2,1757005,1755144,1861
12108701,218.277,170.505,2017,5840,0.835831,0,2,1757161,1755144,2017
12108701,208.992,149.192,2161,4380,0.792602,0,2,1757305,1755144,2161
12113081,206.868,342.168,660,4380,0.749777,0,2,1757497,1756837,660
12120381,209.51,339.897,564,14600,0.704805,0,2,1757725,1757161,564
12121841,230.821,327.41,704,18018,0.647954,0,1,1758105,1757401,704
12124761,226.468,316.484,660,17458,0.59571,0,1,1758301,1757641,660
12126221,247.16,336.923,572,16899,0.559996,0,2,1758693,1758121,572
12127681,247.765,324.808,584,16278,0.541247,0,2,1758945,1758361,584
12129141,249.794,314.207,608,15755,0.529841,0,2,1759209,1758601,608
12130601,251.57,304.931,632,15329,0.532361,0,2,1759473,1758841,632
12132061,257.624,296.815,692,14988,0.547066,0,2,1759773,1759081,692
12133521,261.421,289.713,740,14782,0.579932,0,2,1760061,1759321,740
12134981,264.743,283.499,788,14672,0.621191,0,2,1760349,1759561,788
12136441,266.15,278.061,824,14660,0.664792,0,2,1760625,1759801,824
12149581,296.515,279.328,1091,16120,0.88357,0,2,1763052,1761961,1091
12151041,287.951,274.412,1079,17580,0.896873,0,2,1763280,1762201,1079
12152501,279.082,270.111,1056,17580,0.908514,0,2,1763497,1762441,1056
12162721,265.055,246.211,1188,18892,0.956442,0,2,1765021,1763833,1188
12162721,226.553,84.6004,2776,1460,0.982533,0,2,1766609,1763833,2776
12193381,259.153,331.502,1179,5840,0.948421,0,2,1771009,1769830,1179
12193381,231.759,290.064,1219,5840,0.913618,0,2,1771049,1769830,1219
12193381,228.289,253.806,1423,5840,0.873166,0,2,1771253,1769830,1423
12193381,250.753,222.08,1831,16060,0.82277,0,2,1771661,1769830,1831
12193381,237.409,194.32,1975,7300,0.776174,0,2,1771805,1769830,1975
12193381,219.733,170.03,2071,7300,0.740402,0,2,1771901,1769830,2071
12193381,202.766,148.776,2155,8760,0.709102,0,2,1771985,1769830,2155
12193381,193.92,130.179,2287,10220,0.691714,0,2,1772117,1769830,2287
12205061,177.18,342.782,516,11680,0.6715,0,2,1772177,1771661,516
12207981,189.533,317.934,648,27210,0.668813,0,2,1772453,1771805,648
12210901,203.341,310.192,692,30130,0.668961,0,2,1772753,1772061,692
12213821,215.424,303.418,736,30190,0.691591,0,2,1773053,1772317,736
12229881,208.79,409.984,1111,11680,0.971155,0,2,1777505,1776394,1111
12279521,199.568,350.62,1299,13140,0.991814,0,2,1783469,1782170,1299
12279521,204.622,306.793,1539,13140,0.991587,0,2,1783709,1782170,1539
12279521,196.799,205.527,2091,5840,0.985614,0,2,1784261,1782170,2091
12279521,178.199,179.836,2139,5840,0.976162,0,2,1784309,1782170,2139
12279521,173.924,157.357,2283,5840,0.960392,0,2,1784453,1782170,2283
12279521,170.184,137.687,2427,5840,0.936593,0,2,1784597,1782170,2427
12283901,262.911,466.976,567,24820,0.863269,0,2,1785509,1784942,567
12286821,239.047,423.604,519,26280,0.80411,0,2,1785581,1785062,519
12301421,222.666,385.654,507,27740,0.754847,0,2,1785689,1785182,507
12304341,223.333,352.447,615,28493,0.709241,0,2,1785917,1785302,615
12307261,222.416,338.391,591,27495,0.666836,0,2,1786133,1785542,591
12310181,224.614,326.092,591,26546,0.637231,0,2,1786373,1785782,591
12313101,226.537,315.331,591,25719,0.626327,0,2,1786613,1786022,591
12316021,232.72,305.914,627,24989,0.624286,0,2,1786889,1786262,627
12318941,241.13,297.675,687,24454,0.640001,0,2,1787189,1786502,687
12321861,245.489,290.466,723,24186,0.671251,0,2,1787465,1786742,723
12335001,222.195,104.412,2367,11680,0.931284,0,2,1790309,1787942,2367
12335001,222.921,91.3602,2595,13140,0.918624,0,2,1790537,1787942,2595
12351061,190.439,130.33,2396,23360,0.981642,0,2,1793444,1791048,2396
12351061,149.849,34.2865,3764,16060,0.988921,0,2,1794812,1791048,3764
12351061,167.118,30.0007,4052,17520,0.966555,0,2,1795100,1791048,4052
12351061,167.228,26.2506,4220,17520,0.969486,0,2,1795268,1791048,4220
12351061,228.887,6.04266,6933,5840,0.961726,0,2,1797981,1791048,6933
12370041,225.776,746.162,1210,5840,0.92776,0,2,1798185,1796975,1210
12370041,223.054,652.892,1414,5840,0.87804,0,2,1798389,1796975,1414
12370041,207.172,571.281,1510,5840,0.823285,0,2,1798485,1796975,1510
