#Ack,ack_ewma(ms),send_ewma(ms),rtt_ratio,cwnd (Bytes),Last Router Ocupation Ack Arriaval(Packets),Last Router Ocupation Packet Sent(Packets),Network Situation,AckArrival(ms),TSInsideAck(ms),RTTAck(ms)
23361,25,0,516,26280,0.69,1,1,171477,170961,516
26281,24.2,20,515,27740,0.69,1,1,171501,170986,515
29201,22.44,18.4,519,29200,0.642,1,1,171523,171004,519
32121,18.888,3.68,537,30660,0.6804,1,1,171541,171004,537
35041,11.7776,11.936,533,32120,0.59208,1,1,171551,171018,533
37961,129.556,169.587,483,33580,0.286416,0.9,1,171710,171227,483
40881,153.911,175.517,466,35040,0.0972832,0.9,1,171870,171404,466
43801,62.7822,35.1035,506,36500,0.0434566,0.73,1,171910,171404,506
46721,14.1564,45.4207,460,37960,0.00869133,0.69,1,171912,171452,460
49641,18.8313,29.0841,455,39420,0.0737383,0.69,1,171932,171477,455
52561,20.5663,5.81683,476,40880,0.118748,0.69,1,171953,171477,476
55481,5.71325,20.3634,454,42340,0.12775,0.63,1,171955,171501,454
58401,18.7427,21.6727,454,43800,0.14555,0.63,1,171977,171523,454
61321,14.1485,4.33453,467,45260,0.16511,0.69,1,171990,171523,467
64241,4.42971,15.2669,451,46720,0.169022,0.57,1,171992,171541,451
67161,8.08594,11.0534,450,48180,0.249804,0.57,1,172001,171551,450
70081,111.217,2.21068,587,49640,0.265961,0.21,1,172138,171551,587
73001,23.8434,127.642,430,51100,0.269192,0.05,1,172140,171710,430
75921,127.169,153.528,423,52560,0.301838,0.05,1,172293,171870,423
78841,56.6337,30.7057,462,54020,0.324368,0.03,1,172332,171870,462
81761,12.9267,38.1411,424,55480,0.328874,0,1,172334,171910,424
84681,4.18535,9.22823,424,56940,0.297775,0,1,172336,171912,424
87601,19.2371,1.84565,447,58400,0.323555,0.09,1,172359,171912,447
90521,5.44741,16.3691,429,59860,0.328711,0.13,1,172361,171932,429
93441,16.2895,20.0738,427,61320,0.377742,0.13,1,172380,171953,427
96361,4.8579,4.01477,429,62780,0.387548,0.13,1,172382,171953,429
99281,2.57158,2.40295,429,64240,0.43751,0.15,1,172384,171955,429
102201,18.9143,18.0806,430,65700,0.463502,0.15,1,172407,171977,430
105121,15.7829,3.61612,445,67160,0.4367,0.17,1,172422,171977,445
108041,4.75657,11.1232,434,68620,0.43134,0.17,1,172424,171990,434
110961,2.55131,3.82464,434,70080,0.430268,0.17,1,172426,171992,434
113881,6.91026,0.764929,442,71540,0.446054,0.27,1,172434,171992,442
116801,2.98205,7.35299,435,73000,0.465211,0.27,1,172436,172001,435
119721,111.796,111.071,437,74460,0.565042,0.27,1,172575,172138,437
122641,23.9593,22.2141,439,75920,0.585008,0.27,1,172577,172138,439
125561,6.39186,6.04282,439,77380,0.557002,0.31,1,172579,172140,439
128481,122.878,123.609,438,78840,0.6634,0.31,1,172731,172293,438
131401,53.3757,24.7217,474,80300,0.66868,0.33,1,172767,172293,474
134321,12.2751,36.1443,437,81760,0.669736,0.33,1,172769,172332,437
137241,4.05503,8.82887,437,83220,0.669947,0.33,1,172771,172334,437
140161,2.41101,1.76577,439,84680,0.669989,0.29,1,172773,172334,439
143081,2.0822,1.95315,439,86140,0.669998,0.33,1,172775,172336,439
146001,18.0164,18.7906,438,87600,0.782,0.33,2,172797,172359,438
148921,5.20329,3.75813,440,89060,0.8044,0.33,2,172799,172359,440
151841,2.64066,2.35163,440,90520,0.77688,0.39,2,172801,172361,440
154761,18.1281,15.6703,443,91980,0.851376,0.39,2,172823,172380,443
157681,5.22563,3.13406,445,93440,0.866275,0.39,2,172825,172380,445
160601,2.64513,2.22681,445,94900,0.869255,0.45,2,172827,172382,445
163521,2.12903,2.04536,445,96360,0.869851,0.45,2,172829,172384,445
166441,16.4258,0.409072,465,97820,0.90197,0.47,2,172849,172384,465
169361,4.88516,18.4818,444,99280,0.908394,0.43,2,172851,172407,444
434721,43,51,429,16460,0.01,1,1,174423,173994,429
435981,33.4,10.2,460,14800,0.026,0.09,1,174454,173994,460
449281,12.28,38.84,421,14800,0.0292,0.01,1,174461,174040,421
450741,252.856,97.368,622,61884,0.00584,0.03,1,174774,174152,622
453661,107.371,201.874,465,61918,0.025168,0.03,1,174845,174380,465
456581,51.8742,99.5747,429,61952,0.0290336,0.03,1,174883,174454,429
459501,11.9748,25.5149,424,61986,0.0618067,0.03,1,174885,174461,424
462421,3.99497,5.10299,426,62020,0.0363613,0.03,1,174887,174461,426
465341,2.39899,1.0206,428,62054,0.0312723,0.03,1,174889,174461,428
468261,2.0798,0.20412,430,62088,0.0302545,0.03,1,174891,174461,430
471181,2.01596,0.0408239,432,62122,0.00605089,0.03,1,174893,174461,432
474101,2.00319,0.00816478,434,62156,0.0492102,0.03,1,174895,174461,434
477021,2.00064,0.00163296,436,62190,0.057842,0.03,1,174897,174461,436
479941,2.00013,0.000326591,438,62224,0.0515684,0.03,1,174899,174461,438
482861,2.00003,6.53182e-05,440,62258,0.0503137,0.03,1,174901,174461,440
485781,2.00001,1.30636e-05,442,62292,0.0500627,0.03,1,174903,174461,442
488701,2,2.61273e-06,444,62326,0.0500125,0.03,1,174905,174461,444
491621,2,5.22546e-07,446,62360,0.0500025,0.03,1,174907,174461,446
494541,2,1.04509e-07,448,62394,0.0500005,0.03,1,174909,174461,448
497461,2,2.09018e-08,450,62428,0.0500001,0.03,1,174911,174461,450
500381,2,4.18036e-09,452,62462,0.05,0.03,1,174913,174461,452
503301,2,8.36073e-10,454,62496,0.05,0.03,1,174915,174461,454
506221,2,1.67215e-10,456,62530,0.05,0.03,1,174917,174461,456
509141,2,3.34429e-11,458,62564,0.05,0.03,1,174919,174461,458
510601,161.2,6.68858e-12,659,62598,0.01,0,1,175120,174461,659
513521,149.04,250.4,492,62632,0.002,0.03,1,175266,174774,492
516441,61.008,106.88,460,62666,0.0244,0.03,1,175305,174845,460
519361,14.6016,51.776,425,62700,0.01288,0.07,1,175308,174883,425
522281,4.52032,11.9552,425,62733,0.042576,0.03,1,175310,174885,425
525201,2.50406,3.99104,425,62766,0.0165152,0.03,1,175312,174887,425
528121,2.10081,2.39821,425,62799,0.011303,0.03,1,175314,174889,425
531041,2.02016,2.07964,425,62832,0.0262606,0,1,175316,174891,425
533961,2.00403,2.01593,425,62865,0.0292521,0.06,1,175318,174893,425
536881,2.00081,2.00319,425,62898,0.0298504,0.06,1,175320,174895,425
539801,2.00016,2.00064,425,62931,0.0299701,0.05,1,175322,174897,425
542721,2.00003,2.00013,425,62964,0.045994,0.05,1,175324,174899,425
545641,2.00001,2.00003,425,62997,0.0491988,0.05,1,175326,174901,425
548561,2,2.00001,425,63030,0.0498398,0.05,1,175328,174903,425
551481,2,2,425,63063,0.049968,0.05,1,175330,174905,425
554401,2,2,425,63096,0.0499936,0.05,1,175332,174907,425
557321,2,2,425,63129,0.0499987,0.05,1,175334,174909,425
560241,2,2,425,63162,0.0499997,0.05,1,175336,174911,425
563161,2,2,425,63195,0.0499999,0.05,1,175338,174913,425
566081,2,2,425,63228,0.05,0.05,1,175340,174915,425
569001,2,2,425,63261,0.05,0.05,1,175342,174917,425
570461,161.2,2,624,63294,0.034,0,1,175543,174919,624
573381,147.44,161.2,567,63327,0.0068,0,1,175687,175120,567
576301,60.688,149.04,460,63360,0.02536,0.03,1,175726,175266,460
579221,15.3376,61.008,425,63393,0.029072,0.01,1,175730,175305,425
582141,4.66752,14.6016,424,63426,0.0298144,0.05,1,175732,175308,424
585061,2.5335,4.52032,424,63459,0.0299629,0.01,1,175734,175310,424
587981,2.1067,2.50406,424,63492,0.0299926,0.01,1,175736,175312,424
590901,2.02134,2.10081,424,63525,0.0299985,0.03,1,175738,175314,424
593821,2.00427,2.02016,424,63558,0.0299997,0.03,1,175740,175316,424
596741,2.00085,2.00403,424,63591,0.0299999,0.03,1,175742,175318,424
599661,2.00017,2.00081,424,63624,0.03,0.03,1,175744,175320,424
602581,2.00003,2.00016,424,63657,0.03,0.05,1,175746,175322,424
605501,2.00001,2.00003,424,63690,0.03,0.05,1,175748,175324,424
608421,2,2.00001,424,63723,0.03,0.05,1,175750,175326,424
611341,2,2,424,63756,0.03,0.05,1,175752,175328,424
614261,2,2,424,63789,0.03,0.05,1,175754,175330,424
617181,2,2,424,63822,0.03,0.05,1,175756,175332,424
620101,2,2,424,63855,0.03,0.05,1,175758,175334,424
623021,2,2,424,63888,0.03,0.05,1,175760,175336,424
625941,2,2,424,63921,0.03,0.05,1,175762,175338,424
628861,2,2,424,63954,0.03,0.05,1,175764,175340,424
631781,2,2,424,63987,0.03,0.03,1,175766,175342,424
634701,274,161.2,565,64020,0.014,0,1,176108,175543,565
637621,86.8,147.44,461,64053,0.0268,0.03,1,176148,175687,461
640541,20.56,60.688,426,64086,0.02936,0.03,1,176152,175726,426
643461,5.712,15.3376,424,64119,0.029872,0.03,1,176154,175730,424
646381,2.7424,4.66752,424,64152,0.0299744,0.03,1,176156,175732,424
649301,2.14848,2.5335,424,64185,0.0299949,0.03,1,176158,175734,424
652221,2.0297,2.1067,424,64218,0.029999,0.03,1,176160,175736,424
655141,2.00594,2.02134,424,64251,0.0299998,0.03,1,176162,175738,424
658061,2.00119,2.00427,424,64284,0.03,0.03,1,176164,175740,424
660981,2.00024,2.00085,424,64317,0.03,0.03,1,176166,175742,424
663901,2.00005,2.00017,424,64350,0.03,0.03,1,176168,175744,424
666821,2.00001,2.00003,424,64383,0.03,0.03,1,176170,175746,424
669741,2,2.00001,424,64416,0.046,0.03,1,176172,175748,424
672661,2,2,424,64449,0.0492,0.03,1,176174,175750,424
675581,2,2,424,64482,0.04984,0.03,1,176176,175752,424
678501,2,2,424,64515,0.049968,0.03,1,176178,175754,424
681421,2,2,424,64548,0.0499936,0.03,1,176180,175756,424
684341,2,2,424,64581,0.0499987,0.03,1,176182,175758,424
687261,2,2,424,64614,0.0499997,0.03,1,176184,175760,424
690181,2,2,424,64646,0.0499999,0.03,1,176186,175762,424
693101,2,2,424,64678,0.05,0.03,1,176188,175764,424
694561,161.2,2,623,64710,0.034,0.01,1,176389,175766,623
697481,145.84,274,423,64742,0.0308,0.03,1,176531,176108,423
700401,61.168,86.8,423,64774,0.04616,0.03,1,176571,176148,423
703321,15.4336,20.56,423,64806,0.049232,0.03,1,176575,176152,423
706241,4.68672,5.712,423,64838,0.0498464,0.03,1,176577,176154,423
709161,2.53734,2.7424,423,64870,0.0499693,0.03,1,176579,176156,423
712081,2.10747,2.14848,423,64902,0.0179939,0.03,1,176581,176158,423
715001,2.02149,2.0297,423,64934,0.0435988,0.03,1,176583,176160,423
717921,2.0043,0.405939,425,64966,0.0167198,0.03,1,176585,176160,425
720841,2.00086,1.68119,425,64998,0.011344,0.03,1,176587,176162,425
723761,2.00017,1.93624,425,65030,0.0102688,0.03,1,176589,176164,425
726681,2.00003,1.98725,425,65062,0.0100538,0.03,1,176591,176166,425
729601,2.00001,1.99745,425,65094,0.0100108,0.03,1,176593,176168,425
732521,2,1.99949,425,65126,0.0100022,0.05,1,176595,176170,425
735441,2,1.9999,425,65158,0.0100004,0.05,1,176597,176172,425
738361,2,1.99998,425,65190,0.0100001,0.05,1,176599,176174,425
741281,2,2,425,65222,0.01,0.05,1,176601,176176,425
744201,2,2,425,65254,0.01,0.05,1,176603,176178,425
747121,2,2,425,65286,0.01,0.05,1,176605,176180,425
750041,2,2,425,65318,0.01,0.05,1,176607,176182,425
752961,2,2,425,65350,0.01,0.05,1,176609,176184,425
755881,2,2,425,65382,0.01,0.05,1,176611,176186,425
758801,160.4,2,623,65414,0.106,0.03,1,176811,176188,623
761721,145.68,274.8,422,65446,0.0452,0.05,1,176953,176531,422
764641,61.136,86.96,422,65478,0.03304,0.05,1,176993,176571,422
767561,15.4272,20.592,422,65510,0.006608,0.05,1,176997,176575,422
770481,4.68544,5.7184,422,65542,0.0413216,0.05,1,176999,176577,422
773401,2.53709,2.74368,422,65574,0.0482643,0.01,1,177001,176579,422
776321,2.10742,2.14874,422,65606,0.0176529,0.05,1,177003,176581,422
779241,2.02148,2.02975,422,65638,0.0115306,0.01,1,177005,176583,422
782161,2.0043,2.00595,422,65670,0.0103061,0.01,1,177007,176585,422
785081,2.00086,2.00119,422,65702,0.0100612,0.01,1,177009,176587,422
788001,2.00017,2.00024,422,65734,0.0100122,0.01,1,177011,176589,422
790921,2.00003,2.00005,422,65766,0.0100024,0.01,1,177013,176591,422
793841,2.00001,2.00001,422,65798,0.0100005,0.01,1,177015,176593,422
796761,2,2,422,65830,0.0100001,0.01,1,177017,176595,422
799681,2,2,422,65862,0.026,0.01,1,177019,176597,422
802601,2,2,422,65894,0.0292,0.01,1,177021,176599,422
805521,2,2,422,65926,0.02984,0.01,1,177023,176601,422
808441,2,2,422,65958,0.029968,0.01,1,177025,176603,422
811361,2,2,422,65990,0.0299936,0.01,1,177027,176605,422
814281,2,2,422,66022,0.0299987,0.01,1,177029,176607,422
817201,2,2,422,66054,0.0299997,0.01,1,177031,176609,422
820121,2,2,422,66086,0.0299999,0.13,1,177033,176611,422
823041,163.6,160.4,426,66118,0.126,0.03,1,177237,176811,426
825961,143.12,145.68,422,66150,0.0492,0.03,1,177375,176953,422
828881,60.624,61.136,422,66182,0.03384,0,1,177415,176993,422
831801,15.3248,15.4272,422,66214,0.006768,0.05,1,177419,176997,422
834721,4.66496,4.68544,422,66246,0.0093536,0.05,1,177421,176999,422
837641,2.53299,2.53709,422,66278,0.00987072,0.01,1,177423,177001,422
840561,2.1066,2.10742,422,66310,0.00997414,0.01,1,177425,177003,422
843481,2.02132,2.02148,422,66342,0.00999483,0.01,1,177427,177005,422
846401,2.00426,2.0043,422,66374,0.00999897,0.01,1,177429,177007,422
849321,2.00085,0.400859,424,66406,0.00999979,0.01,1,177431,177007,424
852241,2.00017,1.68017,424,66438,0.00999996,0.01,1,177433,177009,424
855161,2.00003,1.93603,424,66470,0.00999999,0.01,1,177435,177011,424
858081,2.00001,1.98721,424,66502,0.01,0.01,1,177437,177013,424
861001,2,1.99744,424,66534,0.01,0.01,1,177439,177015,424
863921,2,1.99949,424,66566,0.01,0.03,1,177441,177017,424
866841,2,1.9999,424,66598,0.01,0.03,1,177443,177019,424
869761,2,1.99998,424,66630,0.01,0.03,1,177445,177021,424
872681,2,2,424,66661,0.01,0.03,1,177447,177023,424
875601,2,2,424,66692,0.01,0.03,1,177449,177025,424
878521,2,2,424,66723,0.01,0.03,1,177451,177027,424
881441,2,2,424,66754,0.01,0.03,1,177453,177029,424
884361,2,2,424,66785,0.01,0.03,1,177455,177031,424
885821,161.2,2,623,66816,0.058,0.15,1,177656,177033,623
888741,40.24,163.6,429,66847,0.0676,0.03,1,177666,177237,429
891661,112.848,143.12,422,66878,0.14952,0.03,1,177797,177375,422
894581,54.5696,60.624,422,66909,0.069904,0,1,177837,177415,422
897501,14.1139,15.3248,422,66940,0.0539808,0.01,1,177841,177419,422
900421,4.42278,4.66496,422,66971,0.0187962,0.01,1,177843,177421,422
903341,2.48456,2.53299,422,67002,0.0117592,0.01,1,177845,177423,422
906261,2.09691,2.1066,422,67033,0.0103518,0.01,1,177847,177425,422
909181,2.01938,2.02132,422,67064,0.0420704,0.01,1,177849,177427,422
912101,2.00388,2.00426,422,67095,0.0164141,0.01,1,177851,177429,422
915021,2.00078,2.00085,422,67126,0.0112828,0.01,1,177853,177431,422
917941,2.00016,2.00017,422,67157,0.0102566,0.01,1,177855,177433,422
920861,2.00003,2.00003,422,67188,0.0100513,0.01,1,177857,177435,422
923781,2.00001,2.00001,422,67219,0.0100103,0.01,1,177859,177437,422
926701,2,2,422,67250,0.0100021,0.01,1,177861,177439,422
929621,2,2,422,67281,0.0100004,0.01,1,177863,177441,422
932541,2,2,422,67312,0.0100001,0.01,1,177865,177443,422
935461,2,2,422,67343,0.026,0.01,1,177867,177445,422
938381,2,2,422,67374,0.0292,0.01,1,177869,177447,422
941301,2,2,422,67405,0.02984,0.01,1,177871,177449,422
944221,2,2,422,67436,0.029968,0.01,1,177873,177451,422
947141,2,2,422,67467,0.0299936,0.01,1,177875,177453,422
950061,2,2,422,67498,0.0299987,0.07,1,177877,177455,422
952981,172.4,161.2,436,67529,0.00599974,0.07,1,178092,177656,436
955901,138.48,40.24,556,67560,0.0732,0.17,1,178222,177666,556
958821,56.496,112.848,461,67591,0.10264,0.05,1,178258,177797,461
961741,14.4992,54.5696,425,67622,0.108528,0.05,1,178262,177837,425
964661,4.49984,14.1139,423,67653,0.125706,0.01,1,178264,177841,423
967581,2.49997,4.42278,423,67684,0.129141,0.01,1,178266,177843,423
970501,2.09999,2.48456,423,67715,0.129828,0.01,1,178268,177845,423
973421,2.02,2.09691,423,67746,0.129966,0.05,1,178270,177847,423
976341,2.004,2.01938,423,67777,0.129993,0.01,1,178272,177849,423
979261,2.0008,2.00388,423,67808,0.129999,0.01,1,178274,177851,423
982181,2.00016,2.00078,423,67839,0.13,0.01,1,178276,177853,423
985101,2.00003,2.00016,423,67870,0.13,0.01,1,178278,177855,423
988021,2.00001,2.00003,423,67901,0.13,0.01,1,178280,177857,423
990941,2,2.00001,423,67932,0.13,0.01,1,178282,177859,423
993861,2,2,423,67963,0.13,0.01,1,178284,177861,423
996781,2,2,423,67994,0.13,0.01,1,178286,177863,423
999701,2,2,423,68025,0.13,0.03,1,178288,177865,423
1002621,2,2,423,68056,0.13,0.03,1,178290,177867,423
1005541,2,2,423,68087,0.13,0.03,1,178292,177869,423
1008461,2,2,423,68118,0.13,0.03,1,178294,177871,423
1011381,2,2,423,68149,0.13,0.03,1,178296,177873,423
1014301,2,2,423,68180,0.13,0.03,1,178298,177875,423
1017221,2,2,423,68211,0.13,0,1,178300,177877,423
1020141,174,172.4,425,68242,0.162,0.09,1,178517,178092,425
1023061,139.6,138.48,426,68273,0.1684,0.11,1,178648,178222,426
1025981,58.32,56.496,428,68304,0.15368,0.11,1,178686,178258,428
1028901,14.864,14.4992,428,68335,0.150736,0.13,1,178690,178262,428
1031821,4.5728,4.49984,428,68366,0.182147,0.13,1,178692,178264,428
1034741,2.51456,2.49997,428,68397,0.188429,0.13,1,178694,178266,428
1037661,2.10291,2.09999,428,68428,0.157686,0.13,1,178696,178268,428
1040581,2.02058,2.02,428,68459,0.151537,0.13,1,178698,178270,428
1043501,2.00412,2.004,428,68490,0.150307,0.13,1,178700,178272,428
1046421,2.00082,2.0008,428,68521,0.150061,0.13,1,178702,178274,428
1049341,2.00016,2.00016,428,68552,0.150012,0.13,1,178704,178276,428
1052261,2.00003,2.00003,428,68583,0.150002,0.13,1,178706,178278,428
1055181,2.00001,2.00001,428,68614,0.15,0.13,1,178708,178280,428
1058101,2,2,428,68645,0.15,0.13,1,178710,178282,428
1061021,2,2,428,68676,0.15,0.13,1,178712,178284,428
1063941,2,2,428,68707,0.15,0.13,1,178714,178286,428
1066861,2,2,428,68738,0.15,0.13,1,178716,178288,428
1069781,2,2,428,68769,0.15,0.13,1,178718,178290,428
1072701,2,2,428,68799,0.166,0.13,1,178720,178292,428
1075621,2,2,428,68829,0.1692,0.13,1,178722,178294,428
1078541,2,2,428,68859,0.16984,0.13,1,178724,178296,428
1081461,2,2,428,68889,0.169968,0.13,1,178726,178298,428
1084381,2,2,428,68919,0.169994,0.17,1,178728,178300,428
1087301,174,174,428,68949,0.313999,0.17,1,178945,178517,428
1090221,140.4,139.6,429,68979,0.3588,0.15,1,179077,178648,429
1093141,58.48,58.32,429,69009,0.39976,0.15,1,179115,178686,429
1096061,14.896,14.864,429,69039,0.375952,0.19,1,179119,178690,429
1098981,4.5792,4.5728,429,69069,0.38719,0.19,1,179121,178692,429
1101901,2.51584,2.51456,429,69099,0.389438,0.15,1,179123,178694,429
1104821,2.10317,2.10291,429,69129,0.389888,0.15,1,179125,178696,429
1107741,2.02063,2.02058,429,69159,0.389978,0.15,1,179127,178698,429
1110661,2.00413,2.00412,429,69189,0.389995,0.15,1,179129,178700,429
1113581,2.00083,2.00082,429,69219,0.389999,0.15,1,179131,178702,429
1116501,2.00017,2.00016,429,69249,0.39,0.15,1,179133,178704,429
1119421,2.00003,2.00003,429,69279,0.39,0.15,1,179135,178706,429
1122341,2.00001,2.00001,429,69309,0.39,0.15,1,179137,178708,429
1125261,2,0.400001,431,69339,0.39,0.15,1,179139,178708,431
1128181,2,1.68,431,69369,0.39,0.15,1,179141,178710,431
1131101,2,1.936,431,69399,0.39,0.15,1,179143,178712,431
1134021,2,1.9872,431,69429,0.39,0.15,1,179145,178714,431
1136941,2,1.99744,431,69459,0.39,0.15,1,179147,178716,431
1139861,2,1.99949,431,69489,0.39,0.17,1,179149,178718,431
1142781,2,1.9999,431,69519,0.39,0.17,1,179151,178720,431
1145701,2,1.99998,431,69549,0.39,0.17,1,179153,178722,431
1148621,2,2,431,69579,0.39,0.17,1,179155,178724,431
1151541,2,2,431,69609,0.39,0.17,1,179157,178726,431
1153001,161.2,2,630,69639,0.47,0.35,1,179358,178728,630
1155921,51.44,174,437,69669,0.486,0.37,1,179382,178945,437
1158841,118.288,140.4,440,69699,0.5532,0.41,1,179517,179077,440
1161761,54.8576,58.48,441,69729,0.58264,0.37,1,179556,179115,441
1164681,14.1715,14.896,441,69759,0.588528,0.39,1,179560,179119,441
1167601,4.4343,4.5792,441,69789,0.557706,0.39,1,179562,179121,441
1170521,2.48686,2.51584,441,69819,0.551541,0.39,1,179564,179123,441
1173441,2.09737,2.10317,441,69849,0.550308,0.39,1,179566,179125,441
1176361,2.01947,2.02063,441,69879,0.582062,0.39,1,179568,179127,441
1179281,2.00389,2.00413,441,69909,0.556412,0.39,1,179570,179129,441
1182201,2.00078,2.00083,441,69939,0.551282,0.39,1,179572,179131,441
1185121,2.00016,2.00017,441,69969,0.550256,0.39,1,179574,179133,441
1188041,2.00003,2.00003,441,69999,0.550051,0.39,1,179576,179135,441
1190961,2.00001,2.00001,441,70029,0.55001,0.39,1,179578,179137,441
1193881,2,2,441,70059,0.550002,0.39,1,179580,179139,441
1196801,2,2,441,70089,0.55,0.39,1,179582,179141,441
1199721,2,2,441,70119,0.55,0.39,1,179584,179143,441
1202641,2,2,441,70149,0.55,0.39,1,179586,179145,441
1205561,2,2,441,70179,0.55,0.39,1,179588,179147,441
1208481,2,2,441,70209,0.55,0.39,1,179590,179149,441
1211401,2,2,441,70239,0.566,0.39,1,179592,179151,441
1214321,2,2,441,70269,0.5692,0.39,1,179594,179153,441
1217241,2,2,441,70299,0.56984,0.39,1,179596,179155,441
1220161,2,2,441,70329,0.569968,0.49,1,179598,179157,441
1223081,183.6,161.2,469,70359,0.601994,0.49,1,179827,179358,469
1226001,146.32,51.44,582,70389,0.656399,0.57,1,179964,179382,582
1228921,61.264,118.288,487,70419,0.66728,0.59,1,180004,179517,487
1231841,15.4528,54.8576,452,70449,0.669456,0.59,1,180008,179556,452
1234761,4.69056,14.1715,450,70479,0.677891,0.55,1,180010,179560,450
1237681,2.53811,4.4343,450,70509,0.679578,0.55,1,180012,179562,450
1240601,2.10762,2.48686,450,70539,0.679916,0.55,1,180014,179564,450
1243521,2.02152,2.09737,450,70569,0.679983,0.59,1,180016,179566,450
1246441,2.0043,2.01947,450,70599,0.679997,0.55,1,180018,179568,450
1249361,2.00086,2.00389,450,70629,0.679999,0.55,1,180020,179570,450
1252281,2.00017,2.00078,450,70659,0.68,0.55,1,180022,179572,450
1255201,2.00003,2.00016,450,70689,0.68,0.55,1,180024,179574,450
1258121,2.00001,2.00003,450,70719,0.68,0.55,1,180026,179576,450
1261041,2,2.00001,450,70749,0.68,0.55,1,180028,179578,450
1263961,2,2,450,70779,0.68,0.55,1,180030,179580,450
1266881,2,2,450,70809,0.68,0.55,1,180032,179582,450
1269801,2,2,450,70839,0.68,0.55,1,180034,179584,450
1272721,2,2,450,70869,0.68,0.55,1,180036,179586,450
1275641,2,2,450,70899,0.68,0.55,1,180038,179588,450
1278561,2,2,450,70929,0.68,0.57,1,180040,179590,450
1281481,2,2,450,70959,0.68,0.57,1,180042,179592,450
1284401,2,2,450,70989,0.672,0.57,1,180044,179594,450
1287321,2,2,450,71019,0.6704,0.57,1,180046,179596,450
1290241,2,2,450,71049,0.67008,0.61,1,180048,179598,450
1293161,185.2,183.6,452,71079,0.702016,0.67,1,180279,179827,452
1296081,149.04,146.32,455,71108,0.708403,0.67,1,180419,179964,455
1299001,61.808,61.264,455,71137,0.757681,0.67,2,180459,180004,455
1301921,15.5616,15.4528,455,71166,0.767536,0.68,2,180463,180008,455
1645021,161,227,480,35160,0.19,0.33,1,182788,182308,480
1647941,49.8,91,445,35220,0.27,0.25,1,182810,182365,445
1650861,19.56,31.8,440,35280,0.318,0.23,1,182822,182382,440
1653781,10.312,15.96,436,35340,0.3276,0.25,1,182830,182394,436
1656701,34.8624,20.792,455,35400,0.50552,0.35,1,182871,182416,455
1659621,15.7725,25.7584,439,35460,0.621104,0.33,1,182882,182443,439
1662541,17.5545,9.15168,452,35520,0.628221,0.27,1,182900,182448,452
1665461,12.3109,17.8303,443,35580,0.645644,0.23,1,182911,182468,443
1668381,9.66218,18.7661,433,35639,0.665129,0.17,1,182920,182487,433
1671301,3.53244,8.55321,429,35698,0.669026,0.15,1,182922,182493,429
1674221,14.3065,9.71064,436,35757,0.685805,0.13,1,182939,182503,436
1677141,96.4613,101.142,429,35816,0.801161,0.19,2,183056,182627,429
1680061,148.892,149.028,430,35875,0.888232,0.29,2,183218,182788,430
1823141,18,185,482,38657,0.77,1,2,185123,184641,482
1826061,19.6,56.2,478,38712,0.738,1,1,185143,184665,478
1828981,15.12,20.04,481,38767,0.7156,0.94,1,185157,184676,481
1831901,8.624,14.408,475,38821,0.71112,1,1,185164,184689,475
1834821,41.7248,39.6816,479,38875,0.294224,1,1,185214,184735,479
1837741,17.945,20.7363,475,38929,0.178845,1,1,185226,184751,475
1840661,17.989,19.3473,474,38983,0.035769,1,1,185244,184770,474
1843581,27.5978,25.4695,477,39037,0.0631538,1,1,185274,184797,477
1846501,17.5196,21.0939,472,39091,0.0206308,0.93,1,185289,184817,472
1849421,16.3039,12.2188,478,39145,0.0441262,1,1,185305,184827,478
1852341,17.6608,18.4438,476,39199,0.0808252,0.89,1,185323,184847,476
1855261,63.5322,74.0888,463,39253,0.680165,0.69,1,185398,184935,463
1858181,141.506,150.818,454,39307,0.752033,0.77,2,185559,185105,454
1861101,45.9013,44.5635,458,39361,0.798407,0.73,2,185581,185123,458
1864021,24.3803,24.9127,457,39415,0.823681,0.71,2,185600,185143,457
1866941,13.6761,16.1825,454,39469,0.828736,0.71,2,185611,185157,454
1869861,8.33521,8.83651,454,39523,0.813747,0.19,2,185618,185164,454
1872781,20.067,41.7673,427,39576,0.68275,0.15,1,185641,185214,427
1875701,12.0134,17.9535,425,39629,0.62455,0,1,185651,185226,425
1878621,15.2027,17.9907,423,39682,0.61291,0.07,1,185667,185244,423
1881541,27.0405,27.5981,423,39735,0.514582,0.01,1,185697,185274,423
1884461,18.2081,17.5196,424,39788,0.398916,0.05,1,185713,185289,424
1887381,18.0416,16.3039,426,39841,0.311783,0.09,1,185731,185305,426
1890301,47.6083,17.6608,463,39894,0.246357,0.83,1,185786,185323,463
1893221,67.9217,63.5322,461,39947,0.201271,0.77,1,185859,185398,461
1896141,143.184,141.506,462,40000,0.224254,0.81,1,186021,185559,462
1899061,46.2369,45.9013,462,40053,0.260851,0.83,1,186043,185581,462
1901981,23.6474,24.3803,461,40106,0.31617,0.83,1,186061,185600,461
1904901,12.7295,4.87605,471,40159,0.311234,0.83,1,186071,185600,471
1907821,5.74589,9.77521,464,40212,0.310247,0.81,1,186075,185611,464
1910741,14.7492,7.55504,474,40265,0.294049,0.65,1,186092,185618,474
1913661,10.9498,19.911,461,40317,0.29081,0.61,1,186102,185641,461
1916581,13.39,11.9822,465,40369,0.306162,0.61,1,186116,185651,465
1919501,20.278,15.1964,471,40421,0.309232,0.49,1,186138,185667,471
1922421,13.6556,27.0393,453,40473,0.325846,0.37,1,186150,185697,453
1925341,12.3311,18.2079,449,40525,0.329169,0.29,1,186162,185713,449
1928261,45.6662,18.0416,485,40577,0.345834,0.23,1,186216,185731,485
1931181,65.9332,47.6083,501,40629,0.365167,0.19,1,186287,185786,501
1934101,146.787,67.9217,595,40681,0.369033,0.23,1,186454,185859,595
1937021,48.5573,143.184,457,40733,0.305807,0.27,1,186478,186021,457
1939941,24.9115,46.2369,454,40785,0.309161,0.33,1,186497,186043,454
1942861,12.9823,23.6474,446,40837,0.309832,0.31,1,186507,186061,446
1945781,5.79646,12.7295,440,40889,0.309966,0.31,1,186511,186071,440
1948701,13.9593,5.74589,452,40941,0.325993,0.29,1,186527,186075,452
1951621,11.5919,14.7492,446,40993,0.345199,0.29,1,186538,186092,446
1954541,13.5184,10.9498,450,41044,0.34904,0.31,1,186552,186102,450
1957461,21.1037,13.39,459,41095,0.349808,0.31,1,186575,186116,459
1960381,13.8207,20.278,449,41146,0.349962,0.33,1,186587,186138,449
1963301,12.3641,13.6556,449,41197,0.349992,0.33,1,186599,186150,449
1966221,46.4728,12.3311,492,41248,0.365998,0.35,1,186654,186162,492
1969141,67.6946,45.6662,511,41299,0.3692,0.37,1,186727,186216,511
1972061,144.739,65.9332,604,41350,0.46584,0.37,1,186891,186287,604
1974981,46.5478,146.787,459,41401,0.485168,0.29,1,186913,186454,459
1977901,25.3096,48.5573,455,41452,0.489034,0.31,1,186933,186478,455
1980821,13.0619,24.9115,446,41503,0.505807,0.31,1,186943,186497,446
1983741,4.21238,12.9823,438,41554,0.509161,0.31,1,186945,186507,438
1986661,4.04248,5.79646,438,41605,0.509832,0.33,1,186949,186511,438
1989581,13.6085,13.9593,438,41656,0.525966,0.35,1,186965,186527,438
1992501,12.3217,11.5919,439,41707,0.529193,0.35,1,186977,186538,439
1995421,13.6643,13.5184,439,41758,0.529839,0.35,1,186991,186552,439
1998341,21.1329,21.1037,439,41809,0.593968,0.35,1,187014,186575,439
2001261,13.8266,13.8207,439,41859,0.606794,0.35,1,187026,186587,439
2004181,12.3653,12.3641,439,41909,0.577359,0.37,1,187038,186599,439
2007101,47.2731,46.4728,440,41959,0.603472,0.37,1,187094,186654,440
2010021,69.4546,67.6946,442,42009,0.640694,0.49,1,187169,186727,442
2012941,148.291,144.739,446,42059,0.728139,0.49,1,187337,186891,446
2015861,47.2582,46.5478,446,42109,0.777628,0.49,2,187359,186913,446
2018781,26.2516,25.3096,447,42159,0.771526,0.51,2,187380,186933,447
2021701,14.0503,13.0619,448,42209,0.754305,0.51,2,187391,186943,448
2024621,4.41007,4.21238,448,42259,0.750861,0.51,2,187393,186945,448
2027541,4.08201,4.04248,448,42309,0.750172,0.53,2,187397,186949,448
2030461,13.6164,13.6085,448,42359,0.766034,0.53,2,187413,186965,448
2033381,12.3233,12.3217,448,42409,0.769207,0.53,2,187425,186977,448
2036301,14.4647,13.6643,449,42459,0.785841,0.61,2,187440,186991,449
2039221,22.0929,21.1329,450,42509,0.789168,0.61,2,187464,187014,450
2042141,14.0186,13.8266,450,42559,0.757834,0.57,2,187476,187026,450
2045061,12.4037,12.3653,450,42609,0.751567,0.61,2,187488,187038,450
2047981,48.8807,47.2731,452,42659,0.798313,0.65,2,187546,187094,452
2050901,71.3762,69.4546,454,42708,0.823663,0.75,2,187623,187169,454
2053821,152.675,148.291,459,42757,0.828733,0.79,2,187796,187337,459
2056741,48.135,47.2582,459,42806,0.845747,0.77,2,187818,187359,459
2059661,25.627,26.2516,458,42855,0.881149,0.75,2,187838,187380,458
2062581,14.7254,14.0503,459,42904,0.88823,0.75,2,187850,187391,459
2065501,4.54508,4.41007,459,42953,0.857646,0.75,2,187852,187393,459
2068421,4.10902,4.08201,459,43002,0.851529,0.75,2,187856,187397,459
2071341,13.6218,0.816403,475,43051,0.866306,0.77,2,187872,187397,475
2074261,12.3244,12.9633,471,43100,0.869261,0.77,2,187884,187413,471
2077181,13.6649,12.1927,473,43149,0.869852,0.79,2,187898,187425,473
2080101,21.933,14.4385,482,43198,0.86997,0.79,2,187922,187440,482
2083021,13.9866,22.0877,470,43247,0.869994,0.75,2,187934,187464,470
2085941,13.1973,14.0175,471,43296,0.869999,0.75,2,187947,187476,471
2088861,49.0395,12.4035,517,43345,0.902,0.81,2,188005,187488,517
2313701,25,179,498,46944,0.87,1,2,190654,190156,498
2316621,24.2,58.2,494,46989,0.918,1,2,190678,190184,494
2319541,17.64,27.64,490,47034,0.8796,1,2,190694,190204,490
2322461,16.328,19.928,488,47079,0.85592,1,2,190710,190222,488
2325381,17.6656,18.3856,488,47124,0.851184,1,2,190728,190240,488
2328301,19.5331,14.8771,494,47169,0.802237,1,2,190748,190254,494
2331221,21.5066,17.3754,498,47214,0.760447,0.97,2,190770,190272,498
2334141,13.1013,22.6751,485,47259,0.768089,1,2,190781,190296,485
2337061,9.82027,11.735,485,47304,0.769618,1,2,190790,190305,485
2339981,21.1641,11.947,497,47349,0.753924,1,2,190814,190317,497
2342901,12.2328,20.7894,484,47394,0.734785,1,1,190824,190340,484
2345821,6.44656,14.5579,476,47438,0.730957,1,1,190829,190353,476
2348741,6.88931,10.1116,474,47482,0.730191,0.96,1,190836,190362,474
2351661,5.37786,6.82232,473,47526,0.714038,0.81,1,190841,190368,473
2354581,60.2756,71.7645,459,47570,0.758808,0.91,2,190915,190456,459
2357501,155.255,152.753,465,47614,0.895762,0.87,2,191094,190629,465
2360421,52.651,50.5506,467,47658,0.923152,0.93,2,191121,190654,467
2363341,27.3302,29.3101,464,47702,0.94463,0.87,2,191142,190678,464
2554601,34,24,464,22724,0.03,0.43,1,193221,192757,464
2557521,20.4,35.2,443,22817,0.094,0.31,1,193238,192795,443
2560441,13.68,16.64,443,22910,0.0908,0.29,1,193250,192807,443
2563361,162.736,13.728,630,23003,0.07416,0.05,1,193450,192820,630
2566281,80.5472,190.746,455,23095,0.086832,0.01,1,193510,193055,455
2569201,50.5094,82.9491,442,23187,0.0573664,0.01,1,193553,193111,442
2572121,46.1019,50.9898,444,23278,0.0354733,0.05,1,193598,193154,444
2575041,46.8204,36.598,458,23369,0.0790947,0.03,1,193645,193187,458
2577961,23.7641,34.5196,442,23460,0.0558189,0.11,1,193663,193221,442
2580881,13.5528,20.5039,436,23550,0.0831638,0.09,1,193674,193238,436
2583801,162.711,13.7008,624,23640,0.0406328,0.07,1,193874,193250,624
2586721,81.3421,162.74,485,23730,0.0481265,0.09,1,193935,193450,485
2589641,48.2684,80.548,465,23819,0.0656253,0.05,1,193975,193510,465
2592561,48.0537,50.5096,470,23908,0.101125,0.03,1,194023,193553,470
2595481,11.2107,46.1019,427,23997,0.108225,0.09,1,194025,193598,427
2598401,37.4421,46.8204,424,24085,0.109645,0.05,1,194069,193645,424
2601321,22.6884,23.7641,425,24173,0.109929,0.09,1,194088,193663,425
2604241,14.1377,13.5528,426,24261,0.141986,0.03,1,194100,193674,426
2607161,160.428,162.711,423,24348,0.0683972,0.05,1,194297,193874,423
2610081,81.6855,81.3421,424,24435,0.0696794,0.07,1,194359,193935,424
2613001,49.1371,48.2684,425,24522,0.0219359,0.11,1,194400,193975,425
2615921,48.2274,48.0537,425,24608,0.0443872,0.11,1,194448,194023,425
2618841,11.2455,11.2107,425,24694,0.0488774,0.11,1,194450,194025,425
2621761,37.4491,37.4421,425,24780,0.0657755,0.11,1,194494,194069,425
2624681,24.2898,22.6884,427,24866,0.0851551,0.15,1,194515,194088,427
2627601,14.458,14.1377,427,24951,0.105031,0.05,1,194527,194100,427
2630521,157.292,160.428,423,25036,0.0450062,0.07,1,194720,194297,423
2633441,81.0583,81.6855,423,25121,0.0170012,0.01,1,194782,194359,423
2636361,48.2117,49.1371,422,25205,0.0114002,0.05,1,194822,194400,422
2639281,48.8423,48.2274,423,25289,0.05828,0.05,1,194871,194448,423
2642201,11.3685,11.2455,423,25373,0.067656,0.07,1,194873,194450,423
2645121,37.4737,37.4491,423,25457,0.0695312,0.07,1,194917,194494,423
2648041,25.0947,7.48982,445,25540,0.0699062,0.09,1,194939,194494,445
2650961,14.6189,18.298,436,25623,0.0699812,0.11,1,194951,194515,436
2653881,155.724,13.2596,615,25706,0.101996,0.03,1,195142,194527,615
2656801,79.9448,157.052,483,25788,0.108399,0.01,1,195203,194720,483
2659721,47.989,81.0104,461,25870,0.0456799,0.01,1,195243,194782,461
2662641,49.5978,48.2021,471,25952,0.081136,0.07,1,195293,194822,471
2665561,11.5196,48.8404,424,26034,0.0882272,0.07,1,195295,194871,424
2668481,39.1039,11.3681,468,26115,0.0896454,0.07,1,195341,194873,468
2671401,25.4208,37.4736,446,26196,0.105929,0.07,1,195363,194917,446
2674321,15.4842,25.0947,437,26277,0.0931858,0.07,1,195376,194939,437
2677241,156.697,14.6189,617,26358,0.170637,0.11,1,195568,194951,617
2680161,80.1394,155.724,487,26438,0.170127,0.11,1,195629,195142,487
2683081,45.6279,79.9448,463,26518,0.186025,0.03,1,195666,195203,463
2686001,50.7256,47.989,475,26598,0.221205,0.09,1,195718,195243,475
2688921,11.7451,49.5978,427,26678,0.228241,0.09,1,195720,195293,427
2691841,39.949,11.5196,472,26757,0.277648,0.09,1,195767,195295,472
2694761,25.5898,39.1039,448,26836,0.28753,0.11,1,195789,195341,448
2697681,16.318,25.4208,440,26915,0.289506,0.09,1,195803,195363,440
2700601,4.86359,15.4842,429,26994,0.289901,0.19,1,195805,195376,429
2703521,156.173,156.697,431,27072,0.36998,0.17,1,195999,195568,431
2706441,79.2345,80.1394,430,27150,0.433996,0.19,1,196059,195629,430
2709361,47.0469,45.6279,432,27228,0.446799,0.23,1,196098,195666,432
2712281,51.8094,50.7256,433,27306,0.44936,0.23,1,196151,195718,433
2715201,11.9619,11.7451,433,27384,0.449872,0.29,1,196153,195720,433
2718121,42.3924,39.949,436,27461,0.449974,0.29,1,196203,195767,436
2721041,26.0785,25.5898,436,27538,0.449995,0.29,1,196225,195789,436
2723961,16.4157,16.318,436,27615,0.465999,0.29,1,196239,195803,436
2726881,4.88314,4.86359,436,27692,0.4372,0.39,1,196241,195805,436
2729801,160.977,156.173,442,27768,0.49544,0.45,1,196441,195999,442
2732721,80.1953,79.2345,442,27844,0.555088,0.45,1,196501,196059,442
2735641,48.0391,47.0469,443,27920,0.567018,0.45,1,196541,196098,443
2738561,51.2078,51.8094,442,27996,0.537404,0.45,1,196593,196151,442
2741481,11.8416,11.9619,442,28072,0.531481,0.45,1,196595,196153,442
2744401,42.3683,42.3924,442,28147,0.546296,0.45,1,196645,196203,442
2747321,26.8737,26.0785,443,28222,0.581259,0.47,1,196668,196225,443
2750241,16.5747,16.4157,443,28297,0.588252,0.43,1,196682,196239,443
2753161,4.91495,4.88314,443,28372,0.58965,0.43,1,196684,196241,443
2754621,161.783,0.976628,644,28447,0.62193,0.51,1,196885,196241,644
2757541,34.7566,160.195,447,28521,0.644386,0.57,1,196888,196441,447
2760461,55.7513,80.0391,448,28595,0.664877,0.57,1,196949,196501,448
2763381,43.1503,48.0078,448,28669,0.684975,0.53,1,196989,196541,448
2766301,50.2301,51.2016,448,28743,0.704995,0.53,1,197041,196593,448
2769221,11.646,11.8403,448,28817,0.708999,0.55,1,197043,196595,448
2772141,43.9292,42.3681,450,28890,0.7578,0.59,2,197095,196645,450
2775061,26.3858,26.8736,449,28963,0.73556,0.59,1,197117,196668,449
2777981,16.4772,16.5747,449,29036,0.731112,0.59,1,197131,196682,449
2780901,4.89543,4.91494,449,29109,0.762222,0.63,2,197133,196684,449
2783821,166.579,161.783,455,29182,0.848444,0.65,2,197340,196885,455
2786741,84.5158,34.7566,516,29255,0.865689,0.67,2,197404,196888,516
2789661,49.7032,55.7513,496,29327,0.869138,0.69,2,197445,196949,496
2792581,51.5406,43.1503,508,29399,0.869828,0.71,2,197497,196989,508
2795501,11.9081,50.2301,458,29471,0.869965,0.71,2,197499,197041,458
2798421,44.7816,11.646,509,29543,0.885993,0.77,2,197552,197043,509
2801341,26.5563,43.9292,479,29615,0.905199,0.73,2,197574,197095,479
2804261,16.5113,26.3858,471,29686,0.92504,0.73,2,197588,197117,471
2807181,4.90225,16.4772,459,29757,0.929008,0.77,2,197590,197131,459
2929821,33,22,516,32674,0.51,1,1,199746,199230,516
2932741,45,34.8,526,32739,0.43,1,1,199794,199268,526
2935661,26.6,43.76,502,32804,0.382,1,1,199816,199314,502
2938581,30.92,55.152,476,32868,0.3404,1,1,199848,199372,476
2941501,30.184,31.0304,481,32932,0.33208,1,1,199878,199397,481
2944421,26.8368,27.0061,481,32996,0.298416,0.99,1,199904,199423,481
2947341,36.5674,36.6012,481,33060,0.291683,1,1,199943,199462,481
2950261,26.5135,26.5202,481,33124,0.258337,1,1,199967,199486,481
2953181,17.3027,23.704,473,33188,0.267667,0.69,1,199982,199509,473
2956101,132.261,149.541,453,33252,0.253533,0.63,1,200143,199690,453
2959021,43.2521,48.3082,451,33316,0.250707,0.51,1,200164,199713,451
2961941,32.6504,36.0616,448,33379,0.234141,0.41,1,200194,199746,448
2964861,41.7301,45.6123,444,33442,0.262828,0.37,1,200238,199794,444
2967781,23.546,26.7225,441,33505,0.284566,0.33,1,200257,199816,441
2970701,27.9092,30.9445,438,33568,0.256913,0.33,1,200286,199848,438
2973621,27.9818,30.1889,436,33631,0.283383,0.29,1,200314,199878,436
2976541,25.5964,26.8378,435,33694,0.288677,0.29,1,200339,199904,435
2979461,36.3193,36.5676,435,33757,0.321735,0.25,1,200378,199943,435
2982381,24.0639,26.5135,432,33820,0.344347,0.27,1,200399,199967,432
2985301,17.6128,17.3027,433,33883,0.348869,0.25,1,200415,199982,433
2988221,132.323,132.261,433,33945,0.557774,0.25,1,200576,200143,433
2991141,42.4645,43.2521,432,34007,0.599555,0.23,1,200596,200164,432
2994061,32.4929,32.6504,432,34069,0.575911,0.27,1,200626,200194,432
2996981,43.2986,41.7301,434,34131,0.587182,0.29,1,200672,200238,434
2999901,23.8597,23.546,434,34193,0.589436,0.25,1,200691,200257,434
3002821,26.3719,27.9092,432,34255,0.637887,0.25,1,200718,200286,432
3005741,29.2744,5.58184,462,34317,0.647577,0.29,1,200748,200286,462
3008661,26.6549,23.5164,460,34379,0.649515,0.29,1,200774,200314,460
3011581,38.131,24.7033,476,34441,0.681903,0.33,1,200815,200339,476
3014501,23.6262,36.1407,457,34502,0.704381,0.35,1,200835,200378,457
3017421,17.5252,24.0281,452,34563,0.708876,0.35,1,200851,200399,452
3020341,142.705,17.6056,610,34624,0.789775,0.61,2,201025,200415,610
3023261,44.541,132.321,469,34685,0.805955,0.61,2,201045,200576,469
3026181,32.1082,42.4642,478,34746,0.809191,0.57,2,201074,200596,478
3029101,43.2216,32.4928,494,34807,0.889838,0.59,2,201120,200626,494
3032021,23.8443,43.2986,467,34868,0.889968,0.59,2,201139,200672,467
3034941,28.7689,23.8597,478,34929,0.889994,0.65,2,201169,200691,478
3037861,31.3538,26.3719,483,34990,0.905999,0.65,2,201201,200718,483
3040781,27.0708,29.2744,479,35050,0.9252,0.65,2,201227,200748,479
3142981,22,25,484,37101,0.85,1,2,202660,202176,484
3145901,20.4,21.8,483,37158,0.818,1,2,202680,202197,483
3148821,22.48,4.36,506,37215,0.7476,1,1,202703,202197,506
3151741,21.296,24.072,498,37272,0.63752,1,1,202724,202226,498
3154661,27.4592,23.2144,504,37329,0.567504,1,1,202753,202249,504
3157581,145.492,25.4429,653,37386,0.113501,0.98,1,202928,202275,653
3160501,51.4984,144.289,507,37443,0.0467002,1,1,202956,202449,507
3163421,31.8997,52.0577,505,37499,0.01734,1,1,202983,202478,505
3166341,28.7799,32.0115,506,37555,0.043468,1,1,203011,202505,506
3169261,29.756,32.8023,503,37611,0.0086936,1,1,203041,202538,503
3172181,36.3512,27.3605,515,37667,0.0417387,0.91,1,203079,202564,515
3175101,25.6702,41.4721,493,37723,0.0163477,0.88,1,203102,202609,493
3178021,21.134,31.4944,484,37779,0.0272695,0.85,1,203122,202638,484
3180941,18.6268,23.8989,480,37835,0.0294539,0.81,1,203140,202660,480
3183861,17.3254,20.7798,477,37891,0.0298908,0.73,1,203157,202680,477
3186781,15.4651,22.556,469,37947,0.0299782,0.61,1,203172,202703,469
3189701,25.493,21.3112,476,38003,0.0619956,0.55,1,203200,202724,476
3192621,125.099,27.4622,597,38059,0.0123991,0,1,203350,202753,597
3195541,47.4197,145.492,450,38115,0.0584798,0.03,1,203378,202928,450
3198461,30.2839,51.4985,448,38170,0.051696,0.01,1,203404,202956,448
3201381,29.2568,31.8997,450,38225,0.0503392,0.05,1,203433,202983,450
3204301,31.4514,28.7799,454,38280,0.0660678,0,1,203465,203011,454
3207221,35.8903,29.756,461,38335,0.0852136,0.05,1,203502,203041,461
3210141,23.9781,36.3512,444,38390,0.121043,0.01,1,203523,203079,444
3213061,20.7956,25.6702,441,38445,0.0802085,0.03,1,203543,203102,441
3215981,20.1591,21.134,441,38500,0.0720417,0.03,1,203563,203122,441
3218901,17.6318,18.6268,440,38555,0.0704083,0.03,1,203580,203140,440
3221821,14.7264,17.3254,437,38610,0.102082,0.03,1,203594,203157,437
3224741,4.54527,15.4651,424,38665,0.108416,0.07,1,203596,203172,424
3227661,23.3091,25.493,424,38720,0.141683,0,1,203624,203200,424
3230581,123.062,125.099,422,38775,0.0523367,0.07,1,203772,203350,422
3233501,47.0124,47.4197,422,38829,0.0344673,0.05,1,203800,203378,422
3236421,31.0025,30.2839,423,38883,0.0308935,0.05,1,203827,203404,423
3239341,31.0005,29.2568,425,38937,0.00617869,0.07,1,203858,203433,425
3242261,32.6001,31.4514,426,38991,0.0252357,0.09,1,203891,203465,426
3245181,36.12,35.8903,426,39045,0.0450471,0.13,1,203928,203502,426
3248101,26.424,23.9781,429,39099,0.0330094,0.07,1,203952,203523,429
3251021,18.0848,20.7956,425,39153,0.0466019,0.07,1,203968,203543,425
3253941,19.617,20.1591,425,39207,0.0173204,0.07,1,203988,203563,425
3256861,18.3234,17.6318,426,39261,0.0114641,0.11,1,204006,203580,426
3259781,17.2647,14.7264,429,39315,0.0262928,0.11,1,204023,203594,429
3262701,5.05294,4.54527,429,39369,0.0612586,0.15,1,204025,203596,429
3265621,21.8106,23.3091,427,39423,0.0682517,0.03,1,204051,203624,427
3268541,118.762,123.062,422,39477,0.0856503,0.03,1,204194,203772,422
3271461,46.1524,47.0124,422,39530,0.0411301,0.03,1,204222,203800,422
3274381,30.8305,31.0025,422,39583,0.032226,0,1,204249,203827,422
3277301,30.9661,31.0005,422,39636,0.0064452,0.03,1,204280,203858,422
3280221,32.5932,32.6001,422,39689,0.025289,0.05,1,204313,203891,422
3283141,36.9186,36.12,423,39742,0.0290578,0.03,1,204351,203928,423
3286061,25.7837,26.424,422,39795,0.0298116,0.05,1,204374,203952,422
3288981,17.9567,18.0848,422,39848,0.0779623,0.01,1,204390,203968,422
3291901,19.5913,19.617,422,39901,0.0875925,0.01,1,204410,203988,422
3294821,18.3183,18.3234,422,39954,0.0895185,0.03,1,204428,204006,422
3297741,18.0637,17.2647,423,40007,0.105904,0.07,1,204446,204023,423
3300661,5.21273,5.05294,423,40060,0.141181,0.07,1,204448,204025,423
3303581,22.6425,1.01059,450,40113,0.148236,0.07,1,204475,204025,450
3306501,116.529,21.0021,564,40166,0.213647,0.09,1,204615,204051,564
3309421,45.7057,118.6,449,40219,0.210729,0.03,1,204643,204194,449
3312341,30.7411,46.1201,448,40271,0.162146,0.03,1,204670,204222,448
3315261,30.9482,30.824,452,40323,0.0724292,0,1,204701,204249,452
3318181,32.5896,30.9648,454,40375,0.0544858,0.03,1,204734,204280,454
3321101,36.9179,32.593,459,40427,0.0188972,0.03,1,204772,204313,459
3324021,27.3836,36.9186,446,40479,0.0277794,0.03,1,204797,204351,446
3326941,18.2767,25.7837,439,40531,0.0455559,0.09,1,204813,204374,439
3329861,20.4553,17.9567,444,40583,0.0651112,0.09,1,204834,204390,444
3332781,19.2911,19.5913,443,40635,0.0850222,0.09,1,204853,204410,443
3335701,19.0582,18.3183,444,40687,0.0730044,0.11,1,204872,204428,444
3338621,5.41164,18.0637,428,40739,0.0706009,0.15,1,204874,204446,428
3341541,24.2823,5.21273,455,40791,0.0381202,0.15,1,204903,204448,455
3344461,120.856,22.6425,573,40843,0.111624,0.23,1,205048,204475,573
3347381,43.3713,116.529,457,40895,0.158325,0.21,1,205072,204615,457
3350301,26.2743,45.7057,451,40947,0.167665,0.15,1,205094,204643,451
3353221,27.6549,30.7411,452,40999,0.185533,0.05,1,205122,204670,452
3356141,32.731,30.9482,455,41050,0.125107,0.05,1,205156,204701,455
3359061,37.7462,32.5896,461,41101,0.0970213,0.01,1,205195,204734,461
3361981,27.5492,36.9179,448,41152,0.0754043,0.03,1,205220,204772,448
3364901,18.3098,27.3836,439,41203,0.0870809,0.05,1,205236,204797,439
3367821,21.262,18.2767,445,41254,0.0894162,0.07,1,205258,204813,445
3370741,20.2524,20.4553,444,41305,0.0898832,0.09,1,205278,204834,444
3373661,18.4505,19.2911,443,41356,0.105977,0.07,1,205296,204853,443
3376581,5.2901,19.0582,426,41407,0.109195,0.07,1,205298,204872,426
3379501,22.658,5.41164,451,41458,0.141839,0.03,1,205325,204874,451
3382421,125.332,24.2823,573,41509,0.228368,0.13,1,205476,204903,573
3385341,26.6663,120.856,430,41560,0.277674,0.17,1,205478,205048,430
3388261,24.5333,43.3713,430,41611,0.287535,0.17,1,205502,205072,430
3391181,22.5067,26.2743,430,41662,0.305507,0.19,1,205524,205094,430
3394101,27.7013,27.6549,431,41713,0.357101,0.11,1,205553,205122,431
3397021,29.5403,32.731,427,41764,0.33542,0.09,1,205583,205156,427
3399941,36.3081,37.7462,426,41815,0.331084,0.07,1,205621,205195,426
3402861,27.2616,27.5492,426,41865,0.346217,0.09,1,205646,205220,426
3405781,18.2523,18.3098,426,41915,0.317243,0.09,1,205662,205236,426
3408701,21.2505,21.262,426,41965,0.311449,0.09,1,205684,205258,426
3411621,21.0501,20.2524,427,42015,0.32629,0.11,1,205705,205278,427
3414541,19.41,18.4505,428,42065,0.345258,0.11,1,205724,205296,428
3417461,5.482,5.2901,428,42115,0.349052,0.15,1,205726,205298,428
3420381,23.4964,22.658,429,42165,0.36581,0.25,1,205754,205325,429
3423301,131.099,125.332,436,42215,0.353162,0.29,1,205912,205476,436
3426221,27.8199,26.6663,436,42265,0.350632,0.29,1,205914,205478,436
3429141,24.764,24.5333,436,42315,0.366126,0.31,1,205938,205502,436
3432061,24.1528,22.5067,438,42365,0.385225,0.37,1,205962,205524,438
3434981,28.0306,27.7013,438,42415,0.373045,0.33,1,205991,205553,438
3437901,29.6061,29.5403,438,42465,0.418609,0.33,1,206021,205583,438
3440821,36.3212,36.3081,438,42515,0.443722,0.35,1,206059,205621,438
3443741,26.4642,27.2616,437,42565,0.416744,0.31,1,206083,205646,437
3446661,18.0928,18.2523,437,42615,0.443349,0.31,1,206099,205662,437
3449581,21.2186,21.2505,437,42665,0.44867,0.33,1,206121,205684,437
3452501,21.8437,21.0501,438,42714,0.433734,0.35,1,206143,205705,438
3455421,18.7687,19.41,437,42763,0.430747,0.35,1,206161,205724,437
3458341,5.35375,5.482,437,42812,0.462149,0.37,1,206163,205726,437
3461261,24.2708,23.4964,438,42861,0.45243,0.35,1,206192,205754,438
3464181,132.854,131.099,440,42910,0.530486,0.35,1,206352,205912,440
3467101,28.1708,27.8199,440,42959,0.546097,0.37,1,206354,205914,440
3470021,24.8342,24.764,440,43008,0.565219,0.37,1,206378,205938,440
3472941,22.5668,4.95279,462,43057,0.537044,0.39,1,206400,205938,462
3475861,29.3134,20.1906,469,43106,0.547409,0.37,1,206431,205962,469
3478781,29.8627,27.2381,470,43155,0.597482,0.43,1,206461,205991,470
3481701,37.1725,29.4476,479,43204,0.623496,0.45,1,206500,206021,479
3484621,26.6345,36.2895,465,43253,0.644699,0.41,1,206524,206059,465
3487541,18.1269,26.4579,457,43302,0.64894,0.45,1,206540,206083,457
3490461,22.0254,18.0916,464,43351,0.665788,0.45,1,206563,206099,464
3493381,22.0051,21.2183,464,43400,0.669158,0.43,1,206585,206121,464
3496301,18.801,21.8437,460,43449,0.669832,0.43,1,206603,206143,460
3499221,5.3602,18.7687,444,43498,0.669966,0.47,1,206605,206161,444
3502141,25.072,5.35375,472,43547,0.637993,0.45,1,206635,206163,472
3505061,135.414,24.2707,606,43595,0.647599,0.55,1,206798,206192,606
3507981,28.6829,132.854,448,43643,0.64952,0.55,1,206800,206352,448
3510901,25.7366,28.1708,471,43691,0.665904,0.57,1,206825,206354,471
3513821,22.7473,24.8342,469,43739,0.669181,0.53,1,206847,206378,469
3516741,31.7495,22.5668,481,43787,0.701836,0.55,1,206881,206400,481
3519661,31.1499,29.3134,481,43835,0.724367,0.61,1,206912,206431,481
3522581,38.23,29.8627,491,43883,0.760873,0.63,2,206952,206461,491
3525501,27.646,37.1725,477,43931,0.784175,0.65,2,206977,206500,477
3528421,18.3292,26.6345,469,43979,0.788835,0.65,2,206993,206524,469
3531341,22.8658,18.1269,477,44027,0.789767,0.67,2,207017,206540,477
3534261,22.1732,22.0254,476,44075,0.789953,0.67,2,207039,206563,476
3537181,18.8346,22.0051,472,44123,0.789991,0.67,2,207057,206585,472
3540101,5.36693,18.801,456,44171,0.789998,0.67,2,207059,206603,456
3543021,23.4734,5.3602,482,44219,0.806,0.63,2,207087,206605,482
3545941,135.895,25.072,616,44267,0.8892,0.65,2,207251,206635,616
3548861,28.7789,135.414,455,44315,0.90584,0.65,2,207253,206798,455
3551781,26.5558,28.6829,479,44363,0.925168,0.67,2,207279,206800,479
3732821,26,27,509,47219,0.73,1,1,209238,208729,509
3735741,16.4,25.4,498,47264,0.714,1,1,209252,208754,498
3738661,21.68,21.08,501,47309,0.6788,1,1,209275,208774,501
3741581,30.736,21.016,513,47354,0.63976,1,1,209308,208795,513
3744501,24.5472,27.4032,507,47399,0.567952,1,1,209331,208824,507
3747421,16.9094,35.8806,484,47443,0.55359,1,1,209346,208862,484
3750341,25.7819,27.9761,486,47487,0.502718,1,1,209374,208888,486
3753261,26.7564,23.1952,491,47531,0.460544,1,1,209401,208910,491
3756181,24.5513,19.039,497,47575,0.468109,1,1,209425,208928,497
3759101,18.5103,22.2078,491,47619,0.549622,1,1,209442,208951,491
3762021,19.7021,25.2416,485,47663,0.517924,1,1,209462,208977,485
3764941,31.9404,22.6483,498,47707,0.415585,0.95,1,209497,208999,498
3767861,95.9881,118.13,468,47751,0.363117,1,1,209609,209141,468
3770781,32.7976,40.4259,464,47795,0.352623,0.83,1,209626,209162,464
3773701,25.7595,28.8852,462,47839,0.286525,0.76,1,209650,209188,462
3776621,21.9519,24.977,459,47883,0.257305,0.73,1,209671,209212,459
3779541,23.5904,25.7954,457,47927,0.299461,0.71,1,209695,209238,457
3782461,13.5181,16.3591,454,47971,0.291892,0.67,1,209706,209252,454
3785381,21.1036,21.6718,454,48015,0.274378,0.63,1,209729,209275,454
3788301,27.4207,30.7344,450,48059,0.270876,0.55,1,209758,209308,450
3791221,23.8841,24.5469,450,48103,0.318175,0.55,1,209781,209331,450
3794141,15.1768,16.9094,448,48147,0.311635,0.49,1,209794,209346,448
3797061,23.0354,25.7819,445,48191,0.310327,0.45,1,209819,209374,445
3799981,27.0071,26.7564,446,48235,0.326065,0.47,1,209847,209401,446
3802901,23.8014,24.5513,445,48279,0.361213,0.57,1,209870,209425,445
3805821,19.1603,18.5103,446,48323,0.336243,0.51,1,209888,209442,446
3808741,18.2321,19.7021,444,48367,0.331249,0.39,1,209906,209462,444
3811661,32.4464,31.9404,445,48411,0.33025,0.35,1,209942,209497,445
3814581,88.8893,95.9881,436,48455,0.36205,0.35,1,210045,209609,436
3817501,30.5779,32.7976,435,48498,0.33641,0.27,1,210061,209626,435
3820421,24.5156,25.7595,434,48541,0.347282,0.25,1,210084,209650,434
3823341,22.5031,21.9519,435,48584,0.349456,0.31,1,210106,209671,435
3826261,23.7006,23.5904,435,48627,0.381891,0.29,1,210130,209695,435
3829181,14.3401,13.5181,436,48670,0.356378,0.27,1,210142,209706,436
3832101,19.668,21.1036,434,48713,0.367276,0.27,1,210163,209729,434
3835021,27.9336,27.4207,435,48756,0.385455,0.33,1,210193,209758,435
3837941,24.7867,23.8841,436,48799,0.373091,0.31,1,210217,209781,436
3840861,14.5573,15.1768,435,48842,0.402618,0.31,1,210229,209794,435
3843781,23.7115,3.03537,461,48885,0.376524,0.31,1,210255,209794,461
3846701,27.1423,20.6071,464,48928,0.419305,0.33,1,210283,209819,464
3849621,24.6285,26.5214,460,48971,0.411861,0.37,1,210307,209847,460
3852541,19.3257,23.7043,455,49014,0.426372,0.33,1,210325,209870,455
3855461,16.6651,19.1409,453,49057,0.445274,0.33,1,210341,209888,453
3858381,33.733,18.2282,473,49100,0.497055,0.33,1,210379,209906,473
3861301,89.1466,32.4456,540,49143,0.699411,0.37,1,210482,209942,540
3864221,30.6293,88.8891,453,49186,0.739882,0.33,1,210498,210045,453
3867141,25.3259,30.5778,461,49229,0.747976,0.35,1,210522,210061,461
3870061,22.6652,24.5156,460,49272,0.749595,0.35,1,210544,210084,460
3872981,23.733,22.5031,462,49315,0.765919,0.39,2,210568,210106,462
3875901,14.3466,23.7006,450,49358,0.769184,0.35,2,210580,210130,450
3878821,18.8693,14.3401,458,49401,0.769837,0.37,2,210600,210142,458
3881741,29.3739,19.668,469,49444,0.769967,0.39,2,210632,210163,469
3884661,25.0748,27.9336,463,49487,0.753993,0.37,2,210656,210193,463
3887581,14.615,24.7867,451,49530,0.750799,0.41,2,210668,210217,451
3890501,23.723,14.5573,465,49573,0.75016,0.37,2,210694,210229,465
3893421,28.7446,23.7115,469,49615,0.782032,0.43,2,210724,210255,469
3896341,25.7489,27.1423,466,49657,0.756406,0.41,2,210749,210283,466
3899261,19.5498,24.6285,460,49699,0.799281,0.43,2,210767,210307,460
3902181,18.31,19.3257,460,49741,0.807856,0.45,2,210785,210325,460
3905101,35.662,16.6651,484,49783,0.825571,0.51,2,210825,210341,484
3908021,99.1324,33.733,561,49825,0.909114,0.75,2,210940,210379,561
3910941,32.6265,89.1466,474,49867,0.925823,0.75,2,210956,210482,474
3913861,25.7253,30.6293,482,49909,0.929165,0.75,2,210980,210498,482
3916781,23.5451,25.3259,481,49951,0.913833,0.75,2,211003,210522,481
3919701,23.909,22.6652,483,49993,0.910767,0.77,2,211027,210544,483
3922621,14.3818,23.733,471,50035,0.910153,0.77,2,211039,210568,471
3925541,18.8764,14.3466,479,50077,0.910031,0.77,2,211059,210580,479
3928461,27.7753,18.8693,489,50119,0.926006,0.77,2,211089,210600,489
4083221,61,51,507,24266,0.07,0.94,1,212680,212173,507
4086141,41.8,53.4,490,24353,0.038,0.9,1,212717,212227,490
4089061,102.76,32.28,581,24440,0.0476,0.71,1,212835,212254,581
4091981,66.952,133.656,480,24527,0.09752,0.53,1,212893,212413,480
4094901,58.1904,67.5312,485,24613,0.027504,0.31,1,212949,212464,485
4097821,34.0381,64.7062,449,24699,0.0615008,0.21,1,212977,212528,449
4100741,27.6076,37.7412,444,24785,0.0523002,0.03,1,213003,212559,444
4103661,36.7215,55.5482,423,24871,0.03446,0.07,1,213042,212619,423
4106581,57.7443,59.9096,425,24956,0.078892,0.03,1,213105,212680,425
4109501,39.5489,41.5819,423,25041,0.0717784,0.05,1,213140,212717,423
4112421,103.11,102.716,424,25126,0.0863557,0.11,1,213259,212835,424
4115341,67.822,66.9433,425,25210,0.137271,0.01,1,213318,212893,425
4118261,58.3644,58.1887,425,25294,0.115454,0.07,1,213374,212949,425
4121181,32.4729,34.0377,423,25378,0.175091,0.05,1,213400,212977,423
4124101,28.0946,27.6075,424,25461,0.187018,0.05,1,213427,213003,424
4127021,35.2189,5.52151,461,25544,0.189404,0.03,1,213464,213003,461
4129941,56.6438,32.3043,484,25627,0.141881,0.09,1,213526,213042,484
4132861,39.3288,56.8609,456,25710,0.164376,0.07,1,213561,213105,456
4135781,106.266,39.3722,544,25792,0.168875,0.09,1,213684,213140,544
4138701,69.2531,103.074,485,25874,0.169775,0.15,1,213744,213259,485
4141621,59.4506,67.8149,483,25956,0.121955,0.11,1,213801,213318,483
4144541,33.4901,58.363,454,26038,0.128391,0.19,1,213828,213374,454
4147461,29.898,32.4726,457,26119,0.113678,0.19,1,213857,213400,457
4150381,35.5796,28.0945,467,26200,0.126736,0.19,1,213894,213427,467
4153301,55.1159,35.2189,490,26281,0.129347,0.13,1,213954,213464,490
4156221,38.2232,56.6438,462,26362,0.129869,0.17,1,213988,213526,462
4159141,107.645,39.3288,552,26442,0.161974,0.17,1,214113,213561,552
4162061,69.5289,106.266,489,26522,0.248395,0.17,1,214173,213684,489
4164981,57.1058,69.2531,483,26602,0.265679,0.11,1,214227,213744,483
4167901,33.8212,59.4506,454,26682,0.285136,0.13,1,214255,213801,454
4170821,29.1642,33.4901,455,26761,0.321027,0.11,1,214283,213828,455
4173741,36.2328,29.898,464,26840,0.360205,0.13,1,214321,213857,464
4176661,8.84657,35.5796,429,26919,0.368041,0.13,1,214323,213894,429
4179581,48.9693,55.1159,428,26998,0.401608,0.13,1,214382,213954,428
4182501,36.9939,38.2232,428,27076,0.408322,0.17,1,214416,213988,428
4185421,111.399,107.645,433,27154,0.537664,0.27,1,214546,214113,433
4188341,71.8798,69.5289,435,27232,0.547533,0.27,1,214608,214173,435
4191261,57.576,57.1058,435,27310,0.549507,0.29,1,214662,214227,435
4194181,34.7152,33.8212,436,27388,0.533901,0.33,1,214691,214255,436
4197101,30.943,29.1642,438,27465,0.56278,0.37,1,214721,214283,438
4200021,38.1886,36.2328,440,27542,0.568556,0.37,1,214761,214321,440
4202941,9.23772,8.84657,440,27619,0.537711,0.41,1,214763,214323,440
4205861,50.6475,48.9693,442,27696,0.579542,0.41,1,214824,214382,442
4208781,37.3295,36.9939,442,27772,0.603908,0.57,1,214858,214416,442
4211701,116.266,111.399,448,27848,0.608782,0.55,1,214994,214546,448
4214621,72.0532,71.8798,447,27924,0.705756,0.55,1,215055,214608,447
4217541,57.6106,57.576,447,28000,0.725151,0.53,1,215109,214662,447
4220461,35.5221,34.7152,448,28076,0.76103,0.57,2,215139,214691,448
4223381,31.1044,30.943,448,28151,0.752206,0.57,2,215169,214721,448
4226301,38.2209,38.1886,448,28226,0.750441,0.53,2,215209,214761,448
4229221,9.24418,9.23772,448,28301,0.750088,0.59,2,215211,214763,448
4232141,51.4488,50.6475,449,28376,0.830018,0.59,2,215273,214824,449
4235061,37.4898,10.1295,483,28451,0.830003,0.61,2,215307,214824,483
4237981,117.898,29.2259,587,28525,0.846001,0.61,2,215445,214858,587
4240901,76.3796,114.645,517,28599,0.8812,0.73,2,215511,214994,517
4243821,59.2759,71.729,511,28673,0.92024,0.73,2,215566,215055,511
4246741,35.8552,57.5458,487,28747,0.928048,0.77,2,215596,215109,487
4249661,31.971,35.5092,488,28821,0.91361,0.75,2,215627,215139,488
4252581,38.3942,31.1018,498,28894,0.910722,0.75,2,215667,215169,498
4255501,9.27884,38.2204,460,28967,0.910144,0.75,2,215669,215209,460
4258421,54.6558,9.24407,524,29040,0.878029,0.85,2,215735,215211,524
4261341,38.1312,51.4488,496,29113,0.903606,0.83,2,215769,215273,496
4264261,118.826,37.4898,601,29186,0.860721,0.85,2,215908,215307,601
4267181,78.1652,117.898,531,29259,0.932144,0.89,2,215976,215445,531
4363541,32,28,503,31557,0.63,1,1,217523,217020,503
4366461,42.4,28.8,519,31624,0.646,1,1,217568,217049,519
4369381,32.48,36.96,510,31691,0.6812,1,1,217598,217088,510
4372301,28.896,26.592,514,31758,0.65624,1,1,217626,217112,514
4375221,36.1792,42.1184,506,31825,0.555248,1,1,217664,217158,506
4378141,116.036,31.6237,613,31891,0.40705,0.88,1,217800,217187,613
4381061,49.6072,119.925,504,31957,0.37741,0.87,1,217833,217329,504
4383981,40.3214,51.1849,508,32023,0.275482,0.97,1,217871,217363,508
4386901,40.8643,43.837,507,32089,0.207096,0.72,1,217912,217405,507
4389821,33.7729,50.3674,487,32155,0.193419,0.71,1,217944,217457,487
4392741,32.3546,37.2735,485,32221,0.222684,0.63,1,217976,217491,485
4395661,42.4709,33.0547,498,32287,0.164537,0.65,1,218021,217523,498
4398581,32.4942,42.6109,483,32353,0.168907,0.69,1,218051,217568,483
4401501,28.8988,32.5222,481,32418,0.201781,0.65,1,218079,217598,481
4404421,32.1798,28.9044,486,32483,0.192356,0.53,1,218112,217626,486
4407341,106.436,36.1809,573,32548,0.238471,0.37,1,218237,217664,573
4410261,46.0872,116.036,468,32613,0.279694,0.37,1,218268,217800,468
4413181,37.2174,49.6072,470,32678,0.319939,0.25,1,218303,217833,470
4416101,38.6435,40.3214,471,32743,0.311988,0.19,1,218342,217871,471
4419021,9.3287,40.8643,432,32808,0.310398,0.19,1,218344,217912,432
4421941,26.6657,33.7729,431,32872,0.35808,0.23,1,218375,217944,431
4424861,30.1331,32.3546,430,32936,0.383616,0.15,1,218406,217976,430
4427781,41.2266,42.4709,429,33000,0.356723,0.17,1,218450,218021,429
4430701,33.8453,32.4942,431,33064,0.431345,0.21,1,218482,218051,431
4433621,29.9691,28.8988,432,33128,0.462269,0.19,1,218511,218079,432
4436541,32.3938,32.1798,432,33192,0.500454,0.25,1,218544,218112,432
4439461,108.079,106.436,434,33256,0.556091,0.29,1,218671,218237,434
4442381,48.0158,46.0872,436,33320,0.599218,0.33,1,218704,218268,436
4445301,37.6031,37.2174,436,33383,0.559844,0.31,1,218739,218303,436
4448221,40.3206,38.6435,438,33446,0.567969,0.31,1,218780,218342,438
4451141,9.66413,9.3287,438,33509,0.569594,0.37,1,218782,218344,438
4454061,26.7328,26.6657,438,33572,0.585919,0.39,1,218813,218375,438
4456981,30.9466,30.1331,439,33635,0.621184,0.35,1,218845,218406,439
4459901,41.3893,41.2266,439,33698,0.660237,0.45,1,218889,218450,439
4462821,36.2779,33.8453,442,33761,0.636047,0.47,1,218924,218482,442
4465741,33.6556,29.9691,446,33824,0.647209,0.51,1,218957,218511,446
4468661,33.9311,32.3938,447,33887,0.665442,0.57,1,218991,218544,447
4471581,109.986,108.079,449,33949,0.701088,0.61,1,219120,218671,449
4474501,49.1972,48.0158,450,34011,0.708218,0.55,1,219154,218704,450
4477421,37.0394,37.6031,449,34073,0.709643,0.57,1,219188,218739,449
4480341,41.0079,40.3206,450,34135,0.741929,0.57,1,219230,218780,450
4483261,9.80158,9.66413,450,34197,0.716386,0.59,1,219232,218782,450
4486181,27.5603,26.7328,451,34259,0.743277,0.59,1,219264,218813,451
4489101,31.9121,5.34656,484,34321,0.748655,0.63,1,219297,218813,484
4492021,42.3824,26.6693,497,34383,0.765731,0.67,2,219342,218845,497
4494941,35.6765,40.5339,487,34444,0.737146,0.63,1,219376,218889,487
4497861,32.7353,36.1068,484,34505,0.747429,0.65,1,219408,218924,484
4500781,34.5471,33.6214,486,34566,0.797486,0.67,2,219443,218957,486
4503701,111.709,33.9243,583,34627,0.823497,0.71,2,219574,218991,583
4506621,51.1419,109.985,490,34688,0.812699,0.71,2,219610,219120,490
4509541,37.4284,49.197,490,34749,0.81054,0.71,2,219644,219154,490
4512461,41.0857,37.0394,498,34810,0.810108,0.75,2,219686,219188,498
4515381,9.81713,41.0079,458,34871,0.810022,0.71,2,219688,219230,458
4518301,29.9634,9.80158,491,34932,0.826004,0.75,2,219723,219232,491
4521221,31.5927,27.5603,491,34993,0.813201,0.75,2,219755,219264,491
4524141,41.5185,31.9121,502,35053,0.82664,0.77,2,219799,219297,502
4527061,35.5037,42.3824,491,35113,0.845328,0.73,2,219833,219342,491
4529981,33.5007,35.6765,490,35173,0.849066,0.75,2,219866,219376,490
4532901,37.1001,32.7353,496,35233,0.849813,0.81,2,219904,219408,496
4535821,113.02,34.5471,593,35293,0.921963,0.83,2,220036,219443,593
4646781,42,53,504,37502,0.63,1,1,221540,221036,504
4649701,40.4,39.4,508,37558,0.582,1,1,221580,221072,508
4652621,28.08,31.88,503,37614,0.4924,1,1,221605,221102,503
4655541,30.416,23.176,513,37670,0.42648,1,1,221636,221123,513
4658461,31.6832,27.0352,517,37726,0.333296,1,1,221668,221151,517
4661381,28.7366,29.407,515,37782,0.234659,1,1,221696,221181,515
4664301,19.3473,29.8814,502,37838,0.182932,1,1,221713,221211,502
4667221,22.2695,18.7763,509,37894,0.204586,1,1,221736,221227,509
4670141,30.0539,31.7553,506,37950,0.192917,1,1,221768,221262,506
4673061,30.0108,30.3511,506,38006,0.158583,1,1,221798,221292,506
4675981,107.602,30.0702,603,38062,0.119717,0.83,1,221925,221322,603
4678901,43.9204,121.214,487,38118,0.0959433,0.75,1,221953,221466,487
4681821,40.7841,49.8428,495,38173,0.187189,0.63,1,221993,221498,495
4684741,36.1568,43.5686,488,38228,0.269438,0.57,1,222028,221540,488
4687661,21.6314,40.7137,466,38283,0.269888,0.47,1,222046,221580,466
4690581,27.5263,28.1427,470,38338,0.253978,0.41,1,222075,221605,470
4693501,29.5053,30.4285,469,38393,0.314795,0.31,1,222105,221636,469
4696421,21.9011,31.6857,457,38448,0.294959,0.21,1,222125,221668,457
4699341,17.1802,28.7371,445,38503,0.290992,0.17,1,222141,221696,445
4702261,21.836,19.3474,451,38558,0.290198,0.21,1,222164,221713,451
4705181,30.7672,22.2695,461,38613,0.38604,0.19,1,222197,221736,461
4708101,7.75344,30.0539,431,38668,0.405208,0.15,1,222199,221768,431
4711021,21.5507,30.0108,426,38723,0.489042,0.11,1,222224,221798,426
4713941,105.91,107.602,426,38778,0.569808,0.09,1,222351,221925,426
4716861,45.982,43.9204,429,38832,0.617962,0.21,1,222382,221953,429
4719781,44.3964,40.7841,433,38886,0.739592,0.29,1,222426,221993,433
4722701,38.4793,36.1568,435,38940,0.811918,0.27,2,222463,222028,435
4725621,22.0959,21.6314,435,38994,0.858384,0.25,2,222481,222046,435
4728541,26.8192,27.5263,434,39048,0.883677,0.33,2,222509,222075,434
4731461,29.3638,29.5053,434,39102,0.856735,0.29,2,222539,222105,434
4734381,23.4728,21.9011,436,39156,0.883347,0.29,2,222561,222125,436
4737301,18.2946,17.1802,437,39210,0.872669,0.29,2,222578,222141,437
4740221,22.8589,21.836,438,39264,0.886534,0.41,2,222602,222164,438
4743141,34.9718,30.7672,443,39318,0.953307,0.41,2,222640,222197,443
4845341,37,41,517,41155,0.83,1,2,223973,223456,517
4848261,27.4,36.2,507,41206,0.742,1,1,223998,223491,507
5017621,38,30,514,44078,0.91,1,2,225970,225456,514
5020541,32.4,35.6,508,44126,0.894,1,2,226001,225493,508
5023461,17.68,30.32,493,44174,0.8748,1,2,226015,225522,493
5026381,24.336,19.664,502,44222,0.82296,1,2,226041,225539,502
5029301,72.0672,27.1328,557,44270,0.812592,1,2,226125,225568,557
5032221,33.6134,73.4266,496,44318,0.794518,1,2,226149,225653,496
5035141,32.3227,34.6853,503,44366,0.806904,1,2,226181,225678,503
5038061,29.6645,28.5371,505,44414,0.841381,1,2,226210,225705,505
5040981,23.5329,30.5074,496,44461,0.848276,0.94,2,226232,225736,496
5043901,6.30658,24.5015,475,44508,0.849655,0.95,2,226234,225759,475
5046821,22.0613,25.7003,475,44555,0.881931,1,2,226260,225785,475
5049741,26.0123,29.9401,471,44602,0.904386,0.95,2,226287,225816,471
5052661,42.8025,46.788,467,44649,0.908877,0.86,2,226334,225867,467
5055581,36.5605,38.9576,465,44696,0.925775,0.89,2,226369,225904,465
5058501,28.9121,30.1915,464,44743,0.929155,0.91,2,226396,225932,464
5061421,34.5824,36.4383,462,44790,0.929831,0.89,2,226432,225970,462
5280421,72,21,528,21997,0.25,0.91,1,228954,228426,528
5283341,89.6,80.2,527,22093,0.266,0.61,1,229048,228521,527
5286261,53.92,92.04,477,22189,0.2692,0.49,1,229093,228616,477
5289181,45.184,64.808,462,22285,0.25384,0.41,1,229136,228674,462
5292101,34.6368,42.5616,457,22380,0.250768,0.39,1,229168,228711,457
5295021,21.3274,30.9123,447,22475,0.282154,0.33,1,229186,228739,447
5297941,61.0655,50.9825,462,22569,0.272431,0.31,1,229257,228795,462
5300861,116.213,79.7965,505,22663,0.318486,0.25,1,229387,228882,505
5303781,97.6426,73.5593,526,22757,0.375697,0.27,1,229480,228954,526
5306701,57.1285,89.9119,479,22850,0.403139,0.27,1,229527,229048,479
5309621,45.0257,53.9824,476,22943,0.408628,0.25,1,229569,229093,476
5312541,34.6051,45.1965,465,23035,0.409726,0.25,1,229601,229136,465
5315461,22.121,34.6393,452,23127,0.409945,0.29,1,229620,229168,452
5318381,59.6242,21.3279,503,23219,0.425989,0.27,1,229689,229186,503
5321301,120.725,61.0656,568,23310,0.541198,0.33,1,229825,229257,568
5324221,100.145,116.213,533,23401,0.56424,0.39,1,229920,229387,533
5327141,58.429,97.6426,488,23492,0.552848,0.41,1,229968,229480,488
5330061,45.2858,57.1285,483,23582,0.55857,0.41,1,230010,229527,483
5332981,35.4572,45.0257,474,23672,0.583714,0.41,1,230043,229569,474
5335901,21.4914,34.6051,460,23762,0.588743,0.41,1,230061,229601,460
5338821,60.2983,22.121,511,23851,0.621749,0.43,1,230131,229620,511
5341741,124.86,59.6242,583,23940,0.67635,0.57,1,230272,229689,583
5344661,26.5719,120.725,449,24029,0.68727,0.57,1,230274,229825,449
5347581,82.1144,100.145,450,24117,0.785454,0.55,2,230370,229920,450
5350501,54.0229,58.429,449,24205,0.789091,0.56,2,230417,229968,449
5353421,44.4046,45.2858,449,24293,0.957818,0.59,2,230459,230010,449
5438101,34,137,516,26708,0.39,1,1,232186,231670,516
5441021,68.4,65,546,26787,0.118,1,1,232263,231717,546
5443941,39.28,59.4,520,26866,0.0316,1,1,232295,231775,520
5446861,35.856,45.48,513,26945,0.01432,1,1,232330,231817,513
5449781,41.5712,55.496,498,27024,0.010864,1,1,232373,231875,498
5452701,45.9142,46.2992,501,27102,0.0021728,1,1,232420,231919,501
5455621,31.5828,33.2598,499,27180,0.00043456,0.93,1,232448,231949,499
5458541,31.9166,53.052,473,27258,0.0240869,0.49,1,232480,232007,473
5461461,102.383,126.61,448,27336,0.0448174,0.39,1,232600,232152,448
5464381,39.6767,52.5221,438,27413,0.0329635,0.05,1,232624,232186,438
5467301,58.3353,72.1044,424,27490,0.0145927,0.01,1,232687,232263,424
5470221,38.0671,40.0209,425,27567,0.0109185,0.01,1,232720,232295,425
5473141,34.8134,36.0042,424,27644,0.00218371,0.01,1,232754,232330,424
5476061,40.5627,41.6008,423,27721,0.0564367,0,1,232796,232373,423
5478981,44.9125,45.9202,422,27797,0.0352874,0,1,232842,232420,422
5481901,35.3825,31.584,427,27873,0.0790575,0.03,1,232875,232448,427
5484821,28.6765,31.9168,422,27949,0.0398115,0.05,1,232902,232480,422
5487741,101.735,102.383,422,28025,0.0159623,0.03,1,233022,232600,422
5490661,39.5471,39.6767,422,28101,0.0111925,0.01,1,233046,232624,422
5493581,58.3094,58.3353,422,28176,0.0102385,0.01,1,233109,232687,422
5496501,38.0619,38.0671,422,28251,0.0100477,0,1,233142,232720,422
5499421,35.6124,34.8134,423,28326,0.0100095,0.07,1,233177,232754,423
5502341,39.9225,40.5627,422,28401,0.0260019,0.07,1,233218,232796,422
5505261,47.1845,8.11254,471,28476,0.0292004,0.03,1,233267,232796,471
5508181,35.0369,38.4225,457,28550,0.0298401,0.09,1,233299,232842,457
5511101,26.2074,34.0845,448,28624,0.061968,0.03,1,233323,232875,448
5514021,101.241,28.4169,541,28698,0.0683936,0.01,1,233443,232902,541
5516941,39.4483,101.683,445,28772,0.0856787,0.01,1,233467,233022,445
5519861,58.2897,39.5367,484,28846,0.0571357,0.01,1,233530,233046,484
5522781,38.0579,58.3073,454,28919,0.0354271,0.01,1,233563,233109,454
5525701,36.4116,38.0615,457,28992,0.00708543,0.01,1,233599,233142,457
5528621,39.2823,35.6123,462,29065,0.0734171,0.03,1,233639,233177,462
5531541,48.6565,39.9225,472,29138,0.0146834,0.03,1,233690,233218,472
5534461,36.1313,47.1845,456,29211,0.0269367,0.03,1,233723,233267,456
5537381,24.8263,35.0369,446,29283,0.0613873,0.07,1,233745,233299,446
5540301,103.365,26.2074,545,29355,0.0682775,0.07,1,233868,233323,545
5543221,38.273,101.241,447,29427,0.0696555,0.09,1,233890,233443,447
5546141,56.4546,39.4483,484,29499,0.0699311,0.05,1,233951,233467,484
5549061,37.6909,58.2897,454,29571,0.0539862,0.03,1,233984,233530,454
5551981,38.7382,38.0579,460,29643,0.0187972,0,1,234023,233563,460
5554901,39.7476,36.4116,464,29714,0.0597594,0.09,1,234063,233599,464
5557821,47.1495,39.2823,473,29785,0.0119519,0,1,234112,233639,473
5560741,11.0299,48.6565,424,29856,0.0103904,0.03,1,234114,233690,424
5563661,29.406,36.1313,425,29927,0.0100781,0.07,1,234148,233723,425
5566581,23.4812,24.8263,425,29998,0.0100156,0.07,1,234170,233745,425
5569501,103.096,103.365,425,30069,0.0740031,0.07,1,234293,233868,425
5572421,38.2192,38.273,425,30139,0.0708006,0.07,1,234315,233890,425
5575341,56.4438,56.4546,425,30209,0.11816,0.05,1,234376,233951,425
5578261,35.2888,37.6909,422,30279,0.031632,0.01,1,234406,233984,422
5581181,39.0578,38.7382,423,30349,0.0143264,0.07,1,234446,234023,423
5584101,41.4116,39.7476,425,30419,0.0588653,0,1,234488,234063,425
5587021,45.0823,47.1495,422,30489,0.0837731,0.01,1,234534,234112,422
5589941,10.6165,11.0299,422,30558,0.0887546,0.01,1,234536,234114,422
5592861,29.3233,29.406,422,30627,0.121751,0.01,1,234570,234148,422
5595781,23.4647,23.4812,422,30696,0.12835,0.09,1,234592,234170,422
5598701,104.693,103.096,424,30765,0.22567,0.07,1,234717,234293,424
5601621,40.1386,38.2192,426,30834,0.245134,0.13,1,234741,234315,426
5604541,58.4277,56.4438,428,30903,0.265027,0.01,1,234804,234376,428
5607461,30.8855,35.2888,422,30971,0.269005,0.01,1,234828,234406,422
5610381,38.1771,39.0578,422,31039,0.237801,0.07,1,234868,234446,422
5613301,42.8354,41.4116,424,31107,0.24756,0.09,1,234912,234488,424
5616221,45.3671,45.0823,424,31175,0.249512,0.09,1,234958,234534,424
5619141,10.6734,10.6165,424,31243,0.249902,0.13,1,234960,234536,424
5622061,31.7347,29.3233,427,31311,0.24998,0.13,1,234997,234570,427
5624981,23.9469,5.86466,449,31379,0.217996,0.13,1,235019,234570,449
5627901,107.989,18.7729,556,31446,0.259599,0.25,1,235148,234592,556
5630821,40.7979,103.755,455,31513,0.26792,0.25,1,235172,234717,455
5633741,60.9596,39.9509,497,31580,0.317584,0.27,1,235238,234741,497
5636661,31.3919,58.3902,458,31647,0.327517,0.27,1,235262,234804,458
5639581,35.8784,30.878,471,31714,0.313503,0.23,1,235299,234828,471
5642501,42.3757,38.1756,475,31781,0.358701,0.25,1,235343,234868,475
5645421,45.2751,42.8351,477,31848,0.36774,0.25,1,235389,234912,477
5648341,10.655,45.367,433,31914,0.369548,0.25,1,235391,234958,433
5651261,31.731,10.6734,468,31980,0.41791,0.25,1,235428,234960,468
5654181,23.9462,31.7347,453,32046,0.443582,0.21,1,235450,234997,453
5657101,110.389,23.9469,563,32112,0.480716,0.27,1,235582,235019,563
5660021,41.2778,107.989,458,32178,0.504143,0.27,1,235606,235148,458
5662941,63.4556,40.7979,503,32244,0.540829,0.33,1,235675,235172,503
5665861,31.8911,60.9596,461,32310,0.564166,0.33,1,235699,235238,461
5668781,36.7782,31.3919,475,32375,0.568833,0.31,1,235737,235262,475
5671701,43.3556,35.8784,483,32440,0.569767,0.37,1,235782,235299,483
5674621,45.4711,42.3757,485,32505,0.569953,0.37,1,235828,235343,485
5677541,10.6942,45.2751,441,32570,0.569991,0.37,1,235830,235389,441
5680461,34.1388,10.655,479,32635,0.537998,0.43,1,235870,235391,479
5683381,26.0278,31.731,466,32700,0.5476,0.45,1,235894,235428,466
5686301,111.606,23.9462,577,32765,0.61352,0.49,1,236027,235450,577
5689221,23.9211,110.389,447,32830,0.626704,0.51,1,236029,235582,447
5692141,23.9842,41.2778,447,32894,0.645341,0.55,1,236053,235606,447
5695061,61.5968,63.4556,449,32958,0.665068,0.57,1,236124,235675,449
5697981,32.3194,31.8911,450,33022,0.733014,0.57,1,236149,235699,450
5700901,36.8639,36.7782,450,33086,0.762603,0.57,2,236187,235737,450
5703821,43.3728,43.3556,450,33150,0.768521,0.57,2,236232,235782,450
5706741,45.4746,45.4711,450,33214,0.769704,0.57,2,236278,235828,450
5709661,10.6949,10.6942,450,33278,0.769941,0.53,2,236280,235830,450
5712581,32.539,34.1388,448,33342,0.769988,0.55,2,236318,235870,448
5715501,28.1078,26.0278,451,33405,0.737998,0.63,1,236345,235894,451
5718421,114.422,111.606,454,33468,0.827599,0.63,2,236481,236027,454
5721341,24.4843,23.9211,454,33531,0.85352,0.65,2,236483,236029,454
5724261,24.8969,23.9842,455,33594,0.898704,0.67,2,236508,236053,455
5864421,26,26,489,36491,0.91,1,2,238527,238038,489
5867341,35.6,32.4,493,36549,0.814,1,2,238565,238072,493
5870261,33.52,38.48,486,36607,0.7628,1,2,238598,238112,486
5873181,60.304,56.496,492,36665,0.67256,1,1,238665,238173,492
5876101,38.4608,35.2992,495,36723,0.542512,1,1,238698,238203,495
5879021,30.0922,27.8598,497,36781,0.500502,0.99,1,238726,238229,497
5881941,17.2184,28.772,482,36838,0.4281,1,1,238740,238258,482
5884861,94.6437,94.5544,485,36895,0.31762,1,1,238854,238369,485
5887781,50.9287,54.1109,481,36952,0.151524,1,1,238894,238413,481
5890701,34.9857,38.8222,477,37009,0.166305,0.92,1,238925,238448,477
5893621,28.5971,35.7644,469,37066,0.121261,0.91,1,238952,238483,469
5896541,16.9194,21.5529,465,37123,0.0642522,0.91,1,238966,238501,465
5899461,24.1839,25.1106,465,37180,0.0528504,0.91,1,238992,238527,465
5902381,33.6368,5.02212,501,37237,0.0185701,0.79,1,239028,238527,501
5905301,27.5274,31.4044,489,37294,0.059714,0.75,1,239054,238565,489
5908221,56.7055,32.6809,520,37351,0.0519428,0.65,1,239118,238598,520
5911141,33.7411,60.1362,481,37408,0.0983886,0.51,1,239146,238665,481
5914061,24.3482,38.4272,470,37464,0.0916777,0.49,1,239168,238698,470
5916981,13.6696,30.0854,453,37520,0.106336,0.41,1,239179,238726,453
5919901,85.1339,17.2171,542,37576,0.189267,0.29,1,239282,238740,542
5922821,47.4268,94.6434,466,37632,0.237853,0.11,1,239320,238854,466
5925741,35.0854,50.9287,458,37688,0.215571,0.17,1,239352,238894,458
5928661,25.4171,34.9857,450,37744,0.227114,0.11,1,239375,238925,450
5931581,15.4834,28.5971,436,37800,0.277423,0.05,1,239388,238952,436
5934501,23.0967,16.9194,447,37856,0.239485,0.05,1,239413,238966,447
5937421,35.8193,24.1839,460,37912,0.231897,0.01,1,239452,238992,460
5940341,28.7639,33.6368,451,37968,0.262379,0.07,1,239479,239028,451
5943261,55.3528,27.5274,487,38024,0.300476,0.05,1,239541,239054,487
5946181,34.2706,56.7055,452,38080,0.308095,0.11,1,239570,239118,452
5949101,25.2541,33.7411,447,38135,0.309619,0.09,1,239593,239146,447
5952021,14.6508,24.3482,437,38190,0.325924,0.11,1,239605,239168,437
5954941,87.7302,13.6696,532,38245,0.377185,0.21,1,239711,239179,532
5957861,51.146,85.1339,471,38300,0.355437,0.25,1,239753,239282,471
5960781,35.8292,47.4268,465,38355,0.367087,0.21,1,239785,239320,465
5963701,26.3658,35.0854,457,38410,0.385417,0.23,1,239809,239352,457
5966621,14.8732,25.4171,446,38465,0.389083,0.29,1,239821,239375,446
5969541,23.7746,15.4834,459,38520,0.389817,0.23,1,239847,239388,459
5972461,34.3549,23.0967,471,38575,0.405963,0.23,1,239884,239413,471
5975381,8.47099,35.8193,434,38630,0.409193,0.27,1,239886,239452,434
5978301,24.0942,28.7639,435,38685,0.409839,0.31,1,239914,239479,435
5981221,56.8188,55.3528,438,38740,0.473968,0.31,1,239979,239541,438
5984141,33.7638,34.2706,437,38795,0.534794,0.31,1,240007,239570,437
5987061,25.9528,25.2541,438,38849,0.538959,0.33,1,240031,239593,438
5989981,14.7906,14.6508,438,38903,0.531792,0.39,1,240043,239605,438
5992901,90.1581,87.7302,441,38957,0.514358,0.35,1,240152,239711,441
5995821,50.8316,51.146,440,39011,0.526872,0.37,1,240193,239753,440
5998741,36.5663,35.8292,441,39065,0.513374,0.39,1,240226,239785,441
6001661,26.5133,26.3658,441,39119,0.526675,0.39,1,240250,239809,441
6004581,14.9027,14.8732,441,39173,0.497335,0.39,1,240262,239821,441
6007501,23.7805,23.7746,441,39227,0.507467,0.41,1,240288,239847,441
6010421,35.1561,34.3549,442,39281,0.557493,0.41,1,240326,239884,442
6013341,8.63122,8.47099,442,39335,0.567499,0.41,1,240328,239886,442
6016261,24.9262,24.0942,443,39389,0.5695,0.49,1,240357,239914,443
6019181,60.1852,56.8188,447,39443,0.5859,0.55,1,240426,239979,447
6022101,34.437,33.7638,447,39497,0.58918,0.54,1,240454,240007,447
6025021,26.8874,25.9528,448,39550,0.805836,0.53,2,240479,240031,448
6027941,14.9775,14.7906,448,39603,0.873167,0.51,2,240491,240043,448
6030861,89.3955,90.1581,447,39656,0.934633,0.53,2,240599,240152,447
6033781,49.8791,50.8316,446,39709,0.946927,0.51,2,240639,240193,446
6036701,36.3758,36.5663,446,39762,0.933385,0.53,2,240672,240226,446
6176861,33,34,498,42235,0.65,1,1,242347,241849,498
6179781,30.6,29.2,500,42285,0.554,1,1,242377,241877,500
6182701,30.92,25.84,506,42335,0.4868,1,1,242408,241902,506
6185621,36.584,24.368,520,42385,0.40936,1,1,242446,241926,520
6188541,68.1168,80.8736,501,42435,0.297872,1,1,242522,242021,501
6191461,44.0234,59.3747,485,42485,0.291574,1,1,242560,242075,485
6194381,40.0047,42.2749,486,42535,0.210315,0.98,1,242599,242113,486
6197301,30.4009,31.655,485,42585,0.162063,1,1,242627,242142,485
6200221,18.8802,19.931,484,42635,0.136413,1,1,242643,242159,484
6203141,25.376,27.9862,481,42684,0.147283,0.95,1,242670,242189,481
6206061,26.6752,35.1972,471,42733,0.117457,0.84,1,242697,242226,471
6208981,22.135,27.8394,466,42782,0.159491,0.81,1,242718,242252,466
6211901,22.027,26.3679,462,42831,0.135898,0.71,1,242740,242278,462
6214821,28.4054,34.0736,456,42880,0.13118,0.65,1,242770,242314,456
6217741,28.8811,33.2147,452,42929,0.0982359,0.53,1,242799,242347,452
6220661,23.3762,30.6429,444,42978,0.107647,0.47,1,242821,242377,444
6223581,27.8752,30.9286,442,43027,0.0775294,0.47,1,242850,242408,442
6226501,35.175,6.18572,479,43076,0.0875059,0.39,1,242887,242408,479
6229421,60.635,31.6371,508,43125,0.105501,0.27,1,242954,242446,508
6232341,40.127,67.1274,467,43174,0.0931002,0.29,1,242989,242522,467
6235261,36.8254,43.8255,465,43223,0.12262,0.19,1,243025,242560,465
6238181,31.3651,39.9651,456,43272,0.128524,0.15,1,243055,242599,456
6241101,18.273,30.393,443,43321,0.113705,0.13,1,243070,242627,443
6244021,26.0546,18.8786,455,43370,0.174741,0.15,1,243098,242643,455
6246941,26.8109,25.3757,455,43419,0.202948,0.11,1,243125,242670,455
6249861,20.5622,26.6751,447,43468,0.19259,0.17,1,243144,242697,447
6252781,21.7124,22.135,448,43517,0.222518,0.13,1,243166,242718,448
6255701,28.3425,22.027,456,43565,0.196504,0.13,1,243196,242740,456
6258621,27.2685,28.4054,453,43613,0.207301,0.09,1,243223,242770,453
6261541,23.8537,28.8811,447,43661,0.19346,0.11,1,243246,242799,447
6264461,25.5707,23.3762,451,43709,0.238692,0.07,1,243272,242821,451
6267381,36.3141,27.8752,461,43757,0.263738,0.09,1,243311,242850,461
6270301,61.6628,35.175,492,43805,0.332748,0.11,1,243379,242887,492
6273221,40.3326,60.635,460,43853,0.39455,0.09,1,243414,242954,460
6276141,40.0665,40.127,465,43901,0.42291,0.13,1,243454,242989,465
6279061,30.4133,36.8254,457,43949,0.428582,0.13,1,243482,243025,457
6281981,18.8827,31.3651,443,43997,0.445716,0.11,1,243498,243055,443
6284901,27.7765,18.273,458,44045,0.481143,0.19,1,243528,243070,458
6287821,27.9553,26.0546,458,44093,0.488229,0.21,1,243556,243098,458
6290741,19.9911,26.8109,449,44141,0.489646,0.19,1,243574,243125,449
6293661,21.5982,20.5622,452,44189,0.489929,0.23,1,243596,243144,452
6296581,28.3196,21.7124,460,44237,0.489986,0.19,1,243626,243166,460
6299501,29.6639,28.3425,460,44285,0.457997,0.21,1,243656,243196,460
6302421,23.5328,27.2685,455,44333,0.451599,0.19,1,243678,243223,455
6305341,27.1066,23.8537,460,44381,0.41832,0.25,1,243706,243246,460
6308261,38.2213,25.5707,475,44429,0.443664,0.27,1,243747,243272,475
6311181,9.24426,36.3141,438,44476,0.448733,0.35,1,243749,243311,438
6314101,59.4489,61.6628,442,44523,0.529747,0.41,1,243821,243379,442
6317021,39.8898,40.3326,442,44570,0.593949,0.43,1,243856,243414,442
6319941,40.778,40.0665,443,44617,0.62279,0.43,1,243897,243454,443
6322861,31.3556,30.4133,444,44664,0.612558,0.45,1,243926,243482,444
6325781,19.0711,18.8827,444,44711,0.578512,0.49,1,243942,243498,444
6328701,29.4142,27.7765,446,44758,0.571702,0.49,1,243974,243528,446
6331621,28.2828,27.9553,446,44805,0.63434,0.49,1,244002,243556,446
6334541,20.0566,19.9911,446,44852,0.646868,0.49,1,244020,243574,446
6337461,21.6113,21.5982,446,44899,0.617374,0.49,1,244042,243596,446
6340381,28.3223,28.3196,446,44946,0.643475,0.45,1,244072,243626,446
6343301,28.0645,29.6639,444,44993,0.632695,0.45,1,244100,243656,444
6346221,23.2129,23.5328,444,45040,0.630539,0.41,1,244122,243678,444
6349141,25.4426,27.1066,442,45087,0.662108,0.45,1,244148,243706,442
6352061,40.2885,38.2213,445,45134,0.652422,0.45,1,244192,243747,445
6354981,9.6577,9.24426,445,45181,0.650484,0.55,1,244194,243749,445
6357901,61.9315,59.4489,448,45228,0.666097,0.61,1,244269,243821,448
6360821,41.9863,39.8898,450,45275,0.685219,0.63,1,244306,243856,450
6363741,41.9973,40.778,451,45322,0.689044,0.61,1,244348,243897,451
6366661,30.7995,31.3556,450,45369,0.689809,0.57,1,244376,243926,450
6369581,18.9599,19.0711,450,45415,0.705962,0.57,1,244392,243942,450
6372501,30.992,29.4142,452,45461,0.741192,0.65,1,244426,243974,452
6375421,28.5984,28.2828,452,45507,0.780239,0.65,2,244454,244002,452
6378341,20.1197,20.0566,452,45553,0.788048,0.61,2,244472,244020,452
6381261,21.6239,21.6113,452,45599,0.78961,0.65,2,244494,244042,452
6384181,28.3248,28.3223,452,45645,0.821922,0.63,2,244524,244072,452
6387101,28.865,28.0645,453,45691,0.812384,0.63,2,244553,244100,453
6390021,23.373,23.2129,453,45737,0.810477,0.67,2,244575,244122,453
6392941,25.4746,25.4426,453,45783,0.842095,0.65,2,244601,244148,453
6395861,39.4949,40.2885,452,45829,0.864419,0.65,2,244644,244192,452
6398781,9.49898,9.6577,452,45875,0.868884,0.67,2,244646,244194,452
6401701,62.6998,61.9315,453,45921,0.917777,0.67,2,244722,244269,453
6404621,42.14,12.3863,490,45967,0.911555,0.69,2,244759,244269,490
6407541,43.628,32.0773,497,46013,0.926311,0.69,2,244803,244306,497
6609021,61,85,476,22817,0.55,0.79,1,247001,246525,476
6611941,57.8,46.6,496,22910,0.518,0.69,1,247058,246562,496
6614861,89.96,78.92,507,23003,0.5756,0.59,1,247156,246649,507
6617781,71.592,89.384,482,23095,0.57112,0.55,1,247223,246741,482
6620701,46.3184,62.6768,466,23187,0.602224,0.49,1,247263,246797,466
6623621,38.0637,45.3354,461,23278,0.656445,0.45,1,247299,246838,461
6626541,75.6127,32.2671,517,23369,0.731289,0.49,1,247384,246867,517
6629461,67.1225,64.8534,509,23460,0.810258,0.55,2,247449,246940,509
6632381,59.0245,61.7707,505,23550,0.810052,0.51,2,247506,247001,505
6635301,91.8049,57.9541,548,23640,0.81001,0.59,2,247606,247058,548
6638221,71.961,89.9908,517,23730,0.826002,0.57,2,247673,247156,517
6641141,47.1922,71.5982,491,23819,0.8132,0.61,2,247714,247223,491
6644061,40.6384,46.3196,490,23908,0.84264,0.67,2,247753,247263,490
6646981,9.72769,38.0639,456,23997,0.848528,0.75,2,247755,247299,456
6649901,73.9455,75.6128,461,24085,0.913706,0.83,2,247845,247384,461
6749181,56,67,535,26915,0.63,1,1,249854,249319,535
6752101,37.6,67,501,26994,0.63,1,1,249887,249386,501
6755021,70.72,88.6,486,27072,0.598,1,1,249966,249480,486
6757941,66.944,69.72,487,27150,0.5676,0.93,1,250032,249545,487
6760861,43.7888,46.744,484,27228,0.47352,0.99,1,250070,249586,484
6763781,39.1578,39.7488,484,27306,0.486704,1,1,250108,249624,484
6766701,31.8316,45.5498,467,27384,0.489341,0.83,1,250138,249671,467
6769621,36.7663,42.71,463,27461,0.489868,0.73,1,250176,249713,463
6772541,72.1533,76.542,459,27538,0.569974,0.63,1,250257,249798,459
6775461,58.4307,60.1084,458,27615,0.553995,0.63,1,250312,249854,458
6778381,37.2861,38.4217,457,27692,0.550799,0.59,1,250344,249887,457
6781301,61.8572,70.8843,446,27768,0.58216,0.56,1,250412,249966,446
6784221,63.5714,66.9769,444,27844,0.804432,0.45,2,250476,250032,444
6787141,42.3143,43.7954,443,27920,0.840886,0.49,2,250513,250070,443
6790061,38.8629,39.1591,443,27996,0.912177,0.49,2,250551,250108,443
6792981,33.3726,31.8318,445,28072,0.926435,0.49,2,250583,250138,445
6795901,37.8745,36.7664,446,28147,0.913287,0.59,2,250622,250176,446
6798821,75.5749,72.1533,450,28222,0.942657,0.55,2,250707,250257,450
6903941,40,36,494,30806,0.41,1,1,252511,252017,494
6906861,43.2,34.4,504,30875,0.25,1,1,252555,252051,504
6909781,70.24,73.28,498,30944,0.058,1,1,252632,252134,498
6912701,46.848,51.456,493,31012,0.0116,1,1,252673,252180,493
6915621,44.5696,47.8912,490,31080,0.05832,1,1,252717,252227,490
6918541,48.9139,51.9782,487,31148,0.011664,1,1,252767,252280,487
6921461,58.5828,70.3956,473,31216,0.0903328,0.96,1,252828,252355,473
6924381,32.5166,41.2791,465,31284,0.0740666,0.96,1,252854,252389,465
6927301,32.9033,8.25583,498,31352,0.0388133,0.69,1,252887,252389,498
6930221,32.9807,34.4512,490,31419,0.0317627,0.45,1,252920,252430,490
6933141,31.3961,39.6902,480,31486,0.0623525,0.41,1,252951,252471,480
6936061,34.2792,39.938,475,31553,0.0684705,0.21,1,252986,252511,475
6938981,62.8558,43.1876,501,31620,0.0376941,0.01,1,253056,252555,501
6941901,44.5712,70.2375,464,31687,0.0315388,0,1,253096,252632,464
6944821,45.7142,46.8475,469,31754,0.00630776,0.07,1,253142,252673,469
6947741,46.7428,44.5695,472,31821,0.0572616,0,1,253189,252717,472
6950661,59.7486,48.9139,485,31887,0.0834523,0.11,1,253252,252767,485
6953581,31.1497,58.5828,448,31953,0.15269,0.07,1,253276,252828,448
6956501,32.6299,32.5166,455,32019,0.134538,0.03,1,253309,252854,455
6959421,32.926,32.9033,455,32085,0.0829076,0.03,1,253342,252887,455
6962341,33.7852,32.9807,456,32151,0.0725815,0.07,1,253376,252920,456
6965261,33.957,31.3961,459,32217,0.0705163,0.07,1,253410,252951,459
6968181,65.1914,34.2792,497,32283,0.0221033,0.03,1,253483,252986,497
6971101,42.6383,62.8558,464,32349,0.00442065,0.03,1,253520,253056,464
6974021,42.9277,44.5712,467,32414,0.00888413,0,1,253563,253096,467
6976941,49.3855,45.7142,472,32479,0.0257768,0.07,1,253614,253142,472
6979861,60.2771,46.7428,488,32544,0.0291554,0.09,1,253677,253189,488
6982781,32.8554,59.7486,451,32609,0.0458311,0.17,1,253703,253252,451
6985701,32.9711,31.1497,460,32674,0.0651662,0.13,1,253736,253276,460
6988621,28.9942,32.6299,455,32739,0.0850332,0.07,1,253764,253309,455
6991541,7.39884,32.926,424,32804,0.0890067,0.07,1,253766,253342,424
6994461,27.8798,33.7852,423,32868,0.121801,0.07,1,253799,253376,423
6997381,34.376,33.957,425,32932,0.19236,0.01,1,253835,253410,425
7000301,65.2752,65.1914,425,32996,0.206472,0,1,253908,253483,425
7003221,41.855,42.6383,424,33060,0.193294,0.01,1,253944,253520,424
7006141,41.971,42.9277,423,33124,0.0946589,0.03,1,253986,253563,423
7009061,49.1942,49.3855,423,33188,0.0589318,0.03,1,254037,253614,423
7011981,61.0388,60.2771,424,33252,0.0837864,0.05,1,254101,253677,424
7014901,33.0078,32.8554,424,33316,0.0887573,0.07,1,254127,253703,424
7017821,33.8016,32.9711,425,33379,0.0897515,0.09,1,254161,253736,425
