#Ack,ack_ewma(ms),send_ewma(ms),rtt_ratio,cwnd (Bytes),Last Router Ocupation Ack Arriaval(Packets),Last Router Ocupation Packet Sent(Packets),Network Situation,AckArrival(ms),TSInsideAck(ms),RTTAck(ms)
20441,32,36,482,24820,0.01,1,1,291473,290991,482
23361,26.4,7.2,507,26280,0.01,1,1,291498,290991,507
26281,6.88,23.84,481,27740,0.01,0.99,1,291500,291019,481
29201,8.576,13.568,479,29200,0.074,0.99,1,291509,291030,479
32121,19.3152,2.7136,501,30660,0.1508,1,1,291531,291030,501
35041,32.663,22.1427,510,32120,0.11816,0.51,1,291567,291057,510
37961,148.933,195.629,449,33580,0.063632,0.13,1,291745,291296,449
40881,127.387,155.126,426,35040,0.180726,0.13,1,291867,291441,426
43801,47.0773,31.0251,453,36500,0.172145,0.01,1,291894,291441,453
46721,11.0155,31.805,423,37960,0.170429,0.01,1,291896,291473,423
49641,23.0031,26.361,424,39420,0.202086,0.01,1,291922,291498,424
52561,6.20062,5.2722,426,40880,0.176417,0.01,1,291924,291498,426
55481,2.84012,2.65444,426,42340,0.139283,0.09,1,291926,291500,426
58401,8.56802,7.73089,427,43800,0.131857,0.09,1,291936,291509,427
61321,20.1136,1.54618,450,45260,0.194371,0.17,1,291959,291509,450
64241,5.62272,17.9092,430,46720,0.238874,0.11,1,291961,291531,430
67161,30.7245,32.3818,431,48180,0.247775,0.11,1,291998,291567,431
70081,142.145,6.47637,601,49640,0.377555,0.05,1,292168,291567,601
73001,30.029,143.695,425,51100,0.403511,0.21,1,292170,291745,425
75921,107.606,126.339,430,52560,0.440702,0.21,1,292297,291867,430
78841,42.3212,25.2678,456,54020,0.43214,0.17,1,292323,291867,456
81761,10.0642,26.6536,431,55480,0.430428,0.17,1,292325,291894,431
84681,3.61285,6.93071,431,56940,0.430086,0.17,1,292327,291896,431
87601,16.7226,1.38614,451,58400,0.478017,0.21,1,292347,291896,451
90521,4.94451,21.0772,427,59860,0.487603,0.17,1,292349,291922,427
93441,2.5889,5.81545,427,61320,0.489521,0.17,1,292351,291924,427
96361,2.11778,1.16309,429,62780,0.505904,0.13,1,292353,291924,429
99281,2.02356,1.83262,429,64240,0.509181,0.13,1,292355,291926,429
102201,9.20471,8.36652,430,65700,0.605836,0.13,1,292366,291936,430
105121,22.6409,1.6733,456,67160,0.609167,0.21,1,292392,291936,456
108041,6.12819,18.7347,435,68620,0.609833,0.25,1,292394,291959,435
110961,2.82564,5.34693,435,70080,0.609967,0.25,1,292396,291961,435
113881,28.5651,1.06939,470,71540,0.673993,0.25,1,292431,291961,470
116801,7.31303,29.8139,435,73000,0.702799,0.41,1,292433,291998,435
119721,143.063,141.963,442,74460,0.83656,0.41,2,292610,292168,442
122641,30.2125,28.3926,444,75920,0.863312,0.41,2,292612,292168,444
125561,7.6425,7.27851,444,77380,0.868662,0.45,2,292614,292170,444
310981,1,0,432,4380,0.43,0.45,1,295193,294761,432
393121,353.8,344.8,443,5840,0.734,0.45,1,295635,295192,443
396041,72.36,68.96,445,5840,0.7948,0.43,2,295637,295192,445
480721,269,88,636,11862,0.03,0.09,1,298401,297765,636
483641,129,216,482,12041,0.03,0.03,1,298495,298013,482
486561,44.2,92,444,12218,0.046,0.01,1,298518,298074,444
489481,37.64,46.4,445,12392,0.0492,0.03,1,298554,298109,445
492401,223.528,242.88,423,12564,0.20984,0.03,1,298824,298401,423
495321,119.906,123.776,423,12733,0.161968,0.05,1,298918,298495,423
498241,43.1811,43.1552,424,12900,0.168394,0.05,1,298942,298518,424
501161,38.2362,37.431,425,13065,0.185679,0.25,1,298979,298554,425
504081,230.047,223.486,433,13228,0.365136,0.15,1,299257,298824,433
507001,118.809,119.897,430,13389,0.401027,0.17,1,299348,298918,430
509921,42.9619,43.1794,430,13548,0.408205,0.19,1,299372,298942,430
512841,38.9924,38.2359,431,13705,0.441641,0.19,1,299410,298979,431
514301,168.598,7.64718,632,13860,0.480328,0.41,1,299611,298979,632
517221,102.52,223.929,440,14013,0.568066,0.41,1,299697,299257,440
520141,93.3039,117.586,440,14165,0.681613,0.41,1,299788,299348,440
523061,38.6608,42.7172,441,14315,0.688323,0.45,1,299813,299372,441
525981,38.9322,38.9434,442,14463,0.753665,0.49,2,299852,299410,442
528901,243.786,168.589,536,14610,0.814733,0.59,2,300147,299611,536
531821,124.757,102.518,545,14755,0.858947,0.71,2,300242,299697,545
534741,45.7515,93.3035,480,14899,0.867789,0.69,2,300268,299788,480
537661,43.5503,38.6607,498,15042,0.885558,0.77,2,300311,299813,498
540581,10.3101,38.9321,461,15183,0.889112,0.83,2,300313,299852,461
591681,40,70,480,17531,0,1,1,302153,301673,480
594601,55.2,48.4,496,17652,0,1,1,302212,301716,496
597521,47.04,40.88,502,17772,0.024,1,1,302257,301755,502
600441,31.008,39.376,490,17891,0.0128,0.25,1,302284,301794,490
603361,206.202,187.875,515,18010,0.00256,0.03,1,302534,302019,515
606281,42.8403,112.775,423,18128,0.040512,0,1,302536,302113,423
609201,39.7681,54.555,422,18245,0.0081024,0,1,302575,302153,422
612121,56.7536,58.111,424,18361,0.0416205,0.03,1,302636,302212,424
615041,46.5507,47.6222,423,18477,0.0483241,0.01,1,302680,302257,423
617961,30.9101,31.1244,423,18592,0.0816648,0,1,302707,302284,423
620881,206.182,206.225,423,18706,0.072333,0.05,1,302957,302534,423
623801,42.8364,42.845,423,18819,0.0704666,0,1,302959,302536,423
626721,38.9673,39.769,422,18932,0.0700933,0.05,1,302997,302575,422
629641,58.1935,56.7538,424,19044,0.0860187,0.05,1,303060,302636,424
632561,45.2387,46.5508,422,19155,0.0732037,0.09,1,303102,302680,422
635481,32.2477,30.9102,424,19266,0.0386407,0.07,1,303131,302707,424
638401,207.25,206.182,425,19376,0.159728,0.07,1,303382,302957,425
641321,43.0499,42.8364,425,19486,0.215946,0.07,1,303384,302959,425
644241,36.61,38.9673,422,19595,0.227189,0.07,1,303419,302997,422
647161,59.322,7.79346,487,19703,0.101438,0.09,1,303484,302997,487
650081,43.8644,51.9587,464,19811,0.0442876,0.07,1,303524,303060,464
653001,31.9729,43.9917,451,19918,0.0328575,0.03,1,303553,303102,451
654461,167.195,31.9983,623,20025,0.110572,0.19,1,303754,303131,623
657381,81.4389,207.2,432,20131,0.142114,0.23,1,303814,303382,432
660301,17.8878,43.0399,432,20236,0.164423,0.23,1,303816,303384,432
663221,31.5776,36.608,432,20341,0.232885,0.07,1,303851,303419,432
666141,52.7155,59.3216,425,20445,0.278577,0.03,1,303909,303484,425
669061,40.9431,43.8643,423,20549,0.319715,0.03,1,303947,303524,423
671981,31.3886,31.9729,423,20652,0.311943,0.13,1,303976,303553,423
674901,220.678,167.195,490,20755,0.358389,0.15,1,304244,303754,490
677821,45.7355,81.4389,432,20857,0.399678,0.17,1,304246,303814,432
680741,37.9471,17.8878,466,20959,0.359936,0.25,1,304282,303816,466
683661,9.18942,31.5776,433,21060,0.351987,0.29,1,304284,303851,433
686581,51.4379,52.7155,437,21161,0.446397,0.33,1,304346,303909,437
689501,41.4876,40.9431,438,21261,0.481279,0.31,1,304385,303947,438
692421,29.0975,31.3886,435,21361,0.456256,0.37,1,304411,303976,435
695341,224.22,220.678,440,21460,0.531251,0.41,1,304684,304244,440
698261,46.4439,45.7355,440,21559,0.59425,0.35,1,304686,304246,440
701181,38.8888,37.9471,441,21657,0.63885,0.35,1,304723,304282,441
704101,9.37776,9.18942,441,21755,0.64777,0.47,1,304725,304284,441
707021,53.0756,51.4379,443,21852,0.697554,0.49,1,304789,304346,443
709941,42.6151,41.4876,444,21949,0.787511,0.45,2,304829,304385,444
712861,29.323,29.0975,444,22046,0.805502,0.55,2,304855,304411,444
810681,42,40,511,25108,0.55,1,1,307132,306621,511
813601,38.8,38.4,511,25192,0.486,1,1,307170,306659,511
841341,406.16,463.68,439,10220,0.1372,0.07,1,307668,307229,439
842801,294.032,155.136,627,11144,0.08344,0.09,1,307934,307307,627
845721,114.806,197.427,489,11335,0.088688,0.01,1,308004,307515,489
848641,59.7613,115.485,440,11523,0.105738,0.07,1,308050,307610,440
851561,43.9523,47.0971,450,11707,0.0931475,0.07,1,308090,307640,450
854481,280.79,244.619,496,11889,0.21863,0.09,1,308430,307934,496
857401,91.3581,104.924,470,12068,0.243726,0.11,1,308474,308004,470
860321,19.8716,57.7848,426,12244,0.248745,0.09,1,308476,308050,426
863241,34.3743,43.557,424,12418,0.281749,0.25,1,308514,308090,424
866161,286.875,280.711,434,12589,0.28835,0.25,1,308864,308430,434
869081,92.575,91.3423,434,12758,0.33767,0.25,1,308908,308474,434
872001,20.115,19.8685,434,12925,0.363534,0.29,1,308910,308476,434
874921,34.423,34.3737,434,13089,0.416707,0.29,1,308948,308514,434
877841,290.085,286.875,438,13251,0.667341,0.35,1,309302,308864,438
880761,94.8169,92.5749,440,13411,0.733468,0.37,1,309348,308908,440
883681,20.5634,20.115,440,13569,0.714694,0.43,1,309350,308910,440
886601,37.7127,34.423,444,13726,0.710939,0.43,1,309392,308948,444
888061,168.343,6.8846,645,13881,0.710188,0.73,1,309593,308948,645
890981,166.469,284.577,457,14034,0.870038,0.75,2,309759,309302,457
893901,70.0937,93.7154,457,14185,0.902008,0.71,2,309805,309348,457
896821,15.6187,20.3431,457,14335,0.908401,0.71,2,309807,309350,457
952301,40,41,548,16926,0.01,1,1,311779,311231,548
953761,38.4,33.8,554,17051,0.026,1,1,311817,311263,554
972741,380.48,482.76,425,5840,0.0292,0.01,1,312283,311858,425
975661,379.296,370.152,462,6894,0.02984,0.01,1,312662,312200,462
978581,110.259,122.03,445,7203,0.045968,0.03,1,312705,312260,445
981501,326.852,346.006,424,7498,0.0331936,0.05,1,313086,312662,424
984421,101.37,103.601,426,7782,0.0146387,0.05,1,313131,312705,426
985881,181.074,20.7202,627,8055,0.0269277,0.03,1,313332,312705,627
988801,177.015,308.944,422,8319,0.0293855,0.01,1,313508,313086,422
991721,73.803,97.7888,425,8575,0.0618771,0.03,1,313556,313131,425
994641,313.161,180.358,597,8823,0.0523754,0.03,1,313929,313332,597
997561,103.432,176.872,472,9064,0.0344751,0.07,1,313980,313508,472
1000481,22.2864,73.7743,426,9299,0.046895,0.05,1,313982,313556,426
1003401,301.257,313.155,424,9528,0.177379,0.03,1,314353,313929,424
1006321,101.851,103.431,425,9751,0.139476,0.05,1,314405,313980,425
1009241,21.9703,22.2862,425,9969,0.131895,0.21,1,314407,313982,425
1012161,306.794,301.257,432,10182,0.354379,0.13,1,314785,314353,432
1015081,98.1588,101.851,426,10391,0.430876,0.13,1,314831,314405,426
1018001,21.2318,21.9703,426,10596,0.446175,0.41,1,314833,314407,426
1020921,317.846,306.794,440,10797,0.625235,0.41,1,315225,314785,440
1023841,101.169,61.3588,487,10994,0.677047,0.45,1,315272,314785,487
1026761,21.8339,49.0718,443,11187,0.687409,0.45,1,315274,314831,443
1028221,165.167,11.4144,642,11377,0.833482,0.67,2,315475,314833,642
1031141,195.433,315.883,453,11564,0.910696,0.69,2,315678,315225,453
1085161,143,147,497,14807,0.29,0.97,1,317848,317351,497
1088081,199.8,204.6,492,14950,0.082,0.97,1,318062,317570,492
1091001,85.56,61.72,523,15092,0.1204,0.73,1,318119,317596,523
1093921,18.712,67.544,456,15233,0.14408,0.63,1,318121,317665,456
1096841,30.1424,45.5088,449,15372,0.132816,0.29,1,318154,317705,449
1099761,104.428,123.502,429,15510,0.194563,0.03,1,318277,317848,429
1102681,188.086,195.9,424,15647,0.158913,0.13,1,318486,318062,424
1105601,86.4171,84.7801,428,15783,0.199783,0.15,1,318547,318119,428
1108521,18.8834,18.556,428,15918,0.207957,0.13,1,318549,318121,428
1111441,31.7767,30.1112,430,16051,0.177591,0.21,1,318584,318154,430
1114361,107.155,104.422,433,16183,0.267518,0.15,1,318710,318277,433
1117281,185.431,188.084,429,16314,0.413504,0.21,1,318915,318486,429
1120201,86.6862,86.4169,430,16444,0.490701,0.21,1,318977,318547,430
1123121,18.9372,18.8834,430,16573,0.47414,0.17,1,318979,318549,430
1126041,34.1874,31.7767,433,16701,0.550828,0.17,1,319017,318584,433
1128961,107.637,6.35533,559,16828,0.614166,0.29,1,319143,318584,559
1130421,182.328,102.071,634,16954,0.738833,0.45,1,319344,318710,634
1133341,47.6655,184.414,443,17079,0.779767,0.51,2,319358,318915,443
1136261,61.5331,86.4828,446,17203,0.787953,0.47,2,319423,318977,446
1139181,13.9066,18.8966,446,17326,0.789591,0.57,2,319425,318979,446
1142101,35.5813,34.1793,449,17449,0.773918,0.63,2,319466,319017,449
1145021,112.716,107.636,455,17571,0.834784,0.77,2,319598,319143,455
1147941,196.943,182.327,472,17692,0.878957,0.79,2,319816,319344,472
1150861,91.3886,47.6654,523,17812,0.951791,0.79,2,319881,319358,523
1216561,60,123,480,20376,0.55,1,1,321506,321026,480
1219481,209.6,203,504,20480,0.166,1,1,321753,321249,504
1222401,74.72,61.4,519,20584,0.1212,1,1,321794,321275,519
1225321,41.344,47.48,508,20687,0.03224,1,1,321827,321319,508
1228241,42.6688,38.296,515,20790,0.110448,0.97,1,321870,321355,515
1231161,38.9338,46.0592,505,20892,0.11009,0.81,1,321908,321403,505
1234081,42.1868,43.6118,505,20994,0.0940179,0.55,1,321951,321446,505
1237001,10.0374,56.7224,447,21095,0.106804,0.07,1,321953,321506,447
1239921,179.607,208.944,422,21196,0.0453607,0.11,1,322175,321753,422
1242841,70.3215,74.5889,424,21296,0.0810722,0.01,1,322218,321794,424
1245761,38.8643,41.3178,422,21396,0.104214,0.13,1,322249,321827,422
1248681,44.5729,42.6636,425,21495,0.0608429,0.11,1,322295,321870,425
1251601,40.1146,38.9327,426,21594,0.0841686,0.09,1,322334,321908,426
1254521,43.2229,42.1865,427,21692,0.120834,0.11,1,322378,321951,427
1257441,10.2446,10.0373,427,21790,0.160167,0.03,1,322380,321953,427
1260361,175.649,179.607,422,21887,0.0560334,0.09,1,322597,322175,422
1263281,72.7298,70.3215,426,21984,0.0512067,0.11,1,322644,322218,426
1266201,36.146,38.8643,422,22080,0.114241,0.05,1,322671,322249,422
1269121,44.8292,44.5729,423,22176,0.0628483,0.09,1,322718,322295,423
1272041,40.9658,40.1146,424,22272,0.0525697,0.13,1,322758,322334,424
1274961,48.1932,43.2229,430,22367,0.0825139,0.17,1,322808,322378,430
1277881,11.2386,10.2446,430,22462,0.0565028,0.03,1,322810,322380,430
1280801,169.448,175.649,422,22556,0.179301,0.03,1,323019,322597,422
1283721,72.2895,35.1298,470,22650,0.21986,0.05,1,323067,322597,470
1286641,37.6579,44.626,452,22744,0.227972,0.13,1,323096,322644,452
1289561,41.9316,30.5252,468,22837,0.277594,0.05,1,323139,322671,468
1292481,41.9863,43.705,463,22930,0.303519,0.05,1,323181,322718,463
1295401,49.1973,40.741,474,23022,0.372704,0.09,1,323232,322758,474
1298321,11.4395,48.1482,426,23114,0.354541,0.05,1,323234,322808,426
1299781,163.088,11.2296,625,23206,0.462908,0.21,1,323435,322810,625
1302701,44.6176,169.446,431,23297,0.484582,0.23,1,323450,323019,431
1305621,48.9235,72.2892,433,23388,0.520916,0.23,1,323500,323067,433
1308541,32.9847,37.6578,433,23479,0.480183,0.29,1,323529,323096,433
1311461,43.3969,41.9316,436,23569,0.472037,0.31,1,323575,323139,436
1314381,43.8794,41.9863,438,23659,0.486407,0.39,1,323619,323181,438
1317301,50.3759,49.1973,439,23749,0.505281,0.35,1,323671,323232,439
1320221,11.6752,11.4395,439,23838,0.541056,0.49,1,323673,323234,439
1323141,179.935,163.088,460,23927,0.628211,0.49,1,323895,323435,460
1326061,37.587,44.6176,447,24016,0.645642,0.53,1,323897,323450,447
1328981,46.7174,48.9235,446,24104,0.681128,0.47,1,323946,323500,446
1331901,31.7435,32.9847,445,24192,0.704226,0.47,1,323974,323529,445
1334821,43.1487,43.3969,445,24280,0.724845,0.49,1,324020,323575,445
1337741,44.6297,43.8794,446,24367,0.744969,0.51,1,324065,323619,446
1340661,51.3259,50.3759,447,24454,0.748994,0.55,1,324118,323671,447
1343581,11.8652,11.6752,447,24541,0.781799,0.65,2,324120,323673,447
1463301,249,226,487,11862,0.07,0,1,326737,326250,487
1466221,134.6,120.4,499,12041,0.038,0.01,1,326843,326344,499
1469141,51.72,110.48,422,12218,0.0316,0.05,1,326874,326452,422
1472061,39.144,39.696,436,12392,0.03032,0.07,1,326910,326474,436
1474981,209.429,218.339,425,12564,0.062064,0.03,1,327162,326737,425
1477901,125.086,128.468,423,12733,0.0204128,0.03,1,327266,326843,423
1480821,50.6172,50.4936,424,12900,0.00408256,0.03,1,327298,326874,424
1483741,37.3234,38.8987,422,13065,0.0248165,0.07,1,327332,326910,422
1486661,209.865,209.38,423,13228,0.0449633,0.01,1,327585,327162,423
1489581,124.373,125.076,422,13389,0.0329927,0,1,327688,327266,422
1492501,50.4746,50.6152,422,13548,0.0465985,0.03,1,327720,327298,422
1495421,37.2949,37.323,422,13705,0.0333197,0.03,1,327754,327332,422
1496881,168.259,7.46461,623,13860,0.158664,0.05,1,327955,327332,623
1499801,75.2518,203.893,422,14013,0.231733,0.03,1,328007,327585,422
1502721,99.0504,123.179,424,14165,0.0863466,0.05,1,328112,327688,424
1505641,43.8101,50.2357,422,14315,0.137269,0.03,1,328142,327720,422
1508561,35.962,37.2471,422,14463,0.0994539,0.19,1,328176,327754,422
1511481,218.392,168.249,485,14610,0.203891,0.25,1,328440,327955,485
1514401,119.678,75.2499,528,14755,0.240778,0.05,1,328535,328007,528
1517321,51.1357,99.05,457,14899,0.248156,0.15,1,328569,328112,457
1520241,34.2271,43.81,457,15042,0.281631,0.09,1,328599,328142,457
1523161,8.44543,35.962,425,15183,0.288326,0.23,1,328601,328176,425
1526081,219.289,218.392,433,15323,0.337665,0.25,1,328873,328440,433
1529001,119.858,119.678,433,15462,0.411533,0.25,1,328968,328535,433
1531921,53.5716,51.1357,436,15599,0.458307,0.29,1,329005,328569,436
1534841,34.7143,34.2271,436,15735,0.451661,0.29,1,329035,328599,436
1537761,8.54286,8.44543,436,15870,0.482332,0.35,1,329037,328601,436
1540681,220.109,219.289,437,16004,0.664467,0.43,1,329310,328873,437
1543601,123.222,119.858,441,16137,0.732893,0.47,1,329409,328968,441
1546521,56.6443,53.5716,444,16269,0.762579,0.45,2,329449,329005,444
1549441,35.3289,34.7143,444,16400,0.736516,0.49,1,329479,329035,444
1552361,8.66577,8.54286,444,16529,0.731303,0.71,1,329481,329037,444
1555281,228.933,220.109,455,16657,0.794261,0.71,2,329765,329310,455
1558201,126.587,44.0217,556,16784,0.902852,0.75,2,329866,329310,556
1561121,57.3173,88.0043,497,16911,0.94057,0.77,2,329906,329409,497
1642881,211,99,607,8551,0.13,0,1,332511,331904,607
1645801,211.8,183,615,8800,0.034,0,1,332723,332108,615
1647261,203.16,190.2,624,9042,0.0788,0.13,1,332924,332300,624
1650181,54.232,206.84,430,9277,0.08776,0.13,1,332941,332511,430
1651641,171.646,41.368,631,9506,0.017552,0.01,1,333142,332511,631
1654561,37.5293,177.874,423,9730,0.0115104,0.09,1,333146,332723,423
1657481,184.306,196.375,443,9949,0.0263021,0.09,1,333367,332924,443
1660401,194.461,52.8749,623,10163,0.0452604,0.01,1,333564,332941,623
1663321,42.8922,174.575,423,10372,0.0330521,0.03,1,333569,333146,423
1666241,185.378,211.715,423,10577,0.11061,0.05,1,333790,333367,423
1669161,195.476,199.943,424,10778,0.126122,0.05,1,333988,333564,424
1672081,42.2951,39.9886,428,10975,0.161224,0.03,1,333992,333564,428
1673541,169.259,11.9977,624,11169,0.280245,0.13,1,334193,333569,624
1676461,52.2518,179.2,426,11359,0.352049,0.13,1,334216,333790,426
1679381,171.25,194.24,429,11546,0.28641,0.17,1,334417,333988,429
1682301,37.4501,42.048,429,11730,0.273282,0.31,1,334421,333992,429
1685221,193.09,169.21,460,11911,0.414656,0.37,1,334653,334193,460
1688141,197.018,52.2419,635,12089,0.538931,0.27,1,334851,334216,635
1691061,41.0036,171.248,436,12265,0.563786,0.27,1,334853,334417,436
1693981,11.4007,37.4497,436,12438,0.568757,0.45,1,334857,334421,436
1696901,194.28,193.09,444,12609,0.761751,0.57,2,335097,334653,444
1699821,202.856,197.018,451,12778,0.78435,0.57,2,335302,334851,451
1702741,42.1712,41.0036,451,12944,0.78887,0.57,2,335304,334853,451
1705661,11.6342,11.4007,451,13108,0.789774,0.81,2,335308,334857,451
1756761,40,34,516,15770,0.63,1,1,337281,336765,516
1759681,26.4,37.2,501,15905,0.598,1,1,337304,336803,501
1762601,155.68,166.64,490,16039,0.3836,0.73,1,337492,337002,490
1765521,164.736,193.328,457,16171,0.46872,0.67,1,337659,337202,457
1768441,60.9472,69.8656,453,16302,0.533744,0.63,1,337694,337241,453
1771361,40.9894,45.9731,449,16432,0.498749,0.59,1,337730,337281,449
1774281,24.1979,27.5946,446,16561,0.52375,0.33,1,337750,337304,446
1777201,150.44,155.919,440,16689,0.60875,0.33,1,337932,337492,440
1780121,167.688,31.1838,612,16816,0.81775,0.49,2,338104,337492,612
1783041,60.7376,139.837,479,16942,0.87555,0.55,2,338138,337659,479
1785961,43.3475,55.9674,483,17067,0.87111,0.49,2,338177,337694,483
1788881,25.4695,39.9935,468,17191,0.886222,0.53,2,338198,337730,468
1891081,187,203,492,10372,0.45,0.92,1,342837,342345,492
1894001,193.4,210.2,475,10577,0.114,0.77,1,343032,342557,475
1896921,97.88,116.44,456,10778,0.0308,0.77,1,343106,342650,456
1899841,157.176,23.288,628,10975,0.01416,0.45,1,343278,342650,628
1902761,171.435,154.258,616,11169,0.186832,0.03,1,343453,342837,616
1905681,93.487,186.852,495,11359,0.0773664,0.01,1,343527,343032,495
1908601,157.097,96.5703,594,11546,0.0874733,0.01,1,343700,343106,594
1911521,177.819,156.914,605,11730,0.0414947,0.23,1,343883,343278,605
1914441,88.3639,171.383,496,11911,0.00829893,0.05,1,343949,343453,496
1917361,156.073,93.4766,595,12089,0.0736598,0.09,1,344122,343527,595
1920281,33.6146,157.095,425,12265,0.102732,0.03,1,344125,343700,425
1923201,154.723,177.819,427,12438,0.0605464,0,1,344310,343883,427
1926121,81.3446,88.3638,424,12609,0.0521093,0.09,1,344373,343949,424
1929041,154.669,156.073,424,12778,0.0344219,0.11,1,344546,344122,424
1931961,34.1338,33.6146,425,12944,0.0308844,0.05,1,344550,344125,425
1934881,153.227,154.723,423,13108,0.206177,0.05,1,344733,344310,423
1937801,80.2454,81.3446,422,13270,0.161235,0.03,1,344795,344373,422
1940721,155.249,154.669,423,13430,0.104247,0.03,1,344969,344546,423
1943641,34.2498,34.1338,423,13588,0.0928494,0.25,1,344973,344550,423
1946561,160.45,153.227,432,13744,0.12257,0.25,1,345165,344733,432
1949481,76.89,30.6454,488,13899,0.128514,0.15,1,345221,344733,488
1952401,153.778,55.7291,599,14052,0.241703,0.09,1,345394,344795,599
1955321,33.9556,150.346,429,14203,0.264341,0.09,1,345398,344969,429
1958241,160.391,33.2692,617,14353,0.396868,0.13,1,345590,344973,617
1961161,78.4782,160.254,483,14501,0.519374,0.13,1,345648,345165,483
1964081,159.696,76.8508,607,14647,0.639875,0.27,1,345828,345221,607
1967001,35.1391,153.77,438,14792,0.663975,0.27,1,345832,345394,438
1968461,167.828,33.954,635,14936,0.748795,0.43,1,346033,345398,635
1971381,34.3656,160.391,444,15078,0.781759,0.55,2,346034,345590,444
1974301,57.2731,78.4782,449,15219,0.836352,0.55,2,346097,345648,449
2040001,43,47,524,18155,0.65,1,1,348286,347762,524
2042921,96.6,122.2,493,18272,0.634,1,1,348396,347903,493
2045841,51.32,58.84,490,18388,0.6148,1,1,348436,347946,490
2048761,36.664,48.568,477,18503,0.53096,0.83,1,348469,347992,477
2051681,154.533,168.914,462,18618,0.610192,0.75,1,348653,348191,462
2054601,67.7066,75.3827,456,18732,0.594038,0.65,1,348699,348243,456
2057521,47.9413,49.4765,456,18845,0.638808,0.63,1,348742,348286,456
2060441,95.1883,97.8953,453,18958,0.647762,0.61,1,348849,348396,453
2063361,50.2377,51.5791,452,19070,0.633552,0.51,1,348888,348436,452
2066281,32.4475,36.7158,447,19181,0.61471,0.63,1,348916,348469,447
2069201,158.49,154.543,453,19292,0.706942,0.59,1,349106,348653,453
2072121,66.0979,67.7086,450,19402,0.725388,0.65,1,349149,348699,450
2075041,49.2196,47.9417,452,19511,0.761078,0.65,2,349194,348742,452
2077961,95.4439,95.1883,452,19620,0.816216,0.65,2,349301,348849,452
2080881,49.4888,19.0377,490,19728,0.811243,0.63,2,349339,348849,490
2083801,32.2978,35.0075,479,19836,0.842249,0.61,2,349367,348888,479
2159721,48,49,495,22452,0.49,1,1,351307,350812,495
2162641,50.4,46.6,500,22546,0.362,1,1,351358,350858,500
2165561,113.28,9.32,629,22640,0.0804,1,1,351487,350858,629
2168481,79.456,133.064,536,22734,0.07208,0.97,1,351558,351022,536
2171401,51.8912,73.8128,522,22827,0.086416,1,1,351603,351081,522
2174321,67.1782,57.9626,539,22920,0.0732832,0.83,1,351674,351135,539
2177241,44.6356,74.7925,499,23013,0.102657,0.73,1,351713,351214,499
2180161,37.7271,50.9585,490,23105,0.0765313,0.49,1,351749,351259,490
2183081,41.9454,48.5917,485,23197,0.119306,0.33,1,351792,351307,485
2186001,102.789,50.5183,552,23288,0.0798613,0.01,1,351910,351358,552
2188921,78.1578,113.304,495,23379,0.0559722,0.07,1,351982,351487,495
2191841,53.2316,79.4607,471,23470,0.115194,0.09,1,352029,351558,471
2194761,65.8463,51.8921,495,23560,0.0630389,0.07,1,352098,351603,495
2197681,44.3693,67.1784,463,23650,0.0686078,0.11,1,352137,351674,463
2200601,38.4739,44.6357,461,23740,0.117722,0.07,1,352174,351713,461
2203521,45.2948,37.7271,472,23829,0.223544,0.13,1,352221,351749,472
2206441,97.859,41.9454,540,23918,0.260709,0.07,1,352332,351792,540
2209361,21.1718,102.789,424,24007,0.268142,0.05,1,352334,351910,424
2212281,61.8344,78.1578,424,24095,0.221628,0.13,1,352406,351982,424
2215201,53.9669,53.2316,429,24183,0.212326,0.05,1,352458,352029,429
2218121,61.9934,65.8463,424,24271,0.146465,0.07,1,352522,352098,424
2221041,47.5987,44.3693,429,24358,0.149293,0.13,1,352566,352137,429
2223961,38.3197,38.4739,428,24445,0.197859,0.25,1,352602,352174,428
2226881,50.0639,45.2948,434,24532,0.255572,0.27,1,352655,352221,434
2229801,99.6128,97.859,435,24618,0.347114,0.27,1,352767,352332,435
2232721,21.5226,21.1718,435,24704,0.365423,0.21,1,352769,352334,435
2235641,57.9045,61.8344,430,24790,0.401085,0.21,1,352836,352406,430
2238561,53.1809,53.9669,430,24875,0.440217,0.13,1,352888,352458,430
2241481,58.6362,61.9934,426,24960,0.528043,0.15,1,352948,352522,426
2244401,50.1272,47.5987,430,25045,0.513609,0.21,1,352996,352566,430
2247321,39.6254,38.3197,431,25130,0.542722,0.27,1,353033,352602,431
2250241,53.5251,50.0639,435,25214,0.580544,0.37,1,353090,352655,435
2253161,103.505,99.6128,439,25298,0.636109,0.37,1,353206,352767,439
2256081,22.301,21.5226,439,25382,0.647222,0.41,1,353208,352769,439
2259001,58.8602,57.9045,440,25465,0.665444,0.41,1,353276,352836,440
2261921,55.772,11.5809,495,25548,0.669089,0.45,1,353331,352836,495
2264841,61.5544,43.9162,506,25631,0.749818,0.55,1,353394,352888,506
2267761,50.7109,56.7832,494,25714,0.797964,0.51,2,353442,352948,494
2270681,39.7422,49.7566,483,25796,0.807593,0.55,2,353479,352996,483
2273601,55.1484,39.5513,505,25878,0.857519,0.59,2,353538,353033,505
2276521,106.23,53.5103,567,25960,0.931504,0.65,2,353657,353090,567
2279441,22.8459,103.502,453,26042,0.946301,0.65,2,353659,353206,453
2369961,32,0,548,28455,0.83,1,2,355375,354827,548
2372881,28.8,36,531,28529,0.686,1,1,355403,354872,531
2375801,43.36,40.8,536,28603,0.5612,1,1,355450,354914,536
2378721,102.272,55.36,594,28677,0.55224,1,1,355567,354973,594
2381641,60.4544,109.472,521,28751,0.518448,1,1,355617,355096,521
2384561,50.4909,61.0944,520,28825,0.60769,0.89,1,355665,355145,520
2387481,50.0982,49.8189,523,28898,0.689538,1,1,355715,355192,523
2390401,42.8196,52.3638,511,28971,0.673908,0.92,1,355756,355245,511
2393321,44.5639,48.0728,509,29044,0.686782,0.77,1,355801,355292,509
2396241,35.3128,50.4146,491,29117,0.673356,0.83,1,355834,355343,491
2399161,25.4626,35.6829,482,29190,0.702671,0.65,1,355857,355375,482
2402081,40.2925,29.5366,498,29263,0.756534,0.53,2,355901,355403,498
2405001,99.2585,43.5073,565,29335,0.751307,0.55,2,356015,355450,565
2407921,61.4517,102.301,500,29407,0.782261,0.51,2,356067,355567,500
2410841,52.2903,60.4603,500,29479,0.820452,0.63,2,356117,355617,500
2413761,53.6581,50.4921,506,29551,0.82809,0.71,2,356171,355665,506
2416681,41.1316,50.0984,494,29623,0.861618,0.67,2,356209,355715,494
2533481,50,59,522,32357,0.75,1,2,358108,357586,522
2536401,53.2,48.6,530,32422,0.606,1,1,358162,357632,530
2539321,39.44,52.12,513,32487,0.4972,1,1,358198,357685,513
2542241,39.888,44.824,510,32552,0.49144,1,1,358238,357728,510
2545161,51.9776,40.1648,526,32617,0.410288,1,1,358293,357767,526
2548081,30.3955,44.833,505,32682,0.314058,1,1,358318,357813,505
2551001,51.6791,44.1666,518,32747,0.278812,0.97,1,358375,357857,518
2553921,11.9358,43.2333,477,32812,0.271762,1,1,358377,357900,477
2556841,39.9872,43.8467,480,32876,0.174352,0.83,1,358424,357944,480
2559761,46.3974,55.1693,470,32940,0.15487,0.93,1,358472,358002,470
2562681,49.2795,55.8339,464,33004,0.134974,0.75,1,358522,358058,464
2565601,45.0559,51.1668,458,33068,0.0989948,0.57,1,358566,358108,458
2568521,46.6112,53.4334,451,33132,0.059799,0.47,1,358613,358162,451
2571441,32.5222,39.4867,444,33196,0.0839598,0.49,1,358642,358198,444
2574361,35.3044,39.8973,440,33260,0.152792,0.39,1,358678,358238,440
2577281,47.8609,51.9795,436,33324,0.134558,0.29,1,358729,358293,436
2580201,33.5722,30.3959,441,33387,0.162912,0.27,1,358759,358318,441
2583121,45.1144,51.6792,432,33450,0.184582,0.27,1,358807,358375,432
2586041,10.6229,11.9358,432,33513,0.188916,0.15,1,358809,358377,432
2588961,38.9246,39.9872,431,33576,0.253783,0.15,1,358855,358424,431
2591881,41.3849,46.3974,425,33639,0.282757,0.13,1,358897,358472,425
2594801,48.277,49.2795,425,33702,0.320551,0.09,1,358947,358522,425
2597721,45.6554,45.0559,426,33765,0.31211,0.05,1,358992,358566,426
2600641,43.5311,46.6112,422,33828,0.438422,0.09,1,359035,358613,422
2603561,35.9062,32.5222,427,33891,0.447684,0.17,1,359069,358642,427
2606481,36.7812,35.3044,428,33953,0.465537,0.13,1,359106,358678,428
2609401,49.7562,47.8609,430,34015,0.517107,0.17,1,359159,358729,430
2612321,33.9512,33.5722,430,34077,0.543422,0.19,1,359189,358759,430
2615241,46.7902,45.1144,432,34139,0.548684,0.19,1,359239,358807,432
2618161,10.958,10.6229,432,34201,0.549737,0.27,1,359241,358809,432
2621081,41.3916,38.9246,435,34263,0.565947,0.27,1,359290,358855,435
2624001,40.2783,7.78491,475,34325,0.585189,0.29,1,359330,358855,475
2626921,49.6557,35.157,485,34387,0.605038,0.33,1,359382,358897,485
2629841,49.1311,47.0314,484,34448,0.577008,0.31,1,359431,358947,484
2632761,46.6262,45.4063,485,34509,0.635401,0.47,1,359477,358992,485
2635681,37.3252,43.4813,477,34570,0.64708,0.45,1,359512,359035,477
2638601,38.665,35.8963,482,34631,0.665416,0.47,1,359551,359069,482
2641521,51.733,36.7793,500,34692,0.733083,0.53,1,359606,359106,500
2644441,35.1466,49.7559,478,34753,0.762617,0.55,2,359637,359159,478
2647361,45.4293,33.9512,496,34814,0.784523,0.55,2,359685,359189,496
2650281,10.6859,46.7902,448,34875,0.788905,0.55,2,359687,359239,448
2653201,43.7372,10.958,498,34936,0.773781,0.57,2,359739,359241,498
2656121,41.5474,41.3916,490,34997,0.818756,0.59,2,359780,359290,490
2659041,50.7095,40.2783,503,35057,0.891751,0.61,2,359833,359330,503
2676561,33,55,491,35417,0.95,0.77,2,360097,359606,491
2679481,45,35.8,508,35477,0.918,0.79,2,360145,359637,508
2682401,10.6,45.56,462,35537,0.9116,0.79,2,360147,359685,462
2685321,42.92,10.712,511,35596,0.94232,0.77,2,360198,359687,511
2794821,60,44,479,16790,0.03,1,1,361969,361490,479
2813801,427.2,469.6,422,14600,0.03,0.03,1,362488,362066,422
2816721,149.44,133.92,452,16916,0.094,0,1,362568,362116,452
2819641,63.488,66.784,444,17042,0.1548,0.03,1,362610,362166,444
2822561,67.8976,50.1568,467,17167,0.21496,0.03,1,362679,362212,467
2825481,125.58,108.431,484,17291,0.066992,0.07,1,362819,362335,484
2828401,97.9159,100.886,476,17414,0.0373984,0.03,1,362910,362434,476
2831321,89.9832,63.3773,510,17536,0.12748,0.11,1,362998,362488,510
2834241,51.5966,76.6755,472,17657,0.273496,0.17,1,363040,362568,472
2837161,63.9193,48.9351,497,17777,0.350699,0.23,1,363107,362610,497
2840081,121.584,64.987,564,17896,0.25414,0.03,1,363243,362679,564
2843001,97.9168,124.997,516,18015,0.314828,0.03,1,363335,362819,516
2845921,21.1834,97.7995,427,18133,0.326966,0.15,1,363337,362910,427
2848841,79.4367,89.9599,433,18250,0.313393,0.31,1,363431,362998,433
2851761,54.2873,51.592,439,18366,0.294679,0.37,1,363479,363040,439
2854681,65.2575,63.9184,440,18482,0.402936,0.23,1,363547,363107,440
2857601,116.251,121.584,433,18597,0.392587,0.33,1,363676,363243,433
2860521,100.85,97.9167,438,18711,0.406517,0.33,1,363773,363335,438
2863441,21.7701,21.1833,438,18824,0.409303,0.31,1,363775,363337,438
2866361,77.154,79.4367,435,18937,0.473861,0.29,1,363866,363431,435
2869281,56.2308,54.2873,438,19049,0.534772,0.43,1,363917,363479,438
2872201,68.0462,65.2575,441,19160,0.610954,0.39,1,363988,363547,441
2875121,117.609,116.251,442,19271,0.674191,0.41,1,364118,363676,442
2878041,101.122,100.85,442,19381,0.718838,0.41,1,364215,363773,442
2880961,21.8244,21.7701,442,19490,0.727768,0.49,1,364217,363775,442
2883881,79.5649,77.154,445,19599,0.745553,0.49,1,364311,363866,445
2886801,56.713,15.4308,496,19707,0.781111,0.55,2,364362,363866,496
2889721,72.1426,43.8862,521,19815,0.820222,0.63,2,364438,363917,521
2959801,63,66,509,22241,0.43,1,1,366240,365731,509
2962721,45.4,50,504,22336,0.254,1,1,366281,365777,504
2965641,33.08,45.2,490,22431,0.1388,1,1,366311,365821,490
2968561,53.816,57.04,489,22526,0.11576,1,1,366370,365881,489
2971481,98.7632,11.408,599,22620,0.063152,1,1,366480,365881,599
2974401,107.753,107.882,577,22714,0.14863,0.87,1,366590,366013,577
2977321,50.3505,115.176,496,22807,0.101726,0.59,1,366626,366130,496
2980241,50.8701,60.6353,500,22900,0.140345,0.43,1,366677,366177,500
2983161,38.174,62.5271,472,22993,0.180069,0.21,1,366712,366240,472
2986081,26.8348,45.3054,455,23085,0.188014,0.11,1,366736,366281,455
2989001,49.367,33.0611,480,23177,0.237603,0.11,1,366791,366311,480
2991921,98.6734,53.8122,532,23268,0.135521,0.05,1,366902,366370,532
2994841,112.535,98.7624,538,23359,0.211104,0.17,1,367018,366480,538
2997761,49.7069,107.752,462,23450,0.258221,0.09,1,367052,366590,462
3000681,51.5414,50.3505,478,23540,0.267644,0.15,1,367104,366626,478
3003601,40.7083,50.8701,465,23630,0.365529,0.19,1,367142,366677,465
3006521,27.3417,38.174,454,23720,0.433106,0.19,1,367166,366712,454
3009441,51.8683,26.8348,488,23809,0.462621,0.25,1,367224,366736,488
3012361,94.3737,49.367,538,23898,0.484524,0.11,1,367329,366791,538
3015281,117.275,98.6734,550,23987,0.472905,0.23,1,367452,366902,550
3018201,25.0549,112.535,436,24075,0.470581,0.27,1,367454,367018,436
3021121,33.011,49.7069,437,24163,0.470116,0.27,1,367489,367052,437
3024041,48.2022,51.5414,437,24251,0.486023,0.39,1,367541,367104,437
3026961,44.0404,40.7083,442,24338,0.521205,0.45,1,367584,367142,442
3029881,29.6081,27.3417,444,24425,0.576241,0.47,1,367610,367166,444
3032801,53.1216,51.8683,445,24512,0.555248,0.49,1,367669,367224,445
3035721,95.4243,94.3737,446,24598,0.66305,0.47,1,367775,367329,446
3038641,116.685,117.275,445,24684,0.68461,0.47,1,367897,367452,445
3041561,24.937,25.0549,445,24770,0.688922,0.47,1,367899,367454,445
3044481,33.7874,33.011,446,24856,0.737784,0.49,1,367935,367489,446
3047401,49.9575,48.2022,448,24941,0.795557,0.53,2,367989,367541,448
3050321,44.3915,44.0404,448,25026,0.807111,0.59,2,368032,367584,448
3053241,30.4783,29.6081,449,25111,0.841422,0.55,2,368059,367610,449
3056161,53.2957,53.1216,449,25195,0.896284,0.69,2,368118,367669,449
3142301,53,44,528,27605,0.53,1,1,369945,369417,528
3171501,402.6,469.6,442,11680,0.226,0.17,1,370435,369993,442
3174421,194.92,166.72,494,11862,0.1332,0.03,1,370578,370084,494
3177341,189.384,183.744,494,12041,0.09864,0.07,1,370766,370272,494
3180261,75.4768,129.549,425,12218,0.059728,0.09,1,370813,370388,425
3183181,54.2954,46.7098,448,12392,0.0679456,0.11,1,370862,370414,448
3186101,122.059,140.542,423,12564,0.277589,0.09,1,371001,370578,423
3189021,176.412,178.508,425,12733,0.335518,0.05,1,371191,370766,425
3191941,71.2824,73.3017,423,12900,0.411104,0.07,1,371236,370813,423
3194861,55.0565,53.8603,425,13065,0.410221,0.33,1,371287,370862,425
3197781,131.011,121.972,436,13228,0.634044,0.35,1,371437,371001,436
3200701,180.602,176.394,439,13389,0.758809,0.43,2,371630,371191,439
3203621,73.7205,71.2789,441,13548,0.799762,0.41,2,371677,371236,441
3206541,55.5441,55.0558,441,13705,0.823952,0.41,2,371728,371287,441
3257641,47,52,486,16269,0.11,1,1,373611,373125,486
3260561,46.2,40,495,16400,0.062,1,1,373657,373162,495
3263481,31.64,34.4,490,16529,0.0684,0.55,1,373685,373195,490
3266401,83.128,119.68,445,16657,0.10968,0.55,1,373781,373336,445
3267861,177.426,23.936,646,16784,0.045936,0.01,1,373982,373336,646
3270781,42.6851,187.187,427,16911,0.113187,0.11,1,373991,373564,427
3273701,46.137,75.0374,427,17037,0.0786374,0.05,1,374038,373611,427
3276621,45.2274,51.8075,426,17162,0.135727,0.07,1,374083,373657,426
3279541,33.0455,32.7615,428,17286,0.0831455,0.12,1,374113,373685,428
3282461,82.6091,83.3523,427,17409,0.0726291,0.03,1,374208,373781,427
3285381,183.722,177.47,435,17531,0.0385258,0.13,1,374417,373982,435
3288301,72.7444,42.6941,471,17652,0.0317052,0.07,1,374462,373991,471
3291221,52.1489,46.1388,471,17772,0.062341,0.15,1,374509,374038,471
3294141,32.0298,45.2278,453,17891,0.116468,0.07,1,374536,374083,453
3297061,84.806,33.0456,521,18010,0.191294,0.07,1,374634,374113,521
3299981,18.5612,82.6091,428,18128,0.206259,0.03,1,374636,374208,428
3302901,166.912,183.722,423,18245,0.225252,0.03,1,374840,374417,423
3305821,68.5824,72.7444,422,18361,0.21305,0.07,1,374884,374462,422
3308741,53.7165,52.1489,425,18477,0.19461,0.13,1,374934,374509,425
3311661,34.7433,32.0298,428,18592,0.238922,0.21,1,374964,374536,428
3314581,88.5487,84.806,432,18706,0.375784,0.21,1,375066,374634,432
3317501,19.3097,18.5612,432,18819,0.371157,0.23,1,375068,374636,432
3320421,166.262,166.912,431,18932,0.562231,0.21,1,375271,374840,431
3323341,68.4524,68.5824,431,19044,0.632446,0.19,1,375315,374884,431
3326261,55.2905,53.7165,433,19155,0.694489,0.25,1,375367,374934,433
3329181,35.8581,34.7433,434,19266,0.738898,0.41,1,375398,374964,434
3332101,93.5716,88.5487,440,19376,0.77978,0.37,2,375506,375066,440
3335021,20.3143,19.3097,440,19486,0.835956,0.61,2,375508,375068,440
3434301,106,151,447,9933,0,0.03,1,378270,377823,447
3437221,56.4,73.4,437,10147,0.008,0.09,1,378314,377877,437
3440141,231.28,244.28,425,10357,0.1536,0,1,378589,378164,425
3443061,128.656,133.656,422,10562,0.11872,0.01,1,378692,378270,422
3445981,62.5312,61.9312,424,10763,0.031744,0.01,1,378738,378314,424
3447441,173.306,12.3862,625,10961,0.0623488,0.19,1,378939,378314,625
3450361,98.6612,222.477,430,11155,0.24447,0.11,1,379019,378589,430
3453281,98.1322,126.895,425,11346,0.408894,0.01,1,379117,378692,425
3456201,54.0265,62.1791,422,11533,0.377779,0.07,1,379160,378738,422
3459121,244.405,173.236,513,11717,0.227556,0.29,1,379452,378939,513
3462041,134.481,98.6472,540,11898,0.261511,0.45,1,379559,379019,540
3464961,57.2962,98.1294,480,12077,0.316302,0.37,1,379597,379117,480
3467881,13.0592,54.0259,439,12253,0.32726,0.19,1,379599,379160,439
3470801,229.812,244.405,431,12426,0.617452,0.27,1,379883,379452,431
3473721,135.562,134.481,436,12597,0.73949,0.33,1,379995,379559,436
3476641,60.7125,57.2962,440,12766,0.771898,0.33,2,380037,379597,440
3479561,13.7425,13.0592,440,12932,0.77838,0.69,2,380039,379599,440
3482481,242.748,229.812,456,13096,0.675676,0.77,1,380339,379883,456
3485401,140.55,135.562,459,13258,0.799135,0.78,2,380454,379995,459
3530661,45,39,500,15624,0.51,1,1,381995,381495,500
3533581,204.2,211,490,15760,0.11,1,1,382239,381749,490
3536501,76.04,77.4,490,15895,0.046,0.87,1,382283,381793,490
3539421,77.608,101.08,461,16029,0.0492,0.75,1,382361,381900,461
3542341,51.5216,60.216,456,16161,0.00984,0.51,1,382406,381950,456
3545261,36.7043,48.0432,444,16292,0.009968,0.01,1,382439,381995,444
3548181,185.741,204.809,423,16422,0.0419936,0.03,1,382662,382239,423
3551101,71.5482,76.1617,422,16551,0.0963987,0.05,1,382705,382283,422
3554021,78.3096,77.6323,424,16679,0.13928,0.05,1,382785,382361,424
3556941,50.0619,15.5265,467,16806,0.0838559,0,1,382828,382361,467
3559861,35.6124,39.1053,454,16932,0.104771,0.01,1,382860,382406,454
3561321,167.922,34.2211,622,17057,0.0449542,0.05,1,383061,382439,622
3564241,51.9845,185.244,422,17181,0.0649908,0.11,1,383084,382662,422
3567161,45.5969,71.4488,423,17305,0.0689982,0.15,1,383128,382705,423
3570081,74.7194,78.2898,425,17428,0.1018,0.07,1,383210,382785,425
3573001,48.5439,50.058,424,17550,0.12436,0.11,1,383252,382828,424
3575921,36.1088,35.6116,425,17671,0.080872,0.03,1,383285,382860,425
3578841,183.222,167.922,444,17791,0.0561744,0.07,1,383505,383061,444
3581761,74.2444,51.9845,468,17910,0.0672349,0.07,1,383552,383084,468
3584681,84.4489,45.5969,511,18029,0.085447,0.11,1,383639,383128,511
3587601,18.4898,74.7194,431,18147,0.0890894,0.13,1,383641,383210,431
3590521,33.298,48.5439,426,18264,0.0578179,0.07,1,383678,383252,426
3593441,32.2596,36.1088,425,18380,0.147564,0.05,1,383710,383285,425
3596361,180.052,183.222,422,18495,0.213513,0.07,1,383927,383505,422
3599281,76.0104,74.2444,425,18610,0.146703,0.09,1,383977,383552,425
3602201,84.0021,84.4489,424,18724,0.101341,0.09,1,384063,383639,424
3605121,18.4004,18.4898,424,18837,0.108268,0.05,1,384065,383641,424
3608041,34.0801,33.298,425,18950,0.109654,0.17,1,384103,383678,425
3610961,35.616,32.2596,429,19062,0.173931,0.23,1,384139,383710,429
3613881,182.323,180.052,431,19173,0.362786,0.13,1,384358,383927,431
3616801,72.4646,76.0104,426,19284,0.432557,0.09,1,384403,383977,426
3619721,84.0929,84.0021,427,19394,0.462511,0.11,1,384490,384063,427
3622641,18.4186,18.4004,427,19503,0.500502,0.11,1,384492,384065,427
3625561,34.8837,34.0801,428,19612,0.5081,0.11,1,384531,384103,428
3628481,37.3767,6.81602,466,19720,0.52562,0.19,1,384569,384103,466
3629941,168.275,30.1632,631,19828,0.705124,0.41,1,384770,384139,631
3632861,56.0551,181.233,440,19935,0.741025,0.45,1,384798,384358,440
3635781,49.611,72.2465,443,20041,0.796205,0.47,2,384846,384403,443
3638701,81.9222,84.0493,446,20147,0.919241,0.51,2,384936,384490,446
3717541,151,172,490,9469,0.33,0.86,1,387179,386689,490
3720461,193.4,217.6,465,9694,0.33,0.63,1,387383,386918,465
3723381,113.88,131.52,449,9913,0.41,0.33,1,387477,387028,449
3726301,133.976,147.104,437,10128,0.522,0.33,1,387616,387179,437
3729221,189.195,192.621,436,10338,0.6084,0.43,1,387819,387383,436
3732141,118.639,113.724,443,10544,0.65768,0.55,1,387920,387477,443
3735061,140.528,133.945,450,10746,0.683536,0.55,1,388066,387616,450
3736521,188.906,26.789,651,10944,0.768707,0.63,2,388267,387616,651
3739441,41.7811,167.758,453,11138,0.801741,0.67,2,388272,387819,453
3742361,89.1562,114.352,453,11329,0.920348,0.69,2,388373,387920,453
3786161,87,0,601,13877,0,1,1,390300,389699,601
3789081,143,89.6,646,14030,0.056,1,1,390457,389811,646
3792001,66.2,159.52,516,14181,0.1952,0.79,1,390504,389988,516
3794921,126.84,76.704,602,14331,0.12704,0.29,1,390646,390044,602
3797841,86.168,150.541,509,14479,0.065408,0,1,390722,390213,509
3800761,143.634,99.7082,580,14626,0.0130816,0.07,1,390880,390300,580
3803681,73.5267,145.542,479,14771,0.138616,0.23,1,390936,390457,479
3806601,123.505,66.7083,568,14915,0.371723,0.11,1,391072,390504,568
3809521,81.5011,126.942,497,15057,0.450345,0.05,1,391143,390646,497
3812441,17.9002,86.1883,423,15198,0.466069,0,1,391145,390722,423
3815361,129.98,143.638,423,15338,0.389214,0.17,1,391303,390880,423
3818281,78.796,73.5275,433,15476,0.453843,0.43,1,391369,390936,433
3821201,132.559,123.506,443,15613,0.466769,0.47,1,391515,391072,443
3824121,84.9118,81.5011,445,15749,0.533354,0.47,1,391588,391143,445
3827041,18.5824,17.9002,445,15884,0.546671,0.37,1,391590,391145,445
3829961,123.716,129.98,437,16018,0.629334,0.47,1,391740,391303,437
3832881,83.9433,78.796,445,16151,0.837867,0.47,2,391814,391369,445
3888361,48,49,505,18487,0.11,1,1,393535,393030,505
3891281,75.2,90.6,486,18602,0.11,1,1,393617,393131,486
3894201,102.24,91.72,503,18716,0.062,1,1,393726,393223,503
3897121,40.448,44.744,495,18829,0.0124,0.85,1,393751,393256,495
3900041,92.0896,120.949,460,18942,0.20248,0.23,1,393856,393396,460
3902961,69.6179,96.9898,433,19054,0.224496,0.11,1,393920,393487,433
3905881,45.9236,57.798,425,19165,0.212899,0.11,1,393960,393535,425
3908801,76.3847,77.1596,427,19276,0.0825798,0.05,1,394044,393617,427
3911721,100.877,102.632,425,19386,0.024516,0,1,394151,393726,425
3914641,40.1754,40.5264,425,19495,0.0449032,0.25,1,394176,393751,425
3917561,97.6351,92.1053,432,19604,0.176981,0.25,1,394288,393856,432
3920481,67.527,18.4211,492,19712,0.203396,0.23,1,394348,393856,492
3923401,46.3054,54.8842,469,19820,0.208679,0.21,1,394389,393920,469
3926321,73.2611,42.9768,509,19927,0.209736,0.05,1,394469,393960,509
3929241,97.0522,75.7954,528,20033,0.145947,0.01,1,394572,394044,528
3932161,49.8104,100.759,459,20139,0.0851894,0.05,1,394610,394151,459
3935081,95.5621,40.1518,541,20244,0.153038,0.21,1,394717,394176,541
3938001,68.7124,97.6304,491,20349,0.214608,0.21,1,394779,394288,491
3940921,47.3425,67.5261,473,20453,0.210922,0.21,1,394821,394348,473
3943841,71.0685,46.3052,509,20557,0.242184,0.21,1,394898,394389,509
3946761,93.4137,73.261,528,20660,0.232437,0.13,1,394997,394469,528
3949681,48.2827,97.0522,462,20763,0.278487,0.07,1,395034,394572,462
3952601,100.057,49.8104,537,20865,0.479697,0.17,1,395147,394610,537
3955521,71.2113,95.5621,494,20967,0.63194,0.23,1,395211,394717,494
3958441,15.8423,68.7124,434,21068,0.662388,0.21,1,395213,394779,434
3961361,36.7685,47.3425,434,21169,0.684478,0.25,1,395255,394821,434
3964281,68.9537,71.0685,434,21269,0.800896,0.23,2,395332,394898,434
3967201,92.1907,93.4137,433,21369,0.840179,0.29,2,395430,394997,433
3970121,50.4381,48.2827,436,21468,0.880036,0.53,2,395470,395034,436
3973041,110.888,100.057,449,21567,0.904007,0.67,2,395596,395147,449
3975961,78.1775,71.2113,455,21665,0.932801,0.67,2,395666,395211,455
4060641,44,47,487,24343,0.85,1,2,397549,397062,487
4063561,66.4,61.4,494,24430,0.77,1,2,397621,397127,494
4066481,54.08,48.28,500,24517,0.594,1,1,397672,397172,500
4069401,50.816,54.456,494,24603,0.5588,1,1,397722,397228,494
4072321,54.9632,47.6912,504,24689,0.43976,1,1,397778,397274,504
4075241,41.3926,47.1382,495,24775,0.399952,0.92,1,397816,397321,495
4078161,32.2785,41.4276,485,24861,0.50399,0.89,1,397846,397361,485
4081081,108.056,123.486,468,24946,0.476798,0.85,1,397973,397505,468
4084001,54.4111,59.8971,465,25031,0.50336,0.75,1,398014,397549,465
4086921,64.4822,69.5794,460,25116,0.508672,0.55,1,398081,397621,460
4089841,48.8964,54.7159,454,25200,0.573734,0.55,1,398126,397672,454
4092761,44.9793,50.9432,448,25284,0.618747,0.41,1,398170,397722,448
4095681,53.7959,54.9886,448,25368,0.739749,0.39,1,398226,397778,448
4098601,37.9592,41.3977,444,25452,0.69995,0.39,1,398260,397816,444
4101521,33.9918,8.27954,477,25535,0.73999,0.53,1,398293,397816,477
4104441,104.398,25.6559,569,25618,0.811998,0.47,2,398415,397846,569
4107361,55.2797,106.731,485,25701,0.8104,0.51,2,398458,397973,485
4110281,66.2559,54.1462,513,25783,0.84208,0.51,2,398527,398014,513
4113201,50.8512,64.4292,493,25865,0.832416,0.59,2,398574,398081,493
4116121,50.1702,48.8858,498,25947,0.894483,0.63,2,398624,398126,498
4206641,41,60,488,28367,0.69,1,1,400400,399912,488
4209561,44.2,12,533,28442,0.722,1,1,400445,399912,533
4212481,48.04,29.6,548,28516,0.7524,1,2,400494,399946,548
4215401,35.208,49.12,526,28590,0.76648,1,2,400526,400000,526
4218321,42.2416,49.024,521,28664,0.705296,1,1,400570,400049,521
4221241,47.6483,36.2048,537,28738,0.581059,0.99,1,400619,400082,537
4224161,42.3297,52.841,521,28812,0.428212,1,1,400660,400139,521
4227081,46.0659,49.7682,519,28885,0.381642,0.96,1,400707,400188,519
4230001,95.6132,46.7536,581,28958,0.388328,0.75,1,400815,400234,581
4232921,48.7226,109.351,493,29031,0.389666,0.69,1,400852,400359,493
4235841,49.7445,54.6701,502,29104,0.373933,0.73,1,400902,400400,502
4238761,53.1489,46.934,511,29177,0.450787,0.76,1,400956,400445,511
4241681,35.4298,48.5868,493,29250,0.498157,0.77,1,400987,400494,493
4244601,33.486,35.3174,494,29322,0.539631,0.69,1,401020,400526,494
4247521,44.2972,42.2635,497,29394,0.531926,0.55,1,401067,400570,497
4250441,34.4594,47.6527,480,29466,0.514385,0.39,1,401099,400619,480
4253361,45.2919,42.3305,487,29538,0.558877,0.37,1,401147,400660,487
4256281,95.4584,46.0661,548,29610,0.679775,0.39,1,401255,400707,548
4259201,47.8917,95.6132,476,29681,0.735955,0.39,1,401291,400815,476
4262121,49.5783,48.7226,489,29752,0.795191,0.37,2,401341,400852,489
4394981,120,82,476,14023,0.01,0.15,1,403665,403189,476
4397901,160,114,524,14175,0.138,0.07,1,403835,403311,524
4400821,47.2,102.8,443,14325,0.1316,0.05,1,403854,403411,443
4403741,35.84,48.56,441,14473,0.17832,0.03,1,403887,403446,441
4406661,167.168,88.912,542,14620,0.107664,0.01,1,404087,403545,542
4409581,174.234,113.782,598,14765,0.173533,0.17,1,404263,403665,598
4412501,50.8467,158.756,448,14909,0.186707,0.13,1,404283,403835,448
4415421,38.1693,46.9513,464,15051,0.253341,0.19,1,404318,403854,464
4418341,9.23387,35.7903,433,15192,0.266668,0.09,1,404320,403887,433
4421261,156.247,167.158,426,15332,0.221334,0.19,1,404513,404087,426
4424181,176.049,174.232,431,15471,0.212267,0.19,1,404694,404263,431
4427101,52.8099,50.8463,433,15608,0.194453,0.27,1,404716,404283,433
4430021,38.562,38.1693,433,15744,0.206891,0.27,1,404751,404318,433
4432941,9.31239,9.23385,433,15879,0.209378,0.21,1,404753,404320,433
4435861,155.462,156.247,432,16013,0.417876,0.21,1,404945,404513,432
4438781,175.092,176.049,431,16146,0.635575,0.19,1,405125,404694,431
4441701,53.4185,52.8099,432,16278,0.663115,0.21,1,405148,404716,432
4444621,38.6837,38.562,432,16408,0.620623,0.21,1,405183,404751,432
4447541,9.33674,9.31239,432,16537,0.612125,0.47,1,405185,404753,432
4450461,167.467,155.462,447,16665,0.690425,0.47,1,405392,404945,447
4453381,182.293,31.0925,633,16792,0.722085,0.69,1,405578,404945,633
4456301,54.0587,150.218,475,16918,0.728417,0.67,1,405600,405125,475
4459221,38.8117,48.4437,487,17043,0.745683,0.61,1,405635,405148,487
4462141,9.36235,37.6887,454,17168,0.781137,0.61,2,405637,405183,454
4463601,162.672,9.13775,653,17292,0.916227,0.71,2,405838,405185,653
4527841,56,43,548,19816,0.25,1,1,407598,407050,548
4529301,46.4,42.2,550,19923,0.138,1,1,407642,407092,550
4551201,473.28,575.64,421,7300,0.0516,0.01,1,408222,407801,421
4554121,309.856,259.128,510,8295,0.08232,0.05,1,408491,407981,510
4557041,176.371,121.426,566,8551,0.024464,0.03,1,408634,408068,566
4558501,204.874,147.485,624,8800,0.172893,0.09,1,408846,408222,624
4561421,98.5748,244.697,427,9042,0.218579,0.01,1,408918,408491,427
4564341,131.715,163.339,424,9277,0.0997157,0.01,1,409058,408634,424
4565801,187.143,32.6679,625,9506,0.0919431,0.21,1,409259,408634,625
4568721,111.029,176.134,505,9730,0.122389,0.23,1,409351,408846,505
4571641,127.006,92.8267,564,9949,0.144478,0.07,1,409482,408918,564
4573101,186.201,130.565,625,10163,0.132896,0.09,1,409683,409058,625
4576021,113.24,186.913,519,10372,0.242579,0.13,1,409778,409259,519
4578941,129.848,110.983,561,10577,0.376516,0.15,1,409912,409351,561
4581861,184.37,126.997,628,10778,0.499303,0.13,1,410110,409482,628
4584781,118.474,186.199,529,10975,0.651861,0.27,1,410212,409683,529
4587701,135.695,113.24,574,11169,0.794372,0.41,2,410352,409778,574
4627121,46,42,498,13588,0.33,1,1,412067,411569,498
4630041,58,62,492,13744,0.314,1,1,412128,411636,492
4632961,148.4,12.4,663,13899,0.1348,0.89,1,412299,411636,663
4635881,160.08,155.28,635,14052,0.09896,0.45,1,412462,411827,635
4638801,61.616,186.256,478,14203,0.027792,0.33,1,412499,412021,478
4641721,60.3232,74.0512,492,14353,0.0135584,0.31,1,412559,412067,492
4644641,143.265,63.6102,595,14501,0.0587117,0.09,1,412723,412128,595
4647561,158.253,149.522,586,14647,0.163742,0.09,1,412885,412299,586
4650481,62.8506,160.304,462,14792,0.136748,0.01,1,412924,412462,462
4653401,57.3701,61.6609,481,14936,0.19535,0.01,1,412980,412499,481
4656321,147.474,60.3322,591,15078,0.14307,0.07,1,413150,412559,591
4659241,31.0948,143.266,429,15219,0.164614,0.19,1,413152,412723,429
4662161,139.819,158.253,434,15359,0.248923,0.13,1,413319,412885,434
4665081,54.3638,62.8507,428,15497,0.233785,0.21,1,413352,412924,428
4668001,58.0728,57.3701,431,15634,0.326757,0.13,1,413411,412980,431
4670921,146.015,147.474,429,15770,0.441351,0.17,1,413579,413150,429
4673841,30.8029,31.0948,429,15905,0.46427,0.27,1,413581,413152,429
4676761,141.361,139.819,431,16039,0.556854,0.23,1,413750,413319,431
4679681,57.0721,54.3638,434,16171,0.599371,0.35,1,413786,413352,434
4682601,61.0144,58.0728,437,16302,0.639874,0.47,1,413848,413411,437
4685521,153.003,146.015,445,16432,0.839975,0.47,2,414024,413579,445
4688441,32.2006,30.8029,445,16561,0.911995,0.58,2,414026,413581,445
4743921,39,37,497,18845,0.69,1,1,415715,415218,497
4746841,45.4,49.8,491,18958,0.626,0.99,1,415762,415271,491
4749761,168.28,156.36,507,19070,0.2132,1,1,415961,415454,507
4752681,64.856,71.272,496,19181,0.04264,0.97,1,416000,415504,496
4755601,93.7712,118.254,467,19292,0.032528,0.87,1,416101,415634,467
4758521,46.7542,57.2509,460,19402,0.0785056,0.69,1,416136,415676,460
4761441,35.7508,42.6502,454,19511,0.0717011,0.61,1,416169,415715,454
4764361,40.7502,46.13,449,19620,0.0543402,0.61,1,416211,415762,449
4767281,147.35,9.22601,623,19728,0.0828681,0.11,1,416385,415762,623
4770201,63.07,161.045,466,19836,0.0405736,0,1,416427,415961,466
4773121,88.614,63.409,522,19943,0.112115,0.03,1,416522,416000,522
4776041,48.1228,93.4818,459,20049,0.142423,0.09,1,416560,416101,459
4778961,35.2246,46.6964,456,20155,0.132485,0.07,1,416592,416136,456
4781881,40.6449,35.7393,465,20260,0.146497,0.05,1,416634,416169,465
4784801,149.729,40.7479,600,20365,0.229299,0.09,1,416811,416211,600
4787721,61.9458,147.35,466,20469,0.27786,0.03,1,416851,416385,466
4790641,87.5892,63.0699,518,20573,0.335572,0.13,1,416945,416427,518
4793561,50.3178,88.614,464,20676,0.379114,0.15,1,416986,416522,464
4796481,36.4636,48.1228,459,20779,0.387823,0.13,1,417019,416560,459
4799401,41.6927,35.2246,470,20881,0.341565,0.15,1,417062,416592,470
4802321,157.139,40.6449,614,20983,0.492313,0.25,1,417248,416634,614
4805241,33.0277,149.729,439,21084,0.522463,0.29,1,417250,416811,439
4808161,36.2055,61.9458,436,21185,0.592493,0.35,1,417287,416851,436
4811081,84.8411,87.5892,439,21285,0.702498,0.39,1,417384,416945,439
4814001,51.3682,50.3178,441,21385,0.7885,0.39,2,417427,416986,441
4816921,36.6736,36.4636,441,21484,0.8537,0.33,2,417460,417019,441
4819841,40.1347,41.6927,439,21583,0.91474,0.53,2,417501,417062,439
4929341,116,144,460,10632,0.11,0.15,1,420297,419837,460
4932261,53.6,65.6,452,10832,0.158,0.13,1,420335,419883,452
4933721,185.12,47.52,627,11028,0.3596,0.03,1,420553,419926,627
4936641,77.824,213.504,423,11221,0.38392,0.11,1,420604,420181,423
4939561,113.165,135.501,429,11410,0.500784,0.17,1,420726,420297,429
4942481,53.033,57.5002,429,11596,0.508157,0.41,1,420764,420335,429
4945401,235.407,185.9,492,11779,0.765631,0.39,2,421045,420553,492
4990661,53,39,523,14395,0.37,0.96,1,422740,422217,523
4993581,205.8,193.4,535,14543,0.082,0.99,1,422984,422449,535
4996501,133.16,90.68,585,14689,0.0564,0.79,1,423099,422514,585
4999421,52.232,120.536,489,14834,0.05128,0.53,1,423131,422642,489
5002341,50.4464,60.1072,494,14977,0.082256,0.37,1,423181,422687,494
5003801,170.889,54.4214,642,15119,0.0404512,0.01,1,423382,422740,642
5006721,54.1779,206.084,423,15259,0.0320902,0.01,1,423407,422984,423
5009641,103.636,41.2169,539,15398,0.078418,0.05,1,423523,422984,539
5012561,45.5271,100.243,455,15536,0.0876836,0.05,1,423554,423099,455
5015481,51.5054,45.6487,476,15673,0.153537,0.09,1,423607,423131,476
5018401,168.701,49.1297,624,15809,0.198707,0.03,1,423805,423181,624
5021321,53.7402,190.626,423,15943,0.263741,0.09,1,423830,423407,423
5024241,105.948,130.925,426,16076,0.300748,0.09,1,423949,423523,426
5027161,47.5896,50.985,428,16208,0.35615,0.17,1,423982,423554,428
5030081,55.1179,52.597,432,16339,0.44723,0.21,1,424039,423607,432
5033001,171.824,168.919,435,16469,0.561446,0.28,1,424240,423805,435
5035921,55.9647,53.7839,437,16598,0.552289,0.28,1,424267,423830,437
5038841,106.393,10.7568,556,16726,0.622458,0.31,1,424386,423830,556
5041761,50.0786,97.3514,473,16853,0.660492,0.37,1,424422,423949,473
5044681,57.2157,45.8703,499,16979,0.764098,0.47,2,424481,423982,499
5046141,172.243,54.7741,643,17104,0.88082,0.59,2,424682,424039,643
5049061,40.0486,171.755,449,17228,0.920164,0.55,2,424689,424240,449
5051981,28.0097,55.951,447,17351,0.928033,0.64,2,424714,424267,447
5113301,34,27,545,19759,0.71,1,1,426411,425866,545
5116221,155.6,43,684,19866,0.502,1,1,426597,425913,684
5119141,67.12,175.8,520,19973,0.4764,0.98,1,426642,426122,520
5122061,112.624,67.96,603,20079,0.29528,0.91,1,426766,426163,603
5124981,56.9248,125.592,506,20185,0.243056,0.88,1,426809,426303,506
5127901,33.785,61.9184,488,20290,0.136611,0.81,1,426837,426349,488
5130821,29.957,34.7837,489,20395,0.131322,0.71,1,426866,426377,489
5133741,145.991,34.1567,630,20499,0.0662645,0.45,1,427041,426411,630
5136661,65.1983,155.631,489,20602,0.0692529,0.47,1,427086,426597,489
5139581,104.24,67.1263,558,20705,0.149851,0.25,1,427200,426642,558
5142501,52.8479,112.625,474,20807,0.21397,0.23,1,427240,426766,474
5145421,29.7696,56.9251,455,20909,0.226794,0.11,1,427264,426809,455
5148341,29.9539,33.785,457,21010,0.261359,0.13,1,427294,426837,457
5151261,7.59078,29.957,430,21111,0.268272,0.05,1,427296,426866,430
5154181,138.318,145.991,426,21211,0.301654,0.07,1,427467,427041,426
5157101,61.2636,65.1983,423,21311,0.324331,0.17,1,427509,427086,423
5160021,109.853,104.24,431,21411,0.488866,0.23,1,427631,427200,431
5162941,56.3705,52.8479,434,21510,0.569773,0.23,1,427674,427240,434
5165861,31.2741,29.7696,435,21609,0.617955,0.27,1,427699,427264,435
5168781,31.8548,29.9539,437,21707,0.643591,0.27,1,427731,427294,437
5171701,7.97096,7.59078,437,21805,0.696718,0.31,1,427733,427296,437
5174621,138.394,138.318,437,21902,0.787344,0.33,2,427904,427467,437
5177541,62.8788,61.2636,439,21999,0.837469,0.53,2,427948,427509,439
5180461,116.576,109.853,447,22095,0.847494,0.59,2,428078,427631,447
5183381,61.7152,56.3705,452,22191,0.881499,0.63,2,428126,427674,452
5186301,32.343,31.2741,452,22287,0.9363,0.65,2,428151,427699,452
5189221,34.4686,31.8548,455,22382,0.93126,0.71,2,428186,427731,455
5192141,9.29372,7.97096,456,22477,0.914252,0.71,2,428189,427733,456
5279741,44,47,521,25154,0.17,1,1,430201,429680,521
5282661,76,104.6,486,25238,0.106,1,1,430285,429799,486
5285581,59.2,66.52,484,25322,0.0452,1,1,430340,429856,484
5288501,58.24,56.504,488,25406,0.04904,0.87,1,430398,429910,488
5291421,68.448,88.1008,463,25489,0.017808,0.87,1,430469,430006,463
5294341,48.0896,17.6202,506,25572,0.0435616,0.83,1,430512,430006,506
5297261,41.6179,41.924,498,25655,0.0647123,0.73,1,430552,430054,498
5300181,43.5236,45.1848,496,25738,0.0129425,0.35,1,430596,430100,496
5303101,34.3047,54.637,471,25820,0.0265885,0.17,1,430628,430157,471
5306021,71.6609,46.1274,508,25902,0.0613177,0.09,1,430709,430201,508
5308941,55.9322,76.4255,476,25984,0.0522635,0.03,1,430761,430285,476
5311861,57.5864,59.2851,479,26066,0.0184527,0.05,1,430819,430340,479
5314781,69.9173,58.257,494,26147,0.0916905,0.01,1,430892,430398,494
5317701,48.3835,68.4514,466,26228,0.0583381,0.05,1,430935,430469,466
5320621,41.6767,48.0903,463,26309,0.0676676,0.07,1,430975,430512,463
5323541,42.7353,41.6181,466,26390,0.117534,0,1,431018,430552,466
5326461,34.1471,43.5236,454,26470,0.0635067,0.03,1,431050,430596,454
5329381,73.2294,34.3047,505,26550,0.0367013,0.07,1,431133,430628,505
5332301,54.6459,71.6609,474,26630,0.15934,0.05,1,431183,430709,474
5335221,58.9292,55.9322,482,26710,0.151868,0.01,1,431243,430761,482
5338141,69.3858,57.5864,496,26789,0.0703736,0.11,1,431315,430819,496
5341061,48.2772,69.9173,466,26868,0.0860747,0.05,1,431358,430892,466
5343981,11.2554,48.3835,425,26947,0.0892149,0.07,1,431360,430935,425
5346901,35.0511,41.6767,426,27026,0.121843,0.13,1,431401,430975,426
5349821,41.4102,42.7353,426,27104,0.144369,0.05,1,431444,431018,426
5352741,32.282,34.1471,424,27182,0.196874,0.03,1,431474,431050,424
5355661,73.6564,73.2294,425,27260,0.0953747,0.19,1,431558,431133,425
5358581,58.7313,54.6459,430,27338,0.107075,0.15,1,431613,431183,430
5361501,58.9463,58.9292,429,27415,0.173415,0.05,1,431672,431243,429
5364421,65.3893,69.3858,424,27492,0.218683,0.09,1,431739,431315,424
5367341,49.8778,48.2772,427,27569,0.323737,0.09,1,431785,431358,427
5370261,11.5756,11.2554,427,27646,0.344747,0.13,1,431787,431360,427
5373181,35.9151,35.0511,428,27723,0.380949,0.15,1,431829,431401,428
5376101,42.383,41.4102,429,27799,0.45219,0.21,1,431873,431444,429
5379021,33.2766,32.282,430,27875,0.498438,0.07,1,431904,431474,430
5381941,69.8553,73.6564,425,27951,0.507688,0.11,1,431983,431558,425
5384861,57.9711,58.7313,425,28027,0.573538,0.19,1,432038,431613,425
5387781,63.5942,58.9463,431,28103,0.618707,0.23,1,432103,431672,431
5390701,69.5188,65.3893,435,28178,0.643742,0.35,1,432174,431739,435
5393621,53.1038,49.8778,438,28253,0.632748,0.35,1,432223,431785,438
5396541,12.2208,11.5756,438,28328,0.63055,0.39,1,432225,431787,438
5399461,39.2441,35.9151,442,28403,0.69411,0.39,1,432271,431829,442
5402381,44.6488,7.18302,488,28478,0.658822,0.47,1,432317,431829,488
5405301,36.1298,36.6366,478,28552,0.667764,0.51,1,432351,431873,478
5408221,69.626,32.1273,525,28626,0.765553,0.51,2,432429,431904,525
5411141,61.1252,69.6255,505,28700,0.833111,0.59,2,432488,431983,505
5414061,65.825,57.9251,517,28774,0.910622,0.63,2,432555,432038,517
5532321,259,286,421,13140,0.01,0.05,1,435029,434608,421
5535241,146.2,94,493,13302,0.058,0.07,1,435147,434654,493
5538161,67.64,111.6,425,13462,0.1316,0.15,1,435195,434770,425
5541081,54.328,46.32,446,13620,0.09832,0.17,1,435246,434800,446
5544001,114.066,41.264,535,13776,0.171664,0.01,1,435375,434840,535
5546921,181.213,159.453,544,13930,0.0583328,0.07,1,435573,435029,544
5549841,74.6426,126.291,474,14083,0.0836666,0.15,1,435621,435147,474
5552761,57.3285,63.6581,479,14234,0.104733,0.09,1,435674,435195,479
5555681,116.266,53.5316,559,14383,0.156947,0.19,1,435805,435246,559
5558601,176.053,113.906,621,14531,0.247389,0.03,1,435996,435375,621
5561521,76.0106,181.181,474,14677,0.265478,0.09,1,436047,435573,474
5564441,58.4021,74.6363,480,14822,0.269096,0.11,1,436101,435621,480
5567361,118.08,57.3273,560,14965,0.413819,0.17,1,436234,435674,560
5570281,180.416,116.265,625,15107,0.618764,0.27,1,436430,435805,625
5573201,37.6832,176.053,436,15248,0.659753,0.27,1,436432,435996,436
5576121,47.5366,76.0106,435,15387,0.731951,0.27,1,436482,436047,435
5579041,52.7073,58.4021,435,15525,0.77839,0.45,2,436536,436101,435
5581961,124.141,118.08,444,15662,0.851678,0.67,2,436678,436234,444
5662261,316,295,469,7592,0.12,0.09,1,439380,438911,469
5665181,134.4,116.6,486,7872,0.144,0.11,1,439469,438983,486
5666641,203.68,88.12,626,8142,0.2288,0.12,1,439690,439064,626
5669561,135.136,270.424,428,8403,0.30976,0.15,1,439808,439380,428
5672481,99.8272,125.285,430,8656,0.389952,0.25,1,439899,439469,430
5675401,295.165,201.857,553,8902,0.70999,0.33,1,440243,439690,553
5678321,135.033,134.771,530,9141,0.861998,0.41,2,440338,439808,530
5681241,28.6066,99.7543,441,9374,0.8924,0.79,2,440340,439899,441
5717741,56,97,525,11987,0.15,1,1,442302,441777,525
5719201,184.8,57,695,12164,0.07,0.49,1,442519,441824,695
5722121,102.56,276.2,446,12339,0.054,0.49,1,442601,442155,446
5725041,83.712,55.24,525,12511,0.0668,0.15,1,442680,442155,525
5727961,56.7424,83.848,484,12681,0.14936,0.15,1,442730,442246,484
5729421,172.148,61.5696,629,12849,0.293872,0.05,1,442931,442302,629
5732341,108.03,185.914,504,13014,0.514774,0.05,1,443023,442519,504
5735261,85.6059,102.783,502,13177,0.590955,0.07,1,443103,442601,502
5738181,61.9212,83.7566,479,13338,0.558191,0.17,1,443159,442680,479
5739641,173.184,56.7513,630,13497,0.647638,0.33,1,443360,442730,630
5742561,123.437,172.15,540,13654,0.745528,0.57,1,443471,442931,540
5745481,26.2874,108.03,450,13810,0.765105,0.61,2,443473,443023,450
5748401,70.0575,85.606,451,13964,0.753021,0.55,2,443554,443103,451
5751321,57.2115,61.9212,449,14116,0.798604,0.67,2,443608,443159,449
5805341,44,0,552,16744,0.59,1,1,445546,444994,552
5808261,132,36,661,16871,0.174,1,1,445700,445039,661
5811181,152.8,168.8,617,16997,0.1548,1,1,445858,445241,617
5814101,72.16,152.16,521,17122,0.10296,0.85,1,445910,445389,521
5817021,52.832,75.232,513,17246,0.108592,0.73,1,445958,445445,513
5819941,40.9664,60.6464,494,17369,0.109718,0.59,1,445996,445502,494
5822861,108.993,47.3293,576,17491,0.125944,0.07,1,446122,445546,576
5825781,152.999,132.666,586,17612,0.0651887,0.15,1,446286,445700,586
5828701,70.5997,152.933,478,17733,0.133038,0.09,1,446336,445858,478
5831621,54.1199,72.1866,476,17853,0.114608,0.11,1,446386,445910,476
5834541,39.624,52.8373,464,17972,0.158922,0.11,1,446422,445958,464
5837461,108.725,40.9675,552,18090,0.279784,0.13,1,446548,445996,552
5840381,23.345,108.993,428,18207,0.319957,0.05,1,446550,446122,428
5843301,132.669,152.999,424,18324,0.199991,0.15,1,446710,446286,424
5846221,70.5338,70.5997,429,18440,0.271998,0.11,1,446765,446336,429
5849141,54.1068,54.1199,429,18555,0.3184,0.17,1,446815,446386,429
5852061,42.0214,39.624,432,18669,0.27968,0.31,1,446854,446422,432
5854981,113.204,108.725,437,18783,0.463936,0.33,1,446985,446548,437
5857901,24.2409,23.345,437,18896,0.500787,0.17,1,446987,446550,437
5860821,125.648,132.669,428,19008,0.572157,0.29,1,447138,446710,428
5863741,73.9296,70.5338,434,19120,0.586432,0.33,1,447199,446765,434
5866661,57.9859,54.1068,438,19231,0.653286,0.27,1,447253,446815,438
5869581,41.9972,42.0214,437,19341,0.682657,0.51,1,447291,446854,437
5872501,119.599,113.204,445,19451,0.672531,0.51,1,447430,446985,445
5875421,25.5199,24.2409,445,19560,0.670506,0.51,1,447432,446987,445
5878341,129.904,4.84817,601,19668,0.782101,0.59,2,447588,446987,601
5881261,74.7808,121.77,511,19776,0.86842,0.59,2,447649,447138,511
5884181,61.3562,73.1539,508,19883,0.885684,0.67,2,447707,447199,508
5887101,41.8712,57.8308,491,19990,0.889137,0.69,2,447744,447253,491
5965941,31,40,544,22679,0.59,1,1,449723,449179,544
5968861,98.2,48.8,608,22772,0.318,1,1,449838,449230,608
5971781,52.44,107.36,527,22865,0.3276,1,1,449879,449352,527
5974701,92.888,63.072,578,22958,0.21752,1,1,449982,449404,578
5977621,70.5776,103.014,530,23050,0.131504,1,1,450047,449517,530
5980541,64.5155,63.0029,540,23142,0.146301,0.83,1,450110,449570,540
5983461,39.3031,75.8006,494,23234,0.13326,0.63,1,450143,449649,494
5986381,32.6606,49.5601,482,23325,0.098652,0.59,1,450174,449692,482
5989301,88.1321,34.712,553,23416,0.13973,0.25,1,450276,449723,553
5992221,49.6264,98.9424,478,23507,0.179946,0.33,1,450316,449838,478
5995141,87.5253,52.5885,534,23597,0.171989,0.19,1,450413,449879,534
5998061,68.7051,92.9177,495,23687,0.250398,0.11,1,450477,449982,495
6000981,61.741,70.5835,490,23776,0.28208,0.15,1,450537,450047,490
6003901,37.9482,64.5167,459,23865,0.384416,0.13,1,450569,450110,459
6006821,32.3896,39.3033,457,23954,0.468883,0.09,1,450600,450143,457
6009741,8.07793,32.6607,428,24042,0.485777,0.15,1,450602,450174,428
6012661,85.6156,88.1321,431,24130,0.585155,0.19,1,450707,450276,431
6015581,49.1231,49.6264,431,24218,0.653031,0.17,1,450747,450316,431
6018501,89.0246,87.5253,433,24306,0.794606,0.27,2,450846,450413,433
6021421,69.0049,68.7051,433,24393,0.854921,0.29,2,450910,450477,433
6024341,67.401,61.741,440,24480,0.898984,0.41,2,450977,450537,440
6027261,41.4802,37.9482,443,24567,0.907797,0.49,2,451012,450569,443
6030181,35.496,32.3896,446,24653,0.845559,0.49,2,451046,450600,446
6033101,8.69921,8.07793,446,24739,0.865112,0.61,2,451048,450602,446
6161581,178,201,514,12041,0.13,0.03,1,453888,453374,514
6164501,61.2,121,445,12218,0.066,0.11,1,453920,453475,445
6167421,37.84,53.8,440,12392,0.0852,0.17,1,453952,453512,440
6170341,158.768,169.16,431,12564,0.10504,0.13,1,454141,453710,431
6173261,171.754,176.232,428,12733,0.221008,0.05,1,454316,453888,428
6176181,55.9507,60.8464,423,12900,0.260202,0.09,1,454343,453920,423
6179101,39.1901,37.7693,426,13065,0.28404,0.11,1,454378,453952,426
6182021,156.638,158.754,423,13228,0.336808,0.25,1,454564,454141,423
6184941,180.128,171.751,434,13389,0.507362,0.27,1,454750,454316,434
6187861,56.8255,55.9502,433,13548,0.541472,0.29,1,454776,454343,433
6190781,40.1651,39.19,434,13705,0.596294,0.29,1,454812,454378,434
6193701,161.633,7.83801,626,13860,0.767259,0.35,2,455004,454378,626
6253561,134,0,631,16784,0.23,1,1,457126,456495,631
6256481,68.4,122.4,530,16911,0.182,1,1,457178,456648,530
6259401,59.28,68.48,532,17037,0.1244,1,1,457235,456703,532
6262321,131.056,56.096,628,17162,0.14488,0.79,1,457384,456756,628
6265241,72.6112,144.819,519,17286,0.148976,0.49,1,457442,456923,519
6268161,104.922,84.1638,563,17409,0.0857952,0.23,1,457555,456992,563
6271081,64.9844,124.033,484,17531,0.041159,0.17,1,457610,457126,484
6274001,59.3969,66.4066,490,17652,0.0162318,0.11,1,457668,457178,490
6276921,127.079,58.8813,577,17772,0.139246,0.15,1,457812,457235,577
6279841,70.2159,130.976,484,17891,0.211849,0.15,1,457868,457384,484
6282761,103.643,72.5953,538,18010,0.24237,0.07,1,457980,457442,538
6285681,22.3286,104.919,427,18128,0.248474,0.03,1,457982,457555,427
6288601,46.0657,64.9838,424,18245,0.313695,0.01,1,458034,457610,424
6291521,55.6131,59.3968,424,18361,0.326739,0.17,1,458092,457668,424
6294441,131.123,127.079,430,18477,0.425348,0.23,1,458242,457812,430
6297361,73.4245,70.2159,433,18592,0.49307,0.25,1,458301,457868,433
6300281,105.885,103.643,435,18706,0.618614,0.25,1,458415,457980,435
6303201,22.777,22.3286,435,18819,0.643723,0.33,1,458417,457982,435
6306121,50.1554,46.0657,440,18932,0.664745,0.33,1,458474,458034,440
6309041,54.0311,55.6131,437,19044,0.732949,0.45,1,458529,458092,437
6311961,136.406,131.123,444,19155,0.85859,0.51,2,458686,458242,444
6314881,76.8812,73.4245,447,19266,0.883718,0.65,2,458748,458301,447
6399561,68,58,507,22238,0.57,1,1,460916,460409,507
6402481,66.4,57.2,516,22333,0.202,1,1,460982,460466,516
6405401,64.48,57.84,522,22428,0.1124,1,1,461046,460524,522
6408321,57.696,67.568,508,22523,0.11048,1,1,461102,460594,508
6411241,67.5392,13.5136,578,22617,0.142096,1,1,461172,460594,578
6414161,91.1078,81.1027,577,22711,0.148419,0.94,1,461269,460692,577
6417081,44.6216,105.821,498,22804,0.133684,0.73,1,461302,460804,498
6420001,54.5243,56.3641,511,22897,0.0347368,0.57,1,461359,460848,511
6422921,50.1049,65.6728,492,22990,0.0629474,0.11,1,461408,460916,492
6425841,63.621,65.9346,493,23082,0.0685895,0.09,1,461475,460982,493
6428761,53.5242,64.3869,480,23174,0.0377179,0.11,1,461526,461046,480
6431681,70.7048,57.6774,499,23265,0.127544,0.15,1,461601,461102,499
6434601,90.141,67.5355,524,23356,0.0975087,0.15,1,461696,461172,524
6437521,43.6282,91.1071,459,23447,0.123502,0.13,1,461728,461269,459
6440441,51.1256,44.6214,479,23537,0.1287,0.01,1,461781,461302,479
6443361,52.6251,54.5243,475,23627,0.16174,0.07,1,461834,461359,475
6446281,64.125,50.1049,493,23717,0.232348,0.07,1,461901,461408,493
6449201,52.025,63.621,475,23806,0.31047,0.03,1,461950,461475,475
6452121,75.205,53.5242,505,23895,0.438094,0.15,1,462031,461526,505
6455041,87.841,70.7048,521,23984,0.495619,0.09,1,462122,461601,521
6457961,19.1682,90.141,428,24072,0.507124,0.13,1,462124,461696,428
6460881,31.8336,43.6282,431,24160,0.557425,0.13,1,462159,461728,431
6463801,47.1667,51.1256,429,24248,0.583485,0.17,1,462210,461781,429
6466721,52.6333,52.6251,430,24335,0.620697,0.25,1,462264,461834,430
6469641,68.1267,64.125,435,24422,0.676139,0.33,1,462336,461901,435
6472561,56.8253,52.025,440,24509,0.751228,0.47,2,462390,461950,440
6475481,80.1651,75.205,445,24595,0.782246,0.51,2,462476,462031,445
6478401,91.233,87.841,448,24681,0.804449,0.51,2,462570,462122,448
6481321,19.8466,19.1682,448,24767,0.80889,0.57,2,462572,462124,448
6484241,31.9693,31.8336,448,24853,0.857778,0.59,2,462607,462159,448
6596661,100,110,521,12041,0.37,0.35,1,465088,464567,521
6599581,63.2,132.4,437,12218,0.37,0.33,1,465142,464705,437
6602501,53.44,44.88,465,12392,0.434,0.33,1,465193,464728,465
6605421,197.088,216.976,438,12564,0.6868,0.37,1,465426,464988,438
6608341,121.018,123.395,440,12733,0.75336,0.37,2,465528,465088,440
6611261,69.0035,67.879,442,12900,0.798672,0.45,2,465584,465142,442
6614181,59.4007,54.3758,448,13065,0.823734,0.75,2,465641,465193,448
6671121,183,207,479,16004,0.53,1,1,467807,467328,479
6674041,114.2,119,479,16137,0.514,0.9,1,467904,467425,479
6676961,70.04,77.4,471,16269,0.4948,0.95,1,467963,467492,471
6679881,60.408,66.68,465,16400,0.49096,0.93,1,468021,467556,465
6682801,62.4816,67.736,460,16529,0.474192,0.53,1,468084,467624,460
6685721,147.696,159.947,446,16657,0.598838,0.53,1,468253,467807,446
6688641,104.739,31.9894,540,16784,0.735768,0.51,1,468347,467807,540
6691561,69.7479,83.9979,504,16911,0.763154,0.49,2,468408,467904,504
6694481,59.5496,63.9996,502,17037,0.816631,0.49,2,468465,467963,502
6697401,61.5099,59.1999,506,17162,0.875326,0.47,2,468527,468021,506
6758721,59,47,524,19595,0.61,1,1,470395,469871,524
6761641,43.8,9.4,564,19703,0.722,1,1,470435,469871,564
6764561,44.76,46.68,553,19811,0.6324,1,1,470480,469927,553
6767481,133.752,59.736,646,19918,0.40648,1,1,470636,469990,646
6770401,121.95,153.547,588,20025,0.313296,0.92,1,470755,470167,588
6773321,53.1901,120.309,512,20131,0.246659,0.73,1,470791,470279,512
6776241,53.838,69.6619,509,20236,0.265332,0.61,1,470845,470336,509
6779161,45.9676,61.1324,494,20341,0.237066,0.75,1,470889,470395,494
6782081,38.7935,44.2265,491,20445,0.183413,0.61,1,470926,470435,491
6785001,126.959,44.8453,595,20549,0.188683,0.35,1,471075,470480,595
6787921,117.392,133.769,554,20652,0.253737,0.29,1,471190,470636,554
6790841,51.4783,121.954,470,20755,0.250747,0.23,1,471225,470755,470
6793761,51.0957,53.1908,485,20857,0.330149,0.27,1,471276,470791,485
6796681,43.0191,53.8382,472,20959,0.39403,0.23,1,471317,470845,472
6799601,10.2038,45.9676,430,21060,0.406806,0.17,1,471319,470889,430
6802521,29.2408,38.7935,427,21161,0.441361,0.19,1,471353,470926,427
6805441,127.448,126.959,430,21261,0.640272,0.27,1,471505,471075,430
6808361,123.09,117.392,437,21361,0.760054,0.25,2,471627,471190,437
6811281,52.6179,51.4783,437,21460,0.864011,0.35,2,471662,471225,437
6814201,52.9236,51.0957,439,21559,0.884802,0.41,2,471715,471276,439
6817121,44.9847,43.0191,441,21657,0.88896,0.41,2,471758,471317,441
6820041,10.5969,10.2038,441,21755,0.889792,0.45,2,471760,471319,441
6822961,30.1194,29.2408,442,21852,0.937958,0.69,2,471795,471353,442
