#Ack,ack_ewma(ms),send_ewma(ms),rtt_ratio,cwnd (Bytes),Last Router Ocupation Ack Arriaval(Packets),Last Router Ocupation Packet Sent(Packets),Network Situation,AckArrival(ms),TSInsideAck(ms),RTTAck(ms)
100741,199,194,452,19092,0.01,0.05,1,202777,202325,452
103661,76.6,82,444,19203,0.058,0,1,202823,202379,444
106581,52.12,59.6,436,19314,0.0356,0,1,202869,202433,436
109501,24.024,34.32,425,19424,0.03112,0.05,1,202886,202461,425
112421,18.4048,10.064,438,19533,0.030224,0.01,1,202903,202465,438
115341,45.281,45.2128,436,19642,0.0620448,0.05,1,202955,202519,436
116801,204.256,56.2426,621,19750,0.020409,0.01,1,203199,202578,621
119721,42.4512,170.449,424,19857,0.0280818,0.07,1,203201,202777,424
122641,44.4902,70.8897,423,19964,0.0136164,0.03,1,203246,202823,423
125561,46.4981,50.9779,424,20070,0.0267233,0.03,1,203293,202869,424
128481,21.2996,23.7956,422,20176,0.0133447,0.03,1,203308,202886,422
131401,19.4599,18.3591,424,20281,0.0266689,0.07,1,203327,202903,424
134321,45.492,45.2718,424,20386,0.0613338,0.01,1,203379,202955,424
137241,203.498,204.254,423,20490,0.0362668,0.03,1,203622,203199,423
140161,76.6997,42.4509,466,20594,0.0472534,0.01,1,203667,203201,466
143081,53.7399,44.4902,469,20697,0.0334507,0.03,1,203715,203246,469
146001,21.948,46.498,436,20799,0.0306901,0.01,1,203729,203293,436
148921,19.5896,21.2996,440,20901,0.046138,0.03,1,203748,203308,440
151841,46.3179,19.4599,474,21002,0.0332276,0.07,1,203801,203327,474
154761,10.8636,45.492,424,21103,0.0306455,0.03,1,203803,203379,424
157681,194.973,203.498,422,21204,0.0461291,0.05,1,204044,203622,422
160601,76.5945,76.6997,424,21304,0.0972258,0.03,1,204091,203667,424
163521,52.9189,53.7399,423,21404,0.0274452,0.03,1,204138,203715,423
166441,21.7838,21.948,423,21503,0.013489,0.05,1,204152,203729,423
169361,20.3568,19.5896,424,21602,0.0426978,0.03,1,204172,203748,424
172281,45.6714,46.3179,423,21700,0.0485396,0.03,1,204224,203801,423
175201,10.7343,10.8636,423,21798,0.0177079,0.05,1,204226,203803,423
178121,194.147,194.973,422,21895,0.0115416,0.11,1,204466,204044,422
181041,78.8294,76.5945,425,21992,0.0103083,0.01,1,204516,204091,425
183961,50.9659,52.9189,422,22088,0.0260617,0.01,1,204560,204138,422
186881,21.3932,21.7838,422,22184,0.0452123,0.05,1,204574,204152,422
189801,20.2786,20.3568,422,22280,0.0170425,0.05,1,204594,204172,422
192721,45.6557,45.6714,422,22375,0.0434085,0.01,1,204646,204224,422
195641,10.7311,10.7343,422,22470,0.0486817,0.01,1,204648,204226,422
198561,194.146,194.147,422,22564,0.129736,0.01,1,204888,204466,422
201481,78.0292,38.8294,471,22658,0.0659473,0.01,1,204937,204466,471
204401,50.8058,47.7659,465,22752,0.0371895,0.03,1,204981,204516,465
207321,21.3612,44.7532,435,22845,0.0314379,0.05,1,204995,204560,435
210241,21.0722,20.1506,442,22938,0.0142876,0.01,1,205016,204574,442
213161,47.4144,20.0301,476,23030,0.0268575,0.05,1,205070,204594,476
216081,11.0829,45.606,426,23122,0.0613715,0.05,1,205072,204646,426
217541,163.017,10.7212,625,23214,0.116274,0.15,1,205273,204648,625
220461,64.6033,194.144,425,23305,0.143255,0.05,1,205313,204888,425
223381,52.1207,78.0288,425,23396,0.196651,0.03,1,205362,204937,425
226301,44.0241,50.8058,423,23487,0.17533,0.03,1,205404,204981,423
229221,19.2048,21.3612,422,23577,0.155066,0.01,1,205417,204995,422
232141,21.441,21.0722,423,23667,0.135013,0.03,1,205439,205016,423
235061,49.0882,47.4144,425,23757,0.163003,0.07,1,205495,205070,425
237981,11.4176,11.0829,425,23846,0.136601,0.13,1,205497,205072,425
240901,197.484,163.017,468,23935,0.27532,0.15,1,205741,205273,468
243821,41.0967,64.6033,430,24024,0.303064,0.21,1,205743,205313,430
246741,47.4193,52.1207,430,24112,0.324613,0.17,1,205792,205362,430
249661,41.4839,44.0241,428,24200,0.296923,0.15,1,205832,205404,428
252581,17.8968,19.2048,427,24288,0.323385,0.13,1,205844,205417,427
255501,21.9794,21.441,428,24375,0.360677,0.17,1,205867,205439,428
258421,49.9959,49.0882,429,24462,0.384135,0.13,1,205924,205495,429
261341,11.5992,11.4176,429,24549,0.388827,0.31,1,205926,205497,429
264261,203.92,197.484,437,24635,0.405765,0.31,1,206178,205741,437
267181,42.384,41.0967,437,24721,0.377153,0.33,1,206180,205743,437
270101,46.8768,47.4193,436,24807,0.403431,0.29,1,206228,205792,436
273021,41.3754,41.4839,436,24892,0.424686,0.33,1,206268,205832,436
275941,17.8751,17.8968,436,24977,0.412937,0.37,1,206280,205844,436
278861,23.575,21.9794,438,25062,0.394587,0.39,1,206305,205867,438
281781,51.115,49.9959,439,25147,0.406917,0.39,1,206363,205924,439
284701,11.823,11.5992,439,25231,0.441383,0.41,1,206365,205926,439
287621,204.765,203.92,440,25315,0.528277,0.37,1,206618,206178,440
290541,42.5529,42.384,440,25399,0.545655,0.41,1,206620,206180,440
293461,46.9106,46.8768,440,25482,0.549131,0.41,1,206668,206228,440
296381,42.1821,9.37536,481,25565,0.581826,0.43,1,206709,206228,481
299301,18.0364,33.8751,453,25648,0.588365,0.41,1,206721,206268,453
302221,22.8073,16.375,465,25731,0.589673,0.39,1,206745,206280,465
305141,51.7615,23.275,499,25813,0.605935,0.41,1,206804,206305,499
308061,11.9523,51.055,443,25895,0.609187,0.45,1,206806,206363,443
309521,163.19,11.811,642,25977,0.705837,0.55,1,207007,206365,642
312441,79.0381,204.762,447,26059,0.725167,0.55,1,207065,206618,447
315361,17.4076,42.5524,447,26140,0.761033,0.55,2,207067,206620,447
318281,44.2815,46.9105,450,26221,0.752207,0.59,2,207118,206668,450
321201,42.4563,42.1821,451,26302,0.798441,0.59,2,207160,206709,451
324121,18.0913,18.0364,451,26383,0.807688,0.59,2,207172,206721,451
327041,22.8183,22.8073,451,26463,0.825538,0.61,2,207196,206745,451
329961,52.5637,51.7615,452,26543,0.845107,0.61,2,207256,206804,452
332881,12.1127,11.9523,452,26623,0.817022,0.73,2,207258,206806,452
477421,30,27,495,30344,0.59,1,1,209973,209478,495
480341,30,20.6,506,30414,0.526,1,1,210003,209497,506
483261,26,25.72,504,30484,0.5372,1,1,210028,209524,504
486181,22.8,30.744,494,30553,0.38744,1,1,210050,209556,494
489101,15.76,26.1488,483,30622,0.277488,1,1,210064,209581,483
492021,23.952,23.6298,486,30691,0.207498,1,1,210090,209604,486
494941,32.7904,35.926,482,30760,0.0974995,0.98,1,210125,209643,482
497861,36.9581,33.5852,487,30829,0.0434999,0.77,1,210163,209676,487
500781,154.592,179.517,455,30898,0.0487,0.71,1,210347,209892,455
503701,70.9183,76.7034,454,30966,0.00974,0.59,1,210397,209943,454
506621,35.7837,39.3407,451,31034,0.041948,0.51,1,210424,209973,451
509541,26.3567,31.8681,445,31102,0.0643896,0.54,1,210448,210003,445
512461,23.6713,26.3736,443,31170,0.228878,0.35,1,210471,210028,443
515381,15.9343,22.8747,435,31238,0.229776,0.25,1,210485,210050,435
518301,12.7869,15.7749,433,31306,0.261955,0.25,1,210497,210064,433
521221,21.7574,3.15499,457,31374,0.236391,0.19,1,210521,210064,457
524141,30.7515,21.431,464,31441,0.279278,0.07,1,210554,210090,464
527061,30.9503,32.2862,460,31508,0.271856,0.03,1,210585,210125,460
529981,152.59,36.8572,605,31575,0.0783711,0.05,1,210768,210163,605
532901,70.518,154.571,471,31642,0.0156742,0,1,210818,210347,471
535821,35.7036,70.9143,448,31709,0.0271348,0.05,1,210845,210397,448
538741,37.5407,35.7829,459,31776,0.101427,0.07,1,210883,210424,459
541661,23.5081,26.3566,455,31843,0.156285,0.27,1,210903,210448,455
544581,15.9016,23.6713,446,31909,0.167257,0.23,1,210917,210471,446
547501,14.3803,15.9343,446,31975,0.169451,0.27,1,210931,210485,446
550421,20.4761,12.7869,456,32041,0.20189,0.23,1,210953,210497,456
553341,32.8952,21.7574,468,32107,0.208378,0.29,1,210989,210521,468
556261,28.979,30.7515,463,32173,0.241676,0.27,1,211017,210554,463
559181,143.396,30.9503,604,32239,0.312335,0.03,1,211189,210585,604
562101,70.2792,152.59,473,32305,0.230467,0,1,211241,210768,473
565021,36.4558,70.518,451,32370,0.230093,0.03,1,211269,210818,451
567941,41.6912,35.7036,467,32435,0.310019,0.12,1,211312,210845,467
570861,24.3382,37.5407,449,32500,0.390004,0.17,1,211332,210883,449
573781,16.0676,23.5081,443,32565,0.406001,0.17,1,211346,210903,443
576701,15.2135,15.9016,444,32630,0.3932,0.17,1,211361,210917,444
579621,21.4427,14.3803,453,32695,0.40664,0.21,1,211384,210931,453
582541,33.0885,20.4761,467,32760,0.409328,0.21,1,211420,210953,467
585461,8.21771,32.8952,433,32825,0.409866,0.25,1,211422,210989,433
588381,24.8435,28.979,434,32889,0.409973,0.33,1,211451,211017,434
591301,145.769,143.396,438,32953,0.489995,0.21,1,211627,211189,438
594221,65.9537,70.2792,432,33017,0.553999,0.23,1,211673,211241,432
597141,36.3907,36.4558,433,33081,0.5828,0.33,1,211702,211269,433
600061,48.0781,41.6912,441,33145,0.71656,0.41,1,211753,211312,441
602981,26.4156,24.3382,442,33209,0.727312,0.41,1,211774,211332,442
605901,16.4831,16.0676,442,33273,0.745462,0.39,1,211788,211346,442
608821,16.0966,15.2135,443,33337,0.749092,0.41,1,211804,211361,443
611741,20.8193,21.4427,442,33400,0.797819,0.41,2,211826,211384,442
614661,32.9639,33.0885,442,33463,0.775564,0.41,2,211862,211420,442
617581,8.19277,8.21771,442,33526,0.819113,0.41,2,211864,211422,442
620501,24.8386,24.8435,442,33589,0.795823,0.51,2,211893,211451,442
725621,46,60,494,35784,0.67,1,1,213557,213063,494
728541,38,33.6,503,35843,0.494,1,1,213593,213090,503
731461,30,39.52,490,35902,0.4268,1,1,213621,213131,490
734381,29.2,35.104,485,35961,0.34936,1,1,213650,213165,485
737301,36.24,27.0208,498,36020,0.093872,1,1,213688,213190,498
740221,29.648,23.0042,504,36079,0.0427744,1,1,213716,213212,504
743141,19.5296,40.6008,476,36138,0.0485549,1,1,213733,213257,476
746061,36.7059,31.3202,488,36196,0.177711,1,1,213774,213286,488
748981,37.7412,27.864,499,36254,0.0435422,1,1,213812,213313,499
751901,31.5482,32.7728,495,36312,0.0807084,0.91,1,213842,213347,495
754821,82.3096,108.155,463,36370,0.0401417,0.83,1,213937,213474,463
757741,45.2619,51.2309,462,36428,0.0320283,0.67,1,213973,213511,462
760661,36.2524,47.0462,450,36486,0.0624057,0.45,1,214007,213557,450
763581,30.4505,38.2092,443,36544,0.0364811,0.41,1,214036,213593,443
766501,26.8901,30.0418,441,36602,0.0312962,0.33,1,214062,213621,441
769421,26.178,29.2084,438,36660,0.0462592,0.03,1,214088,213650,438
772341,23.6356,36.2417,423,36718,0.0652518,0.03,1,214111,213688,423
775261,27.9271,29.6483,424,36776,0.0210504,0.05,1,214140,213716,424
778181,18.3854,19.5297,423,36833,0.0442101,0.21,1,214156,213733,423
781101,40.4771,36.7059,428,36890,0.032842,0.01,1,214202,213774,428
784021,33.6954,37.7412,422,36947,0.0305684,0.09,1,214234,213812,422
786941,30.7391,31.5482,422,37004,0.0141137,0.03,1,214264,213842,422
789861,82.1478,82.3096,422,37061,0.0108227,0.03,1,214359,213937,422
792781,45.2296,45.2619,422,37118,0.0101645,0.07,1,214395,213973,422
795701,36.2459,36.2524,422,37175,0.0900329,0.07,1,214429,214007,422
798621,29.6492,7.25048,450,37232,0.106007,0.03,1,214457,214007,450
801541,26.7298,24.6501,447,37289,0.125201,0.03,1,214483,214036,447
804461,26.946,25.73,448,37346,0.12904,0.05,1,214510,214062,448
807381,22.9892,25.946,444,37403,0.0978081,0.07,1,214532,214088,444
810301,27.7978,23.5892,450,37459,0.0435616,0.01,1,214561,214111,450
813221,27.9596,27.9178,449,37515,0.0487123,0.05,1,214589,214140,449
816141,34.3919,18.3836,469,37571,0.0497425,0.03,1,214625,214156,469
819061,30.8784,40.4767,453,37627,0.0179485,0.03,1,214655,214202,453
821981,30.1757,33.6953,451,37683,0.0275897,0.01,1,214685,214234,451
824901,82.0351,30.7391,516,37739,0.0295179,0.01,1,214780,214264,516
827821,45.207,82.1478,457,37795,0.0459036,0.01,1,214816,214359,457
830741,41.0414,45.2296,461,37851,0.0491807,0.11,1,214856,214395,461
833661,28.2083,36.2459,452,37907,0.0658361,0.11,1,214881,214429,452
836581,29.6417,29.6492,454,37963,0.101167,0.13,1,214911,214457,454
839501,26.7283,26.7298,454,38019,0.108233,0.13,1,214937,214483,454
842421,20.5457,26.946,446,38075,0.109647,0.09,1,214956,214510,446
845341,26.5091,22.9892,452,38130,0.0779293,0.03,1,214984,214532,452
848261,27.7018,27.7978,451,38185,0.119586,0.05,1,215012,214561,451
851181,33.5404,27.9596,458,38240,0.111917,0.05,1,215047,214589,458
854101,29.9081,34.3919,451,38295,0.0943834,0.01,1,215076,214625,451
857021,29.9816,30.8784,451,38350,0.0588767,0.03,1,215106,214655,451
859941,81.9963,30.1757,516,38405,0.0197753,0.03,1,215201,214685,516
862861,45.1993,82.0351,457,38460,0.0279551,0.05,1,215237,214780,457
865781,42.6399,45.207,463,38515,0.045591,0.05,1,215279,214816,463
868701,30.928,41.0414,451,38570,0.0491182,0.07,1,215307,214856,451
871621,7.78559,28.2083,428,38625,0.0498236,0.11,1,215309,214881,428
874541,24.7571,29.6417,427,38680,0.0819647,0.11,1,215338,214911,427
877461,26.5514,26.7283,428,38735,0.104393,0.11,1,215365,214937,428
880381,19.7103,20.5457,427,38790,0.0768786,0.07,1,215383,214956,427
883301,27.1421,26.5091,428,38844,0.103376,0.13,1,215412,214984,428
886221,27.8284,27.7018,428,38898,0.140675,0.11,1,215440,215012,428
889141,32.7657,33.5404,427,38952,0.116135,0.09,1,215474,215047,427
892061,26.5531,29.9081,423,39006,0.143227,0.05,1,215499,215076,423
894981,28.5106,29.9816,422,39060,0.100645,0.01,1,215528,215106,422
897901,81.7021,81.9963,422,39114,0.0281291,0.03,1,215623,215201,422
900821,45.9404,45.1993,423,39168,0.0136258,0.05,1,215660,215237,423
903741,43.5881,42.6399,424,39222,0.0267252,0.05,1,215703,215279,424
906661,31.1176,30.928,424,39276,0.045345,0.05,1,215731,215307,424
909581,7.82352,7.78559,424,39330,0.017069,0.09,1,215733,215309,424
912501,24.7647,24.7571,424,39384,0.0434138,0.11,1,215762,215338,424
915421,27.3529,26.5514,425,39438,0.0646828,0.07,1,215790,215365,425
918341,19.8706,19.7103,425,39492,0.100937,0.11,1,215808,215383,425
921261,28.7741,27.1421,427,39545,0.108187,0.15,1,215839,215412,427
924181,28.1548,27.8284,427,39598,0.173637,0.11,1,215867,215440,427
927101,32.831,32.7657,427,39651,0.186727,0.15,1,215901,215474,427
930021,26.5662,26.5531,427,39704,0.237346,0.09,1,215926,215499,427
932941,26.1132,28.5106,424,39757,0.263469,0.01,1,215952,215528,424
935861,80.4227,81.7021,423,39810,0.220694,0.01,1,216046,215623,423
938781,45.6845,45.9404,423,39863,0.164139,0.03,1,216083,215660,423
941701,42.7369,43.5881,422,39916,0.120828,0.05,1,216125,215703,422
944621,31.7474,31.1176,423,39969,0.128166,0.01,1,216154,215731,423
947541,7.94948,7.82352,423,40022,0.129633,0.05,1,216156,215733,423
950461,23.9899,24.7647,422,40075,0.145927,0.05,1,216184,215762,422
953381,28.798,4.95294,452,40128,0.117185,0.07,1,216214,215762,452
956301,20.1596,23.3906,442,40181,0.143437,0.11,1,216232,215790,442
959221,31.2319,19.0781,458,40234,0.164687,0.11,1,216266,215808,458
962141,29.4464,28.6156,456,40286,0.216937,0.19,1,216295,215839,456
965061,33.8893,28.1231,463,40338,0.243387,0.19,1,216330,215867,463
967981,29.1779,32.8246,457,40390,0.216678,0.25,1,216358,215901,457
970901,26.6356,26.5649,458,40442,0.259335,0.27,1,216384,215926,458
973821,78.1271,26.113,523,40494,0.283867,0.21,1,216475,215952,523
976741,42.8254,80.4226,463,40546,0.288773,0.15,1,216509,216046,463
979661,42.1651,45.6845,468,40598,0.305755,0.11,1,216551,216083,468
982581,30.833,42.7369,454,40650,0.341151,0.13,1,216579,216125,454
985501,7.7666,31.7474,427,40702,0.34823,0.13,1,216581,216154,427
988421,24.7533,7.94948,454,40754,0.365646,0.15,1,216610,216156,454
991341,29.7507,23.9899,457,40806,0.401129,0.11,1,216641,216184,457
994261,21.9501,28.798,447,40858,0.376226,0.15,1,216661,216214,447
997181,33.19,20.1596,465,40910,0.387245,0.17,1,216697,216232,465
1000101,30.638,31.2319,461,40962,0.421449,0.23,1,216727,216266,461
1003021,33.3276,29.4464,466,41014,0.42829,0.25,1,216761,216295,466
1005941,30.6655,33.8893,461,41065,0.445658,0.21,1,216791,216330,461
1008861,28.5331,29.1779,461,41116,0.449132,0.27,1,216819,216358,461
1011781,78.5066,26.6356,526,41167,0.465826,0.29,1,216910,216384,526
1014701,42.9013,78.1271,469,41218,0.469165,0.29,1,216944,216475,469
1017621,43.7803,42.8254,479,41269,0.501833,0.31,1,216988,216509,479
1020541,31.9561,42.1651,466,41320,0.492367,0.35,1,217017,216551,466
1023461,7.99121,30.833,440,41371,0.490473,0.35,1,217019,216579,440
1026381,25.5982,7.7666,468,41422,0.490095,0.37,1,217049,216581,468
1029301,31.5196,24.7533,472,41473,0.506019,0.41,1,217082,216610,472
1032221,20.7039,29.7507,459,41524,0.525204,0.37,1,217100,216641,459
1035141,5.74079,21.9501,441,41575,0.529041,0.39,1,217102,216661,441
1038061,29.9482,33.19,441,41626,0.577808,0.43,1,217138,216697,441
1040981,31.5896,30.638,443,41677,0.555562,0.43,1,217170,216727,443
1043901,33.5179,33.3276,443,41728,0.519112,0.45,1,217204,216761,443
1046821,32.3036,30.6655,445,41779,0.511822,0.45,1,217236,216791,445
1049741,28.0607,28.5331,444,41830,0.510364,0.47,1,217263,216819,444
1052661,79.2121,78.5066,445,41880,0.558073,0.47,1,217355,216910,445
1055581,43.0424,42.9013,445,41930,0.583615,0.51,1,217389,216944,445
1058501,43.8085,43.7803,445,41980,0.620723,0.49,1,217433,216988,445
1061421,32.7617,31.9561,446,42030,0.628145,0.49,1,217463,217017,446
1064341,8.15234,7.99121,446,42080,0.597629,0.49,1,217465,217019,446
1067261,25.6305,25.5982,446,42130,0.639526,0.51,1,217495,217049,446
1070181,33.1261,31.5196,448,42180,0.679905,0.53,1,217530,217082,448
1073101,21.0252,20.7039,448,42230,0.687981,0.53,1,217548,217100,448
1076021,5.80504,5.74079,448,42280,0.689596,0.59,1,217550,217102,448
1078941,30.761,29.9482,449,42330,0.641919,0.55,1,217587,217138,449
1081861,30.1522,31.5896,447,42380,0.696384,0.51,1,217617,217170,447
1084781,33.2304,33.5179,447,42430,0.707277,0.51,1,217651,217204,447
1087701,31.4461,32.3036,446,42480,0.693455,0.51,1,217682,217236,446
1090621,27.0892,28.0607,445,42530,0.722691,0.57,1,217708,217263,445
1093541,83.0178,79.2121,450,42580,0.808538,0.59,2,217805,217355,450
1096461,44.6036,43.0424,451,42630,0.889708,0.63,2,217840,217389,451
1099381,44.1207,43.8085,451,42680,0.889942,0.63,2,217884,217433,451
1102301,32.8241,32.7617,451,42729,0.921988,0.59,2,217914,217463,451
1105221,8.16483,8.15234,451,42778,0.896398,0.65,2,217916,217465,451
1108141,27.233,25.6305,453,42827,0.89128,0.69,2,217948,217495,453
1111061,34.2466,33.1261,454,42876,0.890256,0.69,2,217984,217530,454
1113981,21.2493,21.0252,454,42925,0.890051,0.69,2,218002,217548,454
1116901,5.84986,5.80504,454,42974,0.85801,0.63,2,218004,217550,454
1119821,29.97,30.761,453,43023,0.851602,0.63,2,218040,217587,453
1122741,30.794,6.1522,484,43072,0.88232,0.71,2,218071,217587,484
1125661,33.3588,25.2304,488,43121,0.904464,0.71,2,218105,217617,488
1128581,32.2718,32.2461,486,43170,0.908893,0.69,2,218137,217651,486
1131501,27.2544,31.2492,481,43219,0.925779,0.73,2,218163,217682,481
1438101,95,77,506,22093,0.53,0.73,1,221704,221198,506
1441021,68.6,75.4,493,22189,0.61,0.71,1,221766,221273,493
1443941,80.12,76.68,499,22285,0.69,0.51,1,221849,221350,499
1446861,51.224,80.936,461,22380,0.77,0.47,2,221893,221432,461
1449781,57.4448,66.5872,457,22475,0.818,0.47,2,221952,221495,457
1452701,34.689,38.1174,455,22569,0.8756,0.49,2,221981,221526,455
1519861,84,78,495,24640,0.47,1,1,223492,222997,495
1522781,44,32.4,508,24726,0.51,1,1,223526,223018,508
1525701,64,72.88,494,24812,0.35,1,1,223595,223101,494
1528621,72.8,73.776,495,24897,0.158,1,1,223670,223175,495
1531541,74.56,89.9552,476,24982,0.1676,1,1,223745,223269,476
1534461,50.112,47.591,483,25067,0.18552,0.91,1,223789,223306,483
1537381,55.6224,66.3182,469,25152,0.221104,0.91,1,223846,223377,469
1540301,34.3245,38.0636,467,25236,0.228221,0.47,1,223875,223408,467
1543221,58.8649,74.8127,448,25320,0.245644,0.52,1,223940,223492,448
1546141,34.173,42.1625,442,25404,0.233129,0.31,1,223968,223526,442
1549061,58.0346,63.6325,437,25487,0.102626,0.31,1,224032,223595,437
1551981,69.2069,12.7265,509,25570,0.0765252,0.11,1,224104,223595,509
1554901,66.6414,62.5453,500,25653,0.087305,0.17,1,224170,223670,500
1557821,54.1283,72.5091,476,25736,0.057461,0.19,1,224221,223745,476
1560741,55.6257,49.7018,488,25818,0.147492,0.23,1,224277,223789,488
1563661,35.1251,55.5404,461,25900,0.101498,0.23,1,224307,223846,461
1566581,59.025,34.3081,497,25982,0.0442997,0.25,1,224372,223875,497
1569501,32.605,58.8616,458,26064,0.0648599,0.23,1,224398,223940,458
1572421,54.521,34.1723,490,26145,0.100972,0.07,1,224458,223968,490
1575341,68.5042,58.0345,498,26226,0.0601944,0.07,1,224530,224032,498
1578261,65.7008,69.2069,491,26307,0.0360389,0.09,1,224595,224104,491
1581181,52.3402,66.6414,474,26388,0.0632078,0.05,1,224644,224170,474
1584101,58.468,54.1283,483,26468,0.0686416,0.17,1,224704,224221,483
1587021,37.2936,55.6257,459,26548,0.0857283,0.09,1,224736,224277,459
1589941,55.4587,35.1251,489,26628,0.153146,0.03,1,224796,224307,489
1592861,31.8917,59.025,450,26708,0.182629,0.07,1,224822,224372,450
1595781,55.9784,32.605,486,26787,0.204526,0.11,1,224884,224398,486
1598701,66.3957,54.521,495,26866,0.192905,0.05,1,224953,224458,495
1601621,14.8791,68.5042,425,26945,0.190581,0.03,1,224955,224530,425
1604541,54.1758,65.7008,424,27024,0.158116,0.07,1,225019,224595,424
1607461,50.8352,52.3402,425,27102,0.231623,0.07,1,225069,224644,425
1610381,58.167,58.468,425,27180,0.230325,0.09,1,225129,224704,425
1613301,40.4334,37.2936,429,27258,0.246065,0.17,1,225165,224736,429
1616221,57.6867,55.4587,431,27336,0.265213,0.19,1,225227,224796,431
1619141,32.3373,31.8917,431,27413,0.285043,0.21,1,225253,224822,431
1622061,56.8675,55.9784,432,27490,0.305009,0.19,1,225316,224884,432
1624981,65.7735,66.3957,431,27567,0.341002,0.19,1,225384,224953,431
1627901,14.7547,14.8791,431,27644,0.3162,0.15,1,225386,224955,431
1630821,52.5509,54.1758,429,27721,0.37524,0.25,1,225448,225019,429
1633741,52.9102,50.8352,432,27797,0.435048,0.23,1,225501,225069,432
1636661,59.382,58.167,433,27873,0.47901,0.25,1,225562,225129,433
1639581,39.8764,40.4334,432,27949,0.519802,0.27,1,225597,225165,432
1642501,59.1753,57.6867,434,28025,0.57596,0.29,1,225661,225227,434
1645421,32.6351,32.3373,434,28101,0.555192,0.31,1,225687,225253,434
1648341,57.727,56.8675,435,28176,0.583038,0.35,1,225751,225316,435
1651261,67.5454,65.7735,437,28251,0.588608,0.31,1,225821,225384,437
1654181,15.1091,14.7547,437,28326,0.621722,0.39,1,225823,225386,437
1657101,54.2218,52.5509,439,28401,0.676344,0.39,1,225887,225448,439
1660021,55.6444,10.5102,495,28476,0.639269,0.45,1,225943,225448,495
1662941,62.3289,44.502,506,28550,0.647854,0.49,1,226007,225501,506
1665861,42.0658,57.7004,482,28624,0.665571,0.53,1,226044,225562,482
1668781,60.4132,39.5401,512,28698,0.717114,0.59,1,226109,225597,512
1671701,33.6826,59.108,475,28772,0.711423,0.55,1,226136,225661,475
1674621,58.7365,32.6216,514,28846,0.726285,0.59,1,226201,225687,514
1677541,67.7473,57.7243,520,28919,0.777257,0.59,2,226271,225751,520
1680461,15.1495,67.5449,452,28992,0.787451,0.63,2,226273,225821,452
1683381,56.6299,15.109,517,29065,0.85349,0.69,2,226340,225823,517
1686301,56.926,54.2218,510,29138,0.882698,0.63,2,226397,225887,510
1689221,61.7852,55.6444,517,29211,0.90454,0.65,2,226460,225943,517
1692141,42.757,62.3289,491,29283,0.908908,0.67,2,226498,226007,491
1797261,28,29,510,31781,0.71,1,1,228238,227728,510
1800181,56.8,33.8,539,31848,0.71,1,1,228302,227763,539
1803101,39.36,63.56,503,31914,0.614,1,1,228337,227834,503
1806021,41.472,37.512,514,31980,0.5308,1,1,228379,227865,514
1808941,32.2944,30.7024,515,32046,0.51416,1,1,228409,227894,515
1811861,64.0589,31.7405,555,32112,0.446832,1,1,228481,227926,555
1814781,35.2118,64.7481,510,32178,0.465366,1,1,228509,227999,510
1817701,59.0424,38.5496,543,32244,0.405073,1,1,228574,228031,543
1820621,61.4085,64.5099,534,32310,0.377015,0.85,1,228636,228102,534
1823541,36.2817,71.302,491,32375,0.403403,0.81,1,228666,228175,491
1826461,28.0563,42.2604,482,32440,0.408681,0.71,1,228692,228210,482
1829381,59.2113,30.8521,521,32505,0.457736,0.71,1,228759,228238,521
1832301,34.2423,57.3704,485,32570,0.467547,0.59,1,228787,228302,485
1835221,38.8485,39.4741,490,32635,0.469509,0.51,1,228827,228337,490
1838141,30.9697,41.4948,477,32700,0.533902,0.51,1,228856,228379,477
1841061,59.7939,32.299,514,32765,0.49878,0.43,1,228923,228409,514
1843981,13.5588,64.0598,444,32830,0.491756,0.47,1,228925,228481,444
1846901,21.9118,35.212,440,32894,0.490351,0.39,1,228949,228509,440
1849821,55.5824,59.0424,439,32958,0.52207,0.37,1,229013,228574,439
1852741,61.5165,61.4085,440,33022,0.560414,0.41,1,229076,228636,440
1855661,37.1033,36.2817,441,33086,0.584083,0.41,1,229107,228666,441
1858581,27.4207,28.0563,440,33150,0.620817,0.47,1,229132,228692,440
1861501,63.0841,59.2113,445,33214,0.692163,0.47,1,229204,228759,445
1864421,35.0168,34.2423,445,33278,0.722433,0.47,1,229232,228787,445
1867341,39.8034,38.8485,446,33342,0.712487,0.55,1,229273,228827,446
1870261,31.9607,30.9697,447,33405,0.678497,0.49,1,229303,228856,447
1873181,59.1921,59.7939,446,33468,0.703699,0.49,1,229369,228923,446
1876101,13.4384,13.5588,446,33531,0.70874,0.49,1,229371,228925,446
1879021,20.2877,21.9118,444,33594,0.693748,0.53,1,229393,228949,444
1881941,58.4575,55.5824,448,33657,0.73875,0.57,1,229461,229013,448
1884861,63.6915,61.5165,450,33720,0.82775,0.59,2,229526,229076,450
1887781,37.5383,37.1033,450,33783,0.89355,0.63,2,229557,229107,450
1890701,28.3077,27.4207,451,33846,0.92271,0.71,2,229583,229132,451
1931581,40,29,507,34709,0.95,0.97,2,230195,229688,507
2051301,38,34,507,37123,0.43,1,1,231898,231391,507
2054221,28.4,34.8,498,37180,0.334,1,1,231924,231426,498
2057141,28.08,6.96,526,37237,0.1868,0.94,1,231952,231426,526
2060061,32.816,30.992,523,37294,0.06136,1,1,231986,231463,523
2062981,66.5632,30.1984,568,37351,0.020272,0.95,1,232061,231493,568
2065901,42.9126,70.0397,525,37408,0.0440544,1,1,232098,231573,525
2068821,31.7825,44.4079,516,37464,0.0168109,1,1,232127,231611,516
2071741,38.3565,40.8816,516,37520,0.0273622,1,1,232167,231651,516
2074661,47.6713,36.1763,531,37576,0.0454724,1,1,232217,231686,531
2077581,35.1343,57.6353,500,37632,0.0490945,0.95,1,232249,231749,500
2080501,23.8269,39.5271,486,37688,0.0498189,0.93,1,232270,231784,486
2083421,36.7654,27.1054,502,37744,0.0339638,0.61,1,232310,231808,502
2086341,29.7531,47.0211,478,37800,0.0627928,0.43,1,232338,231860,478
2089261,21.1506,39.8042,459,37856,0.0525586,0.31,1,232357,231898,459
2092181,21.0301,28.7608,454,37912,0.0345117,0.15,1,232378,231924,454
2095101,28.206,28.1522,456,37968,0.0789023,0.03,1,232408,231952,456
2098021,66.4412,32.8304,498,38024,0.0157805,0.01,1,232484,231986,498
2100941,44.4882,66.5661,462,38080,0.0271561,0.05,1,232523,232061,462
2103861,28.8976,42.9132,450,38135,0.00543122,0.01,1,232548,232098,450
2106781,37.7795,31.7826,461,38190,0.0730862,0.03,1,232588,232127,461
2109701,47.5559,38.3565,471,38245,0.0546172,0.05,1,232638,232167,471
2112621,37.5112,47.6713,456,38300,0.162923,0.05,1,232673,232217,456
2115541,23.5022,35.1343,444,38355,0.152585,0.05,1,232693,232249,444
2118461,38.3004,23.8269,465,38410,0.166517,0.03,1,232735,232270,465
2121381,27.6601,36.7654,450,38465,0.153303,0.07,1,232760,232310,450
2124301,19.932,29.7531,440,38520,0.150661,0.05,1,232778,232338,440
2127221,21.5864,21.1506,443,38575,0.150132,0.03,1,232800,232357,443
2130141,5.91728,21.0301,424,38630,0.150026,0.09,1,232802,232378,424
2133061,23.5835,28.206,422,38685,0.166005,0,1,232830,232408,422
2135981,66.3167,66.4412,423,38740,0.0412011,0.03,1,232907,232484,423
2138901,44.4633,44.4882,423,38795,0.0322402,0,1,232946,232523,423
2141821,29.6927,28.8976,424,38849,0.030448,0.09,1,232972,232548,424
2144741,36.3385,37.7795,422,38903,0.0620896,0.05,1,233010,232588,422
2147661,52.8677,47.5559,429,38957,0.0524179,0.19,1,233067,232638,429
2150581,40.1735,37.5112,431,39011,0.0664836,0.15,1,233104,232673,431
2153501,22.4347,23.5022,429,39065,0.0692967,0.17,1,233122,232693,429
2156421,37.2869,38.3004,428,39119,0.101859,0.15,1,233163,232735,428
2159341,28.2574,27.6601,429,39173,0.124372,0.15,1,233189,232760,429
2162261,20.0515,19.932,429,39227,0.128874,0.15,1,233207,232778,429
2165181,20.0103,21.5864,427,39281,0.129775,0.15,1,233227,232800,427
2168101,5.60206,5.91728,427,39335,0.129955,0.17,1,233229,232802,427
2171021,24.3204,23.5835,428,39389,0.177991,0.01,1,233258,232830,428
2173941,61.6641,66.3167,422,39443,0.0355982,0.03,1,233329,232907,422
2176861,43.5328,44.4633,422,39497,0.0471196,0.03,1,233368,232946,422
2179781,29.5066,29.6927,422,39550,0.0334239,0.07,1,233394,232972,422
2182701,37.1013,36.3385,423,39603,0.0466848,0.05,1,233433,233010,423
2185621,53.0203,52.8677,423,39656,0.049337,0.07,1,233490,233067,423
2188541,41.8041,40.1735,425,39709,0.0658674,0.07,1,233529,233104,425
2191461,25.1608,22.4347,428,39762,0.117173,0.11,1,233550,233122,428
2194381,37.8322,37.2869,428,39815,0.0954347,0.13,1,233591,233163,428
2197301,28.3664,28.2574,428,39868,0.123087,0.13,1,233617,233189,428
2200221,20.0733,20.0515,428,39921,0.0966174,0.13,1,233635,233207,428
2203141,20.8147,20.0103,429,39974,0.107323,0.13,1,233656,233227,429
2206061,5.76293,5.60206,429,40027,0.109465,0.19,1,233658,233229,429
2208981,24.3526,24.3204,429,40080,0.125893,0.19,1,233687,233258,429
2211901,55.2705,4.86408,492,40133,0.113179,0,1,233750,233258,492
2214821,42.2541,57.7728,460,40186,0.0786357,0.05,1,233789,233329,460
2217741,29.2508,42.7546,447,40239,0.0397271,0.03,1,233815,233368,447
2220661,37.0502,29.3509,460,40291,0.0319454,0.05,1,233854,233394,460
2223581,53.01,37.0702,478,40343,0.0303891,0.05,1,233911,233433,478
2226501,44.202,53.014,463,40395,0.0300778,0.07,1,233953,233490,463
2229421,25.6404,41.8028,445,40447,0.0380156,0.13,1,233974,233529,445
2232341,38.7281,25.1606,466,40499,0.0796031,0.09,1,234016,233550,466
2235261,28.5456,37.8321,451,40551,0.0879206,0.13,1,234042,233591,451
2238181,20.1091,28.3664,443,40603,0.137584,0.09,1,234060,233617,443
2241101,21.6218,20.0733,447,40655,0.163517,0.11,1,234082,233635,447
2244021,5.92436,20.8147,428,40707,0.184703,0.11,1,234084,233656,428
2246941,25.1849,5.76293,456,40759,0.188941,0.13,1,234114,233658,456
2249861,53.837,24.3526,488,40811,0.173788,0.11,1,234175,233687,488
2252781,41.1674,55.2705,463,40863,0.250758,0.07,1,234213,233750,463
2255701,26.6335,42.2541,447,40915,0.266152,0.03,1,234236,233789,447
2258621,37.3267,29.2508,461,40967,0.23723,0.03,1,234276,233815,461
2261541,53.0653,37.0502,479,41019,0.199446,0.03,1,234333,233854,479
2264461,44.2131,53.01,464,41070,0.159889,0.03,1,234375,233911,464
2267381,27.2426,44.202,445,41121,0.135978,0.04,1,234398,233953,445
2270301,39.8485,25.6404,467,41172,0.211196,0.09,1,234441,233974,467
2273221,31.1697,38.7281,454,41223,0.258239,0.09,1,234470,234016,454
2276141,20.6339,28.5456,446,41274,0.299648,0.15,1,234488,234042,446
2279061,23.3268,20.1091,452,41325,0.27593,0.17,1,234512,234060,452
2281981,6.26536,21.6218,432,41376,0.271186,0.19,1,234514,234082,432
2284901,25.2531,5.92436,460,41427,0.286237,0.19,1,234544,234084,460
2287821,54.6506,25.1849,492,41478,0.289247,0.17,1,234606,234114,492
2290741,43.7301,53.837,472,41529,0.273849,0.27,1,234647,234175,472
2293661,10.346,41.1674,436,41580,0.27077,0.27,1,234649,234213,436
2296581,19.6692,26.6335,435,41631,0.286154,0.23,1,234671,234236,435
2299501,35.1338,37.3267,434,41682,0.305231,0.19,1,234710,234276,434
2302421,50.2268,53.0653,431,41733,0.309046,0.15,1,234764,234333,431
2305341,42.0454,44.2131,429,41784,0.309809,0.13,1,234804,234375,429
2308261,27.6091,27.2426,430,41835,0.357962,0.23,1,234828,234398,430
2311181,42.3218,39.8485,433,41885,0.399592,0.27,1,234874,234441,433
2314101,34.8644,31.1697,437,41935,0.439918,0.31,1,234907,234470,437
2317021,21.3729,20.6339,437,41985,0.479984,0.27,1,234925,234488,437
2319941,22.6746,23.3268,436,42035,0.519997,0.27,1,234948,234512,436
2322861,6.13491,6.26536,436,42085,0.527999,0.29,1,234950,234514,436
2325781,25.227,25.2531,436,42135,0.5296,0.29,1,234980,234544,436
2328701,54.6454,54.6506,436,42185,0.51392,0.27,1,235042,234606,436
2331621,43.7291,43.7301,436,42235,0.526784,0.27,1,235083,234647,436
2334541,10.3458,10.346,436,42285,0.529357,0.29,1,235085,234649,436
2337461,19.6692,19.6692,436,42335,0.545871,0.31,1,235107,234671,436
2340381,34.3338,35.1338,435,42385,0.581174,0.31,1,235145,234710,435
2343301,51.6668,50.2268,437,42435,0.588235,0.31,1,235201,234764,437
2346221,43.1334,42.0454,438,42485,0.637647,0.37,1,235242,234804,438
2349141,27.8267,27.6091,438,42535,0.647529,0.41,1,235266,234828,438
2352061,45.5653,42.3218,442,42585,0.649506,0.45,1,235316,234874,442
2354981,38.7131,34.8644,446,42635,0.681901,0.49,1,235353,234907,446
2357901,22.1426,21.3729,446,42684,0.67238,0.53,1,235371,234925,446
2360821,22.8285,22.6746,446,42733,0.702476,0.53,1,235394,234948,446
2363741,6.1657,6.13491,446,42782,0.708495,0.53,1,235396,234950,446
2366661,26.0331,25.227,447,42831,0.709699,0.51,1,235427,234980,447
2369581,54.8066,54.6454,447,42880,0.72594,0.53,1,235489,235042,447
2372501,42.9613,43.7291,446,42929,0.729188,0.53,1,235529,235083,446
2375421,10.1923,10.3458,446,42978,0.729838,0.55,1,235531,235085,446
2378341,20.4385,19.6692,447,43027,0.777968,0.55,2,235554,235107,447
2381261,36.0877,3.93383,487,43076,0.755593,0.59,2,235594,235107,487
2384181,52.8175,31.1868,506,43125,0.783119,0.59,2,235651,235145,506
2387101,45.7635,51.0374,494,43174,0.756624,0.65,2,235695,235201,494
2390021,28.3527,43.0075,477,43223,0.751325,0.65,2,235719,235242,477
2392941,47.2705,27.8015,505,43272,0.782265,0.65,2,235771,235266,505
2395861,37.4541,45.5603,490,43321,0.772453,0.69,2,235806,235316,490
2398781,23.4908,38.7121,473,43370,0.754491,0.67,2,235826,235353,473
2401701,22.2982,22.1424,477,43419,0.750898,0.71,2,235848,235371,477
2404621,6.05963,22.8285,456,43468,0.75018,0.71,2,235850,235394,456
2407541,27.6119,6.1657,487,43517,0.750036,0.71,2,235883,235396,487
2410461,55.9224,26.0331,519,43565,0.814007,0.73,2,235946,235427,519
2413381,43.1845,54.8066,497,43613,0.842801,0.73,2,235986,235489,497
2416301,10.2369,42.9613,459,43661,0.84856,0.73,2,235988,235529,459
2419221,21.2474,10.1923,481,43709,0.849712,0.79,2,236012,235531,481
2422141,36.2495,20.4385,498,43757,0.865942,0.75,2,236052,235554,498
2425061,54.4499,36.0877,517,43805,0.917188,0.79,2,236111,235594,517
2652821,504,571,465,20440,0.05,0.63,1,238618,238153,465
2655741,164.8,162.2,485,21270,0.082,0.17,1,238698,238213,485
2658661,93.76,110.04,464,21370,0.0884,0.03,1,238774,238310,464
2661581,59.552,70.808,454,21469,0.16968,0,1,238825,238371,454
2664501,61.5104,78.1616,436,21568,0.089936,0,1,238887,238451,436
2667421,79.5021,49.2323,478,21666,0.0259872,0.03,1,238971,238493,478
2670341,41.5004,79.4465,423,21764,0.0131974,0.03,1,239003,238580,423
2673261,40.3001,37.4893,436,21861,0.0746395,0.09,1,239043,238607,436
2676181,72.06,80.2979,425,21958,0.0709279,0.09,1,239123,238698,425
2679101,76.012,76.8596,426,22055,0.0701856,0.19,1,239200,238774,426
2682021,60.0024,56.1719,431,22151,0.0860371,0.07,1,239256,238825,431
2684941,56.0005,60.8344,424,22247,0.0412074,0.01,1,239311,238887,424
2687861,77.6001,79.3669,423,22342,0.0322415,0.01,1,239394,238971,423
2690781,40.32,41.4734,422,22437,0.0144483,0.09,1,239425,239003,422
2693701,44.064,40.2947,427,22532,0.0588897,0.09,1,239470,239043,427
2696621,70.4128,8.05893,504,22626,0.0997779,0.07,1,239547,239043,504
2699541,75.6826,65.6118,501,22720,0.155956,0.07,1,239624,239123,501
2702461,61.5365,74.7224,482,22813,0.151191,0.09,1,239682,239200,482
2705381,52.3073,59.7445,476,22906,0.134238,0.03,1,239732,239256,476
2708301,76.8615,55.9489,504,22999,0.0828476,0.03,1,239815,239311,504
2711221,40.1723,77.5898,452,23091,0.0405695,0.01,1,239846,239394,452
2714141,46.4345,40.318,469,23183,0.0321139,0.07,1,239894,239425,469
2717061,73.2869,44.0636,504,23274,0.0624228,0.11,1,239974,239470,504
2719981,77.8574,70.4127,506,23365,0.116485,0.17,1,240053,239547,506
2722901,61.1715,75.6825,486,23456,0.111297,0.15,1,240110,239624,486
2725821,51.4343,61.5365,477,23546,0.0942594,0.13,1,240159,239682,477
2728741,71.8869,52.3073,504,23636,0.170852,0.07,1,240236,239732,504
2731661,39.9774,76.8615,453,23726,0.15417,0.03,1,240268,239815,453
2734581,47.1955,40.1723,471,23815,0.150834,0.03,1,240317,239846,471
2737501,75.0391,46.4345,505,23904,0.150167,0.07,1,240399,239894,505
2740421,16.6078,73.2869,427,23993,0.118033,0.13,1,240401,239974,427
2743341,67.3216,77.8574,428,24081,0.239607,0.11,1,240481,240053,428
2746261,58.2643,61.1715,427,24169,0.327921,0.09,1,240537,240110,427
2749181,50.0529,51.4343,426,24257,0.361584,0.19,1,240585,240159,426
2752101,75.6106,71.8869,431,24344,0.384317,0.15,1,240667,240236,431
2755021,39.9221,39.9774,430,24431,0.420863,0.15,1,240698,240268,430
2757941,44.7844,47.1955,427,24518,0.476173,0.15,1,240744,240317,427
2760861,74.5569,75.0391,427,24604,0.535235,0.11,1,240826,240399,427
2763781,16.5114,16.6078,427,24690,0.547047,0.27,1,240828,240401,427
2766701,73.7023,67.3216,435,24776,0.581409,0.35,1,240916,240481,435
2769621,61.1405,58.2643,437,24862,0.684282,0.37,1,240974,240537,437
2772541,51.4281,50.0529,438,24947,0.768856,0.39,2,241023,240585,438
2775461,79.0856,75.6106,442,25032,0.785771,0.43,2,241109,240667,442
2778381,41.4171,39.9221,443,25117,0.805154,0.49,2,241141,240698,443
2781301,45.8834,44.7844,444,25201,0.809031,0.55,2,241188,240744,444
2784221,77.1767,74.5569,447,25285,0.809806,0.55,2,241273,240826,447
2787141,17.0353,16.5114,447,25369,0.841961,0.59,2,241275,240828,447
2865981,39,38,477,27534,0.81,1,2,242834,242357,477
2868901,71,66,483,27611,0.426,1,1,242913,242430,483
2871821,39,34.8,487,27688,0.3172,1,1,242944,242457,487
2874741,67,61.36,493,27764,0.18344,1,1,243018,242525,493
2877661,42.2,44.272,489,27840,0.140688,1,1,243054,242565,489
2880581,36.44,35.2544,491,27916,0.116138,1,1,243089,242598,491
2883501,76.088,86.2509,478,27992,0.0792275,0.92,1,243175,242697,478
2886421,35.2176,44.4502,469,28068,0.0558455,0.95,1,243200,242731,469
2889341,53.4435,60.09,463,28143,0.0351691,0.81,1,243258,242795,463
2892261,35.4887,43.218,455,28218,0.0790338,0.33,1,243289,242834,455
2895181,58.2977,71.8436,440,28293,0.119807,0.29,1,243353,242913,440
2898101,30.8595,39.1687,433,28368,0.127961,0.29,1,243377,242944,433
2901021,57.3719,7.83374,497,28443,0.177592,0.15,1,243441,242944,497
2903941,38.6744,60.7667,457,28517,0.155518,0.13,1,243475,243018,457
2906861,38.9349,40.9534,460,28591,0.135104,0.11,1,243514,243054,460
2909781,73.387,36.1907,507,28665,0.0510207,0.07,1,243596,243089,507
2912701,34.6774,76.0381,446,28739,0.0822041,0.05,1,243621,243175,446
2915621,53.3355,35.2076,479,28813,0.104441,0.03,1,243679,243200,479
2918541,37.0671,53.4415,454,28886,0.0768882,0.09,1,243712,243258,454
2921461,60.2134,35.4883,489,28959,0.119378,0.13,1,243778,243289,489
2924381,32.0427,58.2977,450,29032,0.127876,0.13,1,243803,243353,450
2927301,60.8085,30.8595,494,29105,0.193575,0.19,1,243871,243377,494
2930221,36.9617,57.3719,461,29178,0.174715,0.15,1,243902,243441,461
2933141,37.7923,38.6744,465,29251,0.154943,0.13,1,243940,243475,465
2936061,71.5585,38.9349,506,29323,0.166989,0.03,1,244020,243514,506
2938981,35.1117,73.387,450,29395,0.169398,0.09,1,244046,243596,450
2941901,54.2223,34.6774,484,29467,0.18588,0.11,1,244105,243621,484
2944821,36.4445,53.3355,458,29539,0.173176,0.07,1,244137,243679,458
2947741,62.4889,37.0671,494,29611,0.266635,0.13,1,244206,243712,494
2950661,31.6978,60.2134,452,29682,0.285327,0.13,1,244230,243778,452
2953581,64.7396,32.0427,500,29753,0.241065,0.21,1,244303,243803,500
2956501,36.9479,60.8085,462,29824,0.232213,0.17,1,244333,243871,462
2959421,8.98958,36.9617,433,29895,0.230443,0.15,1,244335,243902,433
2962341,30.5979,37.7923,431,29966,0.278089,0.17,1,244371,243940,431
2965261,69.3196,71.5585,430,30037,0.367618,0.17,1,244450,244020,430
2968181,35.4639,35.1117,431,30107,0.385524,0.19,1,244477,244046,431
2971101,54.2928,54.2223,431,30177,0.373105,0.17,1,244536,244105,431
2974021,37.2586,36.4445,432,30247,0.402621,0.29,1,244569,244137,432
2976941,65.8517,62.4889,436,30317,0.376524,0.29,1,244642,244206,436
2979861,32.3703,31.6978,436,30387,0.419305,0.23,1,244666,244230,436
2982781,62.4741,64.7396,433,30457,0.427861,0.23,1,244736,244303,433
2985701,36.4948,36.9479,433,30526,0.477572,0.23,1,244766,244333,433
2988621,8.89896,8.98958,433,30595,0.455514,0.29,1,244768,244335,433
2991541,31.3798,30.5979,434,30664,0.531103,0.39,1,244805,244371,434
2994461,74.276,69.3196,440,30733,0.578221,0.39,1,244890,244450,440
2997381,35.6552,35.4639,439,30802,0.587644,0.37,1,244916,244477,439
3000301,53.531,54.2928,438,30871,0.589529,0.41,1,244974,244536,438
3003221,39.5062,37.2586,441,30940,0.605906,0.37,1,245010,244569,441
3006141,66.3012,65.8517,441,31008,0.641181,0.43,1,245083,244642,441
3009061,32.4602,32.3703,441,31076,0.616236,0.43,1,245107,244666,441
3011981,64.0921,62.4741,443,31144,0.675247,0.49,1,245179,244736,443
3014901,37.6184,36.4948,444,31212,0.671049,0.45,1,245210,244766,444
3017821,9.12368,8.89896,444,31280,0.70221,0.45,1,245212,244768,444
3020741,33.8247,1.77979,484,31348,0.676442,0.55,1,245252,244768,484
3023661,77.1649,29.956,535,31415,0.735288,0.59,1,245340,244805,535
3026581,36.233,73.9912,476,31482,0.779058,0.59,2,245366,244890,476
3029501,53.6466,35.5982,508,31549,0.835812,0.59,2,245424,244916,508
3032421,38.7293,53.5196,485,31616,0.831162,0.61,2,245459,244974,485
3035341,67.7459,39.5039,524,31683,0.830232,0.65,2,245534,245010,524
3038261,33.5492,66.3008,476,31750,0.814047,0.61,2,245559,245083,476
3041181,65.1098,32.4602,525,31817,0.874809,0.69,2,245632,245107,525
3044101,38.622,64.092,485,31883,0.902962,0.67,2,245664,245179,485
3047021,9.32439,37.6184,456,31949,0.908592,0.71,2,245666,245210,456
3166741,79,27,555,34559,0.59,1,1,247540,246985,555
3169661,49.4,69.4,517,34620,0.542,1,1,247582,247065,517
3172581,33.88,41.08,513,34681,0.4844,1,1,247612,247099,513
3175501,34.776,28.216,523,34742,0.44088,1,1,247647,247124,523
3178421,56.5552,26.4432,559,34803,0.288176,0.92,1,247709,247150,559
3181341,28.911,69.2886,501,34864,0.257635,1,1,247731,247230,501
3184261,28.9822,36.2577,502,34925,0.171527,1,1,247760,247258,502
3187181,36.9964,30.4515,512,34986,0.122305,1,1,247799,247287,512
3190101,27.3993,34.0903,502,35046,0.128461,0.99,1,247824,247322,502
3193021,60.6799,29.2181,543,35106,0.0656922,0.89,1,247893,247350,543
3195941,33.736,69.0436,491,35166,0.0691384,0.83,1,247920,247429,491
3198861,61.9472,39.4087,528,35226,0.0538277,0.59,1,247989,247461,528
3201781,44.3894,71.0817,489,35286,0.0827655,0.53,1,248029,247540,489
3204701,28.0779,47.8164,471,35346,0.168553,0.47,1,248053,247582,471
3207621,30.4156,33.5633,472,35406,0.169711,0.43,1,248084,247612,472
3210541,52.4831,34.7127,495,35466,0.137942,0.25,1,248142,247647,495
3213461,25.6966,56.5425,452,35526,0.179588,0.25,1,248161,247709,452
3216381,24.3393,28.9085,454,35586,0.187918,0.15,1,248185,247731,454
3219301,34.4679,28.9817,462,35645,0.189584,0.11,1,248222,247760,462
3222221,8.49357,36.9963,425,35704,0.189917,0.13,1,248224,247799,425
3225141,19.2987,27.3993,422,35763,0.157983,0.05,1,248246,247824,422
3228061,60.6597,60.6799,424,35822,0.135597,0.07,1,248317,247893,424
3230981,32.9319,33.736,423,35881,0.0991193,0.05,1,248343,247920,423
3233901,63.3864,61.9472,425,35940,0.155824,0.09,1,248414,247989,425
3236821,47.0773,44.3894,428,35999,0.119165,0.19,1,248457,248029,428
3239741,29.4155,28.0779,429,36058,0.127833,0.17,1,248482,248053,429
3242661,29.8831,30.4156,428,36117,0.129567,0.13,1,248512,248084,428
3245581,53.9766,52.4831,430,36176,0.113913,0.19,1,248572,248142,430
3248501,26.7953,25.6966,431,36234,0.174783,0.19,1,248592,248161,431
3251421,22.9591,24.3393,429,36292,0.202957,0.19,1,248614,248185,429
3254341,35.7918,34.4679,431,36350,0.192591,0.19,1,248653,248222,431
3257261,8.75836,8.49357,431,36408,0.158518,0.15,1,248655,248224,431
3260181,19.3517,19.2987,431,36466,0.199704,0.13,1,248677,248246,431
3263101,56.6703,60.6597,426,36524,0.303941,0.09,1,248743,248317,426
3266021,32.1341,32.9319,426,36582,0.292788,0.17,1,248769,248343,426
3268941,64.8268,63.3864,428,36640,0.338558,0.11,1,248842,248414,428
3271861,46.5654,47.0773,427,36698,0.315712,0.13,1,248884,248457,427
3274781,28.5131,29.4155,426,36756,0.327142,0.13,1,248908,248482,426
3277701,29.7026,29.8831,426,36813,0.377428,0.11,1,248938,248512,426
3280621,55.5405,53.9766,428,36870,0.403486,0.19,1,249000,248572,428
3283541,27.9081,26.7953,429,36927,0.424697,0.21,1,249021,248592,429
3286461,23.9816,22.9591,430,36984,0.380939,0.19,1,249044,248614,430
3289381,35.1963,35.7918,429,37041,0.404188,0.15,1,249082,248653,429
3292301,8.63926,8.75836,429,37098,0.376838,0.21,1,249084,248655,429
3295221,20.9279,19.3517,431,37155,0.403367,0.21,1,249108,248677,431
3298141,60.1856,3.87033,501,37212,0.440673,0.33,1,249178,248677,501
3301061,32.8371,53.5741,461,37269,0.448135,0.29,1,249204,248743,461
3303981,65.7674,31.5148,509,37326,0.465627,0.35,1,249278,248769,509
3306901,46.7535,64.703,478,37383,0.517125,0.31,1,249320,248842,478
3309821,30.1507,46.5406,462,37440,0.527425,0.33,1,249346,248884,462
3312741,32.4301,28.5081,471,37496,0.561485,0.39,1,249379,248908,471
3315661,56.086,29.7016,503,37552,0.600297,0.41,1,249441,248938,503
3318581,27.2172,55.5403,461,37608,0.608059,0.43,1,249461,249000,461
3321501,23.0434,27.9081,462,37664,0.641612,0.37,1,249483,249021,462
3324421,35.0087,23.9816,477,37720,0.664322,0.41,1,249521,249044,477
3327341,8.60174,35.1963,441,37776,0.668864,0.37,1,249523,249082,441
3330261,20.9203,8.63926,463,37832,0.701773,0.41,1,249547,249084,463
3333181,63.3841,20.9279,513,37888,0.740355,0.45,1,249621,249108,513
3336101,33.4768,60.1856,469,37944,0.748071,0.45,1,249647,249178,469
3339021,66.6954,32.8371,518,38000,0.781614,0.47,2,249722,249204,518
3341941,49.3391,65.7674,489,38056,0.772323,0.53,2,249767,249278,489
3344861,32.2678,46.7535,475,38112,0.770465,0.53,2,249795,249320,475
3347781,34.4536,30.1507,484,38167,0.786093,0.57,2,249830,249346,484
3350701,56.4907,32.4301,513,38222,0.853219,0.61,2,249892,249379,513
3353621,28.0981,56.086,472,38277,0.866644,0.61,2,249913,249441,472
3356541,24.0196,27.2172,475,38332,0.885329,0.65,2,249936,249461,475
3359461,36.0039,23.0434,492,38387,0.905066,0.67,2,249975,249483,492
3362381,8.80078,35.0087,456,38442,0.909013,0.67,2,249977,249521,456
3365301,22.5602,8.60174,480,38497,0.909803,0.71,2,250003,249523,480
3368221,65.312,20.9203,532,38552,0.893961,0.75,2,250079,249547,532
3371141,34.6624,63.3841,485,38607,0.874792,0.75,2,250106,249621,485
3374061,8.53248,33.4768,461,38662,0.870958,0.79,2,250108,249647,461
3376981,61.7065,66.6954,461,38717,0.934192,0.77,2,250183,249722,461
3525901,70,96,492,18482,0.03,0.67,1,252170,251678,492
3528821,84.4,82.4,501,18597,0.03,0.17,1,252258,251757,501
3531741,64.88,97.28,460,18711,0.006,0.01,1,252318,251858,460
3534661,70.576,94.656,438,18824,0.0252,0,1,252390,251952,438
3537581,46.9152,46.9312,444,18937,0.00504,0.03,1,252431,251987,444
3540501,82.183,99.7862,422,19049,0.025008,0.03,1,252522,252100,422
3543421,73.2366,75.9572,423,19160,0.0050016,0.03,1,252593,252170,423
3546341,85.0473,85.5915,423,19271,0.0250003,0,1,252681,252258,423
3549261,64.2095,65.1183,422,19381,0.00500006,0.03,1,252740,252318,422
3552181,71.2419,70.6237,423,19490,0.057,0,1,252813,252390,423
3555101,46.2484,46.9247,422,19599,0.0674,0,1,252853,252431,422
3558021,81.2497,9.38495,512,19707,0.05348,0.03,1,252943,252431,512
3560941,73.0499,74.677,492,19815,0.018696,0,1,253014,252522,492
3563861,85.01,71.7354,509,19922,0.0277392,0.03,1,253102,252593,509
3566781,64.202,84.7471,480,20028,0.0455478,0,1,253161,252681,480
3569701,72.0404,64.1494,495,20134,0.0171096,0.07,1,253235,252740,495
3572621,45.6081,71.2299,461,20239,0.0274219,0.07,1,253274,252813,461
3575541,81.1216,46.246,511,20344,0.0294844,0.05,1,253364,252853,511
3578461,73.0243,81.2492,492,20448,0.0298969,0.01,1,253435,252943,492
3581381,87.4049,73.0498,512,20552,0.0619794,0.03,1,253526,253014,512
3584301,62.281,85.01,480,20655,0.100396,0.05,1,253582,253102,480
3587221,73.2562,64.202,497,20758,0.0280792,0.01,1,253658,253161,497
3590141,45.0512,72.0404,461,20860,0.0616158,0.03,1,253696,253235,461
3593061,80.2103,45.6081,511,20962,0.0363232,0.03,1,253785,253274,511
3595981,17.642,81.1216,423,21063,0.0312646,0.03,1,253787,253364,423
3598901,60.3284,73.0243,423,21164,0.0142529,0.07,1,253858,253435,423
3601821,86.4657,87.4049,425,21264,0.0108506,0.11,1,253951,253526,425
3604741,62.0931,62.281,425,21364,0.0421701,0.01,1,254007,253582,425
3607661,71.6186,73.2562,423,21463,0.00843402,0.07,1,254081,253658,423
3610581,46.3237,45.0512,425,21562,0.0576868,0.03,1,254121,253696,425
3613501,78.8647,80.2103,423,21660,0.0675374,0.03,1,254208,253785,423
3616421,17.3729,17.642,423,21758,0.0695075,0.01,1,254210,253787,423
3619341,59.4746,60.3284,422,21855,0.0699015,0.01,1,254280,253858,422
3622261,86.2949,86.4657,422,21952,0.0379803,0.05,1,254373,253951,422
3625181,63.659,62.0931,424,22049,0.0635961,0,1,254431,254007,424
3628101,70.3318,71.6186,422,22145,0.0367192,0.07,1,254503,254081,422
3631021,46.8664,46.3237,423,22241,0.0633438,0.07,1,254544,254121,423
3633941,81.3733,78.8647,426,22336,0.132669,0.07,1,254634,254208,426
3636861,17.8747,17.3729,426,22431,0.146534,0.07,1,254636,254210,426
3639781,57.1749,59.4746,423,22526,0.277307,0.07,1,254703,254280,423
3642701,85.035,11.8949,515,22620,0.303461,0.03,1,254795,254280,515
3645621,63.407,76.779,480,22714,0.308692,0.07,1,254853,254373,480
3648541,69.4814,61.7558,493,22807,0.213738,0.03,1,254924,254431,493
3651461,47.4963,69.9512,463,22900,0.146748,0.07,1,254966,254503,463
3654381,86.2993,46.7902,518,22993,0.19735,0.15,1,255062,254544,518
3657301,18.8599,81.358,430,23085,0.20747,0.15,1,255064,254634,430
3660221,62.172,17.8716,501,23177,0.305494,0.31,1,255137,254636,501
3663141,87.6344,57.1743,528,23268,0.341099,0.31,1,255231,254703,528
3666061,63.9269,85.0349,494,23359,0.38022,0.31,1,255289,254795,494
3668981,63.1854,63.407,499,23450,0.436044,0.19,1,255352,254853,499
3671901,45.4371,69.4814,469,23540,0.447209,0.13,1,255393,254924,469
3674821,89.8874,47.4963,528,23630,0.449442,0.21,1,255494,254966,528
3677741,19.5775,86.2993,434,23720,0.449888,0.21,1,255496,255062,434
3680661,66.3155,18.8599,510,23809,0.481978,0.33,1,255574,255064,510
3683581,89.2631,62.172,532,23898,0.536396,0.35,1,255669,255137,532
3686501,66.6526,87.6344,499,23987,0.547279,0.39,1,255730,255231,499
3689421,14.9305,63.9269,443,24075,0.549456,0.45,1,255732,255289,443
3692341,54.1861,63.1854,444,24163,0.565891,0.45,1,255796,255352,444
3695261,43.6372,45.4371,444,24251,0.553178,0.45,1,255837,255393,444
3698181,89.5274,89.8874,444,24338,0.614636,0.45,1,255938,255494,444
3701101,19.5055,19.5775,444,24425,0.674927,0.49,1,255940,255496,444
3704021,68.7011,66.3155,447,24512,0.686985,0.55,1,256021,255574,447
3706941,92.1402,89.2631,450,24598,0.705397,0.55,1,256119,255669,450
3709861,64.828,66.6526,447,24684,0.677079,0.55,1,256177,255730,447
3712781,14.5656,14.9305,447,24770,0.703416,0.57,1,256179,255732,447
3715701,54.9131,54.1861,448,24856,0.724683,0.55,1,256244,255796,448
3718621,44.5826,43.6372,449,24941,0.760937,0.63,2,256286,255837,449
3721541,93.7165,89.5274,454,25026,0.816187,0.69,2,256392,255938,454
3724461,20.3433,19.5055,454,25111,0.827237,0.69,2,256394,255940,454
3727381,68.8687,68.7011,454,25195,0.829448,0.71,2,256475,256021,454
3730301,92.9737,92.1402,455,25279,0.925889,0.67,2,256574,256119,455
3733221,65.7947,64.828,456,25363,0.945178,0.71,2,256633,256177,456
3736141,14.7589,14.5656,456,25447,0.949036,0.71,2,256635,256179,456
3826661,57,58,487,27911,0.55,1,1,258377,257890,487
3829581,93.8,98,482,27987,0.358,1,1,258480,257998,482
3832501,64.36,67.6,479,28063,0.2556,1,1,258537,258058,479
3835421,33.672,36.72,476,28138,0.26712,1,1,258563,258087,476
3838341,41.1344,45.744,471,28213,0.237424,1,1,258606,258135,471
3841261,35.4269,37.9488,469,28288,0.231485,0.99,1,258640,258171,469
3844181,27.8854,33.9898,462,28363,0.182297,0.99,1,258666,258204,462
3847101,62.3771,6.79795,533,28438,0.0604594,0.75,1,258737,258204,533
3850021,40.4754,62.1596,492,28512,0.100092,0.73,1,258772,258280,492
3852941,48.0951,44.4319,502,28586,0.0440184,0.55,1,258822,258320,502
3855861,83.219,54.4864,537,28660,0.112804,0.31,1,258914,258377,537
3858781,62.2438,93.2973,491,28734,0.158561,0.23,1,258971,258480,491
3861701,32.4488,64.2595,459,28808,0.167712,0.27,1,258996,258537,459
3864621,38.4898,33.6519,473,28881,0.201542,0.23,1,259036,258563,473
3867541,35.6979,41.1304,465,28954,0.240308,0.23,1,259071,258606,465
3870461,27.1396,35.4261,456,29027,0.248062,0.17,1,259096,258640,456
3873381,57.4279,27.8852,495,29100,0.297612,0.03,1,259161,258666,495
3876301,41.0856,62.377,461,29173,0.323522,0.11,1,259198,258737,461
3879221,45.8171,40.4754,473,29246,0.360705,0.03,1,259245,258772,473
3882141,85.9634,48.0951,519,29318,0.288141,0.13,1,259341,258822,519
3885061,65.9927,83.219,488,29390,0.321628,0.17,1,259402,258914,488
3887981,31.5985,62.2438,454,29462,0.312326,0.17,1,259425,258971,454
3890901,40.7197,32.4488,472,29534,0.310465,0.21,1,259468,258996,472
3893821,36.9439,38.4898,468,29606,0.326093,0.25,1,259504,259036,468
3896741,27.3888,35.6979,458,29677,0.329219,0.25,1,259529,259071,458
3899661,58.2778,27.1396,499,29748,0.345844,0.31,1,259595,259096,499
3902581,43.6556,57.4279,474,29819,0.365169,0.33,1,259635,259161,474
3905501,10.3311,41.0856,439,29890,0.369034,0.37,1,259637,259198,439
3908421,40.4662,45.8171,440,29961,0.369807,0.27,1,259685,259245,440
3911341,80.8932,85.9634,435,30032,0.401961,0.33,1,259776,259341,435
3914261,67.3786,65.9927,438,30102,0.424392,0.31,1,259840,259402,438
3917181,31.0757,31.5985,437,30172,0.444878,0.31,1,259862,259425,437
3920101,40.6151,40.7197,437,30242,0.480976,0.33,1,259905,259468,437
3923021,38.523,36.9439,439,30312,0.488195,0.33,1,259943,259504,439
3925941,26.9046,27.3888,438,30382,0.505639,0.35,1,259967,259529,438
3928861,58.9809,58.2778,439,30452,0.533128,0.37,1,260034,259595,439
3931781,44.5962,43.6556,440,30521,0.546626,0.37,1,260075,259635,440
3934701,10.5192,10.3311,440,30590,0.517325,0.37,1,260077,259637,440
3937621,38.9038,40.4662,438,30659,0.527465,0.41,1,260123,259685,438
3940541,82.1808,80.8932,440,30728,0.577493,0.43,1,260216,259776,440
3943461,68.4362,67.3786,441,30797,0.619499,0.45,1,260281,259840,441
3946381,32.0872,31.0757,442,30866,0.6439,0.49,1,260304,259862,442
3949301,42.4174,40.6151,444,30935,0.71278,0.49,1,260349,259905,444
3952221,39.6835,38.523,445,31003,0.758556,0.51,2,260388,259943,445
3955141,27.1367,26.9046,445,31071,0.767711,0.54,2,260412,259967,445
4057341,40,43,497,33372,0.87,1,2,262030,261533,497
4060261,60,64.6,492,33435,0.742,1,1,262095,261603,492
4063181,40.8,38.52,496,33498,0.6364,1,1,262131,261635,496
4066101,54.56,52.504,498,33561,0.51928,1,1,262189,261691,498
4069021,38.112,39.3008,496,33624,0.559856,1,1,262223,261727,496
4071941,36.4224,32.6602,501,33687,0.551971,1,1,262259,261758,501
4074861,29.6845,44.132,482,33750,0.550394,1,1,262287,261805,482
4077781,35.5369,35.2264,486,33813,0.486079,1,1,262324,261838,486
4080701,46.3074,55.8453,474,33876,0.409216,0.89,1,262373,261899,474
4083621,48.4615,55.1691,468,33938,0.393843,0.98,1,262422,261954,468
4086541,42.4923,39.8338,473,34000,0.390769,0.87,1,262463,261990,473
4089461,32.4985,39.9668,463,34062,0.438154,0.71,1,262493,262030,463
4092381,51.2997,59.9934,454,34124,0.431631,0.61,1,262549,262095,454
4095301,35.8599,40.7987,450,34186,0.478326,0.49,1,262581,262131,450
4098221,53.572,54.5597,450,34248,0.487665,0.49,1,262639,262189,450
4101141,35.5144,10.9119,481,34310,0.473533,0.57,1,262670,262189,481
4104061,36.7029,29.3824,484,34372,0.454707,0.55,1,262707,262223,484
4106981,26.5406,34.6765,472,34434,0.450941,0.55,1,262731,262259,472
4109901,33.3081,29.3353,479,34495,0.482188,0.47,1,262766,262287,479
4112821,44.2616,35.4671,489,34556,0.504438,0.39,1,262813,262324,489
4115741,45.6523,46.2934,486,34617,0.476888,0.39,1,262859,262373,486
4118661,45.1305,48.4587,482,34678,0.599378,0.39,1,262904,262422,482
4121581,34.6261,42.4917,473,34739,0.623875,0.45,1,262936,262463,473
4124501,50.9252,32.4983,498,34800,0.660775,0.43,1,262991,262493,498
4127421,38.985,51.2997,478,34861,0.716155,0.49,1,263027,262549,478
4130341,51.797,35.8599,501,34922,0.775231,0.49,2,263082,262581,501
4133261,37.5594,53.572,477,34983,0.787046,0.47,2,263116,262639,477
4136181,34.7119,35.5144,480,35043,0.821409,0.45,2,263150,262670,480
4139101,26.1424,36.7029,467,35103,0.828282,0.45,2,263174,262707,467
4142021,34.0285,26.5406,479,35163,0.829656,0.49,2,263210,262731,479
4144941,46.0057,33.3081,493,35223,0.845931,0.51,2,263259,262766,493
4147861,46.0011,44.2616,492,35283,0.865186,0.47,2,263305,262813,492
4150781,50.8002,45.6523,498,35343,0.853037,0.63,2,263357,262859,498
4153701,35.76,45.1305,485,35403,0.866607,0.63,2,263389,262904,485
4156621,52.752,34.6261,510,35463,0.837321,0.67,2,263446,262936,510
4159541,41.7504,50.9252,494,35523,0.863464,0.73,2,263485,262991,494
4162461,53.9501,38.985,515,35583,0.868693,0.79,2,263542,263027,515
4165381,38.79,51.797,495,35642,0.869739,0.79,2,263577,263082,495
4168301,9.358,37.5594,463,35701,0.869948,0.83,2,263579,263116,463
4171221,29.0716,34.7119,463,35760,0.86999,0.83,2,263613,263150,463
4174141,25.8143,26.1424,464,35819,0.885998,0.83,2,263638,263174,464
4177061,34.7629,34.0285,465,35878,0.9052,0.85,2,263675,263210,465
4179981,45.3526,46.0057,464,35937,0.94104,0.87,2,263723,263259,464
4182901,47.4705,46.0011,466,35996,0.916208,0.85,2,263771,263305,466
4185821,49.4941,50.8002,464,36055,0.943242,0.87,2,263821,263357,464
4188741,34.6988,35.76,463,36114,0.948648,0.83,2,263852,263389,463
4340581,58,41,501,39039,0.45,1,1,265915,265414,501
4343501,39.6,50.6,483,39093,0.418,1,1,265950,265467,483
4346421,45.52,42.12,490,39147,0.3156,1,1,265997,265507,490
4349341,48.304,35.624,505,39201,0.15112,1,1,266046,265541,505
4352261,32.8608,30.3248,505,39255,0.038224,1,1,266075,265570,505
4355181,19.3722,30.865,490,39309,0.0956448,1,1,266091,265601,490
4358101,33.4744,34.973,491,39363,0.043129,1,1,266128,265637,491
4361021,33.0949,27.7946,498,39417,0.0486258,1,1,266161,265663,498
4363941,27.419,37.5589,484,39471,0.0497252,0.98,1,266187,265703,484
4366861,27.0838,34.7118,477,39525,0.033945,1,1,266214,265737,477
4369781,20.6168,29.3424,468,39578,0.014789,0.69,1,266233,265765,468
4372701,39.3234,47.4685,460,39631,0.0589578,0.63,1,266277,265817,460
4375621,32.6647,41.4937,451,39684,0.0837916,0.45,1,266308,265857,451
4378541,45.7329,54.6987,442,39737,0.0887583,0.41,1,266357,265915,442
4381461,33.9466,38.9397,438,39790,0.0737517,0.29,1,266388,265950,438
4384381,37.9893,45.388,430,39843,0.15075,0.11,1,266427,265997,430
4387301,43.5979,48.2776,426,39896,0.18215,0.01,1,266472,266046,426
4390221,30.3196,32.8555,424,39949,0.17243,0.11,1,266499,266075,424
4393141,17.2639,19.3711,422,40002,0.074486,0.03,1,266513,266091,422
4396061,33.8528,33.4742,423,40055,0.134897,0.05,1,266551,266128,423
4398981,33.9706,33.0948,424,40108,0.0669794,0.05,1,266585,266161,424
4401901,27.5941,6.61897,450,40161,0.0533959,0.05,1,266611,266161,450
4404821,24.7188,22.1238,448,40214,0.0666792,0.03,1,266635,266187,448
4407741,20.9438,26.0248,441,40267,0.0213358,0.01,1,266655,266214,441
4410661,39.3888,20.405,466,40319,0.0442672,0.07,1,266699,266233,466
4413581,33.4778,39.281,454,40371,0.0488534,0.09,1,266731,266277,454
4416501,46.6955,32.6562,473,40423,0.0177707,0.09,1,266781,266308,473
4419421,35.7391,45.7312,457,40475,0.0755541,0.07,1,266814,266357,457
4422341,40.7478,33.9462,468,40527,0.119111,0.17,1,266856,266388,468
4425261,44.9496,37.9893,475,40579,0.175822,0.19,1,266902,266427,475
4428181,24.9899,43.5978,450,40631,0.219164,0.17,1,266922,266472,450
4431101,15.398,30.3196,436,40683,0.243833,0.05,1,266935,266499,436
4434021,35.8796,17.2639,463,40735,0.232767,0.15,1,266976,266513,463
4436941,31.1759,33.8528,455,40787,0.230553,0.05,1,267006,266551,455
4439861,31.0352,33.9706,452,40839,0.198111,0.05,1,267037,266585,452
4442781,23.007,27.5941,447,40891,0.223622,0.07,1,267058,266611,447
4445701,19.0014,24.7188,441,40943,0.260724,0.01,1,267076,266635,441
4448621,40.6003,20.9438,467,40995,0.252145,0.05,1,267122,266655,467
4451541,33.7201,39.3888,455,41046,0.250429,0.05,1,267154,266699,455
4454461,46.744,33.4778,473,41097,0.250086,0.01,1,267204,266731,473
4457381,38.1488,46.6955,459,41148,0.234017,0.09,1,267240,266781,459
4460301,43.6298,35.7391,471,41199,0.214803,0.13,1,267285,266814,471
4463221,47.126,40.7478,477,41250,0.242961,0.19,1,267333,266856,477
4466141,26.2252,44.9496,452,41301,0.296592,0.23,1,267354,266902,452
4469061,14.845,24.9899,444,41352,0.307318,0.25,1,267366,266922,444
4471981,36.569,15.398,473,41403,0.341464,0.23,1,267408,266935,473
4474901,31.3138,35.8796,462,41454,0.332293,0.23,1,267438,266976,462
4477821,31.0628,31.1759,463,41505,0.346459,0.19,1,267469,267006,463
4480741,7.81255,31.0352,434,41556,0.349292,0.23,1,267471,267037,434
4483661,19.1625,23.007,435,41607,0.349858,0.27,1,267493,267058,435
4486581,18.2325,19.0014,435,41658,0.349972,0.25,1,267511,267076,435
4489501,39.6465,40.6003,434,41709,0.365994,0.25,1,267556,267122,434
4492421,33.5293,33.7201,434,41760,0.401199,0.25,1,267588,267154,434
4495341,46.7059,46.744,434,41811,0.44024,0.23,1,267638,267204,434
4498261,37.3412,38.1488,433,41861,0.416048,0.21,1,267673,267240,433
4501181,43.4682,43.6298,433,41911,0.42721,0.25,1,267718,267285,433
4504101,49.4936,47.126,436,41961,0.477442,0.31,1,267769,267333,436
4507021,27.4987,26.2252,437,42011,0.503488,0.31,1,267791,267354,437
4509941,15.0997,14.845,437,42061,0.492698,0.35,1,267803,267366,437
4512861,39.0199,36.569,440,42111,0.49054,0.33,1,267848,267408,440
4515781,31.004,31.3138,439,42161,0.490108,0.35,1,267877,267438,439
4518701,31.0008,31.0628,439,42211,0.506022,0.35,1,267908,267469,439
4521621,7.80016,7.81255,439,42261,0.509204,0.35,1,267910,267471,439
4524541,19.16,19.1625,439,42311,0.477841,0.35,1,267932,267493,439
4527461,18.232,18.2325,439,42361,0.519568,0.37,1,267950,267511,439
4530381,40.4464,39.6465,440,42411,0.543914,0.41,1,267996,267556,440
4533301,35.2893,33.5293,442,42461,0.532783,0.45,1,268030,267588,442
4536221,47.8579,46.7059,443,42511,0.546557,0.41,1,268081,267638,443
4539141,36.7716,37.3412,442,42561,0.549311,0.43,1,268115,267673,442
4542061,44.1543,43.4682,443,42611,0.565862,0.49,1,268161,267718,443
4544981,50.4309,49.4936,444,42661,0.585172,0.51,1,268213,267769,444
4547901,29.2862,27.4987,446,42710,0.605034,0.49,1,268237,267791,446
4550821,15.4572,15.0997,446,42759,0.641007,0.49,1,268249,267803,446
4553741,38.2914,39.0199,445,42808,0.680201,0.49,1,268293,267848,445
4556661,31.6583,31.004,446,42857,0.67204,0.51,1,268323,267877,446
4559581,30.3317,31.0008,445,42906,0.718408,0.51,1,268353,267908,445
4562501,7.66633,7.80016,445,42955,0.695682,0.47,1,268355,267910,445
4565421,19.1333,19.16,445,43004,0.739136,0.47,1,268377,267932,445
4568341,18.2267,3.83201,463,43053,0.715827,0.53,1,268395,267932,463
4571261,42.0453,15.1664,493,43102,0.775165,0.55,2,268443,267950,493
4574181,34.0091,39.8333,479,43151,0.771033,0.53,2,268475,267996,479
4577101,48.4018,35.1667,497,43200,0.770207,0.55,2,268527,268030,497
4580021,36.8804,47.8333,480,43249,0.770041,0.55,2,268561,268081,480
4582941,44.9761,36.7667,493,43298,0.834008,0.57,2,268608,268115,493
4585861,52.9952,44.1533,502,43347,0.862802,0.59,2,268663,268161,502
4588781,30.599,50.4307,475,43396,0.86856,0.61,2,268688,268213,475
4591701,16.5198,29.2861,464,43445,0.901712,0.65,2,268701,268237,464
4594621,39.304,15.4572,497,43494,0.940342,0.69,2,268746,268249,497
4797561,76,28,533,21270,0.87,1,2,271328,270795,533
4800481,40,68.8,485,21370,0.87,0.94,2,271359,270874,485
4803401,19.2,32.16,476,21469,0.918,1,2,271373,270897,476
4806321,31.84,21.632,492,21568,0.8956,0.91,2,271408,270916,492
4876401,107,93,579,23815,0.57,1,1,273148,272569,579
4879321,55.8,96.2,525,23904,0.378,1,1,273191,272666,525
4882241,43.96,69.64,503,23993,0.3076,1,1,273232,272729,503
4885161,37.592,50.728,493,24081,0.22952,1,1,273268,272775,493
4888081,49.9184,50.1456,496,24169,0.117904,1,1,273321,272825,496
4891001,37.9837,46.8291,485,24257,0.0315808,0.92,1,273356,272871,485
4893921,63.5967,66.1658,484,24344,0.0463162,0.85,1,273426,272942,484
4896841,75.9193,92.4332,464,24431,0.0812632,0.57,1,273505,273041,464
4899761,84.7839,104.087,444,24518,0.0562526,0.33,1,273592,273148,444
4902681,48.9568,55.2173,441,24604,0.0352505,0.29,1,273632,273191,441
4905601,34.5914,43.8435,431,24690,0.0310501,0.21,1,273663,273232,431
4908521,33.3183,37.5687,428,24776,0.04621,0.09,1,273696,273268,428
4911441,49.8637,49.9137,429,24862,0.033242,0.01,1,273750,273321,429
4914361,33.9727,37.9827,424,24947,0.0466484,0.05,1,273780,273356,424
4917281,61.9945,63.5965,423,25032,0.0493297,0.09,1,273849,273426,423
4920201,76.3989,75.9193,424,25117,0.0338659,0.05,1,273929,273505,424
4923121,83.2798,84.7839,422,25201,0.0467732,0.03,1,274014,273592,422
4926041,50.256,48.9568,424,25285,0.0333546,0.03,1,274056,273632,424
4928961,33.2512,34.5914,422,25369,0.0626709,0.05,1,274085,273663,422
4931881,33.0502,33.3183,422,25453,0.0845342,0.05,1,274118,273696,422
4934801,49.01,6.66365,475,25536,0.0409068,0.03,1,274171,273696,475
4937721,33.802,44.5327,451,25619,0.0481814,0.05,1,274201,273750,451
4940641,61.9604,32.9065,490,25702,0.0496363,0.05,1,274270,273780,490
4943561,77.9921,61.7813,503,25784,0.0339273,0.03,1,274352,273849,503
4946481,81.9984,76.3563,506,25866,0.0467855,0.05,1,274435,273929,506
4949401,49.9997,83.2713,463,25948,0.0813571,0.03,1,274477,274014,463
4952321,33.1999,50.2543,450,26030,0.0882714,0.07,1,274506,274056,450
4955241,33.04,33.2509,454,26111,0.0416543,0.09,1,274539,274085,454
4958161,49.808,33.0502,475,26192,0.0803309,0.03,1,274593,274118,475
4961081,34.7616,49.01,453,26273,0.0400662,0.05,1,274624,274171,453
4964001,61.3523,33.802,491,26354,0.0640132,0.05,1,274692,274201,491
4966921,77.8705,61.9604,504,26434,0.0368026,0.03,1,274774,274270,504
4969841,84.3741,77.9921,508,26514,0.0473605,0.05,1,274860,274352,508
4972761,48.8748,81.9984,465,26594,0.0814721,0.09,1,274900,274435,465
4975681,32.975,49.9997,452,26674,0.0882944,0.09,1,274929,274477,452
4978601,32.195,33.1999,455,26753,0.0896589,0.03,1,274961,274506,455
4981521,52.839,33.04,480,26832,0.169932,0.09,1,275019,274539,480
4984441,32.1678,49.808,453,26911,0.137986,0.03,1,275046,274593,453
4987361,8.03356,34.7616,424,26990,0.131597,0.07,1,275048,274624,424
4990281,55.2067,61.3523,423,27068,0.0823195,0.03,1,275115,274692,423
4993201,76.6413,77.8705,423,27146,0.0884639,0.05,1,275197,274774,423
4996121,84.9283,84.3741,424,27224,0.137693,0.09,1,275284,274860,424
4999041,51.3857,48.8748,427,27302,0.163539,0.09,1,275327,274900,427
5001961,32.6771,32.975,426,27380,0.216708,0.09,1,275355,274929,426
5004881,32.9354,32.195,427,27457,0.275342,0.19,1,275388,274961,427
5007801,56.1871,52.839,431,27534,0.303068,0.13,1,275450,275019,431
5010721,30.4374,32.1678,428,27611,0.308614,0.13,1,275474,275046,428
5013641,7.68748,8.03356,428,27688,0.277723,0.07,1,275476,275048,428
5016561,51.9375,55.2067,424,27764,0.319545,0.09,1,275539,275115,424
5019481,75.9875,76.6413,424,27840,0.391909,0.15,1,275621,275197,424
5022401,87.1975,84.9283,427,27916,0.486382,0.17,1,275711,275284,427
5025321,54.2395,51.3857,430,27992,0.473276,0.23,1,275757,275327,430
5028241,35.6479,32.6771,433,28068,0.454655,0.29,1,275788,275355,433
5031161,34.3296,32.9354,434,28143,0.514931,0.31,1,275822,275388,434
5034081,57.2659,56.1871,435,28218,0.606986,0.31,1,275885,275450,435
5037001,31.4532,30.4374,436,28293,0.625397,0.27,1,275910,275474,436
5039921,7.89064,7.68748,436,28368,0.629079,0.27,1,275912,275476,436
5042841,53.5781,1.5375,501,28443,0.581816,0.33,1,275977,275476,501
5045761,79.5156,50.7075,524,28517,0.668363,0.41,1,276063,275539,524
5048681,89.5031,75.7415,534,28591,0.717673,0.51,1,276155,275621,534
5051601,54.7006,87.1483,490,28665,0.727535,0.47,1,276201,275711,490
5054521,34.9401,54.2297,474,28739,0.761507,0.45,2,276231,275757,474
5057441,37.388,35.6459,481,28813,0.768301,0.53,2,276269,275788,481
5060361,60.2776,34.3292,513,28886,0.76966,0.63,2,276335,275822,513
5063281,32.0555,57.2658,475,28959,0.785932,0.63,2,276360,275885,475
5066201,8.0111,31.4532,452,29032,0.789186,0.63,2,276362,275910,452
5069121,54.4022,7.89063,516,29105,0.805837,0.57,2,276428,275912,516
5072041,83.6804,53.5781,542,29178,0.841167,0.69,2,276519,275977,542
5074961,91.1361,79.5156,549,29251,0.832233,0.73,2,276612,276063,549
5077881,55.0272,89.5031,503,29323,0.862447,0.73,2,276658,276155,503
5080801,36.6054,54.7006,489,29395,0.900489,0.77,2,276690,276201,489
5083721,39.3211,34.9401,499,29467,0.924098,0.77,2,276730,276231,499
5185921,87,52,566,31883,0.81,1,2,278420,277854,566
5188841,43.8,76,517,31949,0.762,1,2,278453,277936,517
5191761,42.36,39.2,529,32015,0.6564,1,1,278495,277966,529
5194681,54.872,55.04,528,32081,0.55528,1,1,278553,278025,528
5197601,42.9744,44.608,526,32147,0.455056,1,1,278593,278067,526
5200521,36.5949,40.9216,521,32213,0.451011,1,1,278628,278107,521
5203441,60.919,42.5843,545,32279,0.370202,0.98,1,278695,278150,545
5206361,36.1838,62.1169,508,32345,0.35404,1,1,278725,278217,508
5209281,38.4368,43.6234,508,32410,0.382808,0.85,1,278764,278256,508
5212201,38.8874,35.9247,513,32475,0.340562,0.93,1,278803,278290,513
5215121,66.9775,41.5849,544,32540,0.428112,0.81,1,278877,278333,544
5218041,40.5955,77.917,491,32605,0.413622,0.75,1,278911,278420,491
5220961,36.1191,41.9834,493,32670,0.410724,0.63,1,278946,278453,493
5223881,48.8238,41.9967,503,32735,0.442145,0.53,1,278998,278495,503
5226801,11.3648,54.7993,447,32800,0.448429,0.43,1,279000,278553,447
5229721,31.073,42.9599,443,32864,0.433686,0.45,1,279036,278593,443
5232641,32.6146,36.592,441,32928,0.462737,0.35,1,279069,278628,441
5235561,59.3229,60.9184,440,32992,0.548547,0.35,1,279135,278695,440
5238481,35.0646,36.1837,439,33056,0.58171,0.39,1,279164,278725,439
5241401,39.8129,38.4367,441,33120,0.620342,0.33,1,279205,278764,441
5244321,36.7626,38.8873,438,33184,0.724068,0.45,1,279241,278803,438
5247241,69.7525,66.9775,442,33248,0.776814,0.41,2,279319,278877,442
5250161,42.7505,40.5955,444,33312,0.771363,0.41,2,279355,278911,444
5253081,34.9501,36.1191,442,33375,0.802273,0.45,2,279388,278946,442
5256001,49.39,48.8238,443,33438,0.840454,0.45,2,279441,278998,443
5258921,11.478,11.3648,443,33501,0.848091,0.43,2,279443,279000,443
5261841,31.0956,31.073,443,33564,0.833618,0.47,2,279479,279036,443
5264761,34.2191,32.6146,445,33627,0.862724,0.57,2,279514,279069,445
5267681,62.0438,59.3229,448,33690,0.884545,0.59,2,279583,279135,448
5270601,36.4088,35.0646,449,33753,0.888909,0.63,2,279613,279164,449
5273521,43.2818,39.8129,453,33816,0.905782,0.75,2,279658,279205,453
5276441,40.6563,36.7626,457,33879,0.941156,0.79,2,279698,279241,457
5279361,72.1313,69.7525,459,33941,0.932231,0.77,2,279778,279319,459
5437041,121,72,499,16192,0.03,0.03,1,282100,281601,499
5439961,103.4,109.6,479,16323,0.006,0,1,282199,281720,479
5442881,79.88,100.32,455,16453,0.0252,0.05,1,282273,281818,455
5445801,65.576,96.064,422,16582,0.00504,0.05,1,282335,281913,422
5448721,45.9152,34.4128,444,16710,0.009008,0.01,1,282376,281932,444
5451641,126.783,44.4826,544,16837,0.0418016,0.03,1,282523,281979,544
5454561,102.957,105.697,520,16963,0.0323603,0,1,282620,282100,520
5457481,79.7913,100.339,495,17088,0.0464721,0.03,1,282694,282199,495
5460401,65.5583,79.2679,483,17212,0.00929441,0,1,282756,282273,483
5463321,46.7117,65.4536,463,17335,0.0258589,0.01,1,282798,282335,463
5466241,126.942,45.8907,569,17457,0.0131718,0.05,1,282945,282376,569
5469161,102.188,126.778,518,17579,0.0266344,0.03,1,283041,282523,518
5472081,79.6377,102.956,495,17700,0.0293269,0.05,1,283115,282620,495
5475001,66.3275,79.7911,484,17820,0.0298654,0,1,283178,282694,484
5477921,47.6655,65.5582,465,17939,0.0459731,0.03,1,283221,282756,465
5480841,125.533,46.7116,568,18057,0.0331946,0.01,1,283366,282798,568
5483761,26.7066,126.942,423,18175,0.0306389,0.03,1,283368,282945,423
5486681,82.1413,102.188,423,18292,0.0621278,0.03,1,283464,283041,423
5489601,74.8283,79.6377,422,18408,0.100426,0.03,1,283537,283115,422
5492521,66.1657,66.3275,423,18523,0.108085,0.05,1,283601,283178,423
5495441,48.4331,47.6655,424,18638,0.077617,0.03,1,283645,283221,424
5498361,125.687,125.533,424,18752,0.119523,0.03,1,283790,283366,424
5501281,26.7373,26.7066,424,18865,0.127905,0.07,1,283792,283368,424
5504201,80.5475,82.1413,422,18977,0.161581,0.11,1,283886,283464,422
5507121,77.7095,74.8283,426,19089,0.168316,0.11,1,283963,283537,426
5510041,65.9419,66.1657,425,19200,0.153663,0.07,1,284026,283601,425
5512961,46.7884,48.4331,423,19311,0.166733,0.13,1,284068,283645,423
5515881,129.358,125.687,428,19421,0.265347,0.13,1,284218,283790,428
5518801,27.4715,26.7373,428,19530,0.285069,0.17,1,284220,283792,428
5521721,80.6943,80.5475,428,19639,0.321014,0.17,1,284314,283886,428
5524641,77.7389,16.1095,505,19747,0.344203,0.17,1,284391,283886,505
5527561,65.9478,64.8219,491,19854,0.348841,0.15,1,284454,283963,491
5530481,47.5896,63.3644,471,19961,0.365768,0.17,1,284497,284026,471
5533401,134.318,46.2729,585,20067,0.449154,0.29,1,284653,284068,585
5536321,28.4636,129.255,437,20173,0.465831,0.29,1,284655,284218,437
5539241,83.2927,27.4509,532,20278,0.437166,0.33,1,284752,284220,532
5542161,79.0585,80.6902,516,20383,0.447433,0.35,1,284830,284314,516
5545081,66.2117,77.738,502,20487,0.561487,0.35,1,284893,284391,502
5548001,47.6423,65.9476,482,20591,0.600297,0.37,1,284936,284454,482
5550921,138.328,47.5895,600,20694,0.688059,0.47,1,285097,284497,600
5553841,29.2657,134.318,446,20797,0.705612,0.47,1,285099,284653,446
5556761,83.4531,28.4636,541,20899,0.741122,0.43,1,285196,284655,541
5559681,80.6906,83.2927,524,21000,0.764224,0.45,2,285276,284752,524
5562601,17.7381,79.0585,448,21101,0.768845,0.59,2,285278,284830,448
5565521,54.7476,66.2117,449,21202,0.881769,0.61,2,285342,284893,449
5568441,47.7495,47.6423,452,21302,0.920354,0.71,2,285388,284936,452
5658961,45,34,501,24198,0.39,1,1,287499,286998,501
5661881,44.2,59.6,479,24286,0.342,1,1,287543,287064,479
5664801,92.04,88.72,487,24373,0.2364,1,1,287647,287160,487
5667721,40.808,43.344,483,24460,0.18328,0.99,1,287675,287192,483
5670641,39.3616,49.4688,471,24547,0.108656,1,1,287714,287243,471
5673561,34.2723,33.0938,475,24633,0.125731,0.91,1,287747,287272,475
5676481,27.6545,35.4188,465,24719,0.113146,0.59,1,287773,287308,465
5679401,108.731,123.884,448,24805,0.158629,0.39,1,287902,287454,448
5682321,51.3462,60.7767,440,24890,0.167726,0.33,1,287939,287499,440
5685241,44.6692,47.3553,439,24975,0.217545,0.21,1,287982,287543,439
5688161,84.9338,92.6711,430,25060,0.307509,0.17,1,288077,287647,430
5691081,38.5868,40.9342,429,25145,0.341502,0.09,1,288104,287675,429
5694001,36.5174,39.3868,426,25229,0.3803,0.13,1,288140,287714,426
5696921,34.5035,34.2774,427,25313,0.32406,0.11,1,288174,287747,427
5699841,26.9007,27.6555,426,25397,0.296812,0.17,1,288199,287773,426
5702761,111.78,108.731,430,25480,0.419362,0.17,1,288332,287902,430
5705681,49.556,21.7462,464,25563,0.427873,0.17,1,288366,287902,464
5708601,48.3112,33.9492,475,25646,0.413574,0.23,1,288414,287939,475
5711521,89.6622,41.1898,532,25729,0.474715,0.33,1,288514,287982,532
5714441,40.3324,84.238,465,25811,0.454943,0.35,1,288542,288077,465
5717361,36.8665,38.4476,474,25893,0.450989,0.39,1,288578,288104,474
5720281,34.5733,36.4895,472,25975,0.466198,0.31,1,288612,288140,472
5723201,24.5147,34.4979,460,26057,0.46924,0.29,1,288634,288174,460
5726121,116.903,26.8996,575,26138,0.517848,0.45,1,288774,288199,575
5729041,50.5806,111.78,476,26219,0.60757,0.43,1,288808,288332,476
5731961,47.7161,49.556,489,26300,0.625514,0.41,1,288855,288366,489
5734881,92.7432,48.3112,545,26381,0.629103,0.49,1,288959,288414,545
5737801,39.3486,89.6622,471,26461,0.661821,0.45,1,288985,288514,471
5740721,37.4697,40.3324,480,26541,0.684364,0.45,1,289022,288542,480
5743641,34.6939,36.8665,478,26621,0.736873,0.47,1,289056,288578,478
5746561,25.3388,34.5733,467,26701,0.763375,0.47,2,289079,288612,467
5749481,120.268,24.5147,589,26780,0.832675,0.53,2,289223,288634,589
5752401,53.6536,116.903,486,26859,0.830535,0.63,2,289260,288774,486
5755321,12.3307,50.5806,454,26938,0.830107,0.63,2,289262,288808,454
5758241,39.2661,47.7161,453,27017,0.846021,0.63,2,289308,288855,453
5761161,91.8532,92.7432,454,27095,0.913204,0.67,2,289413,288959,454
5863361,42,29,532,29707,0.69,1,1,291234,290702,532
5866281,51.6,34.6,550,29778,0.514,1,1,291288,290738,550
5869201,43.12,78.12,502,29849,0.4148,1,1,291329,290827,502
5872121,32.624,44.424,496,29920,0.36296,1,1,291359,290863,496
5875041,32.9248,36.8848,494,29991,0.288592,1,1,291392,290898,494
5877961,34.585,34.577,495,30062,0.241718,1,1,291427,290932,495
5880881,35.717,33.3154,498,30132,0.136344,1,1,291463,290965,498
5883801,94.3434,109.063,479,30202,0.115269,0.76,1,291572,291093,479
5886721,54.8687,70.6126,463,30272,0.143054,0.73,1,291617,291154,463
5889641,38.9737,44.5225,460,30342,0.116611,0.69,1,291652,291192,460
5892561,35.7947,42.5045,453,30412,0.0793221,0.47,1,291687,291234,453
5895481,43.9589,51.7009,445,30482,0.0718644,0.39,1,291733,291288,445
5898401,39.9918,43.1402,443,30551,0.118373,0.35,1,291772,291329,443
5901321,27.9984,32.628,438,30620,0.143675,0.27,1,291797,291359,438
5904241,26.3997,32.9256,431,30689,0.180735,0.23,1,291823,291392,431
5907161,30.8799,34.5851,428,30758,0.172147,0.11,1,291855,291427,428
5910081,30.176,35.717,422,30827,0.186429,0.11,1,291885,291463,422
5913001,103.635,94.3434,435,30896,0.253286,0.15,1,292007,291572,435
5915921,48.727,54.8687,425,30964,0.298657,0.11,1,292042,291617,425
5918841,37.7454,38.9737,425,31032,0.323731,0.07,1,292077,291652,425
5921761,37.1491,35.7947,427,31100,0.360746,0.07,1,292114,291687,427
5924681,41.8298,43.9589,424,31168,0.384149,0.13,1,292157,291733,424
5927601,42.766,39.9918,428,31236,0.45283,0.15,1,292200,291772,428
5930521,30.1532,27.9984,430,31304,0.418566,0.15,1,292227,291797,430
5933441,25.2306,5.59967,454,31372,0.411713,0.19,1,292251,291797,454
5936361,33.0461,21.9199,463,31439,0.426343,0.17,1,292286,291823,463
5939281,28.2092,29.984,458,31506,0.429269,0.19,1,292313,291855,458
5942201,108.842,29.9968,557,31573,0.685854,0.27,1,292442,291885,557
5945121,51.3684,103.599,472,31640,0.769171,0.31,2,292479,292007,472
5948041,38.2737,48.7199,472,31707,0.785834,0.33,2,292514,292042,472
5950961,39.6547,37.744,477,31774,0.853167,0.37,2,292554,292077,477
5953881,42.3309,37.1488,483,31841,0.850633,0.39,2,292597,292114,483
5956801,46.0662,41.8298,487,31907,0.882127,0.47,2,292644,292157,487
5959721,28.4132,42.766,468,31973,0.904425,0.41,2,292668,292200,468
5962641,24.8826,30.1532,465,32039,0.924885,0.41,2,292692,292227,465
6047321,51,39,495,33901,0.69,1,1,294043,293548,495
6050241,46.2,47,491,33963,0.61,1,1,294088,293597,491
6053161,42.84,36.6,499,34025,0.586,1,1,294130,293631,499
6056081,39.768,28.92,511,34087,0.5252,1,1,294169,293658,511
6059001,34.3536,35.384,507,34149,0.48104,1,1,294202,293695,507
6061921,23.6707,31.0768,498,34211,0.408208,1,1,294223,293725,498
6064841,21.5341,6.21536,519,34273,0.377642,1,1,294244,293725,519
6067761,73.9068,17.2431,586,34335,0.227528,1,1,294331,293745,586
6070681,37.1814,94.6486,500,34397,0.165506,1,1,294359,293859,500
6073601,41.0363,43.7297,511,34458,0.185101,0.77,1,294401,293890,511
6076521,49.8073,47.9459,514,34519,0.12502,0.85,1,294453,293939,514
6079441,44.3615,51.9892,504,34580,0.065004,0.69,1,294496,293992,504
6082361,43.2723,51.1978,496,34641,0.101001,0.59,1,294539,294043,496
6085281,41.4545,46.2396,492,34702,0.0282002,0.58,1,294580,294088,492
6088201,37.0909,42.8479,486,34763,0.07764,0.51,1,294616,294130,486
6091121,29.8182,39.7696,475,34824,0.119528,0.47,1,294644,294169,475
6094041,21.1636,34.3539,461,34885,0.159906,0.39,1,294663,294202,461
6096961,17.8327,23.6708,457,34946,0.183981,0.37,1,294680,294223,457
6099881,66.7665,21.5342,515,35006,0.188796,0.19,1,294759,294244,515
6102801,35.7533,73.9068,456,35066,0.205759,0.15,1,294787,294331,456
6105721,40.7507,37.1814,470,35126,0.241152,0.19,1,294829,294359,470
6108641,44.9501,41.0363,474,35186,0.28023,0.11,1,294875,294401,474
6111561,44.19,49.8073,466,35246,0.288046,0.05,1,294919,294453,466
6114481,42.438,44.3615,465,35306,0.305609,0.11,1,294961,294496,465
6117401,44.4876,43.2723,467,35366,0.309122,0.01,1,295006,294539,467
6120321,38.4975,41.4545,463,35426,0.325824,0.09,1,295043,294580,463
6123241,30.0995,37.0909,455,35486,0.345165,0.13,1,295071,294616,455
6126161,22.8199,29.8182,448,35546,0.365033,0.17,1,295092,294644,448
6129081,17.364,21.1636,445,35605,0.369007,0.19,1,295108,294663,445
6132001,68.2728,17.8327,509,35664,0.417801,0.19,1,295189,294680,509
6134921,15.2546,66.7665,432,35723,0.42756,0.21,1,295191,294759,432
6137841,26.2509,35.7533,433,35782,0.493512,0.25,1,295220,294787,433
6140761,39.6502,40.7507,434,35841,0.586702,0.29,1,295263,294829,434
6143681,47.93,44.9501,438,35900,0.60534,0.29,1,295313,294875,438
6146601,43.186,44.19,436,35959,0.625068,0.31,1,295355,294919,436
6149521,43.0372,42.438,437,36018,0.661014,0.31,1,295398,294961,437
6152441,44.6074,44.4876,437,36077,0.716203,0.33,1,295443,295006,437
6155361,40.1215,38.4975,439,36136,0.743241,0.35,1,295482,295043,439
6158281,30.4243,30.0995,439,36194,0.796648,0.37,2,295510,295071,439
6161201,23.6849,22.8199,440,36252,0.77533,0.37,2,295532,295092,440
6164121,17.537,17.364,440,36310,0.771066,0.43,2,295548,295108,440
6167041,70.7074,68.2728,443,36368,0.786213,0.43,2,295632,295189,443
6169961,15.7415,15.2546,443,36426,0.821243,0.51,2,295634,295191,443
6172881,29.5483,26.2509,447,36484,0.828249,0.61,2,295667,295220,447
6175801,42.7097,39.6502,450,36542,0.89365,0.61,2,295713,295263,450
6178721,50.9419,47.93,453,36600,0.95473,0.63,2,295766,295313,453
6323261,38,41,522,39382,0.43,1,1,297727,297205,522
6364141,398.8,464.2,441,17520,0.126,0.19,1,298216,297775,441
6367061,162.16,161.64,458,17641,0.0812,0.09,1,298319,297861,458
6369981,94.032,104.328,445,17761,0.02424,0.09,1,298396,297951,445
6372901,91.6064,64.8656,481,17881,0.044848,0.01,1,298487,298006,481
6375821,78.3213,86.5731,464,18000,0.0649696,0,1,298562,298098,464
6378741,38.8643,71.7146,425,18118,0.0369939,0.01,1,298591,298166,425
6381661,49.3729,42.3429,442,18235,0.0473988,0.07,1,298643,298201,442
6384581,90.6746,102.869,425,18351,0.17748,0.01,1,298744,298319,425
6387501,77.3349,82.1737,422,18467,0.219496,0.05,1,298818,298396,422
6390421,89.067,89.2347,423,18582,0.195899,0.07,1,298910,298487,423
6393341,79.4134,77.8469,425,18696,0.22318,0.03,1,298987,298562,425
6396261,36.6827,38.7694,422,18810,0.196636,0.05,1,299013,298591,422
6399181,50.5365,49.3539,424,18923,0.207327,0.21,1,299067,298643,424
6402101,96.5073,90.6708,431,19035,0.289465,0.23,1,299175,298744,431
6405021,79.3015,77.3342,432,19146,0.369893,0.19,1,299250,298818,432
6407941,87.8603,89.0668,430,19257,0.385979,0.23,1,299340,298910,430
6410861,80.7721,79.4134,432,19367,0.421196,0.19,1,299419,298987,432
6413781,35.3544,36.6827,430,19477,0.428239,0.21,1,299443,299013,430
6416701,51.0709,50.5365,431,19586,0.493648,0.21,1,299498,299067,431
6419621,100.614,10.1073,544,19694,0.49073,0.31,1,299611,299067,544
6422541,83.3228,88.4215,515,19802,0.586146,0.39,1,299690,299175,515
6425461,87.8646,77.6843,529,19909,0.637229,0.39,1,299779,299250,529
6428381,81.5729,87.5369,519,20016,0.759446,0.43,2,299859,299340,519
6431301,37.1146,80.7074,466,20122,0.799889,0.43,2,299885,299419,466
6434221,54.6229,35.3415,501,20227,0.823978,0.51,2,299944,299443,501
6437141,102.925,51.0683,561,20332,0.876796,0.49,2,300059,299498,561
6440061,86.1849,100.614,530,20436,0.839359,0.61,2,300141,299611,530
6442981,91.637,83.3227,544,20540,0.847872,0.65,2,300234,299690,544
6445901,87.1274,87.8645,541,20643,0.865574,0.79,2,300320,299779,541
6448821,38.2255,81.5729,487,20746,0.917115,0.81,2,300346,299859,487
6451741,55.6451,37.1146,521,20848,0.895423,0.83,2,300406,299885,521
6518901,120,118,587,23074,0.05,1,1,302072,301485,587
6521821,49.6,106.8,515,23166,0.018,1,1,302104,301589,515
6524741,42.72,56.56,512,23258,0.0596,1,1,302145,301633,512
6527661,66.144,38.512,550,23349,0.03592,1,1,302217,301667,550
6530581,42.8288,66.9024,513,23440,0.031184,1,1,302254,301741,513
6533501,59.7658,47.7805,534,23530,0.0302368,0.83,1,302318,301784,534
6536421,77.5531,55.1561,559,23620,0.0300474,0.53,1,302400,301841,559
6539341,90.7106,99.8312,542,23710,0.0300095,0.05,1,302494,301952,542
6542261,42.9421,115.966,453,23799,0.00600189,0.01,1,302525,302072,453
6545181,41.3884,48.7932,462,23888,0.0252004,0.07,1,302566,302104,462
6548101,65.8777,42.5586,493,23977,0.0770401,0.03,1,302638,302145,493
6551021,14.7755,66.1117,423,24065,0.055408,0.03,1,302640,302217,423
6553941,33.3551,42.8223,424,24153,0.0830816,0.03,1,302678,302254,424
6556861,57.071,59.7645,423,24241,0.0566163,0.03,1,302741,302318,423
6559781,76.2142,77.5529,422,24328,0.115323,0.03,1,302822,302400,422
6562701,92.8428,90.7106,425,24415,0.175065,0,1,302919,302494,425
6565621,41.7686,42.9421,423,24502,0.171013,0.03,1,302948,302525,423
6568541,40.3537,41.3884,422,24588,0.122203,0.09,1,302988,302566,422
6571461,68.8707,65.8777,426,24674,0.112441,0.05,1,303064,302638,426
6574381,15.3741,14.7755,426,24760,0.0784881,0.09,1,303066,302640,426
6577301,30.2748,33.3551,422,24846,0.0716976,0.05,1,303100,302678,422
6580221,56.455,57.071,422,24931,0.0863395,0.13,1,303163,302741,422
6583141,80.891,76.2142,428,25016,0.121268,0.19,1,303250,302822,428
6586061,94.5782,92.8428,429,25101,0.160254,0.17,1,303348,302919,429
6588981,38.1156,41.7686,424,25185,0.168051,0.11,1,303372,302948,424
6591901,39.6231,40.3537,424,25269,0.23361,0.11,1,303412,302988,424
6594821,70.3246,68.8707,426,25353,0.102722,0.07,1,303490,303064,426
6597741,15.6649,15.3741,426,25437,0.0765444,0.07,1,303492,303066,426
6600661,27.133,3.07483,456,25520,0.0393089,0.07,1,303522,303066,456
6603581,55.0266,27.815,484,25603,0.0478618,0.09,1,303584,303100,484
6606501,83.8053,55.963,512,25686,0.0655724,0.13,1,303675,303163,512
6609421,98.3611,80.7926,527,25768,0.117114,0.17,1,303777,303250,527
6612341,39.6722,94.5585,454,25850,0.127423,0.17,1,303802,303348,454
6615261,40.7344,38.1117,471,25932,0.225485,0.25,1,303843,303372,471
6618181,63.3469,39.6223,500,26014,0.309097,0.07,1,303912,303412,500
6621101,14.2694,70.3245,424,26095,0.325819,0.07,1,303914,303490,424
6624021,26.8539,15.6649,452,26176,0.345164,0.03,1,303944,303492,452
6626941,55.7708,27.133,485,26257,0.333033,0.05,1,304007,303522,485
6629861,84.7542,55.0266,515,26338,0.346607,0.07,1,304099,303584,515
6632781,100.951,83.8053,529,26418,0.365321,0.13,1,304204,303675,529
6635701,40.9902,98.3611,453,26498,0.401064,0.13,1,304230,303777,453
6638621,44.998,39.6722,474,26578,0.344213,0.25,1,304276,303802,474
6641541,67.3996,40.7344,506,26658,0.428843,0.33,1,304349,303843,506
6644461,15.0799,63.3469,439,26737,0.445769,0.33,1,304351,303912,439
6647381,27.816,14.2694,468,26816,0.465154,0.35,1,304382,303914,468
6650301,55.1632,26.8539,500,26895,0.469031,0.33,1,304444,303944,500
6653221,12.6326,55.7708,439,26974,0.469806,0.35,1,304446,304007,439
6656141,76.1265,84.7542,439,27053,0.533961,0.37,1,304538,304099,439
6659061,100.025,100.951,440,27131,0.562792,0.41,1,304644,304204,440
6661981,40.8051,40.9902,440,27209,0.584558,0.33,1,304670,304230,440
6664901,44.961,44.998,440,27287,0.620912,0.45,1,304716,304276,440
6667821,70.5922,67.3996,444,27365,0.692182,0.45,1,304793,304349,444
6670741,15.7184,15.0799,444,27442,0.674437,0.47,1,304795,304351,444
6673661,28.7437,27.816,445,27519,0.782887,0.47,2,304827,304382,445
6676581,55.3487,55.1632,445,27596,0.868577,0.47,2,304889,304444,445
6679501,12.6697,12.6326,445,27673,0.901716,0.55,2,304891,304446,445
6682421,77.734,76.1265,447,27750,0.924343,0.57,2,304985,304538,447
6685341,101.147,100.025,448,27826,0.944869,0.59,2,305092,304644,448
6805061,93,88,490,30791,0.41,1,1,307176,306686,490
6807981,54.6,47.2,498,30860,0.234,1,1,307221,306723,498
6810901,42.12,38.24,501,30929,0.0708,1,1,307260,306759,501
6813821,35.624,37.248,498,30997,0.01416,1,1,307294,306796,498
6816741,41.5248,41.0496,499,31065,0.042832,1,1,307337,306838,499
6819661,37.905,42.6099,493,31133,0.0325664,1,1,307374,306881,493
6822581,69.181,78.922,482,31201,0.0625133,1,1,307451,306969,482
6825501,41.8362,43.7844,482,31269,0.0685027,0.93,1,307486,307004,482
6828421,28.3672,39.1569,469,31337,0.0697005,0.93,1,307511,307042,469
6831341,27.2734,7.83138,496,31405,0.11794,0.69,1,307538,307042,496
6834261,67.8547,34.3663,533,31472,0.047588,0.41,1,307616,307083,533
6837181,43.9709,81.2733,478,31539,0.0495176,0.19,1,307654,307176,478
6840101,31.9942,52.2547,462,31606,0.0819035,0.03,1,307683,307221,462
6843021,31.9988,41.6509,455,31673,0.0403807,0,1,307715,307260,455
6845941,41.5998,35.5302,465,31740,0.0480761,0.05,1,307759,307294,465
6848861,37.92,41.506,459,31807,0.0656152,0.03,1,307796,307337,459
6851781,68.384,37.9012,498,31874,0.069123,0.07,1,307872,307374,498
6854701,42.4768,69.1802,457,31940,0.0378246,0.07,1,307908,307451,457
6857621,30.8954,41.836,450,32006,0.0635649,0.07,1,307936,307486,450
6860541,27.7791,28.3672,452,32072,0.132713,0.13,1,307963,307511,452
6863461,64.7558,27.2734,499,32138,0.130543,0.03,1,308037,307538,499
6866381,44.9512,67.8547,461,32204,0.0501085,0.05,1,308077,307616,461
6869301,34.5902,43.9709,455,32270,0.0660217,0.09,1,308109,307654,455
6872221,28.518,31.9942,453,32336,0.0852043,0.03,1,308136,307683,453
6875141,43.3036,31.9988,468,32401,0.0570409,0.05,1,308183,307715,468
6878061,35.8607,41.5998,458,32466,0.0514082,0.07,1,308217,307759,458
6880981,71.9721,37.92,502,32531,0.114282,0.07,1,308298,307796,502
6883901,43.1944,68.384,462,32596,0.158856,0.03,1,308334,307872,462
6886821,30.2389,42.4768,453,32661,0.215771,0.07,1,308361,307908,453
6889741,30.0478,30.8954,455,32726,0.211154,0.15,1,308391,307936,455
6892661,7.60956,27.7791,430,32791,0.210231,0.13,1,308393,307963,430
6895581,59.1219,64.7558,428,32856,0.258046,0.03,1,308465,308037,428
6898501,41.4244,44.9512,425,32920,0.283609,0.07,1,308502,308077,425
6901421,33.8849,34.5902,425,32984,0.272722,0.09,1,308534,308109,425
6904341,25.977,28.518,422,33048,0.302544,0.05,1,308558,308136,422
6907261,45.1954,43.3036,425,33112,0.228509,0.05,1,308608,308183,425
6910181,37.8391,35.8607,427,33176,0.181702,0.13,1,308644,308217,427
6913101,73.1678,71.9721,428,33240,0.20434,0.17,1,308726,308298,428
6916021,46.6336,43.1944,432,33304,0.240868,0.23,1,308766,308334,432
6918941,30.1267,30.2389,431,33368,0.280174,0.21,1,308792,308361,431
6921861,30.8253,30.0478,432,33431,0.304035,0.21,1,308823,308391,432
6924781,7.76507,7.60956,432,33494,0.276807,0.27,1,308825,308393,432
6927701,59.953,59.1219,433,33557,0.367361,0.29,1,308898,308465,433
6930621,42.3906,41.4244,434,33620,0.433472,0.27,1,308936,308502,434
6933541,34.8781,33.8849,435,33683,0.478694,0.31,1,308969,308534,435
6936461,28.5756,25.977,438,33746,0.503739,0.21,1,308996,308558,438
6939381,39.3151,45.1954,430,33809,0.588748,0.17,1,309038,308608,430
6942301,35.063,37.8391,428,33872,0.60575,0.21,1,309072,308644,428
6945221,74.2126,73.1678,430,33934,0.65715,0.25,1,309156,308726,430
6948141,48.4425,46.6336,432,33996,0.65143,0.29,1,309198,308766,432
6951061,32.0885,30.1267,434,34058,0.650286,0.31,1,309226,308792,434
6953981,32.0177,30.8253,435,34120,0.682057,0.27,1,309258,308823,435
6956901,8.00354,7.76507,435,34182,0.720411,0.39,1,309260,308825,435
6959821,63.2007,59.953,439,34244,0.728082,0.39,1,309337,308898,439
6962741,45.4401,11.9906,480,34306,0.713616,0.45,1,309378,308898,480
6965661,37.888,32.7981,478,34368,0.678723,0.49,1,309414,308936,478
6968581,29.9776,32.9596,473,34430,0.703745,0.51,1,309442,308969,473
6971501,42.7955,28.1919,492,34491,0.676749,0.61,1,309488,308996,492
6974421,37.3591,39.2384,486,34552,0.63935,0.61,1,309524,309038,486
6977341,76.2718,35.0477,538,34613,0.72787,0.67,1,309610,309072,538
6980261,48.0544,74.2095,495,34674,0.777574,0.65,2,309651,309156,495
6983181,32.0109,48.4419,481,34735,0.803515,0.65,2,309679,309198,481
6986101,33.6022,32.0884,487,34796,0.856703,0.69,2,309713,309226,487
6989021,8.32043,32.0177,457,34857,0.867341,0.73,2,309715,309258,457
6991941,64.8641,8.00353,534,34918,0.885468,0.73,2,309794,309260,534
6994861,44.9728,63.2007,497,34979,0.953094,0.71,2,309834,309337,497
7151081,66,94,480,17042,0.05,0.05,1,312127,311647,480
7154001,94,111.6,465,17167,0.018,0.03,1,312228,311763,465
7156921,86.8,87.92,468,17291,0.0116,0.05,1,312313,311845,468
7159841,45.36,70.384,437,17414,0.01032,0.03,1,312348,311911,437
7162761,116.272,39.6768,539,17536,0.026064,0.01,1,312482,311943,539
7165681,76.8544,102.335,488,17657,0.0452128,0.05,1,312549,312061,488
7168601,96.9709,73.2671,524,17777,0.0170426,0.01,1,312651,312127,524
7171521,86.5942,95.4534,507,17896,0.0914085,0.01,1,312735,312228,507
7174441,45.3188,87.0907,457,18015,0.0182817,0.01,1,312770,312313,457
7177361,10.6638,45.4181,424,18133,0.0276563,0.03,1,312772,312348,424
7180281,109.333,116.284,424,18250,0.0295313,0.05,1,312906,312482,424
7183201,77.8666,76.8567,427,18366,0.0619063,0.01,1,312976,312549,427
7186121,93.1733,96.9713,422,18482,0.0203812,0.11,1,313073,312651,422
7189041,86.6347,86.5943,423,18597,0.0760763,0,1,313158,312735,423
7191961,45.3269,45.3189,423,18711,0.0712152,0.03,1,313193,312770,423
7194881,10.6654,10.6638,423,18824,0.070243,0.03,1,313195,312772,423
7197801,110.133,109.333,424,18937,0.0380486,0.07,1,313330,312906,424
7200721,79.6266,77.8666,426,19049,0.0316097,0.01,1,313402,312976,426
7203641,90.3253,93.1733,422,19160,0.0783219,0.09,1,313495,313073,422
7206561,87.6651,86.6347,424,19271,0.103664,0.07,1,313582,313158,424
7209481,44.733,45.3269,423,19381,0.124733,0.07,1,313616,313193,423
7212401,10.5466,10.6654,423,19490,0.144947,0.03,1,313618,313195,423
7215321,110.109,110.133,423,19599,0.0849893,0.03,1,313753,313330,423
7218241,78.8219,22.0266,494,19707,0.104998,0.03,1,313824,313330,494
7221161,89.3644,62.0053,514,19815,0.0449996,0.09,1,313916,313402,514
7224081,89.8729,86.8011,511,19922,0.0649999,0.11,1,314006,313495,511
7227001,46.7746,86.9602,460,20028,0.069,0.13,1,314042,313582,460
7229921,10.9549,44.592,428,20134,0.1018,0.15,1,314044,313616,428
7232841,110.191,10.5184,561,20239,0.22036,0.07,1,314179,313618,561
7235761,78.8382,110.104,497,20344,0.276072,0.11,1,314250,313753,497
7238681,87.7676,78.8207,516,20448,0.239214,0.03,1,314340,313824,516
7241601,89.5535,89.3641,514,20552,0.135843,0.07,1,314430,313916,514
7244521,49.1107,89.8728,463,20655,0.131169,0.07,1,314469,314006,463
7247441,11.4221,46.7746,429,20758,0.130234,0.11,1,314471,314042,429
7250361,115.084,10.9549,568,20860,0.242047,0.25,1,314612,314044,568
7253281,81.4169,110.191,506,20962,0.296409,0.29,1,314685,314179,506
7256201,17.8834,78.8382,437,21063,0.307282,0.23,1,314687,314250,437
7259121,72.3767,87.7676,433,21164,0.357456,0.11,1,314773,314340,433
7262041,81.6753,89.5535,427,21264,0.399491,0.13,1,314857,314430,427
7264961,49.9351,49.1107,430,21364,0.407898,0.13,1,314899,314469,430
7267881,11.587,11.4221,430,21463,0.40958,0.27,1,314901,314471,430
7270801,119.117,115.084,435,21562,0.489916,0.31,1,315047,314612,435
7273721,83.8235,81.4169,437,21660,0.569983,0.31,1,315122,314685,437
7276641,18.3647,17.8834,437,21758,0.553997,0.37,1,315124,314687,437
7279561,74.8729,72.3767,440,21855,0.614799,0.41,1,315213,314773,440
7282481,83.7746,81.6753,442,21952,0.70696,0.41,1,315299,314857,442
7285401,48.7549,49.9351,440,22049,0.741392,0.41,1,315339,314899,440
7288321,11.351,11.587,440,22145,0.748278,0.51,1,315341,314901,440
7291241,123.07,119.117,445,22241,0.901656,0.59,2,315492,315047,445
7294161,88.614,83.8235,450,22336,0.924331,0.55,2,315572,315122,450
7297081,19.3228,18.3647,450,22431,0.928866,0.63,2,315574,315124,450
7396361,47,32,496,25447,0.37,1,1,317755,317259,496
7399281,42.2,6.4,537,25530,0.338,1,1,317796,317259,537
7402201,70.04,31.68,576,25613,0.1876,1,1,317873,317297,576
7405121,82.008,84.736,563,25696,0.07752,0.99,1,317958,317395,563
7408041,45.2016,84.9472,514,25778,0.071504,0.98,1,317994,317480,514
7410961,53.0403,51.3894,526,25860,0.0143008,0.97,1,318049,317523,526
7413881,70.6081,55.0779,545,25942,0.10686,0.69,1,318124,317579,545
7416801,40.5216,83.0156,488,26024,0.141372,0.59,1,318157,317669,488
7419721,41.7043,47.8031,491,26105,0.148274,0.37,1,318199,317708,491
7422641,37.9409,47.1606,481,26186,0.245655,0.33,1,318236,317755,481
7425561,59.5882,42.2321,505,26267,0.265131,0.15,1,318301,317796,505
7428481,74.3176,70.0464,506,26348,0.301026,0.05,1,318379,317873,506
7431401,47.6635,82.0093,462,26428,0.260205,0.07,1,318420,317958,462
7434321,50.3327,45.2019,477,26508,0.188041,0,1,318471,317994,477
7437241,74.8665,53.0404,503,26588,0.189608,0.13,1,318552,318049,503
7440161,42.9733,70.6081,463,26668,0.221922,0.15,1,318587,318124,463
7443081,41.3947,40.5216,471,26747,0.276384,0.15,1,318628,318157,471
7446001,42.6789,41.7043,472,26826,0.303277,0.27,1,318671,318199,472
7448921,58.9358,37.9409,498,26905,0.292655,0.27,1,318734,318236,498
7451841,13.3872,59.5882,435,26984,0.290531,0.31,1,318736,318301,435
7454761,68.2774,74.3176,439,27062,0.354106,0.25,1,318818,318379,439
7457681,42.4555,47.6635,434,27140,0.446821,0.17,1,318854,318420,434
7460601,46.0911,50.3327,430,27218,0.417364,0.19,1,318901,318471,430
7463521,74.8182,74.8665,431,27296,0.459473,0.23,1,318983,318552,431
7466441,46.1636,42.9733,435,27374,0.547895,0.29,1,319022,318587,435
7469361,41.2327,41.3947,434,27451,0.597579,0.31,1,319062,318628,434
7472281,45.0465,42.6789,437,27528,0.639516,0.29,1,319108,318671,437
7475201,58.6093,58.9358,436,27605,0.647903,0.29,1,319170,318734,436
7478121,13.3219,13.3872,436,27682,0.649581,0.37,1,319172,318736,436
7481041,71.4644,68.2774,440,27759,0.713916,0.47,1,319258,318818,440
7483961,45.4929,42.4555,443,27835,0.710783,0.41,1,319297,318854,443
7486881,45.8986,46.0911,442,27911,0.774157,0.47,2,319343,318901,442
7489801,77.9797,74.8182,446,27987,0.786831,0.57,2,319429,318983,446
7492721,48.3959,46.1636,448,28063,0.773366,0.61,2,319470,319022,448
7495641,43.2792,41.2327,450,28138,0.802673,0.65,2,319512,319062,450
7498561,47.0558,45.0465,452,28213,0.840535,0.65,2,319560,319108,452
7501481,60.6112,58.6093,454,28288,0.832107,0.65,2,319624,319170,454
7504401,13.7222,13.3219,454,28363,0.830421,0.65,2,319626,319172,454
7507321,72.3444,2.66437,541,28438,0.878084,0.73,2,319713,319172,541
7510241,46.4689,69.3329,495,28512,0.887617,0.71,2,319753,319258,495
7513161,47.6938,45.0666,504,28586,0.905523,0.79,2,319801,319297,504
7612441,90,93,488,31003,0.31,1,1,321552,321064,488
7615361,58.8,54.6,494,31071,0.118,1,1,321603,321109,494
7618281,50.16,45.32,499,31139,0.0956,1,1,321651,321152,499
7621201,47.632,44.264,502,31207,0.04312,1,1,321698,321196,502
7624121,38.3264,38.4528,501,31275,0.016624,1,1,321734,321233,501
7627041,30.8653,34.0906,497,31343,0.0113248,1,1,321763,321266,497
7629961,33.3731,6.81811,531,31411,0.058265,1,1,321797,321266,531
7632881,49.0746,46.1636,528,31478,0.051653,1,1,321850,321322,528
7635801,37.0149,52.4327,508,31545,0.0663306,0.85,1,321884,321376,508
7638721,34.603,45.6865,498,31612,0.0852661,0.79,1,321918,321420,498
7641641,58.9206,42.7373,521,31679,0.121053,0.31,1,321983,321462,521
7644561,48.5841,80.5475,477,31746,0.128211,0.07,1,322029,321552,477
7647481,44.1168,56.9095,469,31813,0.0496421,0.09,1,322072,321603,469
7650401,47.2234,49.7819,469,31880,0.0179284,0.03,1,322120,321651,469
7653321,38.2447,47.5564,458,31946,0.0595857,0.01,1,322156,321698,458
7656241,30.8489,38.3113,451,32012,0.0199171,0.01,1,322185,321734,451
7659161,36.5698,30.8623,460,32078,0.0599834,0.07,1,322223,321763,460
7662081,48.114,33.3725,477,32144,0.0119967,0.05,1,322274,321797,477
7665001,37.6228,49.0745,459,32210,0.0263993,0.07,1,322309,321850,459
7667921,33.9246,37.0149,458,32276,0.0772799,0.09,1,322342,321884,458
7670841,61.1849,34.603,492,32342,0.183456,0.13,1,322410,321918,492
7673761,45.037,58.9206,468,32407,0.188691,0.13,1,322451,321983,468
7676681,43.4074,48.5841,465,32472,0.173738,0.03,1,322494,322029,465
7679601,47.0815,44.1168,470,32537,0.0427476,0.01,1,322542,322072,470
7682521,38.2163,47.2234,458,32602,0.0485495,0.07,1,322578,322120,458
7685441,30.8433,38.2447,451,32667,0.0177099,0.01,1,322607,322156,451
7688361,40.5687,30.8489,465,32732,0.075542,0.07,1,322650,322185,465
7691281,9.71373,36.5698,429,32797,0.0551084,0,1,322652,322223,429
7694201,39.5427,48.114,425,32861,0.0510217,0.03,1,322699,322274,425
7697121,34.3085,37.6228,423,32925,0.0182043,0.09,1,322732,322309,423
7700041,35.6617,33.9246,426,32989,0.0436409,0.21,1,322768,322342,426
7702961,66.3323,61.1849,432,33053,0.0967282,0.19,1,322842,322410,432
7705881,43.6665,45.037,429,33117,0.0913456,0.17,1,322880,322451,429
7708801,42.3333,43.4074,428,33181,0.170269,0.01,1,322922,322494,428
7711721,42.8667,47.0815,423,33245,0.170054,0.05,1,322965,322542,423
7714641,38.1733,38.2163,424,33309,0.170011,0.01,1,323002,322578,424
7717561,31.6347,30.8433,425,33372,0.202002,0.09,1,323032,322607,425
7720481,42.3269,40.5687,427,33435,0.2244,0.05,1,323077,322650,427
7723401,10.0654,9.71373,427,33498,0.22888,0.05,1,323079,322652,427
7726321,35.6131,39.5427,422,33561,0.245776,0.01,1,323121,322699,422
7729241,33.5226,34.3085,422,33624,0.265155,0.05,1,323154,322732,422
7732161,37.9045,35.6617,425,33687,0.317031,0.11,1,323193,322768,425
7735081,67.5809,66.3323,426,33750,0.343406,0.09,1,323268,322842,426
7738001,43.9162,43.6665,426,33813,0.348681,0.19,1,323306,322880,426
7740921,44.7832,42.3333,429,33876,0.381736,0.17,1,323351,322922,429
7743841,42.5566,42.8667,428,33938,0.452347,0.17,1,323393,322965,428
7746761,39.7113,38.1733,430,34000,0.466469,0.21,1,323432,323002,430
7749681,33.5423,31.6347,432,34062,0.501294,0.23,1,323464,323032,432
7752601,42.7085,42.3269,432,34124,0.508259,0.23,1,323509,323077,432
7755521,10.1417,10.0654,432,34186,0.509652,0.25,1,323511,323079,432
7758441,36.4283,35.6131,433,34248,0.49393,0.25,1,323554,323121,433
7761361,34.4857,7.12262,467,34310,0.490786,0.27,1,323588,323121,467
7764281,40.4971,27.8245,476,34372,0.506157,0.33,1,323630,323154,476
7767201,68.8994,36.7649,513,34434,0.541231,0.35,1,323706,323193,513
7770121,44.1799,67.353,476,34495,0.564246,0.35,1,323744,323268,476
7773041,48.836,43.8706,488,34556,0.584849,0.39,1,323794,323306,488
7775961,44.1672,44.7741,486,34617,0.65297,0.47,1,323837,323351,486
7778881,40.0334,42.5548,483,34678,0.666594,0.47,1,323876,323393,483
7781801,34.4067,39.711,477,34739,0.653319,0.51,1,323909,323432,477
7784721,42.0813,33.5422,489,34800,0.682664,0.51,1,323953,323464,489
7787641,10.0163,42.7084,446,34861,0.688533,0.51,1,323955,323509,446
7790561,37.2033,10.1417,488,34922,0.737707,0.49,1,323999,323511,488
7793481,34.6407,36.4283,479,34983,0.747541,0.49,1,324033,323554,479
7796401,41.3281,34.4857,488,35043,0.765508,0.51,2,324076,323588,488
7799321,70.6656,40.4971,524,35103,0.817102,0.55,2,324154,323630,524
7802241,45.3331,68.8994,487,35163,0.82742,0.57,2,324193,323706,487
7805161,51.4666,44.1799,502,35223,0.861484,0.59,2,324246,323744,502
7808081,47.0933,48.836,498,35283,0.900297,0.67,2,324292,323794,498
7971601,86,63,463,16916,0.03,0.03,1,326667,326204,463
7974521,94.8,96.6,455,17042,0.006,0,1,326764,326309,455
7977441,81.36,94.52,439,17167,0.0092,0.05,1,326842,326403,439
7980361,38.672,39.704,441,17291,0.02584,0.01,1,326870,326429,441
7983281,67.7344,40.7408,475,17414,0.061168,0,1,326945,326470,475
7986201,127.947,96.9482,507,17536,0.116234,0.03,1,327088,326581,507
7989121,103.189,88.1896,518,17657,0.0232467,0,1,327185,326667,518
7992041,83.0379,95.2379,499,17777,0.0286493,0.01,1,327263,326764,499
7994961,40.6076,81.4476,451,17896,0.0457299,0.03,1,327293,326842,451
7997881,70.5215,38.6895,501,18015,0.049146,0.07,1,327371,326870,501
8000801,15.7043,67.7379,428,18133,0.0498292,0.13,1,327373,326945,428
8003721,115.941,127.948,426,18250,0.0659658,0,1,327514,327088,426
8006641,98.3882,103.19,423,18366,0.0131932,0.03,1,327608,327185,423
8009561,82.0776,83.0379,423,18482,0.0266386,0.05,1,327686,327263,423
8012481,40.4155,40.6076,423,18597,0.0453277,0.05,1,327716,327293,423
8015401,72.0831,70.5215,425,18711,0.0330655,0.05,1,327796,327371,425
8018321,16.0166,15.7043,425,18824,0.0306131,0.07,1,327798,327373,425
8021241,115.203,115.941,424,18937,0.110123,0,1,327938,327514,424
8024161,96.6407,98.3882,422,19049,0.174025,0.03,1,328030,327608,422
8027081,83.3281,82.0776,424,19160,0.0748049,0.05,1,328110,327686,424
8030001,39.0656,40.4155,422,19271,0.086961,0.03,1,328138,327716,422
8032921,72.6131,72.0831,423,19381,0.0413922,0.03,1,328219,327796,423
8035841,16.1226,16.0166,423,19490,0.0322784,0.13,1,328221,327798,423
8038761,119.225,115.203,428,19599,0.206456,0.13,1,328366,327938,428
8041681,97.4449,23.0407,520,19707,0.225291,0.19,1,328458,327938,520
8044601,79.489,78.2081,503,19815,0.245058,0.05,1,328533,328030,503
8047521,40.6978,79.6416,454,19922,0.265012,0.09,1,328564,328110,454
8050441,69.7396,38.3283,503,20028,0.253002,0.03,1,328641,328138,503
8053361,15.5479,72.4657,424,20134,0.2506,0.03,1,328643,328219,424
8056281,127.11,16.0931,577,20239,0.29812,0.25,1,328798,328221,577
8059201,99.0219,119.219,524,20344,0.323624,0.23,1,328890,328366,524
8062121,79.8044,97.4437,507,20448,0.392725,0.25,1,328965,328458,507
8065041,42.3609,79.4887,465,20552,0.406545,0.27,1,328998,328533,465
8067961,69.2722,40.6977,510,20655,0.505309,0.25,1,329074,328564,510
8070881,15.4544,69.7396,435,20758,0.525062,0.25,1,329076,328641,435
8073801,129.491,15.5479,591,20860,0.673012,0.31,1,329234,328643,591
8076721,100.298,127.11,529,20962,0.702602,0.33,1,329327,328798,529
8079641,21.6596,99.0219,439,21063,0.708521,0.41,1,329329,328890,439
8082561,66.7319,79.8044,442,21164,0.741704,0.41,1,329407,328965,442
8085481,42.1464,42.3609,445,21264,0.780341,0.53,2,329443,328998,445
8088401,73.2293,69.2722,450,21364,0.740068,0.53,1,329524,329074,450
8091321,16.2459,15.4544,450,21463,0.732014,0.71,1,329526,329076,450
8094241,135.249,129.491,457,21562,0.746403,0.71,1,329691,329234,457
8097161,101.45,100.298,457,21660,0.829281,0.71,2,329784,329327,457
8100081,21.89,21.6596,457,21758,0.861856,0.75,2,329786,329329,457
8103001,67.578,66.7319,458,21855,0.900371,0.79,2,329865,329407,458
8105921,42.3156,42.1464,458,21952,0.924074,0.73,2,329901,329443,458
8178921,91,148,495,24251,0.37,1,1,331583,331088,495
8181841,98.2,104.8,501,24338,0.074,1,1,331683,331182,501
8184761,52.44,52.16,503,24425,0.0148,1,1,331724,331221,503
8187681,63.288,66.432,499,24512,0.02696,0.92,1,331790,331291,499
8190601,40.6576,49.2864,489,24598,0.045392,1,1,331825,331336,489
8193521,44.1315,59.4573,472,24684,0.0090784,0.9,1,331870,331398,472
8196441,42.4263,49.4915,467,24770,0.00981568,0.71,1,331912,331445,467
8199361,39.6853,47.4983,459,24856,0.00196314,0.37,1,331951,331492,459
8202281,67.1371,82.2997,442,24941,0.0243926,0,1,332025,331583,442
8205201,79.0274,96.4599,424,25026,0.00487853,0,1,332107,331683,424
8208121,47.0055,52.092,422,25111,0.000975705,0.03,1,332146,331724,422
8211041,63.8011,63.2184,424,25195,0.0241951,0.05,1,332214,331790,424
8213961,39.9602,40.6437,423,25279,0.028839,0,1,332248,331825,423
8216881,43.192,44.1287,422,25363,0.00576781,0.01,1,332292,331870,422
8219801,43.0384,42.4257,423,25447,0.0891536,0.01,1,332335,331912,423
8222721,38.2077,8.48515,460,25530,0.0178307,0,1,332372,331912,460
8225641,66.8415,32.897,495,25613,0.0755661,0.03,1,332446,331951,495
8228561,78.9683,65.7794,503,25696,0.119113,0,1,332528,332025,503
8231481,46.9937,78.7559,460,25778,0.0238226,0,1,332567,332107,460
8234401,63.7987,46.9512,489,25860,0.0527645,0.03,1,332635,332146,489
8237321,40.7597,63.7902,456,25942,0.0345529,0.03,1,332670,332214,456
8240241,42.552,39.958,465,26024,0.0309106,0,1,332713,332248,465
8243161,42.9104,43.1916,464,26105,0.0461821,0.11,1,332756,332292,464
8246081,38.9821,43.0383,459,26186,0.00923642,0,1,332794,332335,459
8249001,67.7964,38.2077,497,26267,0.0418473,0.09,1,332869,332372,497
8251921,79.1593,66.8415,505,26348,0.0963695,0.13,1,332951,332446,505
8254841,45.4319,78.9683,460,26428,0.0192739,0,1,332988,332528,460
8257761,66.6864,46.9937,493,26508,0.139855,0.06,1,333060,332567,493
8260681,38.9373,63.7987,457,26588,0.115971,0.03,1,333092,332635,457
8263601,41.3875,40.7597,464,26668,0.0471942,0.03,1,333134,332670,464
8266521,45.0775,42.552,467,26747,0.0174388,0.05,1,333180,332713,467
8269441,37.8155,42.9104,460,26826,0.00348777,0,1,333216,332756,460
8272361,68.3631,38.9821,498,26905,0.0246976,0.05,1,333292,332794,498
8275281,15.2726,67.7964,425,26984,0.0289395,0.11,1,333294,332869,425
8278201,71.0545,79.1593,428,27062,0.0297879,0,1,333379,332951,428
8281121,39.0109,45.4319,422,27140,0.00595758,0.17,1,333410,332988,422
8284041,71.0022,66.6864,429,27218,0.0731915,0.11,1,333489,333060,429
8286961,38.2004,38.9373,427,27296,0.102638,0.03,1,333519,333092,427
8289881,37.2401,41.3875,422,27374,0.0925277,0.01,1,333556,333134,422
8292801,44.248,45.0775,422,27451,0.122506,0,1,333602,333180,422
8295721,38.4496,37.8155,423,27528,0.0645011,0.03,1,333639,333216,423
8298641,68.4899,68.3631,423,27605,0.1329,0.03,1,333715,333292,423
8301561,15.298,15.2726,423,27682,0.11458,0.03,1,333717,333294,423
8304481,70.2596,71.0545,422,27759,0.110916,0,1,333801,333379,422
8307401,38.8519,39.0109,422,27835,0.0621832,0.09,1,333832,333410,422
8310321,73.3704,71.0022,425,27911,0.0524366,0.11,1,333914,333489,425
8313241,39.4741,38.2004,426,27987,0.0984873,0.09,1,333945,333519,426
8316161,35.8948,37.2401,424,28063,0.155697,0.13,1,333980,333556,424
8319081,45.579,44.248,426,28138,0.19914,0.05,1,334028,333602,426
8322001,37.1158,38.4496,424,28213,0.191828,0.15,1,334063,333639,424
8324921,70.6232,68.4899,427,28288,0.302366,0.11,1,334142,333715,427
8327841,15.7246,15.298,427,28363,0.324473,0.11,1,334144,333717,427
8330761,67.9449,3.0596,508,28438,0.344895,0.11,1,334225,333717,508
8333681,35.989,67.8119,452,28512,0.348979,0.05,1,334253,333801,452
8336601,74.3978,38.3624,505,28586,0.253796,0.05,1,334337,333832,505
8339521,43.6796,73.2725,459,28660,0.266759,0.11,1,334373,333914,459
8342441,35.9359,39.4545,462,28734,0.269352,0.17,1,334407,333945,462
8345361,47.1872,35.8909,477,28808,0.33387,0.21,1,334457,333980,477
8348281,37.4374,45.5782,464,28881,0.378774,0.19,1,334492,334028,464
8351201,77.0875,37.1156,516,28954,0.403755,0.33,1,334579,334063,516
8354121,17.0175,70.6231,439,29027,0.408751,0.33,1,334581,334142,439
8357041,69.0035,15.7246,519,29100,0.44175,0.35,1,334663,334144,519
8359961,34.6007,67.9449,464,29173,0.46435,0.35,1,334689,334225,464
8362881,72.5201,35.989,518,29246,0.50087,0.23,1,334771,334253,518
8365801,43.304,74.3978,470,29318,0.524174,0.27,1,334807,334337,470
8368721,35.8608,43.6796,468,29390,0.560835,0.27,1,334841,334373,468
8371641,50.3722,35.9359,488,29462,0.632167,0.35,1,334895,334407,488
8374561,38.0744,47.1872,473,29534,0.678433,0.39,1,334930,334457,473
8377481,79.6149,37.4374,528,29606,0.735687,0.41,1,335020,334492,528
8380401,17.523,77.0875,443,29677,0.747137,0.41,1,335022,334579,443
8383321,71.5046,17.0175,526,29748,0.797428,0.45,2,335107,334581,526
8386241,35.1009,69.0035,470,29819,0.807486,0.47,2,335133,334663,470
8389161,8.62018,34.6007,446,29890,0.809497,0.51,2,335135,334689,446
8392081,68.924,72.5201,448,29961,0.809899,0.53,2,335219,334771,448
8395001,43.3848,43.304,449,30032,0.80998,0.57,2,335256,334807,449
8397921,36.677,35.8608,450,30102,0.777996,0.65,2,335291,334841,450
8400841,54.5354,50.3722,455,30172,0.787599,0.69,2,335350,334895,455
8403761,39.7071,38.0744,456,30242,0.80552,0.75,2,335386,334930,456
8406681,83.1414,79.6149,460,30312,0.873104,0.75,2,335480,335020,460
8409601,18.2283,17.523,460,30382,0.886621,0.81,2,335482,335022,460
8523481,31,39,498,32989,0.55,1,1,337290,336792,498
8526401,64.6,75.8,486,33053,0.422,1,1,337363,336877,486
8529321,51.32,49.56,491,33117,0.3964,1,1,337411,336920,491
8532241,57.464,63.512,483,33181,0.34328,1,1,337470,336987,483
8535161,41.0928,45.5024,479,33245,0.396656,1,1,337507,337028,479
8538081,36.2186,39.5005,476,33309,0.359331,1,1,337542,337066,476
8541001,29.6437,35.9001,469,33372,0.399866,0.89,1,337570,337101,469
8543921,33.1287,39.18,463,33435,0.423973,0.91,1,337604,337141,463
8546841,36.2257,39.836,460,33498,0.476795,0.71,1,337641,337181,460
8549761,30.4452,32.7672,458,33561,0.503359,0.61,1,337670,337212,458
8552681,42.889,44.1534,457,33624,0.460672,0.55,1,337716,337259,457
8555601,30.1778,33.6307,453,33687,0.532134,0.39,1,337743,337290,453
8558521,57.2356,65.1261,444,33750,0.466427,0.39,1,337807,337363,444
8561441,48.2471,51.4252,442,33813,0.565285,0.33,1,337853,337411,442
8564361,52.8494,57.485,437,33876,0.601057,0.41,1,337907,337470,437
8567281,41.7699,41.097,439,33938,0.608211,0.35,1,337946,337507,439
8570201,38.754,36.2194,442,34000,0.625642,0.41,1,337984,337542,442
8573121,29.3508,29.6439,441,34062,0.661128,0.43,1,338011,337570,441
8576041,33.8702,33.1288,442,34124,0.716226,0.49,1,338046,337604,442
8578961,37.974,36.2258,444,34186,0.775245,0.51,2,338085,337641,444
8581881,32.3948,30.4452,446,34248,0.867049,0.51,2,338116,337670,446
8584801,40.879,6.08903,489,34310,0.86941,0.45,2,338159,337670,489
8587721,32.1758,38.0178,473,34372,0.869882,0.55,2,338189,337716,473
8590641,56.0352,29.2036,508,34434,0.917976,0.45,2,338251,337743,508
8735181,112,112,521,16453,0.69,0.85,1,340557,340036,521
8738101,85.6,104.8,497,16582,0.738,0.89,1,340636,340139,497
8741021,50.72,62.56,487,16710,0.7476,0.97,1,340678,340191,487
8743941,124.544,37.312,599,16837,0.79752,0.65,2,340821,340222,599
8746861,83.3088,123.462,527,16963,0.871504,0.63,2,340894,340367,527
8808181,161,150,507,19421,0.61,1,1,342761,342254,507
8811101,73,70,508,19530,0.594,1,1,342812,342304,508
8814021,39.4,49.2,495,19639,0.4788,1,1,342843,342348,495
8816941,83.88,9.84,590,19747,0.18376,1,1,342938,342348,590
8819861,92.776,89.968,575,19854,0.060752,0.91,1,343033,342458,575
8822781,43.3552,97.9936,506,19961,0.0361504,0.87,1,343064,342558,506
8825701,124.671,53.1987,609,20067,0.0472301,0.61,1,343209,342600,609
8828621,64.9342,139.44,498,20173,0.017446,0.59,1,343259,342761,498
8831541,37.7868,68.6879,478,20278,0.0514892,0.45,1,343290,342812,478
8834461,64.3574,38.5376,518,20383,0.0502978,0.11,1,343361,342843,518
8837381,88.0715,83.7075,517,20487,0.17806,0.03,1,343455,342938,517
8840301,41.6143,92.7415,452,20591,0.0756119,0.03,1,343485,343033,452
8843221,125.123,43.3483,567,20694,0.0391224,0.05,1,343631,343064,567
8846141,65.0246,124.67,472,20797,0.0958245,0.01,1,343681,343209,472
8849061,38.6049,64.9339,454,20899,0.0591649,0.06,1,343713,343259,454
8851981,65.321,37.7868,495,21000,0.067833,0.05,1,343785,343290,495
8854901,14.6642,64.3574,426,21101,0.101567,0.21,1,343787,343361,426
8857821,82.1328,88.0715,431,21202,0.0923133,0.05,1,343886,343455,431
8860741,33.2266,41.6143,422,21302,0.0744627,0.03,1,343907,343485,422
8863661,123.445,125.123,422,21402,0.0388925,0.11,1,344053,343631,422
8866581,67.0891,65.0246,425,21501,0.0637785,0.05,1,344106,343681,425
8869501,37.4178,38.6049,423,21600,0.0847557,0.07,1,344136,343713,423
8872421,66.6836,65.321,425,21698,0.120951,0.11,1,344210,343785,425
8875341,14.9367,14.6642,425,21796,0.12819,0.09,1,344212,343787,425
8878261,82.9873,82.1328,426,21893,0.065638,0.07,1,344312,343886,426
8881181,32.5975,33.2266,425,21990,0.0851276,0.03,1,344332,343907,425
8884101,121.719,123.445,423,22086,0.0170255,0.07,1,344476,344053,423
8887021,69.1439,67.0891,426,22182,0.0594051,0.09,1,344532,344106,426
8889941,36.2288,37.4178,424,22278,0.035881,0.13,1,344560,344136,424
8892861,69.6458,66.6836,428,22373,0.0951762,0.13,1,344638,344210,428
8895781,15.5292,14.9367,428,22468,0.0750352,0.05,1,344640,344212,428
8898701,79.1058,82.9873,423,22562,0.215007,0.05,1,344735,344312,423
8901621,32.6212,16.5975,444,22656,0.259001,0.09,1,344756,344312,444
8904541,119.324,19.3195,565,22750,0.1078,0,1,344897,344332,565
8907461,69.4648,119.064,478,22843,0.0935601,0.07,1,344954,344476,478
8910381,36.293,68.6128,450,22936,0.106712,0.03,1,344982,344532,450
8913301,72.8586,36.1226,504,23028,0.157342,0.11,1,345064,344560,504
8916221,16.1717,69.6245,428,23120,0.167468,0.07,1,345066,344638,428
8919141,84.0343,15.5249,527,23212,0.105494,0.25,1,345167,344640,527
8922061,33.6069,79.105,453,23303,0.109099,0.27,1,345188,344735,453
8924981,112.321,32.621,564,23394,0.21382,0.07,1,345320,344756,564
8927901,70.4643,119.324,483,23485,0.290764,0.09,1,345380,344897,483
8930821,36.4929,69.4648,454,23575,0.274153,0.11,1,345408,344954,454
8933741,75.2986,36.293,511,23665,0.318831,0.17,1,345493,344982,511
8936661,16.6597,72.8586,431,23755,0.327766,0.17,1,345495,345064,431
8939581,80.9319,16.1717,526,23844,0.409553,0.09,1,345592,345066,526
8942501,33.7864,84.0343,447,23933,0.457911,0.11,1,345614,345167,447
8945421,8.35728,33.6069,428,24022,0.483582,0.24,1,345616,345188,428
8948341,112.871,112.321,435,24110,0.520716,0.31,1,345755,345320,435
8951261,70.5743,70.4643,435,24198,0.592143,0.27,1,345815,345380,435
8954181,36.5149,36.4929,435,24286,0.670429,0.33,1,345843,345408,435
8957101,77.703,75.2986,438,24373,0.718086,0.33,1,345931,345493,438
8960021,17.1406,16.6597,438,24460,0.727617,0.43,1,345933,345495,438
8962941,85.8281,80.9319,444,24547,0.793523,0.47,2,346036,345592,444
8965861,36.3656,33.7864,446,24633,0.822705,0.49,2,346060,345614,446
8968781,8.87312,8.35728,446,24719,0.860541,0.53,2,346062,345616,446
9076821,47,45,513,27714,0.67,1,1,348284,347771,513
9079741,47,51.4,507,27790,0.67,1,1,348331,347824,507
9082661,32.6,48.68,488,27866,0.718,1,1,348360,347872,488
9085581,62.52,72.136,480,27942,0.6636,1,1,348430,347950,480
9088501,46.904,51.2272,477,28018,0.54072,1,1,348473,347996,477
9091421,42.1808,40.6454,480,28094,0.468144,0.98,1,348514,348034,480
9094341,67.6362,73.7291,472,28169,0.485629,0.83,1,348588,348116,472
9097261,58.3272,69.1458,460,28244,0.569126,0.69,1,348644,348184,460
9100181,52.4654,56.2292,458,28319,0.585825,0.67,1,348695,348237,458
9103101,45.6931,48.8458,455,28394,0.621165,0.67,1,348739,348284,455
9106021,46.7386,9.76917,502,28469,0.596233,0.67,1,348786,348284,502
9108941,33.3477,39.5538,485,28543,0.623247,0.73,1,348816,348331,485
9111861,59.4695,31.1108,522,28617,0.628649,0.65,1,348882,348360,522
9114781,41.4939,62.2222,489,28691,0.62973,0.51,1,348919,348430,489
9117701,39.4988,46.8444,485,28765,0.661946,0.45,1,348958,348473,485
9120621,67.8998,42.1689,519,28839,0.748389,0.49,1,349033,348514,519
9123541,63.18,67.6338,507,28912,0.717678,0.59,1,349095,348588,507
9126461,51.836,58.3268,500,28985,0.743536,0.59,1,349144,348644,500
9129381,47.9672,52.4653,496,29058,0.748707,0.63,1,349191,348695,496
9132301,47.1934,45.6931,499,29131,0.733741,0.59,1,349238,348739,499
9135221,33.4387,46.7386,482,29204,0.778748,0.63,2,349268,348786,482
9138141,60.2877,33.3477,519,29276,0.77175,0.63,2,349335,348816,519
9141061,40.8575,59.4695,489,29348,0.83435,0.63,2,349371,348882,489
9143981,40.9715,41.4939,493,29420,0.89487,0.67,2,349412,348919,493
9254941,43,45,518,32039,0.67,1,1,351275,350757,518
9257861,35,25.8,530,32105,0.51,1,1,351308,350778,530
9260781,36.6,29.16,537,32171,0.446,1,1,351345,350808,537
9263701,48.12,43.432,541,32237,0.2892,1,1,351396,350855,541
9266621,56.024,51.0864,546,32303,0.08184,1,1,351454,350908,546
9269541,70.4048,68.6173,547,32368,0.016368,1,1,351528,350981,547
9272461,48.481,64.1235,527,32433,0.107274,1,1,351571,351044,527
9275381,50.4962,56.8247,523,32498,0.0614547,1,1,351622,351099,523
9278301,40.4992,54.5649,507,32563,0.0682909,0.96,1,351660,351153,507
9281221,36.8998,41.313,505,32628,0.0856582,0.87,1,351696,351191,505
9284141,36.18,41.0626,500,32693,0.0571316,0.67,1,351732,351232,500
9287061,22.436,42.6125,476,32758,0.0674263,0.47,1,351751,351275,476
9289981,6.0872,34.9225,445,32823,0.0854853,0.43,1,351753,351308,445
9292901,24.4174,36.5845,437,32887,0.153097,0.25,1,351782,351345,437
9295821,36.8835,48.1169,426,32951,0.166619,0.03,1,351822,351396,426
9298741,52.1767,56.0234,424,33015,0.105324,0,1,351878,351454,424
9301661,68.0353,70.4047,422,33079,0.0210648,0.13,1,351950,351528,422
9304581,48.8071,48.4809,423,33143,0.044213,0.05,1,351994,351571,423
9307501,49.7614,50.4962,422,33207,0.112843,0.07,1,352044,351622,422
9310421,42.7523,40.4992,425,33271,0.0785685,0.09,1,352085,351660,425
9313341,38.1505,36.8998,426,33335,0.0877137,0.05,1,352122,351696,426
9316261,35.6301,36.18,425,33398,0.137543,0.07,1,352157,351732,425
9319181,23.126,22.436,426,33461,0.115509,0.09,1,352177,351751,426
9322101,6.2252,6.0872,426,33524,0.143102,0.17,1,352179,351753,426
9325021,26.045,24.4174,428,33587,0.21262,0.17,1,352210,351782,428
9327941,36.409,36.8835,427,33650,0.210524,0.09,1,352249,351822,427
9330861,52.0818,52.1767,427,33713,0.242105,0,1,352305,351878,427
9333781,64.0164,68.0353,422,33776,0.264421,0.05,1,352372,351950,422
9336701,49.6033,48.8071,424,33839,0.188884,0.13,1,352418,351994,424
9339621,50.7207,49.7614,425,33901,0.189777,0.07,1,352469,352044,425
9342541,41.3441,42.7523,423,33963,0.141955,0.09,1,352508,352085,423
9345461,38.6688,38.1505,424,34025,0.116391,0.15,1,352546,352122,424
9348381,36.5338,35.6301,425,34087,0.159278,0.11,1,352582,352157,425
9351301,24.9068,23.126,427,34149,0.167856,0.15,1,352604,352177,427
9354221,6.58135,6.2252,427,34211,0.185571,0.15,1,352606,352179,427
9357141,30.1163,1.24504,463,34273,0.221114,0.23,1,352642,352179,463
9360061,35.6233,25.049,469,34335,0.292223,0.21,1,352679,352210,469
9362981,54.3247,36.2098,489,34397,0.306445,0.25,1,352738,352249,489
9365901,63.6649,52.042,499,34458,0.373289,0.27,1,352804,352305,499
9368821,47.133,64.0084,475,34519,0.402658,0.17,1,352847,352372,475
9371741,49.4266,49.6017,479,34580,0.456532,0.19,1,352897,352418,479
9374661,38.6853,50.7203,464,34641,0.483306,0.13,1,352933,352469,464
9377581,38.9371,41.3441,464,34702,0.504661,0.11,1,352972,352508,464
9380501,38.9874,38.6688,465,34763,0.524932,0.17,1,353011,352546,465
9383421,26.1975,36.5338,452,34824,0.528986,0.17,1,353034,352582,452
9386341,6.8395,24.9068,432,34885,0.529797,0.19,1,353036,352604,432
9389261,32.5679,6.58135,469,34946,0.529959,0.23,1,353075,352606,469
9392181,38.5136,30.1163,473,35006,0.561992,0.31,1,353115,352642,473
9395101,54.9027,35.6233,495,35066,0.584398,0.31,1,353174,352679,495
9398021,66.9805,54.3247,506,35126,0.60488,0.39,1,353244,352738,506
9400941,48.5961,63.6649,484,35186,0.656976,0.41,1,353288,352804,484
9403861,52.1192,47.133,494,35246,0.667395,0.47,1,353341,352847,494
9406781,40.8238,49.4266,482,35306,0.701479,0.49,1,353379,352897,482
9409701,39.3648,38.6853,485,35366,0.756296,0.51,2,353418,352933,485
9412621,40.673,38.9371,487,35426,0.831259,0.53,2,353459,352972,487
9415541,25.7346,38.9874,470,35486,0.814252,0.53,2,353481,353011,470
9418461,6.74692,26.1975,449,35546,0.82685,0.53,2,353483,353034,449
9421381,32.5494,6.8395,486,35605,0.86137,0.53,2,353522,353036,486
9424301,40.1099,32.5679,489,35664,0.884274,0.57,2,353564,353075,489
9427221,9.62198,38.5136,451,35723,0.888855,0.59,2,353566,353115,451
9573221,90,116,513,17042,0.63,0.85,1,355777,355264,513
9576141,90,110.4,494,17167,0.662,0.55,1,355867,355373,494
9579061,90.8,87.68,503,17291,0.7484,0.55,1,355958,355455,503
9581981,42.96,73.536,464,17414,0.71768,0.61,1,355989,355525,464
9584901,130.992,35.5072,591,17536,0.839536,0.65,2,356142,355551,591
9587821,94.1984,115.901,540,17657,0.895907,0.63,2,356227,355687,540
9660821,87,77,567,20448,0.55,1,1,358220,357653,567
9663741,95,96.2,563,20552,0.326,1,1,358317,357754,563
9666661,67.8,99.24,524,20655,0.2812,0.98,1,358378,357854,524
9669581,44.76,57.448,516,20758,0.17624,1,1,358417,357901,516
9672501,87.352,49.0896,567,20860,0.139248,0.89,1,358515,357948,567
9675421,79.0704,90.6179,543,20962,0.11585,0.73,1,358592,358049,543
9678341,17.4141,85.3236,461,21063,0.11117,0.55,1,358594,358133,461
9681261,61.8828,86.6647,447,21164,0.094234,0.27,1,358667,358220,447
9684181,84.3766,94.9329,440,21264,0.154847,0.27,1,358757,358317,440
9687101,60.0753,67.7866,433,21364,0.198969,0.15,1,358811,358378,433
9690021,40.0151,44.7573,429,21463,0.255794,0.13,1,358846,358417,429
9692941,84.803,87.3515,427,21562,0.299159,0.11,1,358942,358515,427
9695861,78.5606,79.0703,427,21660,0.435832,0.11,1,359019,358592,427
9698781,17.3121,17.4141,427,21758,0.431166,0.09,1,359021,358594,427
9701701,63.4624,61.8828,429,21855,0.462233,0.17,1,359096,358667,429
9704621,85.4925,84.3766,430,21952,0.532447,0.21,1,359187,358757,430
9707541,61.8985,60.0753,432,22049,0.514489,0.27,1,359243,358811,432
9710461,41.9797,40.0151,434,22145,0.590898,0.31,1,359280,358846,434
9713381,87.5959,84.803,437,22241,0.62218,0.47,1,359379,358942,437
9716301,83.9192,78.5606,443,22336,0.660436,0.43,1,359462,359019,443
9719221,18.3838,17.3121,443,22431,0.636087,0.47,1,359464,359021,443
9722141,65.2768,63.4624,445,22526,0.663217,0.47,1,359541,359096,445
9725061,88.2554,12.6925,539,22620,0.748644,0.55,1,359635,359096,539
9727981,60.8511,75.3385,502,22714,0.781729,0.51,2,359689,359187,502
9730901,44.1702,59.8677,486,22807,0.756346,0.61,2,359729,359243,486
9733821,88.834,41.5735,549,22900,0.879269,0.63,2,359829,359280,549
9736741,85.7668,87.5147,535,22993,0.919854,0.67,2,359914,359379,535
9739661,18.7534,83.9029,454,23085,0.927971,0.63,2,359916,359462,454
9742581,66.9507,18.3806,531,23177,0.929594,0.67,2,359995,359464,531
9745501,93.3901,65.2761,554,23268,0.945919,0.77,2,360095,359541,554
9748421,61.878,88.2552,514,23359,0.917184,0.79,2,360149,359635,514
9751341,43.5756,60.851,499,23450,0.943437,0.75,2,360188,359689,499
9818501,44,39,497,25447,0.61,1,1,361642,361145,497
9821421,48,7.8,546,25530,0.482,1,1,361691,361145,546
9824341,50.4,35.16,555,25613,0.3284,1,1,361742,361187,555
9827261,85.28,64.632,577,25696,0.12168,1,1,361836,361259,577
9830181,53.856,92.9264,523,25778,0.024336,1,1,361882,361359,523
9833101,45.9712,57.7853,518,25860,0.0768672,1,1,361926,361408,518
9836021,83.5942,37.1571,579,25942,0.0553734,0.88,1,362019,361440,579
9838941,43.9188,99.4314,498,26024,0.0190747,0.71,1,362053,361555,498
9841861,40.7838,54.2863,495,26105,0.0278149,0.61,1,362093,361598,495
9844781,40.1568,46.0573,491,26186,0.061563,0.45,1,362133,361642,491
9847701,41.6314,48.4115,484,26267,0.0363126,0.29,1,362175,361691,484
9850621,73.9263,50.4823,515,26348,0.0792625,0.07,1,362257,361742,515
9853541,52.3853,85.2965,468,26428,0.0398525,0,1,362304,361836,468
9856461,44.8771,53.8593,465,26508,0.111971,0.09,1,362347,361882,465
9859381,83.3754,45.9719,514,26588,0.0783941,0.05,1,362440,361926,514
9862301,44.6751,83.5944,456,26668,0.0236788,0.01,1,362475,362019,456
9865221,42.535,43.9189,464,26747,0.0287358,0.03,1,362517,362053,464
9868141,38.907,40.7838,462,26826,0.0457471,0.07,1,362555,362093,462
9871061,41.3814,40.1568,464,26905,0.177149,0.03,1,362597,362133,464
9873981,9.87628,41.6314,424,26984,0.20343,0.09,1,362599,362175,424
9876901,67.5753,73.9263,424,27062,0.192686,0.03,1,362681,362257,424
9879821,50.315,52.3853,423,27140,0.0465372,0.13,1,362727,362304,423
9882741,48.463,44.8771,428,27218,0.0493074,0.07,1,362775,362347,428
9885661,82.4926,83.3754,426,27296,0.0338615,0.01,1,362866,362440,426
9888581,42.8985,44.6751,424,27374,0.0467723,0.03,1,362899,362475,424
9891501,42.1797,42.535,424,27451,0.113354,0.05,1,362941,362517,424
9894421,39.6359,38.907,425,27528,0.110671,0.21,1,362980,362555,425
9897341,44.7272,41.3814,429,27605,0.222134,0.21,1,363026,362597,429
9900261,10.5454,9.87628,429,27682,0.244427,0.19,1,363028,362599,429
9903181,67.7091,67.5753,429,27759,0.328885,0.01,1,363110,362681,429
9906101,44.7418,50.315,422,27835,0.329777,0.05,1,363149,362727,422
9909021,47.3484,48.463,422,27911,0.265955,0.03,1,363197,362775,422
9911941,82.2697,82.4926,422,27987,0.285191,0.05,1,363288,362866,422
9914861,42.8539,42.8985,422,28063,0.337038,0.13,1,363321,362899,422
9917781,47.7708,42.1797,429,28138,0.283408,0.11,1,363370,362941,429
9920701,39.1542,39.6359,427,28213,0.272682,0.25,1,363407,362980,427
9923621,51.8308,44.7272,436,28288,0.286536,0.25,1,363462,363026,436
9926541,11.9662,10.5454,436,28363,0.257307,0.25,1,363464,363028,436
9929461,69.5932,2.10909,520,28438,0.379461,0.35,1,363548,363028,520
9932381,41.1186,66.0218,472,28512,0.403892,0.33,1,363582,363110,472
9935301,45.0237,44.4044,479,28586,0.408778,0.25,1,363628,363149,479
9938221,83.4047,47.2809,524,28660,0.393756,0.29,1,363721,363197,524
9941141,46.2809,82.2562,470,28734,0.390751,0.35,1,363758,363288,470
9944061,44.4562,42.8512,481,28808,0.42215,0.27,1,363802,363321,481
9946981,40.8912,47.7702,472,28881,0.46043,0.27,1,363842,363370,472
9949901,52.1782,39.154,490,28954,0.516086,0.29,1,363897,363407,490
9952821,12.0356,51.8308,437,29027,0.527217,0.25,1,363899,363462,437
9955741,74.4071,11.9662,525,29100,0.593443,0.41,1,363989,363464,525
9958661,42.0814,69.5932,475,29173,0.622689,0.41,1,364023,363548,475
9961581,46.0163,41.1186,488,29246,0.708538,0.41,1,364070,363582,488
9964501,82.0033,45.0237,533,29318,0.709708,0.39,1,364161,363628,533
9967421,47.6007,83.4047,479,29390,0.709942,0.39,1,364200,363721,479
9970341,44.7201,46.2809,486,29462,0.709988,0.43,1,364244,363758,486
9973261,43.344,44.4562,485,29534,0.773998,0.47,2,364287,363802,485
9976181,55.0688,40.8912,503,29606,0.8028,0.53,2,364345,363842,503
9979101,12.6138,52.1782,450,29677,0.77656,0.53,2,364347,363897,450
9982021,76.9228,12.0356,541,29748,0.819312,0.61,2,364440,363899,541
9984941,44.1846,74.4071,487,29819,0.907862,0.63,2,364476,363989,487
9987861,10.4369,42.0814,455,29890,0.893573,0.73,2,364478,364023,455
9990781,40.4874,46.0163,456,29961,0.922715,0.71,2,364526,364070,456
10092981,51,36,549,32342,0.33,1,1,366247,365698,549
10095901,42.2,49.6,536,32407,0.266,1,1,366287,365751,536
10098821,48.44,41.12,547,32472,0.1092,1,1,366337,365790,547
10101741,48.088,65.824,523,32537,0.02184,1,1,366385,365862,523
10104661,44.0176,45.9648,525,32602,0.092368,1,1,366428,365903,525
10107581,36.8035,41.993,519,32667,0.0904736,1,1,366463,365944,519
10110501,45.7607,45.9986,520,32732,0.0900947,1,1,366511,365991,520
10113421,21.1521,46.7997,488,32797,0.0580189,0.98,1,366526,366038,488
10116341,41.8304,59.7599,472,32861,0.115604,0.83,1,366573,366101,472
10119261,38.7661,52.752,459,32925,0.127121,0.53,1,366611,366152,459
10122181,30.1532,45.7504,443,32989,0.0974242,0.33,1,366639,366196,443
10125101,41.2306,49.9501,436,33053,0.155485,0.25,1,366683,366247,436
10128021,36.2461,41.99,431,33117,0.183097,0.07,1,366718,366287,431
10130941,41.6492,48.398,424,33181,0.156619,0,1,366761,366337,424
10133861,45.1298,48.0796,422,33245,0.199324,0.11,1,366807,366385,422
10136781,44.226,44.0159,423,33309,0.0798648,0.09,1,366851,366428,423
10139701,37.6452,36.8032,424,33372,0.119973,0.09,1,366887,366463,424
10142621,45.929,45.7606,424,33435,0.143995,0.05,1,366935,366511,424
10145541,19.5858,21.1521,422,33498,0.164799,0.13,1,366948,366526,422
10148461,47.1172,41.8304,429,33561,0.16896,0.13,1,367002,366573,429
10151381,37.4234,38.7661,426,33624,0.281792,0.09,1,367037,366611,426
10154301,29.8847,30.1532,426,33687,0.320358,0.17,1,367065,366639,426
10157221,42.7769,41.2306,428,33750,0.296072,0.19,1,367111,366683,428
10160141,37.3554,36.2461,429,33813,0.403214,0.15,1,367147,366718,429
10163061,42.6711,41.6492,430,33876,0.472643,0.21,1,367191,366761,430
10165981,43.7342,45.1298,428,33938,0.486529,0.05,1,367235,366807,428
10168901,39.9468,44.226,423,34000,0.441306,0.13,1,367274,366851,423
10171821,39.1894,37.6452,426,34062,0.480261,0.15,1,367313,366887,426
10174741,46.2379,45.929,426,34124,0.488052,0.17,1,367361,366935,426
10177661,20.4476,19.5858,427,34186,0.45761,0.17,1,367375,366948,427
10180581,51.2895,47.1172,432,34248,0.499522,0.17,1,367434,367002,432
10183501,40.6579,9.42343,470,34310,0.475904,0.31,1,367472,367002,470
10186421,31.3316,29.8847,464,34372,0.519181,0.33,1,367501,367037,464
10189341,42.2663,28.3769,481,34434,0.511836,0.29,1,367546,367065,481
10192261,42.0533,42.4754,477,34495,0.558367,0.43,1,367588,367111,477
10195181,45.2107,37.2951,487,34556,0.551673,0.49,1,367634,367147,487
10198101,44.2421,42.659,487,34617,0.566335,0.49,1,367678,367191,487
10201021,40.8484,43.7318,483,34678,0.585267,0.43,1,367718,367235,483
10203941,40.1697,39.9464,484,34739,0.621053,0.49,1,367758,367274,484
10206861,44.8339,39.1893,491,34800,0.692211,0.49,1,367804,367313,491
10209781,18.5668,46.2379,455,34861,0.706442,0.45,1,367816,367361,455
10212701,53.3134,20.4476,503,34922,0.645288,0.51,1,367878,367375,503
10215621,41.0627,51.2895,482,34983,0.681058,0.47,1,367916,367434,482
10218541,32.2125,40.6579,474,35043,0.752212,0.53,2,367946,367472,474
10221461,44.8425,31.3316,493,35103,0.782442,0.51,2,367994,367501,493
10224381,43.3685,42.2663,491,35163,0.820488,0.57,2,368037,367546,491
10227301,44.6737,42.0533,494,35223,0.876098,0.55,2,368082,367588,494
10230221,44.9347,45.2107,493,35283,0.919219,0.57,2,368127,367634,493
10376221,102,122,429,16060,0.37,0.01,1,370471,370042,429
10379141,112.4,86,467,16916,0.098,0.05,1,370586,370119,467
10382061,111.28,87.6,490,17042,0.0596,0.05,1,370697,370207,490
10384981,98.256,99.92,482,17167,0.03592,0.03,1,370792,370310,482
10387901,37.2512,67.184,445,17291,0.063184,0.07,1,370814,370369,445
10390821,46.6502,50.2368,448,17414,0.0526368,0.37,1,370863,370415,448
10393741,126.93,54.8474,539,17536,0.258527,0.03,1,371010,370471,539
10396661,113.386,102.969,534,17657,0.299705,0.05,1,371120,370586,534
10399581,99.4772,109.394,519,17777,0.387941,0.03,1,371216,370697,519
10402501,36.6954,97.8788,445,17896,0.437588,0.07,1,371237,370792,445
10405421,48.1391,37.1758,474,18015,0.399518,0.05,1,371288,370814,474
10408341,11.2278,46.6352,427,18133,0.391904,0.31,1,371290,370863,427
10411261,129.446,126.927,439,18250,0.630381,0.31,1,371449,371010,439
10414181,113.089,113.385,438,18366,0.758076,0.41,2,371558,371120,438
10417101,102.618,99.4771,442,18482,0.815615,0.45,2,371658,371216,442
10420021,37.3236,36.6954,442,18597,0.843123,0.39,2,371679,371237,442
10422941,49.0647,48.1391,443,18711,0.816625,0.39,2,371731,371288,443
10425861,11.4129,11.2278,443,18824,0.811325,0.69,2,371733,371290,443
10487181,46,92,512,21063,0.09,1,1,373461,372949,512
10490101,83.6,100,503,21164,0.042,1,1,373554,373051,503
10493021,52.72,61.6,496,21264,0.0964,1,1,373599,373103,496
10495941,52.944,53.92,497,21364,0.05928,1,1,373652,373155,497
10498861,35.3888,39.584,492,21463,0.083856,0.65,1,373683,373191,492
10501781,83.8778,118.317,450,21562,0.104771,0.21,1,373779,373329,450
10504701,69.5756,92.4634,430,21660,0.0609542,0.09,1,373845,373415,430
10507621,47.5151,55.2927,426,21758,0.0121908,0.03,1,373887,373461,426
10510541,80.703,85.4585,422,21855,0.0104382,0.11,1,373976,373554,422
10513461,54.5406,53.0917,425,21952,0.0420876,0.05,1,374024,373599,425
10516381,54.1081,53.0183,426,22049,0.0644175,0.09,1,374078,373652,426
10519301,36.4216,35.4037,427,22145,0.0528835,0.11,1,374110,373683,427
10522221,84.0843,83.8807,427,22241,0.0665767,0.05,1,374206,373779,427
10525141,68.0169,69.5761,425,22336,0.149315,0,1,374270,373845,425
10528061,44.8034,47.5152,422,22431,0.117863,0.01,1,374309,373887,422
10530981,81.7607,80.7031,424,22526,0.0315726,0.01,1,374400,373976,424
10533901,53.1521,16.1406,470,22620,0.0143145,0.05,1,374446,373976,470
10536821,57.8304,41.6281,481,22714,0.0588629,0.07,1,374505,374024,481
10539741,32.3661,51.5256,453,22807,0.0837726,0.05,1,374531,374078,453
10542661,87.2732,35.9051,522,22900,0.136755,0.07,1,374632,374110,522
10545581,71.0546,83.981,493,22993,0.275351,0.17,1,374699,374206,493
10548501,41.4109,67.9962,463,23085,0.30307,0.11,1,374733,374270,463
10551421,78.6822,44.7992,512,23177,0.308614,0.01,1,374821,374309,512
10554341,52.5364,81.7599,467,23268,0.245723,0.01,1,374867,374400,467
10557261,60.1073,53.152,483,23359,0.217145,0.07,1,374929,374446,483
10560181,34.4215,57.8304,452,23450,0.227429,0.09,1,374957,374505,452
10563101,91.6843,32.3661,532,23540,0.341486,0.15,1,375063,374531,532
10566021,75.9369,87.2732,503,23630,0.460297,0.31,1,375135,374632,503
10568941,43.1874,71.0546,471,23720,0.500059,0.31,1,375170,374699,471
10571861,75.8375,41.4109,521,23809,0.524012,0.31,1,375254,374733,521
10574781,50.3675,78.6822,477,23898,0.640802,0.23,1,375298,374821,477
10577701,60.4735,52.5364,494,23987,0.66416,0.21,1,375361,374867,494
10580621,13.6947,60.1073,434,24075,0.668832,0.23,1,375363,374929,434
10583541,25.9389,34.4215,435,24163,0.717766,0.37,1,375392,374957,435
10586461,94.7878,91.6843,441,24251,0.759553,0.49,2,375504,375063,441
10589381,80.5576,75.9369,446,24338,0.847911,0.51,2,375581,375135,446
10592301,43.3115,43.1874,445,24425,0.897582,0.53,2,375615,375170,445
10697421,53,53,497,27374,0.27,1,1,377718,377221,497
10700341,46.6,42.6,502,27451,0.11,1,1,377763,377261,502
10703261,44.52,39.72,507,27528,0.078,1,1,377807,377300,507
10706181,63.304,71.144,496,27605,0.0556,1,1,377875,377379,496
10709101,42.2608,45.4288,494,27682,0.01912,1,1,377912,377418,494
10712021,46.8522,53.0858,487,27759,0.011824,1,1,377960,377473,487
10714941,48.5704,57.8172,477,27835,0.0903648,0.91,1,378009,377532,477
10717861,54.5141,63.5634,468,27911,0.106073,0.51,1,378065,377597,468
10720781,48.5028,67.1127,447,27987,0.109215,0.27,1,378112,377665,447
10723701,40.9006,55.8225,433,28063,0.109843,0.07,1,378151,377718,433
10726621,39.3801,47.1645,427,28138,0.0939686,0.07,1,378190,377763,427
10729541,40.676,44.6329,424,28213,0.0427937,0.05,1,378231,377807,424
10732461,61.7352,63.3266,423,28288,0.0325587,0.01,1,378298,377875,423
10735381,43.547,42.2653,425,28363,0.00651175,0.01,1,378337,377912,425
10738301,46.3094,8.45306,472,28438,0.00130235,0.01,1,378384,377912,472
10741221,50.0619,40.0906,475,28512,0.0242605,0.11,1,378435,377960,475
10744141,54.0124,47.2181,481,28586,0.0448521,0.11,1,378490,378009,481
10747061,47.6025,54.2436,471,28660,0.0649704,0.11,1,378536,378065,471
10749981,40.7205,48.4487,463,28734,0.148994,0.11,1,378575,378112,463
10752901,37.7441,40.8897,461,28808,0.213799,0.09,1,378612,378151,461
10755821,39.5488,39.3779,462,28881,0.21076,0.03,1,378652,378190,462
10758741,61.5098,40.6756,488,28954,0.066152,0.03,1,378719,378231,488
10761661,44.302,61.7351,461,29027,0.0132304,0,1,378759,378298,461
10764581,46.4604,43.547,469,29100,0.00264608,0,1,378806,378337,469
10767501,50.0921,46.3094,473,29173,0.0245292,0.03,1,378857,378384,473
10770421,57.2184,50.0619,481,29246,0.0769058,0.05,1,378916,378435,481
10773341,47.4437,54.0124,471,29318,0.103381,0.07,1,378961,378490,471
10776261,44.6887,47.6025,469,29390,0.236676,0.17,1,379005,378536,469
10779181,38.5377,40.7205,467,29462,0.295335,0.23,1,379042,378575,467
10782101,38.1075,37.7441,468,29534,0.323067,0.21,1,379080,378612,468
10785021,55.6215,39.5488,488,29606,0.392613,0.03,1,379140,378652,488
10787941,44.7243,61.5098,463,29677,0.294523,0,1,379182,378719,463
10790861,44.9449,44.302,468,29748,0.194905,0,1,379227,378759,468
10793781,49.789,46.4604,472,29819,0.110981,0.03,1,379278,378806,472
10796701,11.5578,50.0921,423,29890,0.0941962,0.09,1,379280,378857,423
10799621,50.3116,57.2184,424,29961,0.0588392,0.11,1,379340,378916,424
10802541,49.2623,47.4437,428,30032,0.0997678,0.27,1,379389,378961,428
10805461,51.4525,44.6887,436,30102,0.171954,0.31,1,379441,379005,436
10808381,40.6905,38.5377,437,30172,0.186391,0.33,1,379479,379042,437
10811301,39.3381,38.1075,438,30242,0.221278,0.41,1,379518,379080,438
10814221,57.4676,55.6215,440,30312,0.260256,0.27,1,379580,379140,440
10817141,39.4935,44.7243,433,30382,0.348051,0.17,1,379615,379182,433
10820061,39.8987,44.9449,428,30452,0.41361,0.09,1,379655,379227,428
10822981,47.1797,49.789,426,30521,0.490722,0.09,1,379704,379278,426
10825901,11.0359,11.5578,426,30590,0.474144,0.05,1,379706,379280,426
10828821,49.4072,50.3116,425,30659,0.534829,0.11,1,379765,379340,425
10831741,50.6814,49.2623,427,30728,0.562966,0.19,1,379816,379389,427
10834661,54.1363,51.4525,430,30797,0.680593,0.19,1,379871,379441,430
10837581,42.8273,40.6905,432,30866,0.688119,0.23,1,379911,379479,432
10840501,40.5655,39.3381,433,30935,0.705624,0.27,1,379951,379518,433
10843421,60.1131,57.4676,436,31003,0.765125,0.37,2,380016,379580,436
10846341,43.2226,39.4935,440,31071,0.737025,0.43,1,380055,379615,440
10849261,41.4445,39.8987,441,31139,0.747405,0.51,1,380096,379655,441
10852181,50.6889,47.1797,445,31207,0.717481,0.47,1,380149,379704,445
10855101,11.7378,11.0359,445,31275,0.679496,0.55,1,380151,379706,445
10858021,53.5476,49.4072,450,31343,0.671899,0.55,1,380215,379765,450
10860941,51.5095,9.88144,501,31411,0.67038,0.57,1,380266,379765,501
10863861,58.3019,42.7763,510,31478,0.638076,0.71,1,380326,379816,510
10866781,42.0604,52.5553,493,31545,0.711615,0.69,1,380364,379871,493
10869701,42.8121,42.5111,496,31612,0.742323,0.71,1,380407,379911,496
10986501,91,62,491,14746,0.03,0.03,1,382450,381959,491
10989421,103,134.8,444,14890,0.03,0,1,382556,382112,444
10992341,59,63.76,446,15033,0.014,0.01,1,382604,382158,446
10995261,39.8,47.952,437,15174,0.0028,0.01,1,382639,382202,437
10998181,123.16,76.7904,497,15314,0.10456,0.03,1,382783,382286,497
11001101,98.232,146.558,425,15453,0.076912,0.03,1,382875,382450,425
11004021,102.046,114.112,422,15590,0.0713824,0.01,1,382978,382556,422
11006941,58.8093,61.2223,422,15726,0.0542765,0,1,383026,382604,422
11009861,41.3619,40.2445,424,15861,0.0348553,0.13,1,383063,382639,424
11012781,124.272,123.249,425,15995,0.0789711,0.07,1,383208,382783,425
11015701,96.0545,98.2498,422,16128,0.103794,0.07,1,383297,382875,422
11018621,101.611,102.05,422,16260,0.140759,0.05,1,383400,382978,422
11021541,59.5222,58.81,423,16391,0.116152,0.03,1,383449,383026,423
11024461,41.5044,41.362,423,16521,0.11123,0.09,1,383486,383063,423
11027381,129.101,124.272,429,16650,0.0942461,0.09,1,383637,383208,429
11030301,93.0202,24.8545,513,16778,0.154849,0.11,1,383721,383208,513
11033221,101.004,76.1709,527,16905,0.19897,0.15,1,383824,383297,527
11036141,62.6008,97.6342,477,17031,0.239794,0.11,1,383877,383400,477
11039061,38.9202,58.7268,461,17156,0.199959,0.11,1,383910,383449,461
11041981,127.784,41.3454,574,17280,0.127992,0.09,1,384060,383486,574
11044901,97.5568,129.069,513,17403,0.193598,0.17,1,384150,383637,513
11047821,103.511,93.0138,534,17525,0.25472,0.21,1,384255,383721,534
11050741,63.1023,101.003,484,17646,0.346944,0.25,1,384308,383824,484
11053661,39.0205,62.6006,464,17766,0.381389,0.19,1,384341,383877,464
11056581,124.604,38.9201,577,17885,0.468278,0.11,1,384487,383910,577
11059501,102.521,127.784,524,18004,0.565656,0.21,1,384584,384060,524
11062421,22.1042,97.5568,436,18122,0.553131,0.27,1,384586,384150,436
11065341,88.4208,103.511,436,18239,0.646626,0.37,1,384691,384255,436
11068261,64.0842,63.1023,441,18355,0.681325,0.39,1,384749,384308,441
11071181,39.2168,39.0205,441,18471,0.768265,0.49,2,384782,384341,441
11074101,129.443,124.604,447,18586,0.913653,0.59,2,384934,384487,447
11155861,72,66,500,21553,0.45,1,1,387073,386573,500
11158781,49.6,56.4,490,21651,0.466,1,1,387117,386627,490
11161701,53.92,49.68,497,21749,0.3892,1,1,387172,386675,497
11164621,41.184,49.136,486,21847,0.35784,1,1,387210,386724,486
11167541,99.4368,110.627,474,21944,0.287568,0.77,1,387324,386850,474
11170461,94.2874,106.125,462,22041,0.305514,0.65,1,387417,386955,462
11173381,47.6575,58.0251,452,22137,0.325103,0.45,1,387453,387001,452
11176301,65.5315,69.205,450,22233,0.393021,0.47,1,387523,387073,450
11179221,47.5063,49.041,449,22328,0.486604,0.37,1,387566,387117,449
11182141,44.7013,53.8082,438,22423,0.537321,0.35,1,387610,387172,438
11185061,39.3403,41.1616,438,22518,0.627464,0.35,1,387648,387210,438
11187981,98.2681,8.23233,551,22612,0.581493,0.27,1,387761,387210,551
11190901,93.2536,92.8465,529,22706,0.668299,0.31,1,387853,387324,529
11193821,49.8507,92.9693,475,22799,0.63766,0.33,1,387892,387417,475
11196741,68.3701,47.3939,512,22892,0.663532,0.41,1,387965,387453,512
11199661,52.874,65.4788,491,22985,0.636706,0.51,1,388014,387523,491
11202581,45.7748,47.4958,492,23077,0.663341,0.55,1,388058,387566,492
11205501,40.355,44.6992,487,23169,0.636668,0.65,1,388097,387610,487
11208421,99.271,39.3398,563,23261,0.743334,0.57,1,388211,387648,563
11211341,97.4542,98.268,547,23352,0.860667,0.69,2,388308,387761,547
11304781,79,123,533,26098,0.03,1,1,390282,389749,533
11307701,42.2,62.2,519,26179,0.03,1,1,390315,389796,519
11310621,46.84,46.04,525,26260,0.046,1,1,390363,389838,525
11313541,39.768,35.608,530,26341,0.0172,1,1,390401,389871,530
11316461,39.1536,48.7216,517,26421,0.01144,1,1,390440,389923,517
11319381,43.8307,47.3443,515,26501,0.234288,1,1,390485,389970,515
11322301,64.7661,44.6689,541,26581,0.150858,0.79,1,390555,390014,541
11325221,79.3532,73.7338,543,26661,0.182172,0.37,1,390638,390095,543
11328141,67.8706,101.147,500,26740,0.0924343,0.03,1,390703,390203,500
11331061,40.7741,83.4294,455,26819,0.106487,0.03,1,390737,390282,455
11333981,47.3548,43.0859,471,26898,0.0612974,0.05,1,390786,390315,471
11336901,11.071,47.0172,425,26977,0.0522595,0.01,1,390788,390363,425
11339821,31.0142,39.8034,423,27056,0.0664519,0.01,1,390824,390401,423
11342741,36.6028,39.1607,422,27134,0.0132904,0.29,1,390862,390440,422
11345661,51.3206,43.8321,432,27212,0.122658,0.13,1,390917,390485,432
11348581,63.8641,64.7664,429,27290,0.224532,0.19,1,390984,390555,429
11351501,77.5728,79.3533,427,27368,0.372906,0.07,1,391065,390638,427
11354421,63.5146,67.8707,422,27445,0.450581,0.11,1,391125,390703,422
11357341,43.1029,40.7741,426,27522,0.466116,0.05,1,391163,390737,426
11360261,47.8206,47.3548,426,27599,0.405223,0.05,1,391212,390786,426
11363181,11.1641,11.071,426,27676,0.393045,0.07,1,391214,390788,426
11366101,28.6328,31.0142,423,27753,0.470609,0,1,391247,390824,423
11369021,35.3266,36.6028,422,27829,0.486122,0.15,1,391284,390862,422
11371941,58.2653,51.3206,431,27905,0.441224,0.25,1,391348,390917,431
11374861,68.4531,63.8641,435,27981,0.480245,0.41,1,391419,390984,435
11377781,84.0906,77.5728,442,28057,0.440049,0.47,1,391507,391065,442
11380701,65.6181,63.5146,443,28132,0.56001,0.47,1,391568,391125,443
11383621,45.9236,43.1029,446,28207,0.584002,0.39,1,391609,391163,446
11386541,45.1847,47.8206,442,28282,0.6528,0.39,1,391654,391212,442
11389461,10.6369,11.1641,442,28357,0.68256,0.39,1,391656,391214,442
11392381,30.1274,2.23282,477,28432,0.656512,0.49,1,391691,391214,477
11395301,31.6255,26.8466,476,28506,0.667302,0.49,1,391723,391247,476
11398221,60.7251,34.9693,507,28580,0.82946,0.43,2,391791,391284,507
11401141,69.745,58.1939,515,28654,0.893892,0.49,2,391863,391348,515
11520861,111,47,496,13302,0.25,0.05,1,394422,393926,496
11523781,96.6,127.8,441,13462,0.074,0.03,1,394515,394074,441
11526701,52.92,55.16,446,13620,0.1028,0.05,1,394557,394111,446
11529621,156.984,108.632,507,13776,0.15656,0.19,1,394740,394233,507
11532541,123.397,84.1264,544,13930,0.215312,0.25,1,394855,394311,544
11535461,90.2794,105.625,515,14083,0.227062,0.03,1,394937,394422,515
11538381,54.8559,95.5251,468,14234,0.229412,0.11,1,394983,394515,468
11541301,161.371,52.705,614,14383,0.501882,0.17,1,395171,394557,614
11544221,125.074,156.941,547,14531,0.700377,0.23,1,395287,394740,547
11547141,89.0148,123.388,512,14677,0.820075,0.23,2,395367,394855,512
11550061,56.203,90.2776,478,14822,0.860015,0.23,2,395415,394937,478
11551521,172.041,54.8555,633,14965,0.916003,0.57,2,395616,394983,633
11554441,40.8081,161.371,453,15107,0.895201,0.75,2,395624,395171,453
11614301,117,40,591,17825,0.57,1,1,397662,397071,591
11617221,79.4,105.6,539,17944,0.538,1,1,397732,397193,539
11620141,57.48,70.72,529,18062,0.4516,1,1,397784,397255,529
11623061,38.696,52.544,515,18180,0.40232,0.88,1,397818,397303,515
11625981,120.539,163.309,465,18297,0.456464,0.89,1,397959,397494,465
11628901,62.5078,73.4618,462,18413,0.483293,0.57,1,398007,397545,462
11631821,95.7016,108.292,449,18528,0.536659,0.53,1,398111,397662,449
11634741,74.3403,77.6585,448,18643,0.643332,0.43,1,398180,397732,448
11637661,58.8681,57.1317,451,18757,0.760666,0.39,2,398235,397784,451
11640581,35.7736,38.6263,447,18870,0.720133,0.47,1,398265,397818,447
11643501,118.355,120.525,445,18982,0.792027,0.49,2,398404,397959,445
11646421,62.8709,62.5051,446,19094,0.822405,0.55,2,398453,398007,446
11649341,98.1742,95.701,449,19205,0.860481,0.67,2,398560,398111,449
11652261,78.8348,74.3402,454,19315,0.900096,0.79,2,398634,398180,454
11725261,83,78,491,21896,0.8,1,2,400485,399994,491
11728181,71,62,501,21993,0.776,1,2,400553,400052,501
11731101,56.6,69.2,483,22089,0.6912,1,1,400606,400123,483
11734021,47.32,46.64,487,22185,0.53024,1,1,400651,400164,487
11736941,95.864,110.128,469,22281,0.354048,0.75,1,400759,400290,469
11739861,71.9728,82.0256,460,22376,0.38281,0.65,1,400825,400365,460
11742781,39.9946,46.0051,455,22471,0.372562,0.8,1,400857,400402,455
11745701,77.5989,75.601,459,22565,0.466512,0.8,1,400944,400485,459
11748621,68.3198,15.1202,525,22659,0.501302,0.77,1,401010,400485,525
11751541,49.664,57.424,502,22753,0.556261,0.67,1,401055,400553,502
11754461,37.9328,53.8848,484,22846,0.567252,0.49,1,401090,400606,484
11757381,90.7866,46.777,543,22939,0.63345,0.31,1,401194,400651,543
11760301,73.3573,95.7554,504,23031,0.67869,0.39,1,401263,400759,504
11763221,40.2715,71.9511,470,23123,0.703738,0.37,1,401295,400825,470
11849361,140,194,480,10632,0.05,0.71,1,403455,402975,480
11852281,62.4,79.6,472,10832,0.034,0.55,1,403498,403026,472
11853741,186.88,51.12,646,11028,0.0308,0.11,1,403716,403070,646
11856661,57.376,206.224,426,11221,0.07816,0.05,1,403741,403315,426
11859581,121.075,153.245,423,11410,0.183632,0.03,1,403878,403455,423
11862501,58.615,65.049,423,11596,0.124726,0.03,1,403921,403498,423
11865421,206.123,187.41,448,11779,0.0649453,0.09,1,404164,403716,448
11868341,155.625,57.482,566,11959,0.196989,0.21,1,404307,403741,566
11871261,59.9249,121.096,465,12137,0.239398,0.11,1,404343,403878,465
11874181,13.585,58.6193,424,12312,0.24788,0.05,1,404345,403921,424
11877101,197.917,206.124,425,12485,0.0895759,0.23,1,404589,404164,425
11880021,161.183,155.625,434,12655,0.217915,0.25,1,404741,404307,434
11882941,61.0367,59.925,434,12823,0.211583,0.25,1,404777,404343,434
11885861,13.8073,13.585,434,12989,0.226317,0.05,1,404779,404345,434
11888781,189.161,197.917,423,13153,0.421263,0.25,1,405012,404589,423
11891701,166.632,161.183,432,13315,0.604253,0.21,1,405173,404741,432
11894621,62.9265,61.0367,433,13475,0.640851,0.23,1,405210,404777,433
11897541,14.1853,13.8073,433,13633,0.61617,0.23,1,405212,404779,433
11899001,163.637,2.76147,634,13789,0.723234,0.47,1,405413,404779,634
11901921,69.5274,186.952,447,13943,0.776647,0.65,2,405459,405012,447
11904841,146.705,166.19,452,14095,0.755329,0.65,2,405625,405173,452
11907761,58.9411,62.8381,452,14246,0.767066,0.61,2,405662,405210,452
11910681,13.3882,14.1676,452,14395,0.769413,0.75,2,405664,405212,452
11961781,50,171,528,16853,0.41,1,1,407568,407040,528
11964701,53.2,72.6,534,16979,0.25,1,1,407622,407088,534
11967621,132.24,47.32,645,17104,0.05,1,1,407774,407129,645
11970541,68.848,137.464,538,17228,0.034,0.92,1,407827,407289,538
11973461,124.97,80.2928,611,17351,0.0148,0.63,1,407966,407355,611
11976381,57.7939,146.459,489,17473,0.02696,0.41,1,408007,407518,489
11979301,45.9588,69.2917,482,17594,0.045392,0.21,1,408050,407568,482
11982221,125.192,57.0583,573,17715,0.0090784,0,1,408195,407622,573
11985141,69.0383,133.012,476,17835,0.00181568,0.03,1,408250,407774,476
11988061,125.008,69.0023,562,17954,0.152363,0.01,1,408389,407827,562
11990981,58.6015,125,465,18072,0.0544726,0.03,1,408431,407966,465
11993901,13.3203,57.8001,426,18189,0.0348945,0.05,1,408433,408007,426
11996821,37.0641,45.96,426,18306,0.0309789,0,1,408476,408050,426
11999741,120.213,125.192,422,18422,0.0141958,0,1,408617,408195,422
12002661,68.8426,69.0384,423,18537,0.0428392,0.19,1,408673,408250,423
12005581,128.169,125.008,427,18651,0.128568,0.03,1,408816,408389,427
12008501,57.6337,58.6015,425,18765,0.193714,0.03,1,408856,408431,425
12011421,13.1267,13.3203,425,18878,0.222743,0.03,1,408858,408433,425
12014341,36.2254,37.0641,424,18990,0.228549,0.01,1,408900,408476,424
12017261,118.445,120.213,422,19102,0.18171,0.05,1,409039,408617,422
12020181,68.489,68.8426,422,19213,0.108342,0.15,1,409095,408673,422
12023101,135.298,128.169,431,19323,0.0616684,0.21,1,409247,408816,431
12026021,59.0596,57.6337,431,19433,0.0843337,0.23,1,409287,408856,431
12028941,14.2119,13.1267,432,19542,0.104867,0.23,1,409290,408858,432
12031861,36.4424,2.62535,474,19651,0.108973,0.23,1,409332,408858,474
12034781,112.888,34.1251,564,19759,0.141795,0.17,1,409464,408900,564
12037701,65.7777,118.025,479,19866,0.180359,0.09,1,409518,409039,479
12040621,134.756,68.405,575,19973,0.124072,0.05,1,409670,409095,575
12043541,60.5511,135.281,465,20079,0.192814,0.09,1,409712,409247,465
12046461,13.7102,59.0562,427,20185,0.206563,0.11,1,409714,409287,427
12049381,37.942,14.2112,468,20290,0.257313,0.11,1,409758,409290,468
12052301,114.788,36.4422,560,20395,0.363463,0.15,1,409892,409332,560
12055221,67.7577,112.888,484,20499,0.400692,0.19,1,409948,409464,484
12058141,131.952,65.7777,578,20602,0.488138,0.11,1,410096,409518,578
12061061,63.9903,134.756,473,20705,0.521628,0.21,1,410143,409670,473
12063981,14.3981,60.5511,433,20807,0.528326,0.21,1,410145,409712,433
12066901,40.4796,13.7102,478,20909,0.657665,0.27,1,410192,409714,478
12069821,120.096,37.942,574,21010,0.747533,0.39,1,410332,409758,574
12072741,25.6192,114.788,442,21111,0.765507,0.41,2,410334,409892,442
12075661,49.9238,67.7577,442,21211,0.881101,0.51,2,410390,409948,442
12145741,48,54,517,23494,0.29,1,1,412064,411547,517
12148661,52.8,45.2,528,23584,0.354,1,1,412118,411590,528
12151581,78.56,50.64,561,23674,0.1348,1,1,412203,411642,561
12154501,62.112,75.728,537,23764,0.06696,0.96,1,412261,411724,537
12157421,54.0224,68.7456,522,23853,0.101392,0.97,1,412313,411791,522
12160341,96.4045,55.3491,577,23942,0.0762784,0.61,1,412420,411843,577
12163261,20.8809,109.47,456,24031,0.0872557,0.56,1,412422,411966,456
12166181,33.7762,61.894,443,24119,0.0734511,0.29,1,412459,412016,443
12169101,37.1552,50.7788,433,24207,0.0226902,0.37,1,412497,412064,433
12172021,53.831,53.3558,437,24295,0.012538,0.08,1,412555,412118,437
12174941,67.5662,78.6712,423,24382,0.106508,0.05,1,412626,412203,423
12177861,60.7132,62.1342,424,24469,0.0773015,0.11,1,412685,412261,424
12180781,54.5426,54.0268,425,24556,0.15146,0.07,1,412738,412313,425
12183701,95.7085,96.4054,424,24642,0.118292,0.09,1,412844,412420,424
12186621,20.7417,20.8811,424,24728,0.111658,0.07,1,412846,412422,424
12189541,32.9483,33.7762,423,24814,0.142332,0.01,1,412882,412459,423
12192461,37.7897,37.1552,424,24899,0.148466,0.01,1,412921,412497,424
12195381,53.1579,53.831,423,24984,0.181693,0.13,1,412978,412555,423
12198301,69.0316,67.5662,425,25069,0.204339,0.07,1,413051,412626,425
12201221,60.2063,60.7132,424,25154,0.192868,0.17,1,413109,412685,424
12204141,56.0413,54.5426,426,25238,0.190574,0.11,1,413164,412738,426
12207061,96.8083,95.7085,427,25322,0.190115,0.11,1,413271,412844,427
12209981,20.9616,20.7417,427,25406,0.190023,0.15,1,413273,412846,427
12212901,37.7923,32.9483,433,25489,0.254005,0.15,1,413315,412882,433
12215821,33.1585,6.58967,465,25572,0.250801,0.15,1,413347,412882,465
12218741,55.4317,32.5179,487,25655,0.31416,0.19,1,413408,412921,487
12221661,68.6863,52.1036,502,25738,0.422832,0.21,1,413480,412978,502
12224581,59.3373,68.8207,486,25820,0.460566,0.19,1,413537,413051,486
12227501,57.4675,60.1641,485,25902,0.492113,0.19,1,413594,413109,485
12230421,97.8935,56.0328,538,25984,0.522423,0.19,1,413702,413164,538
12233341,21.1787,96.8066,433,26066,0.560485,0.19,1,413704,413271,433
12236261,38.6357,20.9613,474,26147,0.584097,0.27,1,413747,413273,474
12239181,34.9271,37.7923,466,26228,0.620819,0.25,1,413781,413315,466
12242101,58.1854,33.1585,498,26309,0.660164,0.33,1,413845,413347,498
12245021,75.6371,55.4317,517,26390,0.732033,0.45,1,413925,413408,517
12247941,59.9274,68.6863,501,26470,0.810407,0.47,2,413981,413480,501
12350141,182,232,544,12750,0.07,0.63,1,416127,415583,544
12353061,96.4,159.2,478,12917,0.086,0.57,1,416202,415724,478
12355981,50.48,67.04,473,13082,0.0892,0.15,1,416241,415768,473
12358901,110.896,155.008,422,13244,0.08984,0.07,1,416367,415945,422
12361821,170.179,176.602,425,13404,0.089968,0.09,1,416552,416127,425
12364741,94.0358,95.3203,425,13563,0.137994,0.09,1,416627,416202,425
12367661,50.0072,50.2641,425,13720,0.163599,0.09,1,416666,416241,425
12370581,109.201,10.0528,549,13875,0.24872,0.09,1,416790,416241,549
12373501,172.24,102.811,611,14028,0.313744,0.09,1,416978,416367,611
12376421,95.2481,168.562,502,14179,0.358749,0.15,1,417054,416552,502
12379341,52.6496,93.7124,469,14329,0.39975,0.17,1,417096,416627,469
12382261,112.93,49.9425,558,14477,0.47195,0.27,1,417224,416666,558
12385181,177.786,109.189,628,14624,0.75839,0.33,2,417418,416790,628
12388101,93.9572,172.238,513,14769,0.895678,0.37,2,417491,416978,513
12391021,56.3914,95.2475,484,14913,0.923136,0.41,2,417538,417054,484
12458181,154,56,623,17899,0.25,1,1,419797,419174,623
12461101,84.4,136,534,18018,0.33,1,1,419864,419330,534
12464021,49.68,71.2,520,18136,0.234,1,1,419905,419385,520
12466941,30.736,55.84,494,18253,0.1668,0.89,1,419931,419437,494
12469861,104.547,134.368,463,18369,0.04136,0.53,1,420054,419591,463
12472781,52.9094,68.4736,451,18485,0.032272,0.25,1,420094,419643,451
12475701,123.382,136.895,438,18600,0.0304544,0.35,1,420235,419797,438
12478621,73.4764,80.9789,432,18714,0.110091,0.21,1,420296,419864,432
12481541,43.4953,48.9958,427,18827,0.142018,0.15,1,420332,419905,427
12484461,30.2991,30.5992,428,18940,0.116404,0.01,1,420359,419931,428
12487381,99.6598,104.52,422,19052,0.271281,0.03,1,420476,420054,422
12490301,52.732,52.904,423,19163,0.334256,0.03,1,420517,420094,423
12493221,123.346,123.381,423,19274,0.426851,0.13,1,420658,420235,423
12496141,77.4693,73.4762,428,19384,0.50937,0.15,1,420724,420296,428
12499061,44.2939,43.4952,428,19493,0.509874,0.11,1,420760,420332,428
12501981,28.0588,30.299,425,19602,0.525975,0.11,1,420784,420359,425
12504901,107.212,6.05981,552,19710,0.721195,0.31,1,420911,420359,552
12507821,56.6423,94.812,479,19818,0.760239,0.35,2,420955,420476,479
12510741,127.328,51.7624,583,19925,0.848048,0.45,2,421100,420517,583
12574981,45,44,510,22148,0.55,1,1,422686,422176,510
12577901,51.4,39.2,525,22244,0.422,1,1,422739,422214,525
12580821,85.48,110.24,491,22339,0.1724,1,1,422833,422342,491
12583741,37.896,47.648,485,22434,0.10648,1,1,422859,422374,485
12586661,48.3792,62.3296,470,22529,0.021296,1,1,422910,422440,470
12589581,81.6758,12.4659,560,22623,0.0602592,0.89,1,423000,422440,560
12592501,93.9352,83.2932,556,22717,0.0520518,0.82,1,423097,422541,556
12595421,44.387,96.6586,488,22810,0.0664104,0.55,1,423129,422641,488
12598341,48.8774,55.3317,493,22903,0.0852821,0.39,1,423179,422686,493
12601261,73.7755,53.4663,520,22996,0.121056,0.11,1,423259,422739,520
12604181,34.7551,85.8933,451,23088,0.128211,0.09,1,423284,422833,451
12607101,45.351,37.9787,473,23180,0.145642,0,1,423332,422859,473
12610021,81.8702,48.3957,513,23271,0.0691285,0.07,1,423423,422910,513
12612941,94.774,81.6791,521,23362,0.117826,0.05,1,423521,423000,521
12615861,43.7548,93.9358,455,23453,0.0955651,0.07,1,423552,423097,455
12618781,51.151,44.3872,476,23543,0.155113,0.09,1,423605,423129,476
12621701,75.0302,48.8774,507,23633,0.199023,0.13,1,423686,423179,507
12624621,33.406,73.7755,450,23723,0.191805,0.13,1,423709,423259,450
12627541,46.6812,34.7551,475,23812,0.270361,0.15,1,423759,423284,475
12630461,79.7362,45.351,515,23901,0.366072,0.05,1,423847,423332,515
12633381,17.5472,81.8702,426,23990,0.385214,0.13,1,423849,423423,426
12636301,81.9095,94.774,426,24078,0.325043,0.09,1,423947,423521,426
12639221,42.7819,43.7548,428,24166,0.361009,0.17,1,423980,423552,428
12642141,54.1564,51.151,432,24254,0.448202,0.21,1,424037,423605,432
12645061,75.6313,75.0302,432,24341,0.46564,0.19,1,424118,423686,432
12647981,33.5263,33.406,432,24428,0.501128,0.29,1,424141,423709,432
12650901,48.3053,46.6812,434,24515,0.556226,0.39,1,424193,423759,434
12653821,85.661,79.7362,441,24601,0.519245,0.39,1,424288,423847,441
12656741,18.7322,17.5472,441,24687,0.511849,0.31,1,424290,423849,441
12659661,79.7464,81.9095,438,24773,0.62237,0.37,1,424385,423947,438
12662581,44.7493,42.7819,441,24859,0.684474,0.47,1,424421,423980,441
12665501,56.1499,54.1564,443,24944,0.784895,0.47,2,424480,424037,443
12668421,78.43,75.6313,446,25029,0.820979,0.51,2,424564,424118,446
12671341,35.686,33.5263,448,25114,0.812196,0.57,2,424589,424141,448
12674261,48.7372,48.3053,448,25198,0.858439,0.51,2,424641,424193,448
12677181,84.9474,85.661,447,25282,0.915688,0.51,2,424735,424288,447
12680101,18.5895,18.7322,447,25366,0.927138,0.65,2,424737,424290,447
12761861,48,63,492,27608,0.81,1,2,426369,425877,492
12764781,56.8,51,503,27685,0.698,1,1,426428,425925,503
12767701,56.96,60.6,497,27761,0.5156,1,1,426485,425988,497
12770621,40.192,47.32,489,27837,0.52712,1,1,426521,426032,489
12773541,52.8384,47.064,498,27913,0.481424,0.97,1,426577,426079,498
12776461,72.9677,77.4128,491,27989,0.456285,1,1,426655,426164,491
12779381,52.1935,61.0826,481,28065,0.323257,0.89,1,426702,426221,481
12782301,44.8387,50.6165,476,28140,0.296651,0.85,1,426745,426269,476
12785221,45.7677,51.7233,470,28215,0.25933,0.81,1,426791,426321,470
12788141,41.1535,48.7447,462,28290,0.171866,0.67,1,426831,426369,462
12791061,49.0307,56.9489,454,28365,0.170373,0.67,1,426882,426428,454
12793981,49.0061,11.3898,503,28440,0.0580746,0.47,1,426931,426428,503
12796901,40.2012,47.878,484,28514,0.0356149,0.53,1,426969,426485,484
12799821,48.8402,38.3756,499,28588,0.079123,0.47,1,427020,426521,499
12802741,72.968,52.4751,522,28662,0.0238246,0.45,1,427099,426577,522
12805661,48.1936,72.895,486,28736,0.0447649,0.29,1,427141,426655,486
12808581,40.0387,52.179,477,28810,0.080953,0.29,1,427179,426702,477
12811501,44.0077,44.8358,479,28883,0.168191,0.25,1,427224,426745,479
12814421,35.2015,45.7672,466,28956,0.265638,0.15,1,427257,426791,466
12817341,49.4403,41.1534,479,29029,0.301128,0.17,1,427310,426831,479
12820261,43.4881,49.0307,470,29102,0.308226,0.03,1,427352,426882,470
12823181,40.6976,49.0061,461,29175,0.213645,0.03,1,427392,426931,461
12826101,50.5395,40.2012,476,29248,0.274729,0.09,1,427445,426969,476
12829021,71.7079,48.8402,502,29320,0.358946,0.01,1,427522,427020,502
12831941,49.5416,72.968,467,29392,0.431789,0.05,1,427566,427099,467
12834861,40.3083,48.1936,463,29464,0.494358,0.09,1,427604,427141,463
12837781,49.6617,40.0387,477,29536,0.554872,0.19,1,427656,427179,477
12840701,37.1323,44.0077,466,29608,0.598974,0.29,1,427690,427224,466
12843621,52.2265,35.2015,489,29679,0.703795,0.31,1,427746,427257,489
12846541,43.2453,49.4403,477,29750,0.740759,0.31,1,427787,427310,477
12849461,38.2491,43.4881,472,29821,0.764152,0.19,2,427824,427352,472
12852381,9.24981,40.6976,434,29892,0.76883,0.29,2,427826,427392,434
12855301,45.85,50.5395,436,29963,0.801766,0.38,2,427881,427445,436
12858221,73.97,71.7079,440,30034,0.808353,0.45,2,427962,427522,440
12861141,53.194,49.5416,444,30104,0.841671,0.51,2,428010,427566,444
12864061,43.4388,40.3083,447,30174,0.848334,0.57,2,428051,427604,447
12866981,53.4878,49.6617,451,30244,0.881667,0.61,2,428107,427656,451
12869901,38.6976,37.1323,452,30314,0.904333,0.73,2,428142,427690,452
12872821,58.1395,52.2265,459,30384,0.892867,0.75,2,428205,427746,459
12875741,46.0279,43.2453,461,30454,0.938573,0.77,2,428248,427787,461
13014441,87,79,471,14746,0.05,0.01,1,430630,430159,471
13017361,131,95,514,14890,0.05,0.03,1,430772,430258,514
13020281,60.6,108.6,445,15033,0.018,0.01,1,430815,430370,445
13023201,33.72,55.32,430,15174,0.0116,0.03,1,430842,430412,430
13026121,105.944,43.064,514,15314,0.05832,0.05,1,430966,430452,514
13029041,90.7888,151.013,423,15453,0.067664,0.05,1,431053,430630,423
13031961,131.758,143.803,423,15590,0.149533,0.01,1,431195,430772,423
13034881,60.7516,63.1605,423,15726,0.165907,0.01,1,431238,430815,423
13037801,33.7503,34.2321,423,15861,0.121181,0.07,1,431265,430842,423
13040721,108.35,106.046,426,15995,0.128236,0.07,1,431392,430966,426
13043641,88.87,90.8093,423,16128,0.193647,0.17,1,431476,431053,423
13046561,135.374,131.762,428,16260,0.0947295,0.17,1,431623,431195,428
13049481,61.4748,60.7524,428,16391,0.106946,0.11,1,431666,431238,428
13052401,29.095,33.7505,422,16521,0.189389,0.13,1,431687,431265,422
13055321,111.419,108.35,427,16650,0.365878,0.13,1,431819,431392,427
13058241,91.0838,21.67,513,16778,0.513176,0.21,1,431905,431392,513
13061161,132.617,71.534,572,16905,0.574635,0.07,1,432048,431476,572
13064081,63.3233,131.907,471,17031,0.602927,0.11,1,432094,431623,471
13067001,32.6647,60.7814,453,17156,0.656585,0.21,1,432119,431666,453
13069921,118.533,28.9563,572,17280,0.731317,0.41,1,432259,431687,572
13072841,98.9066,111.391,534,17403,0.682263,0.55,1,432353,431819,534
13075761,135.781,91.0783,593,17525,0.816453,0.59,2,432498,431905,593
13078681,66.3563,132.616,499,17646,0.907291,0.61,2,432547,432048,499
13142921,49,103,520,20125,0.73,1,1,434304,433784,520
13145841,105,53.4,598,20230,0.458,1,1,434423,433825,598
13148761,62.6,105.88,531,20335,0.2436,1,1,434475,433944,531
13151681,55.72,61.176,535,20439,0.04872,1,1,434529,433994,535
13154601,99.144,55.4352,591,20543,0.017744,0.93,1,434639,434048,591
13157521,83.0288,100.687,558,20646,0.0595488,0.94,1,434718,434160,558
13160441,48.6058,96.1374,503,20749,0.0679098,0.73,1,434758,434255,503
13163361,91.3211,58.4275,556,20851,0.117582,0.39,1,434860,434304,556
13166281,54.2642,106.886,482,20953,0.0635164,0.19,1,434905,434423,482
13169201,48.4528,62.9771,477,21054,0.100703,0,1,434952,434475,477
13172121,11.2906,55.7954,425,21155,0.0761406,0.01,1,434954,434529,425
13175041,87.8581,99.1591,422,21255,0.0152281,0.07,1,435061,434639,422
13177961,82.3716,83.0318,424,21355,0.0430456,0.07,1,435142,434718,424
13180881,49.2743,48.6064,425,21454,0.0646091,0.13,1,435183,434758,425
13183801,94.6549,91.3213,429,21553,0.132922,0.05,1,435289,434860,429
13186721,50.931,54.2643,424,21651,0.178584,0.11,1,435329,434905,424
13189641,48.5862,48.4529,425,21749,0.187717,0.07,1,435377,434952,425
13192561,11.3172,11.2906,425,21847,0.189543,0,1,435379,434954,425
13195481,85.4635,87.8581,422,21944,0.0939087,0.05,1,435483,435061,422
13198401,85.0927,82.3716,426,22041,0.0187817,0.07,1,435568,435142,426
13201321,50.6185,49.2743,427,22137,0.0437563,0.15,1,435610,435183,427
13204241,95.7237,94.6549,428,22233,0.128751,0.19,1,435717,435289,428
13207161,54.3447,50.931,432,22328,0.19375,0.19,1,435761,435329,432
13210081,48.4689,48.5862,431,22423,0.19075,0.19,1,435808,435377,431
13213001,11.2938,11.3172,431,22518,0.15815,0.19,1,435810,435379,431
13215921,77.4588,2.26345,525,22612,0.21563,0.07,1,435904,435379,525
13218841,83.4918,83.6527,506,22706,0.275126,0,1,435989,435483,506
13221761,52.6983,84.7305,466,22799,0.255025,0.05,1,436034,435568,466
13224681,98.5397,50.5461,534,22892,0.315005,0.15,1,436144,435610,534
13227601,56.5079,95.7092,473,22985,0.391001,0.21,1,436190,435717,473
13230521,48.1016,54.3418,475,23077,0.4382,0.19,1,436236,435761,475
13233441,11.2203,48.4684,430,23169,0.44764,0.15,1,436238,435808,430
13236361,81.4441,11.2937,527,23261,0.497528,0.23,1,436337,435810,527
13239281,85.8888,77.4587,520,23352,0.635506,0.29,1,436424,435904,520
13242201,51.5778,83.4917,478,23443,0.711101,0.25,1,436467,435989,478
13245121,99.9156,52.6983,545,23533,0.82222,0.33,2,436579,436034,545
13248041,61.5831,98.5397,487,23623,0.860444,0.41,2,436631,436144,487
13250961,50.7166,56.5079,489,23713,0.884089,0.45,2,436679,436190,489
13253881,11.7433,48.1016,445,23802,0.888818,0.45,2,436681,436236,445
13344401,53,66,521,26421,0.65,1,1,438589,438068,521
13347321,53.8,51.6,527,26501,0.458,1,1,438643,438116,527
13350241,53.16,45.52,536,26581,0.2756,1,1,438696,438160,536
13353161,109.032,50.704,607,26661,0.06312,1,1,438819,438212,607
13356081,49.0064,107.741,519,26740,0.084624,0.96,1,438853,438334,519
13359001,46.6013,60.7482,516,26819,0.120925,0.98,1,438899,438383,516
13361921,49.3203,49.7496,519,26898,0.096185,0.88,1,438949,438430,519
13364841,11.4641,55.5499,464,26977,0.091237,0.75,1,438951,438487,464
13367761,35.0928,50.31,456,27056,0.122247,0.65,1,438992,438536,456
13370681,47.8186,52.462,454,27134,0.144449,0.41,1,439043,438589,454
13373601,43.1637,53.6924,442,27212,0.14889,0.23,1,439085,438643,442
13376521,42.2327,53.1385,431,27290,0.149778,0.01,1,439127,438696,431
13379441,101.247,109.028,424,27368,0.261956,0.09,1,439243,438819,424
13382361,47.4493,49.0055,424,27445,0.204391,0.13,1,439277,438853,424
13385281,51.8899,46.6011,431,27522,0.208878,0.09,1,439330,438899,431
13388201,46.378,49.3202,426,27599,0.177776,0.09,1,439375,438949,426
13391121,10.8756,11.464,426,27676,0.139555,0.13,1,439377,438951,426
13394041,35.7751,35.0928,427,27753,0.115911,0.15,1,439419,438992,427
13396961,48.755,47.8186,428,27829,0.143182,0.15,1,439471,439043,428
13399881,42.551,43.1637,427,27905,0.148636,0.15,1,439512,439085,427
13402801,42.9102,42.2327,428,27981,0.181727,0.29,1,439555,439127,428
13405721,104.582,101.247,432,28057,0.220345,0.19,1,439675,439243,432
13408641,49.7164,47.4493,434,28132,0.276069,0.21,1,439711,439277,434
13411561,49.1433,51.8899,430,28207,0.287214,0.17,1,439760,439330,430
13414481,42.6287,46.378,426,28282,0.305443,0.13,1,439801,439375,426
13417401,10.1257,10.8756,426,28357,0.341089,0.13,1,439803,439377,426
13420321,34.0251,2.17512,466,28432,0.332218,0.11,1,439843,439377,466
13423241,52.405,34.035,481,28506,0.378444,0.15,1,439900,439419,481
13426161,42.481,48.407,469,28580,0.467689,0.15,1,439940,439471,469
13429081,43.6962,42.4814,472,28654,0.517538,0.19,1,439984,439512,472
13432001,107.139,42.8963,552,28728,0.607508,0.23,1,440107,439555,552
13434921,51.8278,104.579,470,28802,0.561502,0.29,1,440145,439675,470
13437841,48.7656,49.7159,482,28876,0.6803,0.29,1,440193,439711,482
13440761,44.9531,49.1432,477,28949,0.76806,0.31,2,440237,439760,477
13443681,10.5906,42.6286,438,29022,0.785612,0.35,2,440239,439801,438
13446601,35.7181,10.1257,478,29095,0.837122,0.33,2,440281,439803,478
13449521,55.1436,34.0251,498,29168,0.863424,0.39,2,440341,439843,498
13567781,110,132,519,14175,0.07,0.47,1,442541,442022,519
13570701,112.4,122.4,512,14325,0.022,0.21,1,442654,442142,512
13573621,60.88,111.68,451,14473,0.0044,0.17,1,442702,442251,451
13576541,133.776,53.536,564,14620,0.24888,0.03,1,442854,442290,564
13579461,116.355,123.507,535,14765,0.409776,0.07,1,442966,442431,535
13582381,111.271,112.701,535,14909,0.505955,0.01,1,443076,442541,535
13585301,61.4542,112.94,471,15051,0.573191,0,1,443125,442654,471
13588221,13.8908,60.9881,425,15192,0.554638,0.31,1,443127,442702,425
13591141,133.178,133.798,436,15332,0.630928,0.45,1,443290,442854,436
13594061,123.436,116.36,445,15471,0.630186,0.53,1,443411,442966,445
13596981,115.087,111.272,448,15608,0.726037,0.59,1,443524,443076,448
13599901,63.0174,61.4544,449,15744,0.777207,0.55,2,443574,443125,449
13602821,14.2035,13.8909,449,15879,0.755441,0.65,2,443576,443127,449
13664141,56,48,505,18483,0.65,1,1,445532,445027,505
13667061,107.2,116.8,491,18598,0.362,1,1,445652,445161,491
13669981,100.64,107.36,485,18712,0.0724,1,1,445751,445266,485
13672901,54.528,59.072,481,18825,0.05448,0.88,1,445794,445313,481
13675821,86.9056,97.4144,469,18938,0.146896,0.87,1,445889,445420,469
13678741,52.5811,64.2829,457,19050,0.181379,0.65,1,445933,445476,457
13681661,49.7162,57.6566,450,19161,0.188276,0.29,1,445982,445532,450
13684581,92.3432,107.531,433,19272,0.0776552,0,1,446085,445652,433
13687501,89.6687,100.706,423,19382,0.055531,0.05,1,446174,445751,423
13690421,52.3337,54.5413,423,19491,0.0351062,0.17,1,446217,445794,423
13693341,89.6668,86.9083,427,19600,0.111021,0.17,1,446316,445889,427
13696261,54.7333,17.3816,473,19708,0.142204,0.19,1,446362,445889,473
13699181,49.3467,38.6763,477,19816,0.164441,0.19,1,446410,445933,477
13702101,88.2693,46.9353,526,19923,0.280888,0.05,1,446508,445982,526
13705021,87.2539,91.7871,510,20029,0.336178,0.05,1,446595,446085,510
13707941,51.8508,89.5574,464,20135,0.315236,0.03,1,446638,446174,464
13710861,92.7702,52.3115,524,20240,0.215047,0.13,1,446741,446217,524
13713781,57.754,89.6623,474,20345,0.275009,0.15,1,446790,446316,474
13716701,50.7508,54.7325,477,20449,0.319002,0.17,1,446839,446362,477
13719621,92.5502,49.3465,532,20553,0.4398,0.31,1,446942,446410,532
13722541,89.71,88.2693,523,20656,0.49596,0.35,1,447031,446508,523
13725461,52.342,87.2539,479,20759,0.539192,0.31,1,447074,446595,479
13728381,88.8684,51.8508,534,20861,0.611838,0.19,1,447172,446638,534
13731301,60.9737,92.7702,485,20963,0.642368,0.29,1,447226,446741,485
13734221,13.7947,57.754,438,21064,0.648474,0.33,1,447228,446790,438
13737141,40.3589,50.7508,436,21165,0.697695,0.47,1,447275,446839,436
13740061,97.6718,92.5502,445,21265,0.723539,0.51,1,447387,446942,445
13742981,92.3344,89.71,447,21365,0.712708,0.55,1,447478,447031,447
13745901,54.4669,52.342,449,21464,0.774542,0.63,2,447523,447074,449
13748821,91.6934,88.8684,452,21563,0.834908,0.65,2,447624,447172,452
13751741,63.1387,60.9737,454,21661,0.878982,0.65,2,447680,447226,454
13754661,14.2277,13.7947,454,21759,0.855796,0.71,2,447682,447228,454
13757581,42.0455,40.3589,456,21856,0.883159,0.73,2,447731,447275,456
13845181,63,65,511,24599,0.57,1,1,449757,449246,511
13848101,47.8,47.4,512,24685,0.41,1,1,449801,449289,512
13851021,63.96,64.68,511,24771,0.33,1,1,449869,449358,511
13853941,50.392,70.536,486,24857,0.154,1,1,449916,449430,486
13856861,84.4784,98.1072,474,24942,0.1188,1,1,450009,449535,474
13859781,59.2957,61.2214,475,25027,0.20776,0.87,1,450062,449587,475
13862701,52.6591,63.4443,462,25112,0.161552,0.63,1,450113,449651,462
13865621,36.9318,47.0889,452,25196,0.13631,0.57,1,450146,449694,452
13868541,52.9864,59.8178,446,25280,0.115262,0.37,1,450203,449757,446
13871461,37.7973,47.1636,436,25364,0.127052,0.31,1,450237,449801,436
13874381,63.5595,63.8327,438,25448,0.22541,0.31,1,450307,449869,438
13877301,41.5119,12.7665,474,25531,0.165082,0.11,1,450343,449869,474
13880221,80.3024,40.1533,517,25614,0.233016,0.11,1,450433,449916,517
13883141,60.8605,82.4307,480,25697,0.230603,0.23,1,450489,450009,480
13886061,52.1721,58.8861,477,25779,0.342121,0.15,1,450539,450062,477
13888981,36.0344,52.5772,458,25861,0.412424,0.13,1,450571,450113,458
13891901,53.6069,36.9154,483,25943,0.490485,0.11,1,450629,450146,483
13894821,41.1214,52.9831,464,26025,0.554097,0.13,1,450667,450203,464
13897741,63.4243,37.7966,499,26106,0.630819,0.25,1,450736,450237,499
13900661,39.8849,63.5593,463,26187,0.662164,0.15,1,450770,450307,463
13903581,83.177,41.5119,521,26268,0.796433,0.25,2,450864,450343,521
13906501,65.4354,80.3024,492,26349,0.839287,0.23,2,450925,450433,492
13909421,55.4871,60.8605,489,26429,0.879857,0.37,2,450978,450489,489
13912341,39.0974,52.1721,474,26509,0.887972,0.43,2,451013,450539,474
13915261,57.4195,36.0344,504,26589,0.889594,0.51,2,451075,450571,504
14056881,91,172,484,13462,0.09,0.09,1,453828,453344,484
14059801,87.8,116,469,13620,0.042,0.03,1,453915,453446,469
14062721,29.56,59.2,439,13776,0.0324,0.01,1,453930,453491,439
14064181,181.912,42.24,621,13930,0.04648,0.23,1,454150,453529,621
14067101,49.9824,174.848,430,14083,0.081296,0.09,1,454167,453737,430
14070021,81.1965,107.77,428,14234,0.248259,0.03,1,454256,453828,428
14072941,81.8393,91.1539,423,14383,0.249652,0.03,1,454338,453915,423
14075861,30.7679,30.2308,426,14531,0.24993,0.05,1,454356,453930,426
14078781,195.754,182.046,443,14677,0.393986,0.09,1,454593,454150,443
14081701,115.951,50.0092,522,14822,0.518797,0.29,1,454689,454167,522
14084621,88.7901,81.2018,515,14965,0.559759,0.25,1,454771,454256,515
14087541,31.358,81.8404,450,15107,0.551952,0.25,1,454788,454338,450
14090461,7.87161,30.7681,434,15248,0.55039,0.43,1,454790,454356,434
14093381,198.374,195.754,443,15387,0.790078,0.55,2,455036,454593,443
14096301,122.075,115.951,450,15525,0.854016,0.57,2,455139,454689,450
14159081,79,114,507,18297,0.29,1,1,457077,456570,507
14162001,69.4,90,490,18413,0.21,1,1,457144,456654,490
14164921,65.88,60.4,502,18528,0.178,1,1,457209,456707,502
14167841,49.176,52.08,497,18643,0.2676,0.79,1,457254,456757,497
14170761,123.435,153.616,460,18757,0.17352,0.57,1,457396,456936,460
14173681,67.887,80.3232,452,18870,0.138704,0.29,1,457450,456998,452
14176601,59.1774,79.2646,430,18982,0.0837408,0.19,1,457507,457077,430
14179521,67.8355,69.4529,433,19094,0.0567482,0.17,1,457577,457144,433
14182441,56.7671,65.8906,422,19205,0.0993496,0.29,1,457631,457209,422
14185361,52.9534,49.1781,429,19315,0.0438699,0.15,1,457683,457254,429
14188281,123.391,123.436,428,19425,0.144774,0.13,1,457824,457396,428
14191201,65.4781,67.8871,425,19534,0.228955,0.13,1,457875,457450,425
14194121,58.6956,13.5774,482,19643,0.181791,0.07,1,457932,457450,482
14197041,64.5391,48.3155,491,19751,0.284358,0.05,1,457998,457507,491
14199961,56.9078,65.6631,476,19858,0.368872,0.11,1,458053,457577,476
14202881,52.9816,56.3326,474,19965,0.337774,0.03,1,458105,457631,474
14205801,127.396,52.8665,568,20071,0.443555,0.17,1,458251,457683,568
14208721,71.0793,123.373,484,20177,0.512711,0.25,1,458308,457824,484
14211641,56.6159,65.4747,486,20282,0.558542,0.17,1,458361,457875,486
14214561,69.7232,58.6949,502,20387,0.631708,0.31,1,458434,457932,502
14217481,58.7446,64.539,492,20491,0.646342,0.39,1,458490,457998,492
14220401,53.3489,56.9078,489,20595,0.729268,0.33,1,458542,458053,489
14223321,133.87,52.9816,591,20698,0.825854,0.47,2,458696,458105,591
14226241,73.974,127.396,504,20800,0.909171,0.53,2,458755,458251,504
14319681,63,64,542,23847,0.63,1,1,460900,460358,542
14322601,52.6,50.4,545,23936,0.454,1,1,460950,460405,545
14325521,60.92,57.28,549,24025,0.2748,1,1,461013,460464,549
14328441,88.984,126.656,501,24113,0.14296,1,1,461109,460608,501
14331361,53.7968,66.1312,495,24201,0.084592,1,1,461154,460659,495
14334281,51.5594,64.4262,482,24289,0.0409184,0.93,1,461205,460723,482
14337201,37.5119,53.6852,465,24376,0.0641837,0.79,1,461239,460774,465
14340121,51.5024,61.1371,457,24463,0.100837,0.63,1,461294,460837,457
14343041,54.3005,62.6274,449,24550,0.0601673,0.41,1,461349,460900,449
14345961,42.8601,52.5255,439,24636,0.0520335,0.23,1,461389,460950,439
14348881,53.372,60.9051,432,24722,0.0824067,0.11,1,461445,461013,432
14351801,85.0744,88.981,429,24808,0.0724813,0.07,1,461538,461109,429
14354721,51.4149,53.7962,427,24893,0.134496,0.03,1,461581,461154,427
14357641,51.083,51.5592,427,24978,0.178899,0.07,1,461632,461205,427
14360561,35.8166,37.5118,425,25063,0.18778,0.11,1,461664,461239,425
14363481,51.9633,51.5024,426,25148,0.141556,0.05,1,461720,461294,426
14366401,51.1927,54.3005,422,25232,0.164311,0.05,1,461771,461349,422
14369321,42.2385,42.8601,422,25316,0.152862,0.09,1,461811,461389,422
14372241,53.2477,53.372,422,25400,0.182572,0.07,1,461867,461445,422
14375161,88.2495,85.0744,426,25483,0.332514,0.07,1,461964,461538,426
14378081,52.0499,17.0149,469,25566,0.426503,0.15,1,462007,461538,469
14381001,53.61,37.803,480,25649,0.477301,0.19,1,462061,461581,480
14383921,33.922,48.3606,458,25732,0.51946,0.19,1,462090,461632,458
14386841,52.3844,35.2721,483,25814,0.559892,0.13,1,462147,461664,483
14389761,51.2769,51.8544,478,25896,0.583978,0.17,1,462198,461720,478
14392681,43.0554,51.1709,468,25978,0.572796,0.15,1,462239,461771,468
14395601,56.6111,42.2342,488,26060,0.634559,0.19,1,462299,461811,488
14398521,94.5222,53.2468,536,26141,0.726912,0.37,1,462403,461867,536
14401441,56.5044,88.2494,486,26222,0.713382,0.45,1,462450,461964,486
14404361,55.3009,52.0499,498,26303,0.758676,0.49,2,462505,462007,498
14407281,36.6602,53.61,476,26384,0.783735,0.53,2,462537,462061,476
14410201,54.532,33.922,506,26464,0.836747,0.57,2,462596,462090,506
14413121,52.5064,52.3844,501,26544,0.911349,0.59,2,462648,462147,501
14531381,136,74,496,12581,0.79,0.35,2,465424,464928,496
14534301,56,76.4,455,12750,0.774,0.39,2,465460,465005,455
14537221,163.2,65.68,582,12917,0.8348,0.61,2,465650,465068,582
14540141,105.44,189.136,453,13082,0.91096,0.79,2,465741,465288,453
14589781,77,94,484,15611,0.77,1,2,467641,467157,484
14592701,125,131.6,480,15747,0.626,1,1,467778,467298,480
14595621,67.4,69.52,479,15882,0.5012,0.92,1,467831,467352,479
14598541,51.88,49.904,482,16016,0.44424,0.87,1,467879,467397,482
14601461,131.176,143.581,466,16149,0.480848,0.77,1,468030,467564,466
14604381,83.0352,90.3162,460,16280,0.50417,0.59,1,468101,467641,460
14607301,118.207,127.663,450,16410,0.620834,0.47,1,468228,467778,450
14610221,63.6414,67.9326,447,16539,0.644167,0.43,1,468278,467831,447
14613141,45.5283,51.9865,440,16667,0.680833,0.43,1,468319,467879,440
14616061,132.306,10.3973,594,16794,0.832167,0.49,2,468473,467879,594
14686141,54,58,517,19602,0.45,1,1,470539,470022,517
14689061,66,11.6,586,19710,0.402,1,1,470608,470022,586
14691981,61.2,91.92,534,19818,0.3604,1,1,470668,470134,534
14694901,53.84,64.784,528,19925,0.28808,1,1,470720,470192,528
14697821,117.968,51.3568,614,20031,0.241616,0.65,1,470854,470240,614
14700741,86.7936,139.871,531,20137,0.168323,0.57,1,470933,470402,531
14703661,56.5587,94.3743,497,20242,0.201665,0.45,1,470982,470485,497
14706581,64.1117,62.0749,509,20347,0.160333,0.39,1,471048,470539,509
14709501,55.2223,67.615,493,20451,0.168067,0.35,1,471101,470608,493
14712421,52.6445,61.523,485,20555,0.313613,0.27,1,471153,470668,485
14715341,116.129,53.9046,565,20658,0.326723,0.23,1,471285,470720,565
14718261,82.4258,117.981,505,20761,0.425345,0.15,1,471359,470854,505
14721181,56.4852,86.7962,476,20863,0.485069,0.21,1,471409,470933,476
14724101,68.097,56.5592,498,20965,0.569014,0.15,1,471480,470982,498
14727021,15.2194,64.1118,434,21066,0.617803,0.17,1,471482,471048,434
14729941,45.4439,55.2224,434,21167,0.723561,0.35,1,471535,471101,434
14732861,53.8888,52.6445,438,21267,0.760712,0.33,2,471591,471153,438
14735781,118.778,116.129,441,21367,0.880142,0.45,2,471726,471285,441
14738701,84.5555,82.4258,443,21466,0.920028,0.5,2,471802,471359,443
14829221,67,66,498,24341,0.89,1,2,473842,473344,498
14832141,55,50,504,24428,0.778,1,2,473894,473390,504
14835061,50.2,62,488,24515,0.7556,1,2,473943,473455,488
14837981,55.64,42.8,507,24601,0.71912,1,1,474000,473493,507
14840901,43.128,55.76,488,24687,0.727824,1,1,474040,473552,488
14843821,68.6256,74.352,484,24773,0.729565,0.82,1,474115,473631,484
14846741,58.5251,74.0704,466,24859,0.793913,0.87,2,474171,473705,466
14849661,70.905,70.8141,470,24944,0.758783,0.89,2,474245,473775,470
14852581,64.581,67.7628,466,25029,0.751756,0.75,2,474308,473842,466
14855501,45.7162,55.1526,455,25114,0.734351,0.75,1,474349,473894,455
14858421,52.3432,50.2305,460,25198,0.76287,0.71,2,474403,473943,460
14861341,52.8686,55.6461,456,25282,0.816574,0.73,2,474456,474000,456
14864261,41.7737,43.1292,455,25366,0.811315,0.73,2,474495,474040,455
14867181,65.9547,68.6258,452,25450,0.938263,0.73,2,474567,474115,452
