#Ack,ack_ewma(ms),send_ewma(ms),rtt_ratio,cwnd (Bytes),Last Router Ocupation Ack Arriaval(Packets),Last Router Ocupation Packet Sent(Packets),Network Situation,AckArrival(ms),TSInsideAck(ms),RTTAck(ms)
17521,279,457,488,29200,0.02,0.85,1,191380,190892,488
20441,73.4,115.4,480,32120,0.004,0.9,1,191402,190922,480
23361,34.68,47.08,475,35040,0.0328,0.79,1,191427,190952,475
26281,32.536,33.416,477,37960,0.07856,0.81,1,191459,190982,477
29201,27.3072,30.6832,473,40880,0.111712,0.74,1,191485,191012,473
32121,24.6614,30.1366,467,43800,0.142342,0.6,1,191509,191042,467
35041,28.1323,30.0273,466,46720,0.132468,0.58,1,191538,191072,466
37961,26.4265,30.0055,462,49640,0.130494,0.5,1,191564,191102,462
40881,26.0853,30.0011,458,52560,0.114099,0.46,1,191590,191132,458
43801,27.6171,30.0002,456,55480,0.24682,0.02,1,191618,191162,456
46721,164.723,180.4,437,58400,0.105364,0.01,1,191817,191380,437
49641,56.9447,60.08,437,61320,0.0690728,0.02,1,191847,191410,437
52561,37.7889,36.016,440,64240,0.133815,0.12,1,191880,191440,440
55481,33.9578,31.2032,443,67160,0.138763,0.15,1,191913,191470,443
58401,30.7916,30.2406,443,70080,0.203753,0.18,1,191943,191500,443
61321,27.7583,28.4481,442,73000,0.216751,0.15,1,191970,191528,442
64241,20.7517,24.8896,437,75920,0.21135,0.09,1,191989,191552,437
67161,24.1503,22.5779,440,78840,0.25027,0.17,1,192014,191574,440
70081,26.4301,22.1156,445,81760,0.258054,0.28,1,192041,191596,445
73001,26.086,22.0231,449,81760,0.219611,0.33,1,192067,191618,449
75921,27.6172,22.0046,455,81760,0.0679222,0.47,1,192095,191640,455
78841,22.3234,22.0009,454,81760,0.0615844,0.44,1,192116,191662,454
81761,13.2647,22.0002,443,84680,0.100317,0.23,1,192127,191684,443
84681,16.2529,22,438,87600,0.0920634,0.12,1,192144,191706,438
87601,16.8506,22,433,90520,0.0744127,0.05,1,192161,191728,433
90521,20.1701,22,432,93440,0.110883,0.01,1,192182,191750,432
93441,24.034,22,435,96360,0.182177,0.07,1,192207,191772,435
96361,20.8068,22,433,99280,0.276435,0.06,1,192227,191794,433
99281,24.1614,22,436,102200,0.295287,0.09,1,192252,191816,436
102201,23.2323,22,437,105120,0.363057,0.09,1,192275,191838,437
105121,19.8465,20.4,436,108040,0.400611,0.13,1,192294,191858,436
108041,19.1693,18.48,437,110960,0.448122,0.14,1,192313,191876,437
110961,18.2339,18.096,437,113880,0.521624,0.17,1,192331,191894,437
113881,19.6468,18.0192,439,116800,0.608325,0.2,1,192351,191912,439
116801,19.9294,18.0038,441,119720,0.673665,0.21,1,192371,191930,441
119721,18.3859,18.0008,441,122640,0.742733,0.23,1,192389,191948,441
122641,16.4772,18.0002,439,125560,0.796547,0.18,2,192405,191966,439
125561,19.2954,18,441,128480,0.839309,0.23,2,192425,191984,441
128481,19.8591,18,443,131400,0.887862,0.27,2,192445,192002,443
376081,46,0,533,211240,0,1,1,193958,193425,533
393121,13.2,32.8,497,211240,0,1,1,193963,193466,497
394381,61.04,6.56,570,211040,0,1,1,194036,193466,570
400401,17.008,53.312,511,211040,0,1,1,194042,193531,511
401241,18.6016,10.6624,530,210420,0,1,1,194061,193531,530
412481,7.72032,29.3325,501,210420,0,1,1,194066,193565,501
422661,45.5441,29.0665,527,210420,0,1,1,194121,193594,527
423501,42.7088,5.8133,569,209800,0,1,1,194163,193594,569
426401,13.3418,33.1627,535,209800,0,1,1,194169,193634,535
435141,9.86835,19.4325,528,209800,0,1,1,194178,193650,528
565761,792.374,879.887,421,1460,0,0,1,195166,194745,421
568681,506.475,519.977,426,5840,0,0.03,1,195601,195175,426
571601,106.895,110.395,425,8760,0.008,0,1,195608,195183,425
574521,356.579,356.479,426,11680,0.0096,0.01,1,196027,195601,426
577441,76.9158,77.6958,425,14600,0.02592,0.01,1,196034,195609,425
580361,21.7832,21.9392,425,17520,0.053184,0.01,1,196042,195617,425
583281,12.3566,10.7878,427,20440,0.0586368,0.01,1,196052,195625,427
586201,324.071,323.758,427,23360,0.0437274,0.02,1,196454,196027,427
589121,72.8143,71.1515,429,26280,0.0167455,0.07,1,196464,196035,429
592041,20.1629,20.6303,428,29200,0.0353491,0.07,1,196471,196043,428
594961,8.83257,10.5261,426,32120,0.0550698,0.05,1,196477,196051,426
597881,8.16651,8.50521,426,35040,0.075014,0.04,1,196485,196059,426
600801,8.0333,8.10104,426,37960,0.103003,0.02,1,196493,196067,426
603721,8.00666,8.02021,426,40880,0.124601,0.02,1,196501,196075,426
606641,8.00133,8.00404,426,43800,0.13692,0.04,1,196509,196083,426
609561,300,298.401,428,46720,0.059384,0.02,1,196882,196454,428
612481,66.4,66.0802,428,49640,0.0518768,0.05,1,196890,196462,428
615401,19.68,19.616,428,52560,0.0663754,0.07,1,196898,196470,428
618321,11.136,10.3232,429,55480,0.0692751,0.11,1,196907,196478,429
621241,9.4272,8.46464,430,58400,0.093855,0.12,1,196916,196486,430
624161,9.08544,8.09293,431,61320,0.130771,0.14,1,196925,196494,431
627081,7.41709,8.01859,430,64240,0.114154,0.15,1,196932,196502,430
630001,7.08342,8.00372,429,67160,0.174831,0.14,1,196939,196510,429
632921,7.01668,8.00074,428,70080,0.226966,0.1,1,196946,196518,428
635841,7.00334,8.00015,427,73000,0.245393,0.09,1,196953,196526,427
638761,7.00067,8.00003,426,75920,0.241079,0.05,1,196960,196534,426
641681,7.80013,8.00001,426,78840,0.240216,0.06,1,196968,196542,426
644601,8.76003,8,427,81760,0.304043,0.04,1,196977,196550,427
647521,8.15201,8,427,84680,0.340809,0.06,1,196985,196558,427
650441,7.2304,8,426,87600,0.364162,0.06,1,196992,196566,426
653361,7.84608,8,426,90520,0.360832,0.04,1,197000,196574,426
656281,250.369,248,429,93440,0.112166,0.05,1,197311,196882,429
659201,57.2738,56,430,94784,0.0384333,0.07,1,197320,196890,430
662121,17.8548,17.6,430,97704,0.0556867,0.09,1,197328,196898,430
665041,11.571,9.92,432,98179,0.0111373,0.13,1,197338,196906,432
667961,7.91419,8.384,431,98179,0.0422275,0.15,1,197345,196914,431
670881,11.9828,8.0768,436,98179,0.00844549,0.14,1,197358,196922,436
673801,7.99657,8.01536,435,98179,0.0256891,0.2,1,197365,196930,435
676721,8.79931,8.00307,436,98179,0.0131378,0.24,1,197374,196938,436
679641,9.75986,8.00061,438,98179,0.0266276,0.28,1,197384,196946,438
682561,8.35197,8.00012,438,98179,0.0533255,0.29,1,197392,196954,438
685481,9.67039,8.00002,440,98179,0.0106651,0.29,1,197402,196962,440
688401,9.93408,8,442,98179,0.026133,0.35,1,197412,196970,442
691321,9.98682,8,444,98179,0.0292266,0.35,1,197422,196978,444
694241,7.59736,8,443,98179,0.0298453,0.39,1,197429,196986,443
697161,7.91947,8,443,98179,0.00596906,0.4,1,197437,196994,443
700081,7.18389,8,442,98179,0.00919381,0.39,1,197444,197002,442
703001,7.03678,8,441,98179,0.0258388,0.35,1,197451,197010,441
705921,7.00736,8,440,98179,0.0531678,0.33,1,197458,197018,440
708841,7.00147,8,439,98318,0.0426336,0.31,1,197465,197026,439
711761,7.80029,8,439,101238,0.0805267,0.28,1,197473,197034,439
714681,7.16006,8,438,104158,0.0561053,0.29,1,197480,197042,438
717601,5.43201,8,435,107078,0.0352211,0.28,1,197485,197050,435
720521,5.8864,8,433,109998,0.0630442,0.23,1,197491,197058,433
723441,5.17728,8,430,112918,0.0606088,0.17,1,197496,197066,430
726361,7.43546,8,430,115838,0.0761218,0.15,1,197504,197074,430
729281,8.68709,8,431,118758,0.0472244,0.15,1,197513,197082,431
732201,8.13742,8,431,121678,0.0414449,0.17,1,197521,197090,431
735121,8.02748,8,431,124598,0.024289,0.17,1,197529,197098,431
738041,8.0055,8,431,127518,0.0688578,0.16,1,197537,197106,431
740961,8.8011,8,432,130438,0.0217716,0.16,1,197546,197114,432
743881,9.76022,8,434,133358,0.0283543,0.17,1,197556,197122,434
746801,7.55204,8,433,136278,0.0136709,0.05,1,197563,197130,433
749721,152.71,146.4,441,139198,0.0107342,0.04,1,197752,197311,441
752641,61.7421,58.88,443,142118,0.0261468,0.03,1,197791,197348,443
755561,38.7484,40.576,440,145038,0.0292294,0.04,1,197824,197384,440
758481,36.5497,36.9152,440,147958,0.00584587,0.1,1,197860,197420,440
761401,36.1099,36.183,440,150878,0.0331692,0.01,1,197896,197456,440
764321,27.222,31.2366,435,153798,0.0386338,0.07,1,197921,197486,435
767241,19.8444,23.0473,432,156718,0.0317268,0,1,197939,197507,432
770161,17.5689,19.8095,430,159638,0.0463454,0.03,1,197956,197526,430
773081,17.1138,18.3619,429,162558,0.0172691,0.01,1,197973,197544,429
776001,17.0228,16.4724,430,165478,0.0434538,0.03,1,197990,197560,430
778921,15.4046,16.0945,429,168398,0.00869076,0.03,1,198005,197576,429
781841,15.8809,16.0189,429,171318,0.0337382,0.03,1,198021,197592,429
784761,17.5762,16.0038,431,174238,0.0307476,0.07,1,198039,197608,431
787681,14.7152,16.0008,429,176540,0.0541495,0.04,1,198053,197624,429
790601,16.543,16.0002,430,176540,0.0668299,0.03,1,198070,197640,430
793521,16.1086,16,430,176540,0.053366,0.01,1,198086,197656,430
796441,16.8217,16,431,176540,0.0186732,0,1,198103,197672,431
799361,15.3643,16,430,176540,0.0277346,0.03,1,198118,197688,430
802281,15.8729,16,430,176540,0.0135469,0.01,1,198134,197704,430
805201,16.7746,16,431,176540,0.0507094,0.06,1,198151,197720,431
808121,15.3549,16,430,176540,0.0421419,0.03,1,198166,197736,430
811041,15.071,16,429,176540,0.0404284,0.02,1,198181,197752,429
813961,14.2142,14.4,429,176540,0.0320857,0.04,1,198195,197766,429
816881,13.2428,14.08,428,176540,0.0464171,0.01,1,198208,197780,428
819801,15.4486,14.016,430,176540,0.0332834,0.05,1,198224,197794,430
822721,13.4897,14.0032,429,176540,0.0146567,0.04,1,198237,197808,429
825641,14.6979,14.0006,430,176540,0.0349313,0.04,1,198252,197822,430
828561,14.1396,14.0001,430,176540,0.0469863,0.04,1,198266,197836,430
831481,12.4279,14,428,176540,0.0573973,0.01,1,198278,197850,428
834401,15.2856,14,430,176540,0.0434795,0.05,1,198294,197864,430
837321,13.4571,14,429,176540,0.00869589,0.06,1,198307,197878,429
840241,15.4914,14,431,176540,0.0417392,0.04,1,198323,197892,431
843161,13.4983,14,430,176540,0.0323478,0.05,1,198336,197906,430
846081,13.8997,14,430,176540,0.0144696,0.03,1,198350,197920,430
849001,13.9799,14,430,176540,0.0748939,0.01,1,198364,197934,430
851921,13.196,14,429,176540,0.0789788,0.03,1,198377,197948,429
854841,13.8392,14,429,176540,0.0717958,0,1,198391,197962,429
857761,15.5678,14,431,176540,0.0943592,0.05,1,198407,197976,431
860681,12.7136,14,429,176540,0.0348718,0.01,1,198419,197990,429
863601,15.3427,14,431,176540,0.0309744,0.01,1,198435,198004,431
866521,13.4685,14,430,176540,0.0381949,0.03,1,198448,198018,430
869441,14.6937,14,431,176540,0.063639,0.09,1,198463,198032,431
872361,14.9387,14,432,176540,0.0447278,0.07,1,198478,198046,432
875281,14.1877,14,432,176540,0.0409456,0.09,1,198492,198060,432
878201,12.4375,14,430,176540,0.0401891,0.08,1,198504,198074,430
881121,12.8875,14,429,176540,0.0480378,0.01,1,198517,198088,429
884041,13.7775,14,429,176540,0.00960756,0.02,1,198531,198102,429
886961,13.1555,14,428,176540,0.0259215,0.03,1,198544,198116,428
889881,16.2311,14,431,176540,0.0451843,0.05,1,198561,198130,431
892801,13.6462,14,430,176540,0.0490369,0.04,1,198574,198144,430
895721,14.7292,14,431,176540,0.0498074,0.04,1,198589,198158,431
898641,14.1458,14,431,176540,0.0739615,0.03,1,198603,198172,431
901561,14.0292,14,431,176540,0.0947923,0.03,1,198617,198186,431
904481,13.2058,14,430,178304,0.106958,0.09,1,198630,198200,430
907401,13.8412,14,430,179066,0.0853917,0.04,1,198644,198214,430
910321,13.9682,14,430,179066,0.0890783,0.02,1,198658,198228,430
913241,13.1936,14,429,179066,0.105816,0.05,1,198671,198242,429
916161,16.2387,14,432,179449,0.0851631,0.08,1,198688,198256,432
919081,13.6477,14,431,179449,0.105033,0.12,1,198701,198270,431
922001,12.3295,14,429,179449,0.0770065,0.04,1,198713,198284,429
924921,14.4659,14,430,179449,0.0874013,0.05,1,198728,198298,430
927841,14.0932,14,430,179449,0.0814803,0.04,1,198742,198312,430
930761,13.2186,14,429,179449,0.0642961,0.04,1,198755,198326,429
933681,16.2437,14,432,179449,0.0448592,0.04,1,198772,198340,432
936601,15.2487,14,433,179449,0.0169718,0.12,1,198787,198354,433
939521,12.6497,14,431,179449,0.0513944,0.1,1,198799,198368,431
942441,14.5299,14,432,179449,0.0502789,0.09,1,198814,198382,432
945361,12.506,14,430,179449,0.0660558,0.05,1,198826,198396,430
948281,12.9012,14,429,179449,0.0292112,0.03,1,198839,198410,429
951201,14.5802,14,430,179449,0.0298422,0.08,1,198854,198424,430
954121,14.116,14,430,179834,0.0379684,0.06,1,198868,198438,430
957041,14.0232,14,430,179834,0.0475937,0.07,1,198882,198452,430
959961,13.2046,14,429,179834,0.0495187,0.05,1,198895,198466,429
962881,14.6409,14,430,179834,0.0339037,0.03,1,198910,198480,430
965801,13.3282,14,429,179834,0.0467808,0.05,1,198923,198494,429
968721,13.8656,14,429,180610,0.0333561,0.03,1,198937,198508,429
971641,13.9731,14,429,180610,0.00667123,0.05,1,198951,198522,429
974561,13.1946,14,428,180610,0.0173342,0.03,1,198964,198536,428
977481,15.4389,14,430,180610,0.00346685,0.07,1,198980,198550,430
980401,15.0878,14,431,180610,0.00869337,0.05,1,198995,198564,431
983321,13.4176,14,430,180610,0.0257387,0.11,1,199008,198578,430
986241,14.6835,14,431,180610,0.0291477,0.07,1,199023,198592,431
989161,15.7367,14,433,180610,0.0458295,0.07,1,199039,198606,433
992081,15.9473,14,435,180610,0.0651659,0.17,1,199055,198620,435
995001,11.9895,14,432,180610,0.0690332,0.13,1,199066,198634,432
997921,13.5979,14,432,180610,0.0378066,0.11,1,199080,198648,432
1000841,16.3196,14,435,180610,0.0635613,0.14,1,199097,198662,435
1003761,12.8639,14,433,180610,0.0527123,0.11,1,199109,198676,433
1006681,11.3728,14,430,180610,0.0345425,0.07,1,199120,198690,430
1009601,15.8746,14,433,180610,0.0469085,0.11,1,199137,198704,433
1012521,15.1749,14,434,180610,0.0333817,0.11,1,199152,198718,434
1015441,11.835,14,431,180610,0.0706763,0.1,1,199163,198732,431
1018361,11.167,14,428,180610,0.0541353,0.03,1,199174,198746,428
1021281,15.0334,14,430,180610,0.0588271,0.05,1,199190,198760,430
1024201,12.6067,14,428,180610,0.0357654,0.01,1,199202,198774,428
1027121,15.3213,14,430,180610,0.0471531,0.05,1,199218,198788,430
1030041,14.2643,14,430,180610,0.00943062,0.03,1,199232,198802,430
1032961,14.0529,14,430,180610,0.00988612,0.03,1,199246,198816,430
1035881,12.4106,14,428,180610,0.0259772,0.01,1,199258,198830,428
1038801,16.8821,14,432,181000,0.0291954,0.02,1,199276,198844,432
1041721,12.1764,14,429,181000,0.00583909,0.02,1,199287,198858,429
1044641,13.6353,14,429,181000,0.0251678,0.04,1,199301,198872,429
1047561,14.7271,14,430,181000,0.0290336,0.03,1,199316,198886,430
1050481,12.5454,14,428,181000,0.0298067,0.03,1,199328,198900,428
1053401,15.3091,14,430,181000,0.0539613,0.08,1,199344,198914,430
1056321,13.4618,14,429,181000,0.0267923,0.03,1,199357,198928,429
1059241,13.8924,14,429,181000,0.0293585,0.05,1,199371,198942,429
1062161,13.1785,14,428,181000,0.0298717,0.01,1,199384,198956,428
1065081,15.4357,14,430,181000,0.0139743,0.08,1,199400,198970,430
1068001,14.2871,14,430,181000,0.0267949,0,1,199414,198984,430
1070921,13.2574,14,429,181000,0.00535897,0.09,1,199427,198998,429
1073841,13.8515,14,429,181000,0.0250718,0.05,1,199441,199012,429
1076761,15.5703,14,431,181000,0.0690144,0.06,1,199457,199026,431
1079681,13.5141,14,430,181000,0.0538029,0.1,1,199470,199040,430
1082601,14.7028,14,431,181000,0.0427606,0.05,1,199485,199054,431
1085521,11.7406,14,428,181000,0.0485521,0.03,1,199496,199068,428
1088441,15.1481,14,430,182182,0.0497104,0.08,1,199512,199082,430
1091361,13.4296,14,429,182182,0.0579421,0.05,1,199525,199096,429
1094281,13.8859,14,429,182182,0.0675884,0.05,1,199539,199110,429
1097201,14.7772,14,430,182182,0.0615177,0.06,1,199554,199124,430
1100121,14.1554,14,430,182182,0.0363035,0.07,1,199568,199138,430
1103041,14.0311,14,430,182182,0.0632607,0.05,1,199582,199152,430
1105961,14.0062,14,430,182182,0.0446521,0.09,1,199596,199166,430
1108881,14.8012,14,431,182182,0.0649304,0.1,1,199611,199180,431
1111801,14.9602,14,432,182182,0.0769861,0.07,1,199626,199194,432
1114721,12.592,14,430,182182,0.0953972,0.05,1,199638,199208,430
1117641,13.7184,14,430,182182,0.0990794,0.06,1,199652,199222,430
1120561,13.1437,14,429,182182,0.131816,0,1,199665,199236,429
1123481,14.6287,14,430,182182,0.114363,0.03,1,199680,199250,430
1126401,13.3257,14,429,182182,0.134873,0.03,1,199693,199264,429
1129321,13.8651,14,429,182182,0.122975,0.02,1,199707,199278,429
1132241,13.173,14,428,182182,0.152595,0.05,1,199720,199292,428
1135161,16.2346,14,431,182182,0.158519,0.03,1,199737,199306,431
1138081,12.8469,14,429,182182,0.127704,0.03,1,199749,199320,429
1141001,13.7694,14,429,182182,0.169541,0.04,1,199763,199334,429
1143921,14.7539,14,430,182182,0.121908,0.05,1,199778,199348,430
1146841,14.1508,14,430,182182,0.112382,0.06,1,199792,199362,430
1149761,13.2302,14,429,182182,0.126476,0.09,1,199805,199376,429
1152681,14.646,14,430,182182,0.137295,0.03,1,199820,199390,430
1155601,12.5292,14,428,182182,0.195459,0,1,199832,199404,428
1158521,14.5058,14,429,182182,0.207092,0.09,1,199847,199418,429
1161441,15.7012,14,431,182182,0.185418,0.03,1,199863,199432,431
1164361,14.3402,14,431,182182,0.213084,0.08,1,199877,199446,431
1167281,12.468,14,429,182182,0.242617,0.04,1,199889,199460,429
1170201,15.2936,14,431,182182,0.256523,0.06,1,199905,199474,431
1173121,13.4587,14,430,182182,0.315305,0.02,1,199918,199488,430
1176041,13.8917,14,430,182182,0.335061,0.08,1,199932,199502,430
1178961,15.5783,14,432,182182,0.339012,0.08,1,199948,199516,432
1181881,13.5157,14,431,182182,0.379802,0.07,1,199961,199530,431
1184801,14.7031,14,432,182182,0.35596,0.11,1,199976,199544,432
1187721,13.3406,14,431,182182,0.383192,0.07,1,199989,199558,431
1190641,12.2681,14,429,182182,0.364638,0.05,1,200001,199572,429
1193561,13.6536,14,429,182182,0.400928,0.07,1,200015,199586,429
1196481,17.1307,14,433,182182,0.392186,0.07,1,200033,199600,433
1199401,13.0261,14,431,182182,0.406437,0.07,1,200045,199614,431
1202321,16.2052,14,434,182182,0.457287,0.15,1,200062,199628,434
1205241,15.241,14,435,182182,0.475457,0.17,1,200077,199642,435
1208161,14.2482,14,435,182182,0.503091,0.14,1,200091,199656,435
1211081,12.4496,14,433,185102,0.508618,0.15,1,200103,199670,433
1214001,14.4899,14,434,185102,0.533724,0.16,1,200118,199684,434
1216921,16.498,14,437,185102,0.554745,0.15,1,200135,199698,437
1219841,13.6996,14,436,185102,0.534949,0.18,1,200148,199712,436
1222761,13.9399,14,436,185102,0.54699,0.19,1,200162,199726,436
1225681,12.388,14,434,185102,0.517398,0.12,1,200174,199740,434
1228601,12.8776,14,433,185102,0.47148,0.16,1,200187,199754,433
1231521,16.1755,14,436,185102,0.494296,0.17,1,200204,199768,436
1234441,13.6351,14,435,185102,0.530859,0.14,1,200217,199782,435
1237361,13.927,14,435,185102,0.570172,0.2,1,200231,199796,435
1240281,15.5854,14,437,185102,0.602034,0.21,1,200247,199810,437
1243201,14.3171,14,437,185102,0.608407,0.2,1,200261,199824,437
1246121,14.0634,14,437,185102,0.601681,0.22,1,200275,199838,437
1249041,16.4127,14,440,185102,0.664336,0.21,1,200292,199852,440
1251961,16.0825,14,442,185102,0.660867,0.26,1,200308,199866,442
1254881,13.6165,14,441,185102,0.668173,0.3,1,200321,199880,441
1257801,15.5233,14,443,185102,0.653635,0.32,1,200337,199894,443
1260721,15.9047,14,445,185102,0.674727,0.37,1,200353,199908,445
1263641,13.5809,14,444,185102,0.686945,0.36,1,200366,199922,444
1266561,15.5162,14,446,185102,0.737389,0.37,1,200382,199936,446
1269481,15.1032,14,447,185102,0.787478,0.38,2,200397,199950,447
1272401,15.0206,14,448,185102,0.813496,0.39,2,200412,199964,448
1275321,15.0041,14,449,185102,0.794699,0.42,2,200427,199978,449
1278241,13.4008,14,448,185102,0.83894,0.41,2,200440,199992,448
1631761,1316,1391,423,1460,0.01,0,1,203378,202955,423
1633221,833.6,689.4,622,5840,0.026,0.03,1,204091,203469,622
1634681,577.92,549.08,622,7083,0.0292,0.03,1,204605,203983,622
1636141,526.784,521.016,622,7083,0.01384,0.02,1,205119,204497,622
1637601,516.557,515.403,622,8543,0.002768,0.08,1,205633,205011,622
1639061,516.911,514.281,625,9746,0.0965536,0.11,1,206150,205525,625
1640521,468.982,466.056,628,9746,0.0353107,0.16,1,206607,205979,628
1641981,458.596,456.411,630,9746,0.0150621,0.24,1,207063,206433,630
1643441,457.319,454.482,633,9746,0.0830124,0.35,1,207520,206887,633
1644901,458.664,454.096,638,5840,0.160602,0.15,1,207979,207341,638
1646361,443.733,454.019,624,5840,0.40012,0.32,1,208419,207795,624
1647821,555.947,545.204,640,7639,0.592024,0.47,1,209003,208363,640
1649281,573.589,563.441,650,7639,0.366405,0.43,1,209581,208931,650
1650741,566.718,567.088,647,7639,0.081281,0.03,1,210146,209499,647
1652201,546.944,567.818,621,7639,0.592256,0.66,1,210688,210067,621
1662421,417,454,623,10559,0.13,0.08,1,214096,213473,623
1663881,447.4,454,624,10559,0.226,0.29,1,214551,213927,624
1665341,463.08,454,637,10559,0.4452,0.47,1,215018,214381,637
1666801,459.016,454,641,10559,0.80104,0.72,2,215476,214835,641
1675561,528,526,625,10115,0.05,0,1,218472,217847,625
1677021,523.2,526,621,5840,0.01,0,1,218994,218373,621
1678481,527.04,526,623,5840,0.002,0,1,219522,218899,623
1679941,635.008,631.6,627,7430,0.0244,0,1,220184,219557,627
1681401,649.402,652.72,622,7422,0.00488,0,1,220837,220215,622
1682861,655.48,656.944,621,7413,0.032976,0,1,221494,220873,621
1684321,659.896,657.789,624,8873,0.126595,0,1,222155,221531,624
1685781,667.179,657.958,635,10319,0.745319,0,1,222824,222189,635
1694541,552,533,662,10279,0.01,0.39,1,226500,225838,662
1696001,518.4,533,639,10279,0.01,0.03,1,227010,226371,639
1697461,516.48,533,622,10279,0.066,0.05,1,227526,226904,622
1698921,529.696,533,622,10279,0.1012,0.11,1,228059,227437,622
1700381,536.339,533,627,10279,0.04424,0.01,1,228597,227970,627
1701841,532.068,533,625,10279,0.008848,0,1,229128,228503,625
1703301,530.414,533,622,10279,0.48177,0.76,1,229658,229036,622
1704761,562.083,533,659,10279,0.104354,0.1,1,230228,229569,659
1706221,510.817,533,624,10279,0.0448708,0.01,1,230726,230102,624
1707681,526.963,533,622,10279,0.0169742,0.04,1,231257,230635,622
1709141,533.393,533,624,10279,0.147395,0.05,1,231792,231168,624
1710601,537.079,533,629,10279,0.029479,0.05,1,232330,231701,629
1712061,530.616,533,625,10279,0.0138958,0.03,1,232859,232234,625
1713521,529.323,533,621,10274,0.106779,0.02,1,233388,232767,621
1714981,533.865,533,623,10270,0.0533558,0.04,1,233923,233300,623
1716441,534.773,533,625,10265,0.0346712,0.1,1,234458,233833,625
1717901,532.555,533,624,10261,0.00693423,0.03,1,234990,234366,624
1719361,532.111,533,623,10257,0.0253868,0.03,1,235522,234899,623
1720821,531.222,533,621,9824,0.109077,0.09,1,236053,235432,621
1722281,538.244,533,628,9820,0.0618155,0.05,1,236593,235965,628
1723741,603.649,605.8,624,9820,0.0523631,0.05,1,237213,236589,624
1725201,619.93,620.36,624,9820,0.114473,0.13,1,237837,237213,624
1726661,623.186,623.272,624,9820,0.0228945,0,1,238461,237837,624
1728121,623.037,623.854,623,9820,0.0685789,0,1,239084,238461,623
1729581,625.407,623.971,625,9820,0.0137158,0,1,239710,239085,625
1731041,746.682,748.794,622,9763,0.0347432,0,1,240487,239865,622
1732501,786.936,788.159,621,9760,0.0389486,0,1,241284,240663,621
1733961,795.787,796.032,621,9756,0.0157897,0,1,242082,241461,621
1735421,798.357,797.606,622,9756,0.0191579,0,1,242881,242259,622
1736881,798.072,797.921,622,9756,0.00383159,0,1,243679,243057,622
1738341,800.414,797.984,625,9756,0.000766318,0,1,244480,243855,625
1739801,796.083,797.997,622,9756,0.0561533,0,1,245275,244653,622
1741261,796.817,797.999,621,8697,0.0512307,0,1,246072,245451,621
1742721,1281.76,1281.2,622,1460,0.0822461,0,1,247475,246853,622
1744181,1397.15,1553.04,427,1460,0.0564492,0,1,248901,248474,427
