#Ack,ack_ewma(ms),send_ewma(ms),rtt_ratio,cwnd (Bytes),Last Router Ocupation Ack Arriaval(Packets),Last Router Ocupation Packet Sent(Packets),Network Situation,AckArrival(ms),TSInsideAck(ms),RTTAck(ms)
62781,51,243,468,13462,0.21,0.31,1,222398,221930,468
65701,39.8,83.8,461,13620,0.226,0.29,1,222435,221974,461
68621,15.96,39.96,442,13776,0.1972,0.21,1,222445,222003,442
71541,27.192,25.592,450,13930,0.23944,0.15,1,222475,222025,450
74461,288.638,262.718,482,14083,0.471888,0.21,1,222829,222347,482
77381,86.5277,93.3437,467,14234,0.518378,0.23,1,222865,222398,467
80301,25.3055,48.2687,440,14383,0.527676,0.19,1,222875,222435,440
83221,31.4611,17.6537,463,14531,0.561535,0.25,1,222908,222445,463
84681,167.092,27.5307,634,14677,0.632307,0.53,1,223109,222475,634
87601,167.818,288.706,448,14822,0.662461,0.53,1,223277,222829,448
90521,62.3637,86.5412,448,14965,0.700492,0.53,1,223313,222865,448
93441,21.2727,25.3082,449,15107,0.692098,0.57,1,223324,222875,449
96361,31.4545,31.4616,450,15248,0.65842,0.57,1,223358,222908,450
97821,167.091,6.29233,651,15387,0.683684,0.65,1,223559,222908,651
100741,171.018,162.058,622,15525,0.768737,0.67,2,223731,223109,622
103661,63.0036,166.812,490,15662,0.817747,0.71,2,223767,223277,490
106581,20.6007,62.1623,464,15798,0.843549,0.69,2,223777,223313,464
109501,32.1201,21.2325,488,15932,0.89671,0.65,2,223812,223324,488
110961,167.224,31.4465,655,16065,0.923342,0.69,2,224013,223358,655
113881,176.645,167.089,633,16197,0.880668,0.79,2,224192,223559,633
116801,65.729,171.018,499,16328,0.904134,0.83,2,224230,223731,499
119721,21.1458,63.0036,473,16458,0.908827,0.85,2,224240,223767,473
122641,33.0292,20.6007,499,16587,0.941765,0.91,2,224276,223777,499
173741,32,27,495,18757,0.79,1,2,225747,225252,495
176661,128.8,145.4,473,18870,0.55,0.91,1,225900,225427,473
179581,196.96,193.88,481,18982,0.406,0.99,1,226114,225633,481
182501,56.192,62.776,472,19094,0.3292,0.93,1,226135,225663,472
185421,26.4384,33.3552,465,19205,0.29784,0.93,1,226154,225689,465
188341,24.4877,27.471,463,19315,0.259568,0.79,1,226178,225715,463
191261,28.0975,31.0942,460,19425,0.267914,0.49,1,226207,225747,460
194181,116.02,128.619,445,19534,0.333583,0.49,1,226345,225900,445
195641,184.004,25.7238,646,19643,0.474717,0.37,1,226546,225900,646
198561,40.0008,176.345,436,19751,0.502943,0.31,1,226550,226114,436
201481,24.0002,52.0689,435,19858,0.524589,0.29,1,226570,226135,435
204401,19.2,25.6138,434,19965,0.528918,0.25,1,226588,226154,434
207321,21.44,24.3228,432,20071,0.497784,0.27,1,226610,226178,432
210241,29.888,28.0646,435,20177,0.523557,0.35,1,226642,226207,435
213161,120.378,116.013,440,20282,0.640711,0.51,1,226785,226345,440
216081,192.076,184.003,449,20387,0.760142,0.51,2,226995,226546,449
219001,54.4151,40.0005,465,20491,0.800028,0.53,2,227015,226550,465
221921,25.283,24.0001,463,20595,0.808006,0.53,2,227033,226570,463
224841,22.6566,19.2,467,20698,0.809601,0.49,2,227055,226588,467
227761,31.7313,21.44,479,20800,0.80992,0.53,2,227089,226610,479
230681,126.346,29.888,597,20902,0.825984,0.67,2,227239,226642,597
232141,186.069,120.378,655,21003,0.845197,0.79,2,227440,226785,655
235061,50.0138,192.076,461,21104,0.865039,0.79,2,227456,226995,461
237981,26.0028,38.4151,481,21205,0.853008,0.81,2,227476,226995,481
240901,19.6006,23.683,479,21305,0.850602,0.81,2,227494,227015,479
243821,21.5201,19.1366,483,21405,0.85012,0.81,2,227516,227033,483
246741,33.104,21.4273,497,21504,0.866024,0.81,2,227552,227055,497
318281,32,25,507,23847,0.77,1,2,229382,228875,507
321201,25.6,28.2,502,23936,0.674,1,1,229406,228904,502
324121,21.12,24.04,499,24025,0.6708,1,1,229426,228927,499
325581,27.424,4.808,528,24113,0.60616,1,1,229455,228927,528
351861,386.285,451.362,441,10220,0.193232,0.05,1,229931,229490,441
354781,342.057,346.272,452,10428,0.0626464,0.01,1,230262,229810,452
357701,119.611,119.654,453,10632,0.0845293,0.11,1,230326,229873,453
360621,30.3223,47.1309,432,10832,0.0889059,0.09,1,230334,229902,432
362081,182.864,32.6262,624,11028,0.0897812,0.03,1,230555,229931,624
365001,141.373,271.325,424,11221,0.0179562,0.09,1,230686,230262,424
367921,81.0746,105.465,426,11410,0.0275912,0.09,1,230752,230326,426
370841,22.6149,27.493,426,11596,0.0775183,0.09,1,230760,230334,426
373761,282.123,182.299,552,11779,0.0555037,0,1,231107,230555,552
376681,110.825,141.26,489,11959,0.0191007,0.03,1,231175,230686,489
379601,28.5649,81.0519,431,12137,0.0438201,0.09,1,231183,230752,431
382521,7.31298,22.6104,425,12312,0.048764,0.05,1,231185,230760,425
385441,278.263,282.122,424,12485,0.193753,0.01,1,231531,231107,424
388361,110.053,110.824,424,12655,0.174751,0.05,1,231599,231175,424
391281,28.4105,28.5649,424,12823,0.13895,0.05,1,231607,231183,424
394201,7.2821,7.31298,424,12989,0.13179,0.23,1,231609,231185,424
397121,283.856,278.263,431,13153,0.194358,0.17,1,231962,231531,431
400041,108.771,110.053,428,13315,0.270872,0.13,1,232027,231599,428
402961,28.1543,28.4105,428,13475,0.254174,0.13,1,232035,231607,428
405881,7.23085,7.2821,428,13633,0.250835,0.13,1,232037,231609,428
407341,162.246,1.45642,629,13789,0.362167,0.21,1,232238,231609,629
410261,157.249,282.691,432,13943,0.464433,0.29,1,232394,231962,432
413181,85.0498,108.538,434,14095,0.500887,0.25,1,232461,232027,434
416101,23.41,28.1076,434,14246,0.540177,0.25,1,232469,232035,434
419021,6.28199,7.22153,434,14395,0.516035,0.39,1,232471,232037,434
421941,295.656,162.244,601,14543,0.687207,0.49,1,232839,232238,601
424861,113.531,157.249,513,14689,0.737441,0.51,1,232907,232394,513
427781,29.1063,85.0498,454,14834,0.747488,0.55,1,232915,232461,454
430701,7.42125,23.41,448,14977,0.765498,0.51,2,232917,232469,448
432161,162.284,6.28199,647,15119,0.8011,0.73,2,233118,232471,647
435081,175.657,295.656,458,15259,0.90422,0.73,2,233297,232839,458
438001,90.3314,59.1313,527,15398,0.940844,0.75,2,233366,232839,527
440921,25.2663,66.2263,468,15536,0.932169,0.75,2,233375,232907,468
500781,33,22,519,18189,0.63,1,1,235314,234795,519
503701,29.8,30.8,515,18306,0.678,1,1,235343,234828,515
506621,104.36,127.76,486,18422,0.5436,1,1,235466,234980,486
509541,166.472,184.752,469,18537,0.27672,0.92,1,235648,235179,469
512461,84.4944,88.9504,468,18651,0.207344,0.79,1,235712,235244,468
515381,37.6989,47.3901,457,18765,0.193469,0.63,1,235738,235281,457
518301,30.7398,35.878,453,18878,0.206694,0.69,1,235767,235314,453
521221,29.348,30.3756,453,18990,0.193339,0.51,1,235796,235343,453
524141,94.6696,104.475,441,19102,0.142668,0.21,1,235907,235466,441
527061,156.534,166.495,431,19213,0.180534,0.19,1,236079,235648,431
529981,81.7068,84.499,430,19323,0.204107,0.19,1,236142,235712,430
532901,37.9414,37.6998,431,19433,0.240821,0.21,1,236169,235738,431
535821,29.9883,30.74,430,19542,0.184164,0.21,1,236197,235767,430
538741,29.1977,6.14799,459,19651,0.188833,0.19,1,236226,235767,459
541661,90.6395,24.4296,536,19759,0.205767,0.13,1,236332,235796,536
544581,159.728,93.6859,602,19866,0.321153,0.19,1,236509,235907,602
547501,82.3456,156.337,493,19973,0.376231,0.21,1,236572,236079,493
550421,38.8691,81.6674,458,20079,0.371246,0.25,1,236600,236142,458
553341,28.5738,37.9335,457,20185,0.370249,0.17,1,236626,236169,457
556261,29.7148,29.9867,459,20290,0.37005,0.19,1,236656,236197,459
559181,92.343,29.1973,538,20395,0.43401,0.21,1,236764,236226,538
562101,164.869,90.6395,615,20499,0.558802,0.35,1,236947,236332,615
565021,84.1737,159.728,502,20602,0.61576,0.39,1,237011,236509,502
567941,39.2347,82.3456,467,20705,0.595152,0.37,1,237039,236572,467
570861,28.6469,38.8691,465,20807,0.60703,0.37,1,237065,236600,465
573781,30.5294,28.5738,470,20909,0.593406,0.37,1,237096,236626,470
576701,95.7059,29.7148,552,21010,0.686681,0.45,1,237208,236656,552
579621,20.7412,92.343,446,21111,0.705336,0.59,1,237210,236764,446
582541,154.548,164.869,451,21211,0.789067,0.63,2,237398,236947,451
585461,82.1096,84.1737,451,21311,0.789813,0.59,2,237462,237011,451
588381,39.6219,39.2347,452,21411,0.805963,0.61,2,237491,237039,452
591301,28.7244,28.6469,452,21510,0.841193,0.59,2,237517,237065,452
594221,31.3449,30.5294,453,21609,0.864239,0.71,2,237549,237096,453
597141,99.069,95.7059,457,21707,0.852848,0.71,2,237665,237208,457
600061,21.4138,20.7412,457,21805,0.85057,0.81,2,237667,237210,457
602981,157.083,154.548,460,21902,0.914114,0.79,2,237858,237398,460
605901,83.4166,82.1096,461,21999,0.926823,0.81,2,237923,237462,461
693501,33,21,499,24728,0.65,1,1,239845,239346,499
696421,29.8,27.4,499,24814,0.586,1,1,239874,239375,499
699341,29.16,26.28,502,24899,0.4292,1,1,239903,239401,502
702261,35.432,38.056,498,24984,0.33384,1,1,239940,239442,498
705181,87.8864,103.611,479,25069,0.170768,1,1,240041,239562,479
708101,41.5773,47.1222,476,25154,0.0581536,0.87,1,240071,239595,476
711021,128.315,136.624,467,25238,0.0356307,0.75,1,240221,239754,467
713941,64.8631,73.7249,458,25322,0.0631261,0.65,1,240270,239812,458
716861,32.9726,41.145,450,25406,0.100625,0.57,1,240295,239845,450
719781,23.3945,31.429,442,25489,0.124125,0.57,1,240316,239874,442
722701,27.0789,6.2858,470,25572,0.080825,0.39,1,240344,239874,470
725621,30.2158,24.4572,472,25655,0.120165,0.31,1,240375,239903,472
728541,76.4432,34.4914,523,25738,0.144033,0.13,1,240463,239940,523
731461,39.2886,87.6983,452,25820,0.0848066,0.03,1,240493,240041,452
734381,127.058,41.5397,571,25902,0.0409613,0.03,1,240642,240071,571
737301,66.2115,128.308,472,25984,0.0161923,0.07,1,240693,240221,472
740221,35.6423,64.8616,451,26066,0.123238,0.11,1,240721,240270,451
743141,21.5285,32.9723,444,26147,0.144648,0.13,1,240739,240295,444
746061,28.3057,23.3945,453,26228,0.13293,0.07,1,240769,240316,453
748981,28.8611,27.0789,454,26309,0.178586,0.13,1,240798,240344,454
751901,80.1722,30.2158,516,26390,0.219717,0.15,1,240891,240375,516
754821,35.2344,76.4432,452,26470,0.227943,0.07,1,240915,240463,452
757741,125.447,39.2886,570,26550,0.0535887,0.03,1,241063,240493,570
760661,69.0894,127.058,476,26630,0.0347177,0.01,1,241118,240642,476
763581,38.6179,66.2115,456,26710,0.0309435,0.15,1,241149,240693,456
766501,22.9236,35.6423,447,26789,0.0621887,0.15,1,241168,240721,447
769421,28.5847,21.5285,459,26868,0.100438,0.13,1,241198,240739,459
772341,7.31694,28.3057,431,26947,0.108088,0.19,1,241200,240769,431
775261,24.6634,28.8611,431,27026,0.157618,0.23,1,241229,240798,431
778181,80.9327,80.1722,433,27104,0.167524,0.23,1,241324,240891,433
781101,35.3865,35.2344,433,27182,0.169505,0.01,1,241348,240915,433
784021,117.477,125.447,423,27260,0.153901,0.03,1,241486,241063,423
786941,68.2955,69.0894,424,27338,0.0307802,0.03,1,241542,241118,424
789861,37.6591,38.6179,423,27415,0.062156,0.07,1,241572,241149,423
792781,25.9318,22.9236,427,27492,0.0204312,0.11,1,241595,241168,427
795701,29.1864,28.5847,427,27569,0.0440862,0.11,1,241625,241198,427
798621,7.43727,7.31694,427,27646,0.0488172,0.17,1,241627,241200,427
801541,25.4875,24.6634,428,27723,0.0977634,0.17,1,241657,241229,428
804461,81.0975,80.9327,428,27799,0.187553,0.17,1,241752,241324,428
807381,35.4195,35.3865,428,27875,0.221511,0.15,1,241776,241348,428
810301,116.684,117.477,427,27951,0.292302,0,1,241913,241486,427
813221,64.1368,68.2955,422,28027,0.29046,0.07,1,241964,241542,422
816141,37.6274,37.6591,423,28103,0.274092,0.01,1,241995,241572,423
819061,25.9255,25.9318,423,28178,0.254818,0.05,1,242018,241595,423
821981,30.7851,29.1864,425,28253,0.234964,0.05,1,242050,241625,425
824901,7.75702,7.43727,425,28328,0.230993,0.11,1,242052,241627,425
827821,25.5514,25.4875,425,28403,0.230199,0.11,1,242082,241657,425
830741,84.3103,5.09749,524,28478,0.26204,0.21,1,242181,241657,524
833661,37.6621,77.0195,455,28552,0.268408,0.23,1,242207,241752,455
836581,119.532,34.6039,571,28626,0.333682,0.31,1,242347,241776,571
839501,63.9065,116.521,484,28700,0.362736,0.29,1,242397,241913,484
842421,36.7813,64.1042,463,28774,0.368547,0.27,1,242427,241964,463
845341,24.9563,37.6208,454,28848,0.369709,0.25,1,242449,241995,454
848261,31.3913,25.9242,464,28921,0.353942,0.23,1,242482,242018,464
851181,7.87825,30.7848,434,28994,0.350788,0.23,1,242484,242050,434
854101,26.3757,7.75697,463,29067,0.350158,0.23,1,242515,242052,463
857021,85.2751,25.5514,533,29140,0.462032,0.27,1,242615,242082,533
859941,39.455,84.3103,462,29213,0.516406,0.27,1,242643,242181,462
862861,121.491,37.6621,578,29285,0.575281,0.35,1,242785,242207,578
865781,65.0982,119.532,489,29357,0.651056,0.37,1,242836,242347,489
868701,37.0196,63.9065,469,29429,0.666211,0.37,1,242866,242397,469
871621,25.0039,36.7813,461,29501,0.669242,0.37,1,242888,242427,461
874541,30.6008,24.9563,471,29573,0.669849,0.35,1,242920,242449,471
877461,7.72016,31.3913,440,29645,0.66997,0.35,1,242922,242482,440
880381,27.944,7.87825,471,29716,0.685994,0.35,1,242955,242484,471
883301,89.5888,26.3757,545,29787,0.753199,0.49,2,243060,242515,545
886221,19.5178,85.2751,447,29858,0.76664,0.53,2,243062,242615,447
889141,27.1036,39.455,448,29929,0.785328,0.59,2,243091,242643,448
892061,121.421,121.491,451,30000,0.741066,0.67,1,243236,242785,451
894981,68.2841,65.0982,455,30071,0.748213,0.67,1,243291,242836,455
897901,37.6568,37.0196,455,30141,0.797643,0.67,2,243321,242866,455
900821,25.1314,25.0039,455,30211,0.775529,0.67,2,243343,242888,455
903741,30.6263,30.6008,455,30281,0.787106,0.67,2,243375,242920,455
906661,7.72525,7.72016,455,30351,0.821421,0.69,2,243377,242922,455
909581,30.3451,27.944,458,30421,0.796284,0.77,2,243413,242955,458
912501,91.669,89.5888,460,30491,0.855257,0.77,2,243520,243060,460
915421,19.9338,19.5178,460,30560,0.867051,0.79,2,243522,243062,460
918341,26.3868,27.1036,459,30629,0.83741,0.73,2,243550,243091,459
1064341,91,206,458,14890,0.03,0,1,246096,245638,458
1067261,80.6,102.8,459,15033,0.006,0,1,246174,245715,459
1070181,40.92,54.96,447,15174,0.0252,0.15,1,246205,245758,447
1073101,30.584,36.592,443,15314,0.06104,0.03,1,246233,245790,443
1076021,162.117,179.318,423,15453,0.052208,0.03,1,246428,246005,423
1078941,107.623,108.664,426,15590,0.0984416,0,1,246522,246096,426
1081861,80.7247,84.1327,422,15726,0.0436883,0.03,1,246596,246174,422
1084781,42.5449,41.6265,424,15861,0.0487377,0.07,1,246629,246205,424
1087701,31.709,30.7253,425,15995,0.0817475,0.05,1,246658,246233,425
1090621,161.542,162.145,424,16128,0.10435,0.11,1,246852,246428,424
1093541,108.308,107.629,425,16260,0.0608699,0.03,1,246947,246522,425
1096461,78.4617,80.7258,422,16391,0.020174,0.05,1,247018,246596,422
1099381,42.8923,42.5452,423,16521,0.0600348,0.09,1,247052,246629,423
1102301,32.5785,31.709,424,16650,0.084007,0.09,1,247082,246658,424
1105221,161.716,6.34181,618,16778,0.0888014,0.11,1,247276,246658,618
1108141,105.943,156.468,516,16905,0.13776,0.05,1,247368,246852,516
1111061,77.9886,107.294,492,17031,0.163552,0.01,1,247439,246947,492
1113981,43.5977,78.2587,456,17156,0.0727104,0.07,1,247474,247018,456
1116901,33.5195,42.8517,453,17280,0.0385421,0.09,1,247505,247052,453
1119821,163.504,32.5703,619,17403,0.143708,0.09,1,247701,247082,619
1122741,108.701,161.714,520,17525,0.180742,0.15,1,247796,247276,520
1125661,76.1402,105.943,496,17646,0.204148,0.17,1,247864,247368,496
1128581,41.628,77.9886,458,17766,0.17683,0.05,1,247897,247439,458
1131501,32.3256,43.5977,453,17885,0.187366,0.03,1,247927,247474,453
1132961,167.265,33.5195,623,18004,0.253473,0.17,1,248128,247505,623
1135881,35.853,163.504,430,18122,0.250695,0.17,1,248131,247701,430
1138801,83.1706,32.7008,525,18239,0.298139,0.19,1,248226,247701,525
1141721,72.6341,82.5402,500,18355,0.387628,0.21,1,248296,247796,500
1144641,39.3268,70.908,463,18471,0.357526,0.17,1,248327,247864,463
1147561,31.8654,40.5816,460,18586,0.351505,0.19,1,248357,247897,460
1149021,167.173,32.1163,631,18700,0.494301,0.27,1,248558,247927,631
1151941,39.0346,167.223,437,18813,0.53886,0.25,1,248565,248128,437
1154861,85.4069,35.8447,531,18926,0.563772,0.31,1,248662,248131,531
1157781,75.4814,83.1689,509,19038,0.584754,0.41,1,248735,248226,509
1160701,39.0963,72.6338,469,19149,0.604951,0.35,1,248765,248296,469
1163621,31.8193,39.3268,468,19260,0.60899,0.35,1,248795,248327,468
1165081,167.164,31.8654,639,19370,0.625798,0.53,1,248996,248357,639
1168001,46.2328,167.173,454,19480,0.69316,0.55,1,249012,248558,454
1170921,88.4466,39.0346,546,19589,0.658632,0.57,1,249111,248565,546
1173841,19.2893,85.4069,451,19697,0.651726,0.59,1,249113,248662,451
1176761,62.2579,75.4814,451,19805,0.650345,0.61,1,249186,248735,451
1179681,37.2516,39.0963,452,19912,0.714069,0.61,1,249217,248765,452
1182601,31.4503,31.8193,452,20019,0.726814,0.63,1,249247,248795,452
1185521,181.49,167.164,470,20125,0.841363,0.71,2,249466,248996,470
1188441,115.498,46.2328,553,20230,0.896273,0.65,2,249565,249012,553
1191361,24.6996,88.4466,456,20335,0.907255,0.65,2,249567,249111,456
1194281,62.5399,19.2893,526,20439,0.925451,0.65,2,249639,249113,526
1197201,38.908,62.2579,486,20543,0.92909,0.73,2,249672,249186,486
1200121,33.3816,37.2516,487,20646,0.929818,0.73,2,249704,249217,487
1273121,27,28,511,23169,0.69,1,1,251531,251020,511
1276041,30.2,41.6,497,23261,0.61,1,1,251562,251065,497
1278961,38.84,28.32,513,23352,0.61,1,1,251603,251090,513
1281881,157.368,29.664,670,23443,0.37,1,1,251790,251120,670
1284801,66.6736,167.533,512,23533,0.386,0.95,1,251834,251322,512
1287721,83.7347,64.7066,561,23623,0.4052,0.79,1,251922,251361,561
1290641,47.1469,92.9413,499,23713,0.37704,0.75,1,251960,251461,499
1293561,30.2294,52.9883,482,23802,0.403408,0.69,1,251986,251504,482
1296481,27.6459,32.1977,482,23891,0.408682,0.59,1,252013,251531,482
1299401,34.3292,31.2395,487,23980,0.409736,0.61,1,252049,251562,487
1302321,8.46583,39.0479,448,24068,0.377947,0.31,1,252051,251603,448
1305241,144.893,157.41,440,24156,0.499589,0.39,1,252230,251790,440
1308161,64.1786,66.6819,440,24244,0.571918,0.41,1,252274,251834,440
1311081,84.8357,83.7364,442,24331,0.618384,0.37,1,252364,251922,442
1314001,47.3671,47.1473,442,24418,0.627677,0.41,1,252402,251960,442
1316921,28.6734,30.2295,440,24505,0.693535,0.41,1,252426,251986,440
1319841,28.9347,27.6459,442,24591,0.738707,0.41,1,252455,252013,442
1322761,35.3869,34.3292,443,24677,0.731741,0.37,1,252492,252049,443
1325681,8.67739,8.46584,443,24763,0.730348,0.53,1,252494,252051,443
1328601,148.935,144.893,448,24849,0.81007,0.59,2,252678,252230,448
1331521,65.7871,64.1786,449,24934,0.810014,0.63,2,252723,252274,449
1334441,88.3574,84.8357,453,25019,0.794003,0.63,2,252817,252364,453
1337361,48.8715,47.3671,454,25104,0.774801,0.71,2,252856,252402,454
1340281,29.7743,28.6734,455,25188,0.75496,0.75,2,252881,252426,455
1343201,30.7549,28.9347,457,25272,0.766992,0.73,2,252912,252455,457
1346121,34.951,35.3869,456,25356,0.817398,0.73,2,252948,252492,456
1349041,8.59019,8.67739,456,25440,0.82748,0.73,2,252950,252494,456
1351961,152.118,1.73548,644,25523,0.813496,0.83,2,253138,252494,644
1354881,65.6236,147.547,504,25606,0.826699,0.81,2,253182,252678,504
1357801,87.5247,65.5094,552,25689,0.87734,0.79,2,253275,252723,552
1360721,47.9049,88.3019,496,25771,0.935468,0.77,2,253313,252817,496
1363641,30.381,48.8604,483,25853,0.947094,0.75,2,253339,252856,483
1451241,161,189,487,28207,0.61,1,1,255045,254558,487
1454161,61,71.4,481,28282,0.61,1,1,255081,254600,481
1457081,37,34.28,487,28357,0.546,1,1,255112,254625,487
1460001,61.8,6.856,555,28432,0.4372,1,1,255180,254625,555
1462921,47.56,69.3712,514,28506,0.36744,0.92,1,255224,254710,514
1465841,31.112,43.4742,504,28580,0.369488,1,1,255251,254747,504
1468761,38.2224,31.8948,515,28654,0.369898,1,1,255291,254776,515
1471681,31.6445,42.379,500,28728,0.35398,0.92,1,255321,254821,500
1474601,29.5289,33.2758,498,28802,0.382796,0.8,1,255350,254852,498
1477521,123.506,32.2552,613,28876,0.308559,0.61,1,255497,254884,613
1480441,51.1012,135.251,485,28949,0.293712,0.61,1,255530,255045,485
1483361,31.8202,55.8502,476,29022,0.306742,0.53,1,255557,255081,476
1486281,56.764,35.97,508,29095,0.245348,0.41,1,255620,255112,508
1489201,47.3528,61.594,485,29168,0.28107,0.35,1,255665,255180,485
1492121,28.6706,47.5188,465,29241,0.304214,0.37,1,255689,255224,465
1495041,39.3341,31.1038,480,29313,0.244843,0.37,1,255731,255251,480
1497961,31.8668,38.2208,470,29385,0.264969,0.35,1,255761,255291,470
1500881,28.7734,31.6441,468,29457,0.332994,0.39,1,255789,255321,468
1503801,121.755,29.5288,584,29529,0.266599,0.29,1,255934,255350,584
1506721,49.1509,123.506,468,29601,0.26932,0.29,1,255965,255497,468
1509641,31.4302,51.1012,462,29673,0.205864,0.31,1,255992,255530,462
1512561,54.286,31.8202,495,29744,0.241173,0.23,1,256052,255557,495
1515481,49.2572,56.764,480,29815,0.216235,0.29,1,256100,255620,480
1518401,11.4514,47.3528,437,29886,0.211247,0.31,1,256102,255665,437
1521321,19.8903,28.6706,435,29957,0.242249,0.23,1,256124,255689,435
1524241,37.5781,39.3341,435,30028,0.26445,0.27,1,256166,255731,435
1527161,31.5156,31.8668,435,30098,0.30089,0.35,1,256196,255761,435
1530081,30.3031,28.7734,437,30168,0.292178,0.25,1,256226,255789,437
1533001,119.661,121.755,434,30238,0.418436,0.27,1,256368,255934,434
1535921,47.9321,49.1509,433,30308,0.443687,0.19,1,256398,255965,433
1538841,31.9864,31.4302,434,30378,0.416737,0.25,1,256426,255992,434
1541761,54.3973,54.286,434,30448,0.459347,0.21,1,256486,256052,434
1544681,47.6795,49.2572,432,30518,0.48387,0.21,1,256532,256100,432
1547601,11.1359,11.4514,432,30587,0.456774,0.25,1,256534,256102,432
1550521,19.8272,19.8903,432,30656,0.451355,0.27,1,256556,256124,432
1553441,38.3654,37.5781,433,30725,0.514271,0.31,1,256599,256166,433
1556361,33.2731,31.5156,435,30794,0.558854,0.29,1,256631,256196,435
1559281,32.2546,30.3031,437,30863,0.567771,0.45,1,256663,256226,437
1562201,124.051,119.661,442,30932,0.585554,0.45,1,256810,256368,442
1565121,48.8102,47.9321,442,31000,0.637111,0.41,1,256840,256398,442
1568041,32.962,31.9864,443,31068,0.631422,0.47,1,256869,256426,443
1570961,54.5924,54.3973,443,31136,0.646284,0.49,1,256929,256486,443
1573881,48.5185,47.6795,444,31204,0.601257,0.45,1,256976,256532,444
1576801,11.3037,11.1359,444,31272,0.592251,0.45,1,256978,256534,444
1579721,19.8607,19.8272,444,31340,0.59045,0.45,1,257000,256556,444
1582641,39.1721,3.96544,488,31408,0.62209,0.53,1,257044,256556,488
1585561,36.6344,35.1931,481,31475,0.644418,0.57,1,257080,256599,481
1588481,32.1269,32.6386,480,31542,0.664884,0.57,1,257111,256631,480
1591401,126.425,32.1277,598,31609,0.684977,0.59,1,257261,256663,598
1594321,49.2851,124.026,481,31676,0.768995,0.65,2,257291,256810,481
1597241,33.057,48.8051,480,31743,0.801799,0.63,2,257320,256840,480
1600161,54.6114,32.961,511,31810,0.77636,0.65,2,257380,256869,511
1603081,47.7223,54.5922,497,31877,0.771272,0.59,2,257426,256929,497
1606001,11.1445,48.5184,452,31943,0.770254,0.59,2,257428,256976,452
1608921,19.8289,11.3037,472,32009,0.786051,0.59,2,257450,256978,472
1611841,40.7658,19.8607,496,32075,0.78921,0.63,2,257496,257000,496
1614761,37.7532,39.1721,489,32141,0.837842,0.65,2,257533,257044,489
1617681,31.5506,36.6344,483,32207,0.847568,0.67,2,257563,257080,483
1722801,34,34,516,34493,0.89,1,2,259226,258710,516
1725721,37.2,27.6,528,34554,0.802,1,2,259264,258736,528
1728641,60.24,55.92,531,34615,0.7604,1,2,259330,258799,531
1731561,28.048,47.984,505,34676,0.72008,1,1,259350,258845,505
1734481,28.0096,27.1968,511,34737,0.760016,1,2,259378,258867,511
1737401,19.2019,23.8394,505,34798,0.736003,1,1,259395,258890,505
1740321,19.8404,27.1679,497,34859,0.683201,1,1,259415,258918,497
1743241,18.3681,23.0336,493,34920,0.65664,0.93,1,259433,258940,493
1746161,22.0736,18.2067,499,34981,0.667328,1,1,259456,258957,499
1749081,125.215,23.6413,625,35041,0.557466,0.89,1,259607,258982,625
1752001,65.0429,131.128,517,35101,0.519493,0.87,1,259657,259140,517
1754921,40.2086,67.8257,499,35161,0.495899,0.89,1,259691,259192,499
1757841,36.8417,40.7651,501,35221,0.45918,0.78,1,259727,259226,501
1760761,56.9683,38.553,525,35281,0.435836,0.75,1,259789,259264,525
1763681,25.7937,60.5106,477,35341,0.431167,0.71,1,259807,259330,477
1766601,26.7587,28.1021,484,35401,0.414233,0.77,1,259834,259350,484
1769521,19.7517,28.0204,474,35461,0.410847,0.73,1,259852,259378,474
1772441,18.3503,19.2041,475,35521,0.410169,0.67,1,259870,259395,475
1775361,15.6701,19.8408,470,35581,0.458034,0.65,1,259885,259415,470
1778281,22.334,18.3682,476,35640,0.403607,0.67,1,259909,259433,476
1781201,6.0668,22.0736,455,35699,0.440721,0.53,1,259911,259456,455
1784121,115.613,125.215,447,35758,0.496144,0.51,1,260054,259607,447
1787041,62.3227,65.0429,446,35817,0.523229,0.49,1,260103,259657,446
1789961,39.6645,40.2086,446,35876,0.512646,0.45,1,260137,259691,446
1792881,36.7329,36.8417,446,35935,0.478529,0.43,1,260173,259727,446
1795801,53.7466,56.9683,442,35994,0.535706,0.43,1,260231,259789,442
1798721,25.9493,25.7937,443,36053,0.579141,0.41,1,260250,259807,443
1801641,25.9899,26.7587,442,36112,0.603828,0.41,1,260276,259834,442
1804561,19.598,19.7517,442,36171,0.608766,0.41,1,260294,259852,442
1807481,19.9196,18.3503,444,36229,0.641753,0.47,1,260314,259870,444
1810401,15.1839,15.6701,443,36287,0.616351,0.39,1,260328,259885,443
1813321,23.8368,22.334,445,36345,0.61127,0.45,1,260354,259909,445
1816241,6.36736,6.0668,445,36403,0.610254,0.51,1,260356,259911,445
1819161,117.273,115.613,447,36461,0.642051,0.53,1,260501,260054,447
1822081,62.6547,62.3227,447,36519,0.71241,0.51,1,260550,260103,447
1825001,39.7309,39.6645,447,36577,0.710482,0.47,1,260584,260137,447
1827921,35.1462,36.7329,445,36635,0.726096,0.55,1,260618,260173,445
1830841,57.4292,53.7466,450,36693,0.761219,0.59,2,260681,260231,450
1833761,25.8858,25.9493,449,36751,0.768244,0.61,2,260699,260250,449
1836681,28.3772,25.9899,452,36809,0.753649,0.61,2,260728,260276,452
1839601,20.0754,19.598,452,36866,0.75073,0.65,2,260746,260294,452
1842521,20.0151,19.9196,452,36923,0.798146,0.61,2,260766,260314,452
1845441,15.203,15.1839,452,36980,0.775629,0.61,2,260780,260328,452
1848361,23.8406,23.8368,452,37037,0.771126,0.61,2,260806,260354,452
1851281,6.36812,6.36736,452,37094,0.770225,0.65,2,260808,260356,452
1854201,118.874,117.273,454,37151,0.850045,0.65,2,260955,260501,454
1857121,63.7747,23.4547,504,37208,0.834009,0.73,2,261005,260501,504
1860041,41.5549,43.8909,491,37265,0.814802,0.71,2,261041,260550,491
1862961,35.511,35.9782,491,37322,0.82696,0.73,2,261075,260584,491
1865881,59.1022,34.3956,522,37379,0.845392,0.77,2,261140,260618,522
1868801,26.2204,57.2791,477,37436,0.849078,0.77,2,261158,260681,477
1871721,27.6441,25.8558,487,37492,0.881816,0.75,2,261186,260699,487
1874641,19.9288,28.3712,476,37548,0.888363,0.75,2,261204,260728,476
1877561,20.7858,20.0742,479,37604,0.873673,0.81,2,261225,260746,479
1880481,15.3572,20.0148,473,37660,0.870734,0.77,2,261239,260766,473
1883401,23.8714,15.203,485,37716,0.886147,0.77,2,261265,260780,485
1886321,6.37429,23.8406,461,37772,0.889229,0.77,2,261267,260806,461
1889241,121.275,6.36812,609,37828,0.937846,0.87,2,261417,260808,609
2044001,38,49,513,40682,0.51,1,1,263417,262904,513
2046921,50.8,42.6,526,40734,0.414,1,1,263471,262945,526
2049841,34.96,46.92,509,40786,0.3148,1,1,263502,262993,509
2052761,34.192,31.784,515,40838,0.19896,1,1,263536,263021,515
2055681,24.4384,29.5568,508,40890,0.159792,1,1,263558,263050,508
2058601,29.6877,30.7114,508,40942,0.0559584,1,1,263589,263081,508
2061521,31.5375,30.9423,509,40994,0.0111917,1,1,263621,263112,509
2064441,22.3075,24.5885,506,41045,0.106238,1,1,263641,263135,506
2067361,26.8615,26.5177,507,41096,0.0452477,0.91,1,263669,263162,507
2070281,14.1723,30.9035,486,41147,0.0330495,0.89,1,263680,263194,486
2073201,15.6345,16.5807,489,41198,0.0306099,0.98,1,263696,263207,489
2076121,83.9269,18.5161,571,41249,0.030122,0.73,1,263797,263226,571
2079041,41.5854,98.1032,484,41300,0.0460244,0.57,1,263828,263344,484
2081961,33.9171,47.6206,481,41351,0.0492049,0.51,1,263860,263379,481
2084881,45.1834,39.9241,491,41402,0.065841,0.39,1,263908,263417,491
2087801,31.4367,51.1848,465,41453,0.101168,0.29,1,263936,263471,465
2090721,27.8873,35.037,461,41504,0.0762336,0.17,1,263963,263502,461
2093641,7.17747,34.2074,429,41555,0.119247,0.15,1,263965,263536,429
2096561,15.8355,24.4415,425,41606,0.0958494,0.03,1,263983,263558,425
2099481,25.5671,29.6883,422,41657,0.12317,0,1,264011,263589,422
2102401,33.1134,31.5377,425,41708,0.064634,0.13,1,264046,263621,425
2105321,21.0227,22.3075,423,41759,0.0369268,0.03,1,264064,263641,423
2108241,25.8045,26.8615,422,41810,0.0313854,0.03,1,264091,263669,422
2111161,13.9609,14.1723,422,41860,0.0462771,0.03,1,264102,263680,422
2114081,15.5922,15.6345,422,41910,0.0492554,0.03,1,264118,263696,422
2117001,83.9184,83.9269,422,41960,0.0178511,0.05,1,264219,263797,422
2119921,43.9837,41.5854,425,42010,0.0275702,0.05,1,264253,263828,425
2122841,34.3967,33.9171,425,42060,0.077514,0.07,1,264285,263860,425
2125761,43.6793,45.1834,423,42110,0.0715028,0.11,1,264331,263908,423
2128681,33.5359,31.4367,426,42160,0.0703006,0.07,1,264362,263936,426
2131601,28.3072,27.8873,426,42210,0.0700601,0.13,1,264389,263963,426
2134521,7.26143,7.17747,426,42260,0.070012,0.09,1,264391,263965,426
2137441,15.8523,15.8355,426,42310,0.102002,0.13,1,264409,263983,426
2140361,23.9705,25.5671,424,42360,0.1244,0.05,1,264435,264011,424
2143281,31.9941,33.1134,423,42410,0.12888,0.03,1,264469,264046,423
2146201,19.9988,21.0227,422,42460,0.113776,0.03,1,264486,264064,422
2149121,26.3998,25.8045,423,42510,0.0787552,0.05,1,264514,264091,423
2152041,13.28,13.9609,422,42560,0.055751,0.05,1,264524,264102,422
2154961,15.456,15.5922,422,42610,0.0191502,0.01,1,264540,264118,422
2157881,83.8912,83.9184,422,42660,0.04383,0.03,1,264641,264219,422
2160801,44.7782,43.9837,423,42709,0.048766,0.09,1,264676,264253,423
2163721,35.3556,34.3967,424,42758,0.0337532,0.07,1,264709,264285,424
2166641,44.6711,43.6793,425,42807,0.0467506,0.07,1,264756,264331,425
2169561,32.9342,33.5359,424,42856,0.0333501,0.07,1,264786,264362,424
2172481,28.9868,28.3072,425,42905,0.03067,0.07,1,264814,264389,425
2175401,7.39737,7.26143,425,42954,0.030134,0.11,1,264816,264391,425
2178321,15.8795,15.8523,425,43003,0.0460268,0.11,1,264834,264409,425
2181241,24.7759,3.17046,452,43052,0.0812054,0.13,1,264861,264409,452
2184161,31.3552,21.4341,459,43101,0.0722411,0.13,1,264894,264435,459
2187081,17.471,31.4868,439,43150,0.0704482,0.11,1,264908,264469,439
2190001,26.6942,19.8974,451,43199,0.0700896,0.07,1,264937,264486,451
2192921,11.7388,26.3795,431,43248,0.102018,0.05,1,264945,264514,431
2195841,15.9478,13.2759,438,43297,0.0604036,0.01,1,264962,264524,438
2198761,83.1896,15.4552,522,43346,0.0680807,0.05,1,265062,264540,522
2201681,44.6379,83.891,456,43395,0.0536161,0.05,1,265097,264641,456
2204601,36.1276,44.7782,455,43444,0.0667232,0.03,1,265131,264676,455
2207521,44.0255,35.3556,468,43493,0.0693446,0.05,1,265177,264709,468
2210441,33.6051,44.6711,452,43542,0.0538689,0.03,1,265208,264756,452
2213361,29.921,32.9342,451,43590,0.0667738,0.03,1,265237,264786,451
2216281,7.5842,28.9868,425,43638,0.0693548,0.03,1,265239,264814,425
2219201,15.9168,7.39737,441,43686,0.117871,0.05,1,265257,264816,441
2222121,26.3834,15.8795,452,43734,0.159574,0.09,1,265286,264834,452
2225041,30.8767,24.7759,457,43782,0.167915,0.07,1,265318,264861,457
2227961,17.3753,31.3552,438,43830,0.185583,0.07,1,265332,264894,438
2230881,28.2751,17.471,455,43878,0.221117,0.07,1,265363,264908,455
2233801,8.85501,26.6942,430,43926,0.228223,0.11,1,265367,264937,430
2236721,14.571,11.7388,438,43974,0.229645,0.05,1,265383,264945,438
2239641,83.7142,15.9478,522,44022,0.261929,0.07,1,265484,264962,522
2242561,45.5428,83.1896,458,44070,0.268386,0.05,1,265520,265062,458
2245481,37.1086,44.6379,458,44118,0.269677,0.07,1,265555,265097,458
2248401,44.2217,36.1276,470,44166,0.269935,0.07,1,265601,265131,470
2251321,32.8443,44.0255,454,44214,0.269987,0.05,1,265631,265177,454
2254241,32.9689,33.6051,456,44262,0.301997,0.07,1,265664,265208,456
2257161,8.19377,29.921,429,44310,0.276399,0.07,1,265666,265237,429
2260081,16.8388,7.5842,446,44358,0.28728,0.13,1,265685,265239,446
2263001,27.3678,15.9168,458,44406,0.289456,0.17,1,265715,265257,458
2265921,31.0736,26.3834,461,44454,0.289891,0.17,1,265747,265286,461
2268841,7.81471,30.8767,431,44501,0.289978,0.19,1,265749,265318,431
2271761,12.7629,17.3753,431,44548,0.305996,0.23,1,265763,265332,431
2274681,28.9526,28.2751,433,44595,0.309199,0.23,1,265796,265363,433
2277601,8.99052,8.85501,433,44642,0.34184,0.23,1,265800,265367,433
2280521,15.3981,14.571,434,44689,0.332368,0.27,1,265817,265383,434
2283441,84.6796,83.7142,435,44736,0.362474,0.27,1,265919,265484,435
2286361,45.7359,45.5428,435,44783,0.384495,0.27,1,265955,265520,435
2289281,37.1472,37.1086,435,44830,0.372899,0.27,1,265990,265555,435
2292201,44.2294,44.2217,435,44877,0.35458,0.27,1,266036,265601,435
2295121,32.8459,32.8443,435,44924,0.350916,0.31,1,266066,265631,435
2298041,32.9692,32.9689,435,44971,0.398183,0.27,1,266099,265664,435
2300961,8.19383,8.19377,435,45018,0.407637,0.29,1,266101,265666,435
2303881,17.6388,16.8388,436,45065,0.393527,0.29,1,266121,265685,436
2306801,27.5278,27.3678,436,45112,0.454705,0.29,1,266151,265715,436
2309721,31.9055,31.0736,437,45159,0.466941,0.29,1,266184,265747,437
2312641,7.98111,7.81471,437,45206,0.469388,0.31,1,266186,265749,437
2315561,12.7962,12.7629,437,45253,0.437878,0.31,1,266200,265763,437
2318481,28.9592,28.9526,437,45300,0.463576,0.35,1,266233,265796,437
2321401,8.99185,8.99052,437,45347,0.436715,0.33,1,266237,265800,437
2324321,16.9984,15.3981,439,45394,0.463343,0.37,1,266256,265817,439
2327241,85.7997,84.6796,440,45440,0.532669,0.39,1,266359,265919,440
2330161,45.1599,45.7359,439,45486,0.530534,0.37,1,266394,265955,439
2333081,36.232,37.1472,438,45532,0.498107,0.35,1,266428,265990,438
2336001,44.8464,44.2294,439,45578,0.587621,0.35,1,266475,266036,439
2338921,32.9693,32.8459,439,45624,0.605524,0.41,1,266505,266066,439
2341841,33.7939,32.9692,440,45670,0.593105,0.41,1,266539,266099,440
2344761,8.35877,8.19383,440,45716,0.622621,0.39,1,266541,266101,440
2347681,19.2718,17.6388,442,45762,0.644524,0.47,1,266563,266121,442
2350601,28.6544,27.5278,443,45808,0.632905,0.47,1,266594,266151,443
2353521,32.1309,31.9055,443,45854,0.646581,0.47,1,266627,266184,443
2356441,8.02617,7.98111,443,45900,0.617316,0.43,1,266629,266186,443
2359361,12.8052,12.7962,443,45946,0.643463,0.43,1,266643,266200,443
2362281,28.961,2.55924,476,45992,0.648693,0.47,1,266676,266200,476
2365201,8.99221,26.9118,447,46038,0.617738,0.43,1,266680,266233,447
2368121,16.1984,8.58237,461,46084,0.643548,0.47,1,266698,266237,461
2371041,88.8397,16.9165,549,46130,0.66471,0.55,1,266805,266256,549
2373961,44.9679,85.7833,480,46176,0.668942,0.53,1,266839,266359,480
2376881,36.9936,45.1567,480,46222,0.653788,0.49,1,266874,266394,480
2379801,47.3987,36.2313,496,46268,0.746758,0.61,1,266924,266428,496
2382721,34.2797,44.8463,480,46314,0.781352,0.61,2,266955,266475,480
2385641,34.0559,32.9693,484,46360,0.78827,0.59,2,266989,266505,484
2388561,8.41119,33.7939,452,46405,0.789654,0.63,2,266991,266539,452
2391481,20.0822,8.35877,473,46450,0.789931,0.65,2,267014,266541,473
2394401,28.0164,19.2718,481,46495,0.789986,0.63,2,267044,266563,481
2397321,32.8033,28.6544,484,46540,0.805997,0.65,2,267078,266594,484
2400241,8.16066,32.1309,453,46585,0.809199,0.61,2,267080,266627,453
2403161,12.8321,8.02617,465,46630,0.80984,0.65,2,267094,266629,465
2406081,30.5664,12.8052,486,46675,0.857968,0.65,2,267129,266643,486
2409001,9.31328,28.961,457,46720,0.867594,0.61,2,267133,266676,457
2411921,16.2627,8.99221,471,46765,0.901519,0.65,2,267151,266680,471
2690781,145,179,429,23360,0.13,0.11,1,270183,269754,429
2693701,87.4,58.2,474,23451,0.082,0.03,1,270256,269782,474
2696621,76.68,74.04,470,23541,0.0564,0.03,1,270330,269860,470
2699541,50.536,67.608,448,23631,0.05128,0.05,1,270374,269926,448
2702461,55.7072,69.5216,435,23721,0.098256,0.03,1,270431,269996,435
2705381,25.5414,25.1043,439,23810,0.107651,0.03,1,270449,270010,439
2708301,13.9083,22.6209,428,23899,0.12553,0.13,1,270460,270032,428
2711221,67.5817,52.5242,449,23988,0.129106,0.13,1,270541,270092,449
2714141,68.7163,44.9048,475,24076,0.161821,0.07,1,270610,270135,475
2717061,70.5433,105.781,425,24164,0.216364,0.05,1,270681,270256,425
2719981,70.9087,80.3562,422,24252,0.179273,0.05,1,270752,270330,422
2722901,49.3817,51.2712,422,24339,0.0598546,0.11,1,270796,270374,422
2725821,59.4763,55.8542,427,24426,0.0679709,0.11,1,270858,270431,427
2728741,26.2953,25.5708,427,24513,0.101594,0.13,1,270876,270449,427
2731661,14.8591,13.9142,428,24599,0.0763188,0.13,1,270888,270460,428
2734581,67.7718,67.5828,428,24685,0.0872638,0.17,1,270969,270541,428
2737501,70.3544,68.7166,430,24771,0.153453,0.23,1,271040,270610,430
2740421,71.6709,70.5433,431,24857,0.182691,0.17,1,271112,270681,431
2743341,68.7342,70.9087,428,24942,0.236538,0.03,1,271180,270752,428
2746261,44.1468,49.3817,422,25027,0.263308,0.07,1,271218,270796,422
2749181,60.8294,59.4763,425,25112,0.236662,0.11,1,271283,270858,425
2752101,26.5659,26.2953,425,25196,0.199332,0.07,1,271301,270876,425
2755021,14.9132,14.8591,425,25280,0.191866,0.09,1,271313,270888,425
2757941,69.3826,67.7718,427,25364,0.254373,0.17,1,271396,270969,427
2760861,71.4765,70.3544,428,25448,0.250875,0.17,1,271468,271040,428
2763781,73.4953,14.0709,502,25531,0.282175,0.19,1,271542,271040,502
2766701,71.4991,60.4142,501,25614,0.320435,0.25,1,271613,271112,501
2769621,40.6998,66.4828,466,25697,0.360087,0.27,1,271646,271180,466
2772541,61.74,43.6966,495,25779,0.352017,0.23,1,271713,271218,495
2775461,26.748,60.7393,448,25861,0.350403,0.19,1,271731,271283,448
2778381,15.7496,26.5479,443,25943,0.366081,0.19,1,271744,271301,443
2781301,70.3499,14.9096,515,26025,0.353216,0.27,1,271828,271313,515
2784221,72.47,69.3819,505,26106,0.414643,0.25,1,271901,271396,505
2787141,75.294,71.4764,509,26187,0.426929,0.29,1,271977,271468,509
2790061,73.4588,73.4953,508,26268,0.429386,0.33,1,272050,271542,508
2792981,42.6918,71.4991,472,26349,0.461877,0.37,1,272085,271613,472
2795901,61.3384,40.6998,505,26429,0.484375,0.35,1,272151,271646,505
2798821,26.6677,61.74,456,26509,0.488875,0.35,1,272169,271713,456
2801741,14.9335,26.748,450,26589,0.489775,0.37,1,272181,271731,450
2804661,70.9867,15.7496,522,26669,0.521955,0.35,1,272266,271744,522
2807581,75.7973,70.3499,515,26748,0.608391,0.43,1,272343,271828,515
2810501,75.9595,72.47,518,26827,0.625678,0.43,1,272419,271901,518
2813421,73.5919,75.294,515,26906,0.629136,0.43,1,272492,271977,515
2816341,16.3184,73.4588,444,26985,0.629827,0.47,1,272494,272050,444
2819261,32.0637,42.6918,445,27063,0.629965,0.49,1,272530,272085,445
2822181,60.0127,61.3384,446,27141,0.645993,0.49,1,272597,272151,446
2825101,26.4025,26.6677,446,27219,0.681199,0.49,1,272615,272169,446
2828021,14.8805,14.9335,446,27297,0.68824,0.53,1,272627,272181,446
2830941,72.5761,70.9867,448,27375,0.689648,0.63,1,272714,272266,448
2833861,80.1152,75.7973,453,27452,0.75393,0.63,2,272796,272343,453
2836781,76.823,75.9595,453,27529,0.798786,0.63,2,272872,272419,453
2839701,73.7646,73.5919,453,27606,0.823757,0.63,2,272945,272492,453
2842621,16.3529,16.3184,453,27683,0.860751,0.63,2,272947,272494,453
2845541,32.0706,32.0637,453,27760,0.90015,0.65,2,272983,272530,453
3006141,52,89,519,31680,0.67,0.97,1,275778,275259,519
3009061,63.2,53,541,31747,0.59,1,1,275844,275303,541
3011981,41.44,65,509,31814,0.542,0.98,1,275880,275371,509
3014901,29.888,40.2,502,31881,0.6124,1,1,275907,275405,502
3017821,33.9776,31.24,508,31947,0.57848,1,1,275942,275434,508
3020741,15.5955,35.848,482,32013,0.603696,0.96,1,275953,275471,482
3023661,31.9191,19.1696,503,32079,0.608739,0.89,1,275989,275486,503
3026581,28.7838,33.4339,494,32145,0.625748,0.91,1,276017,275523,494
3029501,72.1568,29.0868,549,32211,0.64515,0.79,1,276100,275551,549
3032421,79.2314,73.0174,546,32277,0.68103,0.67,1,276181,275635,546
3035341,55.8463,87.4035,505,32343,0.656206,0.67,1,276231,275726,505
3038261,60.7693,59.0807,515,32408,0.715241,0.57,1,276293,275778,515
3041181,39.3539,64.6161,483,32473,0.727048,0.53,1,276327,275844,483
3044101,29.4708,41.7232,474,32538,0.74541,0.63,1,276354,275880,474
3047021,36.2942,29.9446,485,32603,0.749082,0.57,1,276392,275907,485
3049941,16.8588,33.9889,462,32668,0.717816,0.61,1,276404,275942,462
3052861,32.1718,15.5978,487,32733,0.711563,0.61,1,276440,275953,487
3055781,8.03435,31.9196,453,32798,0.710313,0.63,1,276442,275989,453
3058701,24.0069,28.7839,453,32862,0.742063,0.65,1,276470,276017,453
3061621,72.0014,72.1568,454,32926,0.748412,0.69,1,276554,276100,454
3064541,80.8003,79.2314,456,32990,0.797683,0.65,2,276637,276181,456
3067461,56.1601,55.8463,456,33054,0.791537,0.73,2,276687,276231,456
3070381,62.432,60.7693,458,33118,0.854307,0.73,2,276751,276293,458
3073301,39.6864,39.3539,458,33182,0.882861,0.75,2,276785,276327,458
3076221,28.7373,29.4708,457,33246,0.888572,0.75,2,276811,276354,457
3079141,36.1475,36.2942,457,33310,0.889714,0.71,2,276849,276392,457
3082061,16.8295,16.8588,457,33373,0.921943,0.71,2,276861,276404,457
3213461,30,30,492,36115,0.79,1,2,278783,278291,492
3216381,33.2,28.4,498,36174,0.79,1,2,278817,278319,498
3219301,27.44,32.88,490,36232,0.87,1,2,278843,278353,490
3222221,27.088,32.176,485,36290,0.822,1,2,278870,278385,485
3225141,44.6176,46.4352,484,36348,0.8604,1,2,278919,278435,484
3228061,33.7235,38.887,478,36406,0.82008,0.94,2,278950,278472,478
3230981,71.5447,67.7774,484,36464,0.796016,1,2,279031,278547,484
3233901,40.7089,42.3555,481,36522,0.791203,0.95,2,279064,278583,481
3236821,56.9418,66.8711,469,36580,0.806241,0.95,2,279125,278656,469
3239741,39.3884,42.9742,467,36638,0.809248,0.81,2,279160,278693,467
3242661,31.8777,34.9948,464,36696,0.77785,0.87,2,279190,278726,464
3245581,26.3755,28.599,462,36754,0.75557,0.79,2,279215,278753,462
3248501,28.4751,29.7198,461,36811,0.799114,0.79,2,279244,278783,461
3251421,32.895,33.144,461,36868,0.807823,0.89,2,279278,278817,461
3254341,28.179,27.4288,462,36925,0.761565,0.81,2,279305,278843,462
3257261,25.6358,27.0858,460,36982,0.768313,0.87,2,279330,278870,460
3260181,47.5272,44.6172,464,37039,0.801663,0.81,2,279383,278919,464
3263101,32.7054,33.7234,462,37096,0.824332,0.79,2,279412,278950,462
3266021,67.3411,71.5447,457,37153,0.860866,0.79,2,279488,279031,457
3268941,40.6682,14.3089,491,37210,0.868173,0.79,2,279522,279031,491
3271861,58.5336,29.2618,521,37267,0.869635,0.81,2,279585,279064,521
3274781,38.9067,54.6524,494,37324,0.901927,0.81,2,279619,279125,494
3277701,31.7813,38.9305,489,37381,0.908385,0.77,2,279649,279160,489
3280621,27.1563,31.7861,485,37438,0.909677,0.75,2,279675,279190,485
3283541,27.8313,26.3572,488,37494,0.941935,0.81,2,279703,279215,488
3477721,85,35,511,18366,0.03,0.23,1,282401,281890,511
3480641,90.6,105.4,480,18482,0.014,0.03,1,282493,282013,480
3483561,74.92,109.08,441,18597,0.0268,0.01,1,282564,282123,441
3486481,32.584,48.216,430,18711,0.10936,0.01,1,282586,282156,430
3489401,50.5168,26.4432,464,18824,0.045872,0.03,1,282641,282177,464
3492321,86.9034,61.2886,490,18937,0.0091744,0.03,1,282737,282247,490
3495241,88.5807,135.458,425,19049,0.0258349,0.01,1,282826,282401,425
3498161,92.1161,100.692,426,19160,0.061167,0.03,1,282919,282493,426
3501081,74.4232,76.9383,425,19271,0.0522334,0.13,1,282989,282564,425
3504001,34.0846,32.9877,427,19381,0.0184467,0.03,1,283013,282586,427
3506921,46.8169,50.5975,422,19490,0.0276893,0,1,283063,282641,422
3509841,87.7634,86.9195,424,19599,0.0295379,0,1,283161,282737,424
3512761,87.1527,17.3839,511,19707,0.0459076,0.03,1,283248,282737,511
3515681,91.8305,74.6768,515,19815,0.113182,0.07,1,283341,282826,515
3518601,73.5661,89.3354,491,19922,0.0466363,0.05,1,283410,282919,491
3521521,34.7132,73.8671,446,20028,0.0333273,0.01,1,283435,282989,446
3524441,46.1426,33.9734,471,20134,0.0146655,0.03,1,283484,283013,471
3527361,87.6285,46.7947,519,20239,0.0269331,0.03,1,283582,283063,519
3530281,88.7257,87.7589,510,20344,0.0293866,0.05,1,283671,283161,510
3533201,95.3451,87.1518,520,20448,0.141877,0.13,1,283768,283248,520
3536121,71.069,91.8304,492,20552,0.164375,0.03,1,283833,283341,492
3539041,33.4138,73.5661,447,20655,0.184875,0.03,1,283857,283410,447
3541961,46.6828,34.7132,472,20758,0.124975,0.01,1,283907,283435,472
3544881,86.1366,46.1426,519,20860,0.032995,0.03,1,284003,283484,519
3547801,89.2273,87.6285,511,20962,0.030599,0.03,1,284093,283582,511
3550721,19.4455,88.7257,424,21063,0.0301198,0.17,1,284095,283671,424
3553641,87.0891,95.3451,431,21164,0.030024,0.17,1,284199,283768,431
3556561,68.6178,71.069,430,21264,0.0780048,0.19,1,284263,283833,430
3559481,33.7236,33.4138,431,21364,0.071601,0.11,1,284288,283857,431
3562401,43.5447,46.6828,427,21463,0.0703202,0.01,1,284334,283907,427
3565321,82.3089,86.1366,423,21562,0.134064,0.03,1,284426,284003,423
3568241,88.4618,89.2273,423,21660,0.0668128,0.03,1,284516,284093,423
3571161,19.2924,19.4455,423,21758,0.0533626,0.03,1,284518,284095,423
3574081,87.0585,87.0891,423,21855,0.0666725,0.09,1,284622,284199,423
3577001,71.0117,68.6178,426,21952,0.117335,0.07,1,284689,284263,426
3579921,33.4023,33.7236,425,22049,0.111467,0.07,1,284713,284288,425
3582841,43.4805,43.5447,425,22145,0.126293,0.15,1,284759,284334,425
3585761,83.8961,82.3089,427,22241,0.177259,0.05,1,284853,284426,427
3588681,86.3792,88.4618,424,22336,0.171452,0.05,1,284940,284516,424
3591601,18.8758,19.2924,424,22431,0.17029,0.07,1,284942,284518,424
3594521,86.1752,87.0585,423,22526,0.186058,0.07,1,285045,284622,423
3597441,73.235,17.4117,493,22620,0.269212,0.13,1,285115,284622,493
3600361,33.847,57.0823,450,22714,0.269842,0.11,1,285139,284689,450
3603281,44.3694,30.6165,473,22807,0.301968,0.13,1,285186,284713,473
3606201,84.8739,42.9233,522,22900,0.356394,0.19,1,285281,284759,522
3609121,87.3748,83.7847,516,22993,0.415279,0.17,1,285369,284853,516
3612041,19.075,86.3569,431,23085,0.427056,0.17,1,285371,284940,431
3614961,87.015,18.8714,533,23177,0.429411,0.19,1,285475,284942,533
3617881,75.803,86.1743,503,23268,0.477882,0.29,1,285548,285045,503
3620801,35.9606,73.2349,459,23359,0.519576,0.27,1,285574,285115,459
3623721,45.5921,33.847,483,23450,0.575915,0.31,1,285622,285139,483
3626641,87.5184,44.3694,534,23540,0.587183,0.37,1,285720,285186,534
3629561,90.3037,84.8739,530,23630,0.669437,0.43,1,285811,285281,530
3632481,19.6607,87.3748,444,23720,0.685887,0.43,1,285813,285369,444
3635401,87.1322,19.075,546,23809,0.705177,0.43,1,285917,285371,546
3638321,78.2264,87.015,518,23898,0.709036,0.49,1,285993,285475,518
3641241,38.8453,75.803,474,23987,0.693807,0.53,1,286022,285548,474
3644161,9.36906,35.9606,450,24075,0.690761,0.59,1,286024,285574,450
3647081,41.0738,45.5921,451,24163,0.738152,0.59,1,286073,285622,451
3650001,86.6148,87.5184,451,24251,0.76363,0.69,2,286171,285720,451
3652921,94.123,90.3037,456,24338,0.768726,0.69,2,286267,285811,456
3655841,20.4246,19.6607,456,24425,0.769745,0.71,2,286269,285813,456
3658761,88.0849,87.1322,457,24512,0.865949,0.71,2,286374,285917,457
3661681,78.417,78.2264,457,24598,0.85319,0.69,2,286450,285993,457
3664601,38.0834,38.8453,456,24684,0.866638,0.69,2,286478,286022,456
3667521,9.21668,9.36906,456,24770,0.869328,0.75,2,286480,286024,456
3670441,43.4433,41.0738,459,24856,0.853866,0.77,2,286532,286073,459
3778481,42,30,498,27835,0.83,1,2,288682,288184,498
3781401,62.8,70.8,485,27911,0.75,1,2,288750,288265,485
3784321,73.36,81.36,477,27987,0.622,1,1,288826,288349,477
3787241,47.472,41.872,486,28063,0.6604,1,1,288867,288381,486
3790161,39.8944,33.9744,492,28138,0.55608,1,1,288905,288413,492
3793081,32.7789,23.5949,502,28213,0.535216,0.94,1,288936,288434,502
3796001,52.9558,74.319,473,28288,0.515043,0.89,1,288994,288521,473
3798921,39.3912,46.8638,469,28363,0.495009,0.89,1,289030,288561,469
3801841,69.4782,9.37276,546,28438,0.507002,0.88,1,289107,288561,546
3804761,46.6956,65.0746,508,28512,0.5094,0.83,1,289148,288640,508
3807681,57.3391,46.6149,526,28586,0.49388,0.73,1,289208,288682,526
3810601,69.0678,63.723,530,28660,0.522776,0.59,1,289280,288750,530
3813521,42.6136,73.5446,490,28734,0.576555,0.67,1,289316,288826,490
3816441,41.3227,47.5089,490,28808,0.587311,0.53,1,289357,288867,490
3819361,30.6645,39.9018,480,28881,0.589462,0.53,1,289385,288905,480
3822281,49.3329,32.7804,503,28954,0.589892,0.51,1,289439,288936,503
3825201,37.0666,52.9561,479,29027,0.573978,0.49,1,289473,288994,479
3828121,71.4133,39.3912,523,29100,0.618796,0.51,1,289553,289030,523
3831041,46.2827,69.4782,486,29173,0.691759,0.51,1,289593,289107,486
3833961,56.4565,46.6956,504,29246,0.738352,0.49,1,289652,289148,504
3836881,71.2913,57.3391,519,29318,0.74767,0.53,1,289727,289208,519
3839801,44.6583,69.0678,485,29390,0.765534,0.59,2,289765,289280,485
3842721,42.5317,42.6136,491,29462,0.817107,0.59,2,289807,289316,491
3845641,29.3063,41.3227,476,29534,0.827421,0.59,2,289833,289357,476
3848561,51.4613,30.6645,505,29606,0.845484,0.59,2,289890,289385,505
3851481,35.8923,49.3329,483,29677,0.849097,0.57,2,289922,289439,483
3854401,75.9785,37.0666,535,29748,0.865819,0.63,2,290008,289473,535
3857321,48.7957,71.4133,497,29819,0.885164,0.71,2,290050,289553,497
3860241,11.3591,46.2827,459,29890,0.889033,0.75,2,290052,289593,459
3863161,49.4718,56.4565,459,29961,0.921807,0.75,2,290111,289652,459
3979961,33,24,530,32667,0.83,1,2,292017,291487,530
3982881,56.2,34.4,555,32732,0.782,1,2,292079,291524,555
3985801,38.44,69.28,511,32797,0.7404,1,1,292113,291602,511
3988721,30.088,41.056,505,32861,0.70008,0.88,1,292141,291636,505
3991641,38.8176,61.0112,480,32925,0.740016,1,1,292182,291702,480
3994561,34.9635,37.0022,483,32989,0.652003,1,1,292216,291733,483
3997481,35.7927,36.2004,483,33053,0.634401,1,1,292252,291769,483
4000401,32.7585,37.6401,477,33117,0.67888,1,1,292284,291807,477
4003321,61.7517,57.128,484,33181,0.655776,0.93,1,292353,291869,484
4006241,61.1503,73.0256,468,33245,0.667155,0.87,1,292414,291946,468
4009161,39.4301,45.0051,464,33309,0.717431,0.83,1,292448,291984,464
4012081,31.886,35.401,461,33372,0.695486,0.77,1,292478,292017,461
4015001,57.5772,56.6802,463,33435,0.707097,0.73,1,292542,292079,463
4017921,34.7154,38.536,458,33498,0.693419,0.69,1,292571,292113,458
4020841,28.5431,30.1072,457,33561,0.722684,0.75,1,292598,292141,457
4023761,39.3086,38.8214,458,33624,0.760537,0.63,2,292640,292182,458
4026681,32.6617,34.9643,455,33687,0.784107,0.63,2,292671,292216,455
4029601,35.3323,35.7929,455,33750,0.836821,0.69,2,292707,292252,455
4032521,35.0665,32.7586,458,33813,0.831364,0.65,2,292742,292284,458
4035441,60.6133,61.7517,456,33876,0.862273,0.67,2,292809,292353,456
4038361,60.1227,61.1503,455,33938,0.900455,0.73,2,292869,292414,455
4041281,40.0245,39.4301,456,34000,0.924091,0.69,2,292904,292448,456
4044201,32.0049,31.886,456,34062,0.912818,0.71,2,292934,292478,456
4204801,53,36,535,37323,0.87,1,2,295186,294651,535
4207721,55.4,62.4,522,37380,0.87,0.98,2,295242,294720,522
4210641,47.88,48.48,523,37437,0.822,1,2,295288,294765,523
4213561,37.576,52.896,504,37493,0.7804,1,2,295323,294819,504
4216481,55.5152,40.9792,526,37549,0.78808,0.95,2,295383,294857,526
4219401,38.303,52.9958,504,37605,0.805616,1,2,295417,294913,504
4222321,33.2606,37.7992,502,37661,0.825123,1,2,295449,294947,502
4225241,25.0521,32.3598,494,37717,0.877025,1,2,295472,294978,494
4228161,36.2104,25.672,509,37773,0.855405,0.99,2,295511,295002,509
4231081,35.2421,40.3344,500,37829,0.867081,0.93,2,295546,295046,500
4234001,32.6484,36.0669,497,37885,0.869416,0.87,2,295578,295081,497
4236921,21.7297,32.0134,485,37941,0.869883,0.87,2,295597,295112,485
4388761,32,27,506,40735,0.45,1,1,297537,297031,506
4391681,34.4,33.4,506,40787,0.322,1,1,297572,297066,506
4394601,41.28,32.28,517,40839,0.0724,0.92,1,297615,297098,517
4397521,34.656,35.256,514,40891,0.02248,1,1,297648,297134,514
4400441,33.3312,36.6512,510,40943,0.012496,1,1,297681,297171,510
4403361,60.2662,37.7302,539,40995,0.0744992,1,1,297748,297209,539
4406281,37.6532,62.746,502,41046,0.0548998,1,1,297780,297278,502
4409201,45.1307,38.1492,517,41097,0.03498,1,1,297827,297310,517
4412121,28.2261,38.8298,502,41148,0.00699599,1,1,297851,297349,502
4415041,20.0452,29.366,493,41199,0.0013992,1,1,297869,297376,493
4417961,37.609,24.2732,512,41250,0.0722798,1,1,297911,297399,512
4420881,28.3218,36.8546,498,41301,0.086456,0.87,1,297937,297439,498
4423801,20.0644,36.9709,479,41352,0.0892912,0.63,1,297955,297476,479
4426721,23.2129,30.5942,474,41403,0.0898582,0.45,1,297979,297505,474
4429641,25.4426,31.7188,468,41454,0.0739717,0.29,1,298005,297537,468
4432561,29.8885,34.3438,464,41505,0.0387943,0.01,1,298036,297572,464
4435481,7.5777,41.2688,423,41556,0.0317589,0.01,1,298038,297615,423
4438401,27.1155,34.6538,422,41607,0.0303518,0.01,1,298070,297648,422
4441321,31.8231,33.3307,422,41658,0.0300704,0.09,1,298103,297681,422
4444241,63.9646,60.2662,427,41709,0.00601407,0.05,1,298175,297748,427
4447161,35.9929,37.6532,424,41760,0.0252028,0.03,1,298204,297780,424
4450081,44.7986,45.1306,424,41811,0.0930406,0,1,298251,297827,424
4453001,27.3597,28.2261,423,41861,0.0266081,0,1,298274,297851,423
4455921,19.0719,20.0452,422,41911,0.00532162,0.09,1,298291,297869,422
4458841,40.6144,37.609,426,41961,0.0730643,0.09,1,298337,297911,426
4461761,28.9229,28.3218,426,42011,0.0706129,0.09,1,298363,297937,426
4464681,20.9846,20.0644,427,42061,0.118123,0.09,1,298382,297955,427
4467601,20.1969,23.2129,423,42111,0.0636245,0.07,1,298402,297979,423
4470521,28.8394,25.4426,428,42161,0.148725,0.03,1,298433,298005,428
4473441,25.7679,29.8885,422,42211,0.117745,0.03,1,298458,298036,422
4476361,6.75358,7.5777,422,42261,0.111549,0.03,1,298460,298038,422
4479281,26.9507,27.1155,422,42311,0.0623098,0.03,1,298492,298070,422
4482201,31.7901,31.8231,422,42361,0.036462,0,1,298525,298103,422
4485121,64.758,63.9646,423,42411,0.0312924,0.03,1,298598,298175,423
4488041,36.1516,35.9929,423,42461,0.0302585,0.11,1,298627,298204,423
4490961,47.2303,44.7986,426,42511,0.0300517,0.01,1,298677,298251,426
4493881,24.6461,27.3597,422,42561,0.0140103,0,1,298696,298274,422
4496801,18.5292,19.0719,422,42611,0.00280207,0.09,1,298713,298291,422
4499721,42.1058,40.6144,424,42661,0.0565604,0.07,1,298761,298337,424
4502641,30.0212,28.9229,425,42710,0.0833121,0.13,1,298788,298363,425
4505561,22.0042,20.9846,426,42759,0.104662,0.05,1,298808,298382,426
4508481,18.8008,20.1969,424,42808,0.0769325,0.17,1,298826,298402,424
4511401,31.7602,28.8394,428,42857,0.135386,0.11,1,298861,298433,428
4514321,21.552,25.7679,422,42906,0.179077,0.11,1,298880,298458,422
4517241,5.91041,6.75358,422,42955,0.187815,0.05,1,298882,298460,422
4520161,26.7821,26.9507,422,43004,0.189563,0.05,1,298914,298492,422
4523081,30.9564,5.39014,454,43053,0.0939126,0.03,1,298946,298492,454
4526001,66.1913,27.478,496,43102,0.0427825,0.03,1,299021,298525,496
4528921,35.6383,63.8956,451,43151,0.0325565,0.03,1,299049,298598,451
4531841,47.1277,35.9791,472,43200,0.0465113,0.03,1,299099,298627,472
4534761,24.6255,47.1958,441,43249,0.0333023,0.01,1,299118,298677,441
4537681,17.7251,24.6392,438,43298,0.00666045,0,1,299134,298696,438
4540601,43.545,18.5278,471,43347,0.0573321,0.07,1,299184,298713,471
4543521,30.309,42.1056,450,43396,0.0514664,0.09,1,299211,298761,450
4546441,22.8618,30.0211,444,43445,0.0822933,0.11,1,299232,298788,444
4549361,20.5724,22.0042,444,43494,0.0884587,0.07,1,299252,298808,444
4552281,34.5145,18.8008,464,43543,0.0416917,0.15,1,299290,298826,464
4555201,21.3029,31.7602,447,43591,0.0643383,0.19,1,299308,298861,447
4558121,5.86058,21.552,430,43639,0.0688677,0.19,1,299310,298880,430
4561041,26.7721,5.91041,460,43687,0.0857735,0.19,1,299342,298882,460
4563961,25.3544,26.7821,453,43735,0.0731547,0.07,1,299367,298914,453
4566881,65.8709,30.9564,497,43783,0.0226309,0.03,1,299443,298946,497
4569801,36.3742,66.1913,451,43831,0.0125262,0.03,1,299472,299021,451
4572721,47.2748,35.6383,473,43879,0.0585052,0.05,1,299522,299049,473
4575641,23.855,47.1277,441,43927,0.083701,0.03,1,299540,299099,441
4578561,17.571,24.6255,438,43975,0.0567402,0,1,299556,299118,438
4581481,45.1142,17.7251,474,44023,0.051348,0.07,1,299608,299134,474
4584401,30.6228,43.545,451,44071,0.0982696,0.05,1,299635,299184,451
4587321,23.7246,30.309,446,44119,0.107654,0.09,1,299657,299211,446
4590241,19.1449,22.8618,443,44167,0.125531,0.09,1,299675,299232,443
4593161,35.029,20.5724,462,44215,0.113106,0.03,1,299714,299252,462
4596081,21.4058,34.5145,442,44263,0.110621,0.07,1,299732,299290,442
4599001,5.88116,21.3029,426,44311,0.110124,0.07,1,299734,299308,426
4601921,27.5762,5.86058,457,44359,0.0940249,0.09,1,299767,299310,457
4604841,26.3152,26.7721,451,44407,0.122805,0.07,1,299793,299342,451
4607761,62.063,25.3544,497,44455,0.112561,0.01,1,299864,299367,497
4610681,14.0126,65.8709,423,44502,0.110512,0.01,1,299866,299443,423
4613601,26.0025,36.3742,423,44549,0.0461024,0.07,1,299895,299472,423
4616521,46.8005,47.2748,425,44596,0.0492205,0.09,1,299947,299522,425
4619441,24.5601,23.855,426,44643,0.0658441,0.05,1,299966,299540,426
4622361,14.512,17.571,422,44690,0.0691688,0.05,1,299978,299556,422
4625281,46.1024,45.1142,424,44737,0.0858338,0.11,1,300032,299608,424
4628201,33.2205,30.6228,427,44784,0.0571668,0.11,1,300062,299635,427
4631121,24.2441,23.7246,427,44831,0.0674333,0.13,1,300084,299657,427
4634041,20.0488,19.1449,428,44878,0.0854867,0.11,1,300103,299675,428
4636961,34.4098,35.029,427,44925,0.105097,0.11,1,300141,299714,427
4639881,21.282,21.4058,427,44972,0.109019,0.11,1,300159,299732,427
4642801,5.85639,5.88116,427,45019,0.109804,0.09,1,300161,299734,427
4645721,27.5713,27.5762,427,45066,0.109961,0.13,1,300194,299767,427
4648641,28.7143,26.3152,430,45113,0.125992,0.11,1,300223,299793,430
4651561,58.5429,62.063,425,45160,0.193198,0.11,1,300289,299864,425
4654481,13.3086,14.0126,425,45207,0.17464,0.03,1,300291,299866,425
4657401,24.2617,26.0025,423,45254,0.170928,0.05,1,300318,299895,423
4660321,45.6523,46.8005,422,45301,0.0741856,0.07,1,300369,299947,422
4663241,25.1305,24.5601,423,45348,0.0708371,0.07,1,300389,299966,423
4666161,13.8261,14.512,422,45395,0.0861674,0.09,1,300400,299978,422
4669081,47.5652,46.1024,424,45441,0.0412335,0.05,1,300456,300032,424
4672001,33.513,33.2205,424,45487,0.0642467,0.07,1,300486,300062,424
4674921,25.1026,24.2441,425,45533,0.116849,0.09,1,300509,300084,425
4677841,19.4205,20.0488,424,45579,0.0953699,0.11,1,300527,300103,424
4680761,35.0841,34.4098,425,45625,0.123074,0.11,1,300566,300141,425
4683681,21.4168,21.282,425,45671,0.0966148,0.11,1,300584,300159,425
4686601,5.88336,5.85639,425,45717,0.139323,0.11,1,300586,300161,425
4689521,27.5767,27.5713,425,45763,0.163865,0.13,1,300619,300194,425
4692441,31.1153,28.7143,428,45809,0.168773,0.21,1,300651,300223,428
4695361,60.6231,58.5429,430,45855,0.217755,0.17,1,300719,300289,430
4698281,13.7246,13.3086,430,45901,0.227551,0.17,1,300721,300291,430
4701201,22.7449,24.2617,428,45947,0.26151,0.17,1,300746,300318,428
4704121,41.349,4.85234,474,45993,0.268302,0.05,1,300792,300318,474
4707041,25.0698,41.7705,444,46039,0.25366,0.07,1,300813,300369,444
4709961,13.014,24.3541,434,46085,0.266732,0.09,1,300823,300389,434
4712881,46.6028,13.6708,478,46131,0.221346,0.03,1,300878,300400,478
4715801,34.9206,47.5342,454,46177,0.228269,0.07,1,300910,300456,454
4718721,26.1841,33.5068,448,46223,0.245654,0.13,1,300934,300486,448
4721641,19.6368,25.1014,443,46269,0.249131,0.09,1,300952,300509,443
4724561,35.1274,19.4203,464,46315,0.265826,0.13,1,300991,300527,464
4727481,22.2255,35.0841,444,46361,0.269165,0.09,1,301010,300566,444
4730401,6.04509,21.4168,428,46406,0.301833,0.15,1,301012,300584,428
4733321,28.409,5.88336,460,46451,0.308367,0.17,1,301046,300586,460
4736241,34.4818,27.5767,463,46496,0.277673,0.17,1,301082,300619,463
4739161,62.0964,31.1153,500,46541,0.271535,0.23,1,301151,300651,500
4742081,14.0193,60.6231,434,46586,0.270307,0.23,1,301153,300719,434
4745001,24.4039,13.7246,459,46631,0.286061,0.27,1,301180,300721,459
4747921,41.6808,22.7449,480,46676,0.289212,0.27,1,301226,300746,480
4750841,25.1362,41.349,455,46721,0.321842,0.25,1,301247,300792,455
4753761,13.0272,25.0698,444,46766,0.328368,0.27,1,301257,300813,444
4756681,45.0054,13.014,487,46811,0.345674,0.21,1,301310,300823,487
4759601,34.6011,46.6028,464,46856,0.333135,0.23,1,301342,300878,464
4762521,26.9202,34.9206,457,46901,0.314627,0.25,1,301367,300910,457
4765441,19.784,26.1841,451,46946,0.342925,0.25,1,301385,300934,451
4768361,36.7568,19.6368,474,46991,0.348585,0.27,1,301426,300952,474
4771281,23.3514,35.1274,455,47036,0.381717,0.27,1,301446,300991,455
4774201,6.27027,22.2255,438,47081,0.388343,0.31,1,301448,301010,438
4777121,28.4541,6.04509,470,47126,0.421669,0.31,1,301482,301012,470
4780041,32.8908,28.409,470,47171,0.428334,0.27,1,301516,301046,470
4782961,62.5782,34.4818,504,47216,0.477667,0.27,1,301586,301082,504
4785881,14.1156,62.0964,437,47261,0.487533,0.27,1,301588,301151,437
4788801,24.4231,14.0193,462,47306,0.457507,0.29,1,301615,301153,462
4791721,41.6846,24.4039,481,47351,0.467501,0.29,1,301661,301180,481
4794641,9.93692,41.6808,437,47396,0.4695,0.33,1,301663,301226,437
4797561,19.5874,25.1362,438,47440,0.4859,0.33,1,301685,301247,438
4800481,11.9175,13.0272,438,47484,0.50518,0.35,1,301695,301257,438
4803401,43.9835,45.0054,437,47528,0.573036,0.33,1,301747,301310,437
4806321,35.1967,34.6011,438,47572,0.538607,0.31,1,301780,301342,438
4809241,27.8393,26.9202,439,47616,0.579721,0.35,1,301806,301367,439
4812161,19.9679,19.784,439,47660,0.619944,0.35,1,301824,301385,439
4815081,38.3936,36.7568,441,47704,0.659989,0.39,1,301867,301426,441
4818001,25.2787,23.3514,443,47748,0.651998,0.39,1,301889,301446,443
4820921,6.65574,6.27027,443,47792,0.6504,0.43,1,301891,301448,443
4823841,28.5311,28.4541,443,47836,0.61808,0.43,1,301925,301482,443
4826761,32.9062,32.8908,443,47880,0.643616,0.49,1,301959,301516,443
4829681,64.1812,62.5782,445,47924,0.632723,0.49,1,302031,301586,445
4832601,14.4362,14.1156,445,47968,0.630545,0.45,1,302033,301588,445
4835521,24.4872,24.4231,445,48012,0.646109,0.47,1,302060,301615,445
4838441,42.4975,41.6846,446,48056,0.665222,0.47,1,302107,301661,446
4841361,10.0995,9.93692,446,48100,0.669044,0.49,1,302109,301663,446
4844281,20.4199,19.5874,447,48144,0.685809,0.51,1,302132,301685,447
4847201,12.884,11.9175,448,48188,0.721162,0.59,1,302143,301695,448
4850121,44.9768,43.9835,449,48232,0.744232,0.53,1,302196,301747,449
4853041,35.3954,35.1967,449,48276,0.764847,0.59,2,302229,301780,449
4855961,29.4791,27.8393,451,48320,0.768969,0.63,2,302257,301806,451
4858881,20.2958,19.9679,451,48364,0.801794,0.67,2,302275,301824,451
4861801,40.8592,38.3936,454,48408,0.856359,0.65,2,302321,301867,454
4864721,24.1718,25.2787,452,48452,0.883272,0.65,2,302341,301889,452
4867641,6.43437,6.65574,452,48495,0.888654,0.61,2,302343,301891,452
4870561,28.4869,28.5311,452,48538,0.905731,0.65,2,302377,301925,452
4873481,32.8974,32.9062,452,48581,0.877146,0.63,2,302411,301959,452
4876401,64.9795,64.1812,453,48624,0.887429,0.63,2,302484,302031,453
4879321,14.5959,14.4362,453,48667,0.921486,0.65,2,302486,302033,453
4882241,25.3192,24.4872,454,48710,0.912297,0.67,2,302514,302060,454
4885161,43.4638,42.4975,455,48753,0.910459,0.67,2,302562,302107,455
4888081,10.2928,10.0995,455,48796,0.910092,0.69,2,302564,302109,455
5321701,300,341,428,23360,0.01,0.07,1,307227,306799,428
5347981,207.2,217.8,425,24820,0.026,0.05,1,307411,306986,425
5350901,61.44,58.76,431,25633,0.0612,0.03,1,307436,307005,431
5353821,66.688,42.952,460,25716,0.06824,0.03,1,307504,307044,460
5356741,66.9376,60.5904,462,25798,0.021648,0.03,1,307571,307109,462
5359661,54.9875,64.9181,448,25880,0.0043296,0.01,1,307623,307175,448
5362581,32.5975,54.5836,423,25962,0.0568659,0.09,1,307650,307227,423
5365501,34.5195,30.1167,434,26044,0.0833732,0.11,1,307685,307251,434
5368421,37.3039,28.4233,444,26125,0.120675,0.05,1,307723,307279,444
5371341,46.6608,38.4847,452,26206,0.0801349,0.03,1,307772,307320,452
5374261,78.1322,80.4969,447,26287,0.072027,0.07,1,307858,307411,447
5377181,71.6264,36.0994,492,26368,0.0544054,0.07,1,307928,307436,492
5380101,66.3253,61.6199,489,26448,0.0508811,0.01,1,307993,307504,489
5383021,54.0651,65.924,473,26528,0.0501762,0,1,308044,307571,473
5385941,33.213,54.7848,449,26608,0.0340352,0.07,1,308072,307623,449
5388861,33.8426,32.557,456,26688,0.0948071,0.09,1,308106,307650,456
5391781,41.9685,34.5114,465,26767,0.0909614,0.13,1,308150,307685,465
5394701,43.5937,37.3023,471,26846,0.0901923,0.07,1,308194,307723,471
5397621,10.3187,46.6605,424,26925,0.0900385,0.07,1,308196,307772,424
5400541,71.6637,78.1321,425,27004,0.122008,0.05,1,308283,307858,425
5403461,69.5327,71.6264,424,27082,0.128402,0.05,1,308352,307928,424
5406381,65.1065,66.3253,423,27160,0.0656803,0.05,1,308416,307993,423
5409301,53.8213,54.0651,423,27238,0.0531361,0.03,1,308467,308044,423
5412221,33.9643,33.213,424,27316,0.114627,0.11,1,308496,308072,424
5415141,36.3929,33.8426,427,27394,0.142925,0.09,1,308533,308106,427
5418061,41.6786,41.9685,426,27471,0.148585,0.09,1,308576,308150,426
5420981,43.5357,43.5937,426,27548,0.197717,0.09,1,308620,308194,426
5423901,10.3071,10.3187,426,27625,0.207543,0.13,1,308622,308196,426
5426821,71.6614,71.6637,426,27702,0.225509,0.13,1,308709,308283,426
5429741,71.1323,69.5327,428,27778,0.245102,0.05,1,308780,308352,428
5432661,60.6265,65.1065,422,27854,0.26502,0.05,1,308838,308416,422
5435581,55.3253,53.8213,425,27930,0.269004,0.13,1,308892,308467,425
5438501,36.6651,33.9643,428,28006,0.253801,0.15,1,308924,308496,428
5441421,37.733,36.3929,429,28082,0.25076,0.15,1,308962,308533,429
5444341,41.9466,41.6786,429,28157,0.282152,0.21,1,309005,308576,429
5447261,44.3893,43.5357,430,28232,0.33643,0.21,1,309050,308620,430
5450181,10.4779,10.3071,430,28307,0.363286,0.23,1,309052,308622,430
5453101,74.0956,71.6614,433,28382,0.336657,0.23,1,309142,308709,433
5456021,71.6191,14.3323,504,28457,0.331331,0.25,1,309213,308709,504
5458941,61.5238,59.6665,492,28531,0.346266,0.27,1,309272,308780,492
5461861,53.9048,58.3333,486,28605,0.365253,0.27,1,309324,308838,486
5464781,37.181,54.8667,465,28679,0.401051,0.25,1,309357,308892,465
5467701,38.6362,36.5733,472,28753,0.45621,0.25,1,309396,308924,472
5470621,42.9272,37.7147,478,28827,0.403242,0.29,1,309440,308962,478
5473541,46.1854,41.9429,482,28900,0.408648,0.35,1,309487,309005,482
5476461,10.8371,44.3886,439,28973,0.44173,0.37,1,309489,309050,439
5479381,74.1674,10.4777,527,29046,0.496346,0.33,1,309579,309052,527
5482301,71.6335,74.0955,508,29119,0.523269,0.33,1,309650,309142,508
5485221,63.1267,71.6191,498,29192,0.608654,0.35,1,309711,309213,498
5488141,54.2253,61.5238,491,29265,0.641731,0.37,1,309763,309272,491
5491061,38.8451,53.9048,474,29337,0.648346,0.41,1,309798,309324,474
5493981,39.769,37.181,481,29409,0.681669,0.47,1,309838,309357,481
5496901,42.3538,38.6362,485,29481,0.720334,0.39,1,309881,309396,485
5499821,47.6708,42.9272,490,29553,0.760067,0.41,2,309930,309440,490
5502741,11.1342,46.1854,445,29625,0.768013,0.45,2,309932,309487,445
5505661,76.6268,10.8371,536,29696,0.753603,0.51,2,310025,309489,536
5508581,74.5254,74.1674,520,29767,0.766721,0.53,2,310099,309579,520
5511501,66.1051,71.6335,513,29838,0.801344,0.63,2,310163,309650,513
5514421,14.821,63.1267,454,29909,0.808269,0.65,2,310165,309711,454
5517341,44.5642,54.2253,454,29980,0.825654,0.65,2,310217,309763,454
5520261,36.9128,38.8451,454,30051,0.845131,0.69,2,310252,309798,454
5523181,40.9826,39.769,456,30121,0.817026,0.73,2,310294,309838,456
5526101,44.1965,42.3538,458,30191,0.907405,0.77,2,310339,309881,458
5529021,51.2393,47.6708,462,30261,0.909481,0.77,2,310392,309930,462
5531941,11.8479,11.1342,462,30331,0.909896,0.75,2,310394,309932,462
5666261,32,31,516,33389,0.63,1,1,312613,312097,516
5669181,25.6,34.2,505,33452,0.582,1,1,312637,312132,505
5672101,23.52,27.64,502,33515,0.5564,1,1,312660,312158,502
5675021,36.704,37.528,502,33578,0.50328,1,1,312700,312198,502
5677941,29.7408,37.1056,493,33641,0.524656,1,1,312728,312235,493
5680861,61.1482,61.8211,494,33704,0.336931,1,1,312797,312303,494
5683781,41.0296,41.9642,493,33767,0.315386,1,1,312833,312340,493
5686701,31.4059,36.3928,487,33830,0.231077,1,1,312862,312375,487
5689621,63.8812,69.6786,481,33893,0.166215,0.83,1,312934,312453,481
5692541,67.9762,86.7357,459,33955,0.137243,0.71,1,313003,312544,459
5695461,38.3952,46.9471,453,34017,0.195449,0.63,1,313034,312581,453
5698381,31.679,34.9894,451,34079,0.17509,0.57,1,313064,312613,451
5701301,23.1358,26.1979,448,34141,0.187018,0.55,1,313085,312637,448
5704221,19.0272,23.6396,443,34203,0.189404,0.49,1,313103,312660,443
5707141,34.2054,36.7279,441,34265,0.205881,0.49,1,313141,312700,441
5710061,28.4411,7.34558,468,34327,0.225176,0.53,1,313168,312700,468
5712981,57.6882,23.8691,505,34389,0.229035,0.29,1,313233,312728,505
5715901,40.3376,59.9738,472,34450,0.229807,0.31,1,313269,312797,472
5718821,30.4675,40.7948,464,34511,0.229961,0.21,1,313297,312833,464
5721741,58.0935,31.359,500,34572,0.261992,0.15,1,313362,312862,500
5724661,66.8187,63.8718,497,34633,0.300398,0.13,1,313431,312934,497
5727581,38.9637,67.9744,460,34694,0.30808,0.21,1,313463,313003,460
5730501,30.1927,38.3949,457,34755,0.309616,0.17,1,313491,313034,457
5733421,23.6385,31.679,449,34816,0.325923,0.19,1,313513,313064,449
5736341,19.9277,23.1358,447,34877,0.313185,0.19,1,313532,313085,447
5739261,35.9855,19.0272,469,34938,0.374637,0.21,1,313572,313103,469
5742181,29.5971,34.2054,459,34999,0.386927,0.23,1,313600,313141,459
5745101,59.5194,28.4411,499,35059,0.469386,0.23,1,313667,313168,499
5748021,39.1039,57.6882,468,35119,0.485877,0.23,1,313701,313233,468
5750941,32.6208,40.3376,463,35179,0.489175,0.23,1,313732,313269,463
5753861,57.7242,30.4675,499,35239,0.521835,0.27,1,313796,313297,499
5756781,68.3448,58.0935,505,35299,0.560367,0.31,1,313867,313362,505
5759701,39.269,66.8187,468,35359,0.584073,0.31,1,313899,313431,468
5762621,30.2538,38.9637,464,35419,0.588815,0.31,1,313927,313463,464
5765541,24.4508,30.1927,459,35479,0.573763,0.33,1,313950,313491,459
5768461,20.8902,23.6385,457,35539,0.602753,0.31,1,313970,313513,457
5771381,37.778,19.9277,480,35598,0.576551,0.39,1,314012,313532,480
5774301,29.9556,35.9855,468,35657,0.58731,0.39,1,314040,313572,468
5777221,7.59112,29.5971,442,35716,0.589462,0.49,1,314042,313600,442
5780141,58.3182,59.5194,446,35775,0.605892,0.49,1,314113,313667,446
5783061,39.6636,39.1039,447,35834,0.609178,0.49,1,314148,313701,447
5785981,31.9327,32.6208,446,35893,0.641836,0.53,1,314178,313732,446
5788901,59.1865,57.7242,448,35952,0.664367,0.57,1,314244,313796,448
5791821,70.2373,68.3448,450,36011,0.684873,0.59,1,314317,313867,450
5794741,40.4475,39.269,451,36070,0.736975,0.59,1,314350,313899,451
5797661,30.4895,30.2538,451,36129,0.731395,0.57,1,314378,313927,451
5800581,25.2979,24.4508,452,36187,0.730279,0.61,1,314402,313950,452
5803501,21.0596,20.8902,452,36245,0.762056,0.57,2,314422,313970,452
5806421,37.0119,37.778,451,36303,0.752411,0.59,2,314463,314012,451
5809341,29.8024,29.9556,451,36361,0.750482,0.59,2,314491,314040,451
5812261,7.56048,7.59112,451,36419,0.750096,0.61,2,314493,314042,451
5815181,57.5121,58.3182,450,36477,0.814019,0.61,2,314563,314113,450
5818101,41.1024,39.6636,452,36535,0.810804,0.65,2,314600,314148,452
5821021,32.2205,31.9327,452,36593,0.858161,0.67,2,314630,314178,452
5823941,60.0441,59.1865,453,36651,0.883632,0.69,2,314697,314244,453
5826861,72.8088,70.2373,456,36709,0.856726,0.75,2,314773,314317,456
5829781,41.7618,40.4475,457,36767,0.899345,0.73,2,314807,314350,457
5832701,31.5524,30.4895,458,36824,0.923869,0.73,2,314836,314378,458
5835621,25.5105,25.2979,458,36881,0.928774,0.77,2,314860,314402,458
5838541,21.1021,21.0596,458,36938,0.945755,0.75,2,314880,314422,458
5997681,140,78,553,17761,0.19,0.65,1,317137,316584,553
6000601,97.6,126,502,17881,0.222,0.41,1,317224,316722,502
6003521,68.32,98,472,18000,0.2124,0.25,1,317285,316813,472
6006441,40.864,62.8,452,18118,0.17848,0.21,1,317319,316867,452
6009361,28.9728,38.16,446,18235,0.235696,0.11,1,317345,316899,446
6012281,68.9946,86.032,427,18351,0.247139,0.19,1,317424,316997,427
6015201,128.999,129.206,431,18467,0.345428,0.23,1,317568,317137,431
6018121,96.9998,95.4413,433,18582,0.397086,0.21,1,317657,317224,433
6021041,67.4,67.8883,432,18696,0.455417,0.17,1,317717,317285,432
6023961,41.48,40.7777,433,18810,0.451083,0.25,1,317752,317319,433
6026881,29.896,28.9555,434,18923,0.418217,0.25,1,317779,317345,434
6029801,69.1792,68.9911,434,19035,0.459643,0.37,1,317858,317424,434
6032721,133.836,128.998,440,19146,0.531929,0.41,1,318008,317568,440
6035641,99.5672,96.9996,442,19257,0.562386,0.47,1,318099,317657,442
6038561,68.7134,67.3999,443,19367,0.584477,0.45,1,318160,317717,443
6041481,40.9427,41.48,442,19477,0.588895,0.41,1,318194,317752,442
6044401,29.7885,29.896,442,19586,0.605779,0.41,1,318221,317779,442
6047321,70.7577,5.9792,523,19694,0.593156,0.47,1,318302,317779,523
6050241,135.752,64.3958,596,19802,0.638631,0.55,1,318454,317858,596
6053161,100.75,132.879,538,19909,0.679726,0.57,1,318546,318008,538
6056081,69.7501,99.3758,509,20016,0.735945,0.59,1,318608,318099,509
6059001,41.15,68.6752,482,20122,0.763189,0.59,2,318642,318160,482
6061921,30.63,40.935,476,20227,0.768638,0.61,2,318670,318194,476
6064841,71.726,29.787,531,20332,0.833728,0.59,2,318752,318221,531
6067761,139.145,70.7574,606,20436,0.926746,0.65,2,318908,318302,606
6152441,37,28,516,23258,0.35,1,1,320877,320361,516
6155361,78.6,50.4,549,23349,0.27,1,1,320966,320417,549
6158281,36.52,74.88,494,23440,0.19,1,1,320992,320498,494
6161201,46.504,38.176,514,23530,0.206,1,1,321041,320527,514
6164121,55.7008,34.0352,539,23620,0.2092,1,1,321099,320560,539
6167041,137.54,61.207,629,23710,0.19384,0.63,1,321257,320628,629
6169961,50.708,155.441,479,23799,0.206768,0.51,1,321286,320807,479
6172881,37.3416,57.4883,480,23888,0.177354,0.35,1,321320,320840,480
6175801,69.0683,41.0977,520,23977,0.251471,0.25,1,321397,320877,520
6178721,15.4137,79.4195,433,24065,0.250294,0.17,1,321399,320966,433
6181641,22.2827,36.6839,431,24153,0.266059,0.21,1,321423,320992,431
6184561,46.0565,46.5368,434,24241,0.317212,0.21,1,321475,321041,434
6187481,54.8113,55.7074,433,24328,0.343442,0.19,1,321532,321099,433
6190401,136.562,137.541,432,24415,0.380688,0.21,1,321689,321257,432
6193321,48.9125,50.7083,430,24502,0.420138,0.17,1,321716,321286,430
6196241,38.5825,37.3417,432,24588,0.444028,0.27,1,321752,321320,432
6199161,70.9165,69.0683,434,24674,0.464806,0.25,1,321831,321397,434
6202081,15.7833,15.4137,434,24760,0.468961,0.27,1,321833,321399,434
6205001,23.1567,22.2827,435,24846,0.469792,0.33,1,321858,321423,435
6207921,48.6313,46.0565,438,24931,0.469958,0.35,1,321913,321475,438
6210841,56.1263,54.8113,439,25016,0.549992,0.39,1,321971,321532,439
6213761,139.225,136.562,442,25101,0.565998,0.43,1,322131,321689,442
6216681,49.445,48.9125,442,25185,0.5852,0.45,1,322158,321716,442
6219601,38.689,38.5825,442,25269,0.55704,0.47,1,322194,321752,442
6222521,71.7378,70.9165,443,25353,0.599408,0.47,1,322274,321831,443
6225441,15.9476,15.7833,443,25437,0.607882,0.47,1,322276,321833,443
6228361,22.3895,3.15666,467,25520,0.625576,0.47,1,322300,321833,467
6231281,52.4779,20.6313,502,25603,0.709115,0.47,1,322360,321858,502
6234201,56.8956,48.1263,505,25686,0.709823,0.57,1,322418,321913,505
6237121,140.979,56.0253,609,25768,0.741965,0.57,1,322580,321971,609
6240041,48.9958,139.205,475,25850,0.748393,0.59,1,322606,322131,475
6242961,38.5992,49.441,484,25932,0.781679,0.55,2,322642,322158,484
6245881,74.1198,38.6882,531,26014,0.820336,0.61,2,322725,322194,531
6248801,16.424,71.7376,453,26095,0.844067,0.61,2,322727,322274,453
6251721,23.2848,15.9475,476,26176,0.832813,0.63,2,322752,322276,476
6254641,55.057,22.3895,515,26257,0.910563,0.73,2,322815,322300,515
6257561,58.2114,52.4779,514,26338,0.942113,0.71,2,322874,322360,514
6374361,60,33,541,29382,0.67,1,1,325080,324539,541
6377281,40.8,60.2,510,29454,0.59,1,1,325116,324606,510
6380201,33.76,37.64,510,29526,0.478,1,1,325148,324638,510
6383121,35.552,29.928,518,29598,0.3756,1,1,325184,324666,518
6386041,34.3104,38.7856,511,29670,0.24312,1,1,325218,324707,511
6388961,37.2621,32.5571,518,29741,0.168624,1,1,325256,324738,518
6391881,136.252,31.3114,648,29812,0.0897248,1,1,325417,324769,648
6394801,28.8505,148.662,472,29883,0.105945,0.97,1,325419,324947,472
6397721,29.7701,57.7325,467,29954,0.093189,0.81,1,325449,324982,467
6400641,32.354,41.9465,462,30025,0.0906378,0.67,1,325482,325020,462
6403561,48.0708,56.3893,454,30095,0.122128,0.57,1,325534,325080,454
6406481,31.2142,40.0779,445,30165,0.128426,0.45,1,325561,325116,445
6409401,27.8428,33.6156,440,30235,0.113685,0.35,1,325588,325148,440
6412321,30.3686,35.5231,435,30305,0.126737,0.21,1,325619,325184,435
6415241,30.0737,34.3046,431,30375,0.161347,0.15,1,325649,325218,431
6418161,34.8147,37.2609,429,30445,0.136269,0.07,1,325685,325256,429
6421081,132.563,136.252,425,30515,0.163254,0.11,1,325842,325417,425
6424001,28.1126,28.8504,425,30584,0.168651,0.09,1,325844,325419,425
6426921,28.8225,29.7701,424,30653,0.18573,0.09,1,325873,325449,424
6429841,33.7645,32.354,426,30722,0.237146,0.13,1,325908,325482,426
6432761,48.3529,48.0708,426,30791,0.279429,0.13,1,325960,325534,426
6435681,32.8706,31.2142,428,30860,0.271886,0.11,1,325989,325561,428
6438601,27.3741,27.8428,427,30929,0.238377,0.13,1,326015,325588,427
6441521,31.0748,30.3686,428,30997,0.263675,0.17,1,326047,325619,428
6444441,30.215,30.0737,428,31065,0.300735,0.13,1,326077,325649,428
6447361,34.843,34.8147,428,31133,0.276147,0.17,1,326113,325685,428
6450281,133.369,132.563,429,31201,0.383229,0.17,1,326271,325842,429
6453201,28.2737,28.1126,429,31269,0.404646,0.19,1,326273,325844,429
6456121,28.8547,28.8225,429,31337,0.440929,0.19,1,326302,325873,429
6459041,35.3709,5.7645,466,31405,0.432186,0.25,1,326339,325873,466
6461961,50.2742,29.1529,485,31472,0.462437,0.29,1,326393,325908,485
6464881,32.4548,47.4306,461,31539,0.484487,0.27,1,326421,325960,461
6467801,27.291,32.6861,458,31606,0.488897,0.23,1,326447,325989,458
6470721,31.0582,27.3372,464,31673,0.48978,0.27,1,326479,326015,464
6473641,31.8116,31.0674,464,31740,0.489956,0.31,1,326511,326047,464
6476561,35.1623,30.2135,470,31807,0.505991,0.27,1,326547,326077,470
6479481,139.832,34.8427,600,31874,0.589198,0.41,1,326713,326113,600
6482401,29.5665,133.369,444,31940,0.60584,0.41,1,326715,326271,444
6485321,28.3133,28.2737,470,32006,0.625168,0.45,1,326743,326273,470
6488241,36.0627,28.8547,479,32072,0.629034,0.43,1,326781,326302,479
6491161,52.0125,35.3709,498,32138,0.693807,0.47,1,326837,326339,498
6494081,33.6025,50.2742,473,32204,0.722761,0.49,1,326866,326393,473
6497001,27.5205,32.4548,471,32270,0.728552,0.49,1,326892,326421,471
6499921,31.1041,27.291,477,32336,0.76171,0.49,2,326924,326447,477
6502841,31.8208,31.0582,477,32401,0.768342,0.49,2,326956,326479,477
6505761,35.9642,31.8116,482,32466,0.753668,0.51,2,326993,326511,482
6508681,143.993,35.1623,617,32531,0.734734,0.61,1,327164,326547,617
6511601,30.3986,139.832,453,32596,0.730947,0.61,1,327166,326713,453
6514521,29.2797,29.5665,480,32661,0.730189,0.63,1,327195,326715,480
6517441,37.0559,28.3133,491,32726,0.746038,0.63,1,327234,326743,491
6520361,9.01119,36.0627,455,32791,0.717208,0.71,1,327236,326781,455
6523281,48.2022,52.0125,457,32856,0.791442,0.73,2,327294,326837,457
6526201,33.6404,33.6025,458,32920,0.854288,0.73,2,327324,326866,458
6529121,27.5281,27.5205,458,32984,0.866858,0.77,2,327350,326892,458
6532041,32.7056,31.1041,460,33048,0.901372,0.77,2,327384,326924,460
6534961,32.1411,31.8208,460,33112,0.876274,0.75,2,327416,326956,460
6537881,35.2282,35.9642,459,33176,0.871255,0.73,2,327452,326993,459
6540801,143.846,143.993,459,33240,0.902251,0.73,2,327623,327164,459
6543721,30.3691,30.3986,459,33304,0.90845,0.73,2,327625,327166,459
6546641,28.4738,29.2797,458,33368,0.92569,0.75,2,327653,327195,458
6549561,36.0948,37.0559,457,33431,0.945138,0.71,2,327691,327234,457
6552481,8.81895,9.01119,457,33494,0.917028,0.81,2,327693,327236,457
6691181,73,77,507,16323,0.05,0.61,1,329842,329335,507
6694101,158.6,181,480,16453,0.082,0.41,1,330022,329542,480
6697021,61.32,89.8,450,16582,0.0884,0.29,1,330059,329609,450
6699941,41.064,43.56,454,16710,0.10568,0.27,1,330095,329641,454
6702861,87.4128,36.712,518,16837,0.157136,0.09,1,330194,329676,518
6705781,74.2826,81.7424,496,16963,0.0874272,0.05,1,330265,329769,496
6708701,159.657,74.7485,604,17088,0.153485,0.09,1,330446,329842,604
6711621,63.1313,158.95,463,17212,0.134697,0.09,1,330485,330022,463
6714541,42.2263,61.3899,463,17335,0.178939,0.11,1,330522,330059,463
6717461,89.2453,41.078,528,17457,0.203788,0.17,1,330623,330095,528
6720381,71.4491,87.4156,496,17579,0.208758,0.07,1,330690,330194,496
6723301,163.09,74.2831,611,17700,0.305752,0.17,1,330876,330265,611
6726221,63.018,159.657,468,17820,0.32515,0.13,1,330914,330446,468
6729141,43.0036,63.1313,467,17939,0.36103,0.19,1,330952,330485,467
6732061,90.2007,42.2263,532,18057,0.352206,0.21,1,331054,330522,532
6734981,19.6401,89.2453,433,18175,0.350441,0.21,1,331056,330623,433
6737901,56.728,71.4491,432,18292,0.414088,0.33,1,331122,330690,432
6740821,164.946,163.09,438,18408,0.442818,0.33,1,331314,330876,438
6743741,63.3891,63.018,438,18523,0.464564,0.37,1,331352,330914,438
6746661,44.6778,43.0036,440,18638,0.500913,0.35,1,331392,330952,440
6749581,89.7356,90.2007,439,18752,0.492183,0.35,1,331493,331054,439
6752501,19.5471,19.6401,439,18865,0.490437,0.43,1,331495,331056,439
6755421,58.3094,56.728,441,18977,0.522087,0.45,1,331563,331122,441
6758341,167.662,164.946,444,19089,0.608417,0.47,1,331758,331314,444
6761261,64.7324,63.3891,445,19200,0.657683,0.51,1,331797,331352,445
6764181,44.9465,44.6778,445,19311,0.651537,0.49,1,331837,331392,445
6767101,88.9893,89.7356,444,19421,0.730307,0.49,1,331937,331493,444
6770021,19.3979,19.5471,444,19530,0.746062,0.53,1,331939,331495,444
6772941,61.4796,58.3094,448,19639,0.749212,0.53,1,332011,331563,448
6775861,169.896,11.6619,645,19747,0.845842,0.63,2,332208,331563,645
6778781,66.7792,158.332,491,19854,0.881169,0.67,2,332249,331758,491
6781701,46.9558,62.8665,494,19961,0.920234,0.65,2,332291,331797,494
6913101,68,82,472,24373,0.63,1,1,335316,334844,472
6916021,60,45.2,494,24460,0.566,1,1,335374,334880,494
6918941,157.6,169.84,475,24547,0.3772,0.89,1,335556,335081,475
6921861,63.52,65.968,475,24633,0.37144,0.99,1,335596,335121,475
6924781,28.704,33.9936,469,24719,0.338288,0.89,1,335616,335147,469
6927701,24.1408,29.9987,463,24805,0.363658,0.85,1,335639,335176,463
6930621,33.6282,37.1997,460,24890,0.416732,0.79,1,335675,335215,460
6933541,31.5256,33.8399,458,24975,0.379346,0.63,1,335706,335248,458
6936461,53.5051,61.168,449,25060,0.387869,0.55,1,335765,335316,449
6939381,56.301,58.6336,448,25145,0.421574,0.33,1,335822,335374,448
6942301,147.26,157.327,436,25229,0.476315,0.37,1,335992,335556,436
6945221,61.452,63.4653,436,25313,0.519263,0.33,1,336032,335596,436
6948141,29.8904,28.6931,438,25397,0.527853,0.37,1,336054,335616,438
6951061,25.9781,24.1386,440,25480,0.481571,0.37,1,336079,335639,440
6953981,33.9956,4.82772,476,25563,0.488314,0.43,1,336115,335639,476
6956901,29.1991,29.7655,468,25646,0.505663,0.37,1,336143,335675,468
6959821,55.4398,30.7531,499,25729,0.557133,0.39,1,336205,335706,499
6962741,57.488,53.3506,498,25811,0.615427,0.43,1,336263,335765,498
6965661,149.898,56.2701,614,25893,0.691085,0.49,1,336436,335822,614
6968581,62.7795,147.254,485,25975,0.722217,0.53,1,336477,335992,485
6971501,30.1559,61.4508,467,26057,0.728443,0.53,1,336499,336032,467
6974421,26.0312,29.8902,470,26138,0.729689,0.47,1,336524,336054,470
6977341,34.0062,25.978,481,26219,0.729938,0.49,1,336560,336079,481
6980261,30.0012,33.9956,474,26300,0.729988,0.51,1,336589,336115,474
6983181,58.0002,29.1991,511,26381,0.777997,0.57,2,336654,336143,511
6986101,61.2001,55.4398,511,26461,0.8036,0.63,2,336716,336205,511
6989021,151.44,57.488,627,26541,0.85672,0.71,2,336890,336263,627
6991941,65.488,149.898,498,26621,0.883344,0.73,2,336934,336436,498
6994861,31.4976,62.7795,480,26701,0.888669,0.73,2,336957,336477,480
6997781,25.4995,30.1559,482,26780,0.921734,0.73,2,336981,336499,482
7123341,148,154,484,29991,0.59,1,1,339245,338761,484
7126261,87.2,82.8,491,30062,0.43,1,1,339317,338826,491
7129181,43.84,44.56,489,30132,0.43,1,1,339350,338861,489
7132101,31.968,37.712,482,30202,0.35,0.98,1,339379,338897,482
7135021,27.1936,31.5424,478,30272,0.302,0.96,1,339405,338927,478
7137941,21.4387,27.1085,472,30342,0.2924,0.98,1,339425,338953,472
7140861,26.6877,28.6217,471,30412,0.24248,1,1,339453,338982,471
7143781,30.1375,33.7243,467,30482,0.184496,0.88,1,339484,339017,467
7146701,30.8275,30.7449,468,30551,0.172899,0.85,1,339515,339047,468
7149621,41.3655,46.149,462,30620,0.0745798,0.59,1,339559,339097,462
7152541,115.473,127.63,448,30689,0.086916,0.39,1,339693,339245,448
7155461,75.0946,83.126,441,30758,0.0573832,0.43,1,339758,339317,441
7158381,38.2189,43.0252,437,30827,0.115477,0.33,1,339787,339350,437
7161301,32.4438,31.805,439,30896,0.159095,0.29,1,339818,339379,439
7164221,23.2888,27.161,434,30964,0.119819,0.29,1,339839,339405,434
7167141,21.4578,21.4322,435,31032,0.0959638,0.23,1,339860,339425,435
7170061,23.4916,26.6864,431,31100,0.123193,0.17,1,339884,339453,431
7172981,29.4983,30.1373,431,31168,0.144639,0.17,1,339915,339484,431
7175901,28.2997,30.8275,428,31236,0.148928,0.05,1,339943,339515,428
7178821,36.8599,41.3655,423,31304,0.133786,0.05,1,339982,339559,423
7181741,114.572,8.2731,557,31372,0.178757,0.09,1,340116,339559,557
7184661,74.9144,108.855,488,31439,0.219751,0.05,1,340181,339693,488
7187581,41.3829,73.7709,456,31506,0.24395,0.13,1,340214,339758,456
7190501,31.4766,37.9542,456,31573,0.24879,0.17,1,340243,339787,456
7193421,22.2953,32.3908,445,31640,0.281758,0.11,1,340263,339818,445
7196341,22.0591,23.2782,446,31707,0.288352,0.09,1,340285,339839,446
7199261,24.4118,21.4556,450,31774,0.28967,0.13,1,340310,339860,450
7202181,29.6824,23.4911,457,31841,0.305934,0.15,1,340341,339884,457
7205101,28.3365,29.4982,454,31907,0.309187,0.15,1,340369,339915,454
7208021,37.6673,28.2996,466,31973,0.309837,0.13,1,340409,339943,466
7210941,117.133,36.8599,564,32039,0.389967,0.19,1,340546,339982,564
7213861,77.0267,114.572,497,32105,0.405993,0.23,1,340613,340116,497
7216781,43.4053,74.9144,467,32171,0.409199,0.25,1,340648,340181,467
7219701,32.6811,41.3829,464,32237,0.40984,0.25,1,340678,340214,464
7222621,22.5362,31.4766,455,32303,0.441968,0.29,1,340698,340243,455
7225541,22.9072,22.2953,458,32368,0.432394,0.29,1,340721,340263,458
7228461,23.7814,22.0591,460,32433,0.462479,0.29,1,340745,340285,460
7231381,30.3563,24.4118,467,32498,0.484496,0.31,1,340777,340310,467
7234301,28.4713,29.6824,464,32563,0.488899,0.31,1,340805,340341,464
7237221,37.6943,28.3365,476,32628,0.48978,0.31,1,340845,340369,476
7240141,121.939,37.6673,579,32693,0.569956,0.41,1,340988,340409,579
7243061,77.1878,117.133,508,32758,0.633991,0.41,1,341054,340546,508
7245981,17.0376,77.0267,443,32823,0.646798,0.41,1,341056,340613,443
7248901,30.6075,43.4053,442,32887,0.68136,0.41,1,341090,340648,442
7251821,30.9215,32.6811,443,32951,0.688272,0.45,1,341121,340678,443
7254741,22.9843,22.5362,444,33015,0.673654,0.43,1,341142,340698,444
7257661,23.7969,22.9072,445,33079,0.686731,0.47,1,341166,340721,445
7260581,23.9594,23.7814,445,33143,0.689346,0.49,1,341190,340745,445
7263501,31.1919,30.3563,446,33207,0.673869,0.49,1,341223,340777,446
7266421,28.6384,28.4713,446,33271,0.686774,0.49,1,341251,340805,446
7269341,37.7277,37.6943,446,33335,0.673355,0.59,1,341291,340845,446
7272261,126.746,121.939,452,33398,0.702671,0.65,1,341440,340988,452
7275181,79.7491,77.1878,454,33461,0.756534,0.65,2,341508,341054,454
7278101,17.5498,17.0376,454,33524,0.767307,0.69,2,341510,341056,454
7281021,31.51,30.6075,455,33587,0.769461,0.69,2,341545,341090,455
7283941,30.302,30.9215,454,33650,0.801892,0.67,2,341575,341121,454
7286861,22.0604,22.9843,453,33713,0.808378,0.69,2,341595,341142,453
7289781,24.4121,23.7969,454,33776,0.809676,0.69,2,341620,341166,454
7292701,24.0824,23.9594,454,33839,0.873935,0.67,2,341644,341190,454
7295621,31.2165,31.1919,454,33901,0.870787,0.69,2,341677,341223,454
7298541,29.4433,28.6384,455,33963,0.854157,0.67,2,341706,341251,455
7301461,37.8887,37.7277,455,34025,0.898831,0.71,2,341746,341291,455
7304381,129.178,126.746,458,34087,0.907766,0.77,2,341898,341440,458
7307301,80.2355,79.7491,458,34149,0.909553,0.77,2,341966,341508,458
7310221,17.6471,17.5498,458,34211,0.941911,0.77,2,341968,341510,458
7313141,32.3294,3.50996,494,34273,0.948382,0.77,2,342004,341510,494
7472281,51,139,473,17042,0.23,0.39,1,344411,343938,473
7475201,68.6,80.6,480,17167,0.262,0.31,1,344484,344004,480
7478121,51.32,74.52,454,17291,0.2364,0.25,1,344531,344077,454
7481041,37.464,46.904,448,17414,0.23128,0.17,1,344565,344117,448
7482501,182.693,38.9808,630,17536,0.342256,0.21,1,344784,344154,630
7485421,42.9386,172.596,432,17657,0.364451,0.23,1,344792,344360,432
7488341,50.1877,75.3192,433,17777,0.41689,0.27,1,344844,344411,433
7491261,68.4375,73.4638,433,17896,0.475378,0.23,1,344917,344484,433
7494181,52.8875,52.2928,435,18015,0.503076,0.23,1,344966,344531,435
7497101,36.9775,37.6586,434,18133,0.508615,0.23,1,344999,344565,434
7498561,168.196,7.53171,635,18250,0.525723,0.37,1,345200,344565,635
7501481,57.6391,176.706,446,18366,0.577145,0.37,1,345230,344784,446
7504401,54.7278,41.7413,492,18482,0.571429,0.43,1,345284,344792,492
7507321,71.7456,49.9483,516,18597,0.586286,0.49,1,345360,344844,516
7510241,54.3491,68.3897,493,18711,0.621257,0.51,1,345410,344917,493
7513161,38.8698,52.8779,479,18824,0.644251,0.51,1,345445,344966,479
7514621,168.574,36.9756,647,18937,0.74485,0.53,1,345646,344999,647
7517541,60.1148,168.195,479,19049,0.79697,0.59,2,345679,345200,479
7520461,55.223,57.639,503,19160,0.807394,0.57,2,345733,345230,503
7523381,72.6446,54.7278,526,19271,0.825479,0.59,2,345810,345284,526
7526301,56.1289,71.7456,502,19381,0.845096,0.63,2,345862,345360,502
7529221,40.8258,54.3491,489,19490,0.881019,0.65,2,345899,345410,489
7530681,168.965,38.8698,655,19599,0.872204,0.77,2,346100,345445,655
7533601,40.193,168.574,462,19707,0.918441,0.81,2,346108,345646,462
7619741,49,52,540,22714,0.85,1,2,348158,347618,540
7622661,69.8,72.8,537,22807,0.786,1,2,348233,347696,537
7625581,43.56,67.36,508,22900,0.7732,1,2,348270,347762,508
7627041,183.112,43.872,688,22993,0.62664,1,1,348488,347800,688
7629961,40.6224,181.574,477,23085,0.613328,0.98,1,348493,348016,477
7632881,36.9245,66.7149,475,23177,0.618666,0.88,1,348529,348054,475
7635801,25.7849,35.743,470,23268,0.595733,0.87,1,348552,348082,470
7638721,24.357,28.7486,467,23359,0.591147,0.85,1,348576,348109,467
7641641,40.8714,44.9497,463,23450,0.622229,0.77,1,348621,348158,463
7644561,62.5743,68.9899,456,23540,0.596446,0.77,1,348689,348233,456
7647481,42.1149,43.398,456,23630,0.575289,0.59,1,348726,348270,456
7650401,183.623,183.08,457,23720,0.603058,0.61,1,348945,348488,457
7653321,63.9246,40.6159,486,23809,0.592612,0.62,1,348979,348493,486
7656241,31.1849,36.9232,473,23898,0.590522,0.59,1,349002,348529,473
7659161,24.637,25.7846,473,23987,0.606104,0.59,1,349025,348552,473
7662081,6.5274,24.3569,451,24075,0.577221,0.63,1,349027,348576,451
7665001,37.3055,40.8714,451,24163,0.587444,0.59,1,349072,348621,451
7667921,62.6611,62.5743,452,24251,0.621489,0.57,1,349141,348689,452
7670841,39.7322,42.1149,449,24338,0.676298,0.61,1,349175,348726,449
7673761,182.346,183.623,448,24425,0.75126,0.59,2,349393,348945,448
7676681,66.8693,63.9246,452,24512,0.766252,0.59,2,349431,348979,452
7679601,30.9739,31.1849,451,24598,0.80125,0.61,2,349453,349002,451
7682521,25.3948,24.637,452,24684,0.79225,0.57,2,349477,349025,452
7685441,6.67895,6.5274,452,24770,0.79045,0.59,2,349479,349027,452
7688361,36.5358,37.3055,451,24856,0.82209,0.63,2,349523,349072,451
7691281,64.1072,62.6611,453,24941,0.844418,0.69,2,349594,349141,453
7694201,40.8214,39.7322,454,25026,0.880884,0.77,2,349629,349175,454
7803701,25,26,488,28063,0.55,1,1,351828,351340,488
7806621,28.2,33.2,482,28138,0.566,1,1,351857,351375,482
7809541,40.84,34.64,491,28213,0.4732,1,1,351901,351410,491
7812461,25.768,26.928,488,28288,0.50264,1,1,351923,351435,488
7815381,22.7536,23.7856,487,28363,0.396528,1,1,351945,351458,487
7818301,24.5507,4.75712,512,28438,0.439306,0.99,1,351970,351458,512
7821221,40.9101,31.3514,519,28512,0.415861,1,1,352015,351496,519
7822681,172.982,45.4703,676,28586,0.491172,0.73,1,352221,351545,676
7825601,35.3964,187.494,454,28660,0.522234,0.55,1,352222,351768,454
7828521,33.4793,65.4988,452,28734,0.544447,0.55,1,352255,351803,452
7831441,24.2959,33.0998,449,28808,0.532889,0.57,1,352277,351828,449
7834361,25.6592,29.82,446,28881,0.562578,0.45,1,352303,351857,446
7837281,39.5318,41.164,445,28954,0.616516,0.51,1,352346,351901,445
7840201,27.9064,25.8328,448,29027,0.627303,0.37,1,352371,351923,448
7843121,22.3813,22.7666,447,29100,0.629461,0.45,1,352392,351945,447
7846041,21.2763,24.5533,443,29173,0.613892,0.41,1,352413,351970,443
7848961,39.4553,40.9107,442,29246,0.626778,0.51,1,352457,352015,442
7851881,176.691,172.982,447,29318,0.693356,0.53,1,352668,352221,447
7854801,64.1382,35.3964,482,29390,0.722671,0.55,1,352704,352222,482
7857721,28.8276,33.4793,469,29462,0.744534,0.53,1,352724,352255,469
7860641,27.3655,24.2959,474,29534,0.732907,0.57,1,352751,352277,474
7863561,41.4731,25.6592,493,29606,0.746581,0.63,1,352796,352303,493
7866481,29.0946,39.5318,476,29677,0.749316,0.63,1,352822,352346,476
7869401,21.8189,27.9064,471,29748,0.749863,0.63,1,352842,352371,471
7872321,21.9638,22.3813,472,29819,0.749973,0.61,1,352864,352392,472
7875241,5.99276,21.2763,453,29890,0.749995,0.63,1,352866,352413,453
7878161,36.3986,39.4553,453,29961,0.813999,0.71,2,352910,352457,453
7881081,179.28,176.691,457,30032,0.8428,0.73,2,353125,352668,457
7884001,66.2559,64.1382,459,30102,0.86456,0.75,2,353163,352704,459
7886921,29.2512,28.8276,459,30172,0.900912,0.73,2,353183,352724,459
7889841,26.6502,27.3655,458,30242,0.908182,0.75,2,353209,352751,458
7892761,42.13,41.4731,459,30312,0.909637,0.75,2,353255,352796,459
8011021,49,38,498,33053,0.75,1,2,355146,354648,498
8013941,38.6,34.8,500,33117,0.718,1,1,355182,354682,500
8016861,34.12,32.56,501,33181,0.6156,1,1,355215,354714,501
8019781,29.224,30.512,499,33245,0.43512,1,1,355243,354744,499
8022701,33.8448,29.3024,505,33309,0.271024,1,1,355278,354773,505
8025621,29.169,25.0605,509,33372,0.190205,1,1,355306,354797,509
8028541,29.0338,28.2121,509,33435,0.094041,1,1,355335,354826,509
8031461,26.6068,35.2424,498,33498,0.138808,1,1,355361,354863,498
8034381,123.721,145.448,473,33561,0.0517616,0.93,1,355509,355036,473
8037301,43.9443,53.8897,466,33624,0.0503523,0.83,1,355533,355067,466
8040221,30.3889,34.7779,463,33687,0.0180705,0.75,1,355560,355097,463
8043141,41.2778,46.1556,458,33750,0.0276141,0.71,1,355604,355146,458
8046061,32.2556,38.0311,452,33813,0.0935228,0.59,1,355634,355182,452
8048981,28.8511,34.0062,447,33876,0.0747046,0.39,1,355662,355215,447
8051901,21.7702,29.2012,439,33938,0.0549409,0.23,1,355682,355243,439
8054821,26.754,33.8402,432,34000,0.130988,0.17,1,355710,355278,432
8057741,28.5508,29.168,433,34062,0.114198,0.07,1,355739,355306,433
8060661,21.7102,29.0336,424,34124,0.11084,0.15,1,355759,355335,424
8063581,25.142,26.6067,424,34186,0.110168,0.03,1,355785,355361,424
8066501,121.828,123.721,422,34248,0.0620336,0.03,1,355931,355509,422
8069421,44.3657,24.7443,447,34310,0.0844067,0.05,1,355956,355509,447
8072341,28.8731,24.1489,448,34372,0.0568813,0.01,1,355981,355533,448
8075261,40.9746,26.4298,465,34434,0.0193763,0.03,1,356025,355560,465
8078181,34.5949,40.486,454,34495,0.0598753,0.11,1,356058,355604,454
8081101,26.919,32.0972,449,34556,0.019975,0.07,1,356083,355634,449
8084021,23.7838,28.8194,444,34617,0.027995,0.05,1,356106,355662,444
8086941,27.9568,21.7639,453,34678,0.061599,0.15,1,356135,355682,453
8089861,27.9914,26.7528,453,34739,0.13232,0.11,1,356163,355710,453
8092781,22.3983,28.5506,445,34800,0.130464,0.11,1,356184,355739,445
8095701,26.0797,21.7101,452,34861,0.114093,0.11,1,356211,355759,452
8098621,118.016,25.142,567,34922,0.158819,0.05,1,356352,355785,567
8101541,46.8032,121.828,450,34983,0.151764,0.09,1,356381,355931,450
8104461,26.1606,44.3657,446,35043,0.182353,0.05,1,356402,355956,446
8107381,42.0321,28.8731,467,35103,0.140471,0.01,1,356448,355981,467
8110301,34.0064,40.9746,455,35163,0.148094,0.07,1,356480,356025,455
8113221,27.6013,34.5949,448,35223,0.149619,0.01,1,356506,356058,448
8116141,23.9203,26.919,446,35283,0.149924,0.03,1,356529,356083,446
8119061,31.1841,23.7838,456,35343,0.149985,0.07,1,356562,356106,456
8121981,29.4368,27.9568,456,35403,0.149997,0.15,1,356591,356135,456
8124901,21.8874,27.9914,448,35463,0.149999,0.13,1,356611,356163,448
8127821,27.5775,22.3983,456,35523,0.134,0.11,1,356640,356184,456
8130741,117.515,26.0797,569,35583,0.1628,0.17,1,356780,356211,569
8133661,46.7031,118.016,457,35642,0.18456,0.15,1,356809,356352,457
8136581,10.9406,46.8032,430,35701,0.204912,0.19,1,356811,356381,430
8139501,20.5881,26.1606,432,35760,0.224982,0.13,1,356834,356402,432
8142421,38.5176,42.0321,429,35819,0.276996,0.15,1,356877,356448,429
8145341,33.3035,34.0064,429,35878,0.287399,0.15,1,356909,356480,429
8148261,28.2607,27.6013,430,35937,0.27348,0.15,1,356936,356506,430
8151181,23.2521,23.9203,429,35996,0.302696,0.15,1,356958,356529,429
8154101,31.8504,31.1841,430,36055,0.276539,0.15,1,356992,356562,430
8157021,28.7701,29.4368,429,36114,0.303308,0.15,1,357020,356591,429
8159941,21.754,21.8874,429,36173,0.292662,0.13,1,357040,356611,429
8162861,26.7508,27.5775,428,36231,0.322532,0.17,1,357068,356640,428
8165781,118.95,117.515,430,36289,0.392506,0.19,1,357210,356780,430
8168701,48.59,46.7031,432,36347,0.390501,0.21,1,357241,356809,432
8171621,11.318,10.9406,432,36405,0.3901,0.23,1,357243,356811,432
8174541,22.2636,20.5881,434,36463,0.37402,0.29,1,357268,356834,434
8177461,38.8527,38.5176,434,36521,0.386804,0.29,1,357311,356877,434
8180381,33.3705,33.3035,434,36579,0.421361,0.27,1,357343,356909,434
8183301,29.0741,28.2607,435,36637,0.396272,0.31,1,357371,356936,435
8186221,23.4148,23.2521,435,36695,0.423254,0.27,1,357393,356958,435
8189141,31.883,31.8504,435,36753,0.444651,0.31,1,357427,356992,435
8192061,29.5766,28.7701,436,36810,0.44893,0.29,1,357456,357020,436
8194981,21.9153,21.754,436,36867,0.449786,0.33,1,357476,357040,436
8197901,26.7831,26.7508,436,36924,0.513957,0.41,1,357504,357068,436
8200821,122.157,118.95,440,36981,0.558791,0.39,1,357650,357210,440
8203741,48.4313,48.59,439,37038,0.583758,0.39,1,357680,357241,439
8206661,11.2863,11.318,439,37095,0.556752,0.37,1,357682,357243,439
8209581,21.4573,22.2636,438,37152,0.55135,0.37,1,357706,357268,438
8212501,39.4915,4.45272,482,37209,0.51827,0.39,1,357750,357268,482
8215421,34.2983,35.2905,472,37266,0.575654,0.43,1,357783,357311,472
8218341,29.2597,32.6581,468,37323,0.603131,0.39,1,357811,357343,468
8221261,23.4519,28.9316,462,37380,0.608626,0.43,1,357833,357371,462
8224181,33.4904,23.3863,476,37437,0.577725,0.45,1,357869,357393,476
8227101,30.6981,31.8773,472,37493,0.571545,0.45,1,357899,357427,472
8230021,22.9396,29.5755,464,37549,0.586309,0.45,1,357920,357456,464
8232941,27.7879,21.9151,473,37605,0.621262,0.53,1,357949,357476,473
8235861,123.958,26.783,593,37661,0.692252,0.57,1,358097,357504,593
8238781,49.5915,122.157,478,37717,0.73845,0.59,1,358128,357650,478
8241701,11.5183,48.4313,450,37773,0.74769,0.55,1,358130,357680,450
8244621,21.5037,11.2863,472,37829,0.765538,0.55,2,358154,357682,472
8247541,37.9007,21.4573,490,37885,0.769108,0.51,2,358196,357706,490
8250461,37.9801,39.4915,484,37941,0.801822,0.59,2,358234,357750,484
8253381,29.996,34.2983,479,37997,0.872364,0.61,2,358262,357783,479
8256301,23.5992,29.2597,473,38053,0.902473,0.61,2,358284,357811,473
8259221,31.9198,23.4519,485,38109,0.924495,0.57,2,358318,357833,485
8262141,30.384,33.4904,479,38164,0.928899,0.57,2,358348,357869,479
8265061,23.6768,30.6981,471,38219,0.92978,0.59,2,358370,357899,471
8267981,29.5354,22.9396,481,38274,0.945956,0.63,2,358401,357920,481
8422741,137,29,629,41097,0.63,1,1,360452,359823,629
8425661,53.8,127.4,510,41148,0.534,1,1,360485,359975,510
8428581,34.76,51.08,508,41199,0.4828,1,1,360515,360007,508
8431501,17.352,22.216,506,41250,0.44056,1,1,360528,360022,506
8434421,29.0704,22.0432,516,41301,0.400112,0.94,1,360560,360044,516
8437341,27.4141,32.4086,508,41352,0.408022,1,1,360587,360079,508
8440261,28.6828,40.8817,494,41403,0.345604,1,1,360616,360122,494
8443181,28.1366,28.1763,497,41454,0.381121,1,1,360644,360147,497
8446101,29.6273,24.8353,503,41505,0.356224,1,1,360674,360171,503
8449021,7.52546,29.7671,474,41556,0.383245,1,1,360676,360202,474
8451941,19.9051,22.7534,476,41607,0.356649,1,1,360699,360223,476
8454861,23.181,27.7507,471,41658,0.31933,0.92,1,360723,360252,471
8457781,29.4362,31.9501,469,41709,0.295866,0.91,1,360754,360285,469
8460701,28.2872,30.39,467,41760,0.275173,0.63,1,360782,360315,467
8463621,97.6574,115.678,445,41811,0.271035,0.51,1,360897,360452,445
8466541,44.3315,49.5356,443,41861,0.286207,0.47,1,360928,360485,443
8469461,32.0663,33.9071,442,41911,0.289241,0.43,1,360957,360515,442
8472381,17.6133,17.1814,443,41961,0.305848,0.39,1,360971,360528,443
8475301,25.1227,29.0363,438,42011,0.32517,0.41,1,360998,360560,438
8478221,28.2245,27.4073,440,42061,0.345034,0.33,1,361027,360587,440
8481141,28.0449,28.6815,439,42111,0.349007,0.39,1,361055,360616,439
8484061,28.009,28.1363,439,42161,0.317801,0.35,1,361083,360644,439
8486981,28.8018,29.6273,438,42211,0.37556,0.39,1,361112,360674,438
8489901,7.36036,7.52545,438,42261,0.387112,0.35,1,361114,360676,438
8492821,16.6721,19.9051,434,42311,0.405422,0.31,1,361133,360699,434
8495741,24.1344,23.181,436,42361,0.409084,0.29,1,361159,360723,436
8498661,29.6269,29.4362,436,42411,0.425817,0.27,1,361190,360754,436
8501581,26.7254,28.2872,434,42461,0.445163,0.27,1,361216,360782,434
8504501,98.1451,97.6574,435,42511,0.449033,0.29,1,361332,360897,435
8507421,46.829,44.3315,438,42561,0.417807,0.29,1,361366,360928,438
8510341,33.3658,32.0663,439,42611,0.443561,0.31,1,361396,360957,439
8513261,17.8732,17.6133,439,42661,0.496712,0.33,1,361410,360971,439
8516181,23.5746,25.1227,437,42710,0.491342,0.35,1,361435,360998,437
8519101,29.5149,28.2245,439,42759,0.506268,0.35,1,361466,361027,439
8522021,26.703,28.0449,437,42808,0.557254,0.31,1,361492,361055,437
8524941,28.5406,28.009,438,42857,0.551451,0.39,1,361521,361083,438
8527861,31.3081,28.8018,441,42906,0.56629,0.39,1,361553,361112,441
8530781,7.86162,7.36036,441,42955,0.569258,0.41,1,361555,361114,441
8533701,15.9723,16.6721,440,43004,0.617852,0.41,1,361573,361133,440
8536621,24.7945,3.33441,467,43053,0.57957,0.41,1,361600,361133,467
8539541,29.7589,21.4669,472,43102,0.587914,0.43,1,361631,361159,472
8542461,26.7518,29.0934,467,43151,0.557583,0.45,1,361657,361190,467
8545381,98.1504,26.6187,557,43200,0.583517,0.45,1,361773,361216,557
8548301,46.8301,98.1237,475,43249,0.620703,0.41,1,361807,361332,475
8551221,35.766,46.8247,474,43298,0.644141,0.45,1,361840,361366,474
8554141,18.3532,33.3649,458,43347,0.648828,0.51,1,361854,361396,458
8557061,24.4706,17.873,470,43396,0.649766,0.49,1,361880,361410,470
8559981,31.2941,23.5746,478,43445,0.681953,0.51,1,361913,361435,478
8562901,27.0588,29.5149,473,43494,0.720391,0.57,1,361939,361466,473
8565821,27.8118,26.703,475,43543,0.744078,0.55,1,361967,361492,475
8568741,34.3624,28.5406,482,43591,0.748816,0.57,1,362003,361521,482
8571661,8.47247,31.3081,452,43639,0.749763,0.57,1,362005,361553,452
8574581,16.0945,7.86162,468,43687,0.813953,0.63,2,362023,361555,468
8577501,24.0189,15.9723,476,43735,0.826791,0.57,2,362049,361573,476
8580421,28.8038,24.7945,479,43783,0.829358,0.59,2,362079,361600,479
8583341,26.5608,29.7589,474,43831,0.845872,0.55,2,362105,361631,474
8837381,70,76,484,22093,0.03,0.51,1,365026,364542,484
8840301,54.8,68.8,468,22189,0.03,0.09,1,365077,364609,468
8843221,72.56,81.76,460,22285,0.03,0.03,1,365154,364694,460
8846141,68.112,72.352,457,22380,0.03,0.03,1,365221,364764,457
8849061,51.2224,75.2704,428,22475,0.014,0.03,1,365268,364840,428
8851981,32.6445,36.6541,429,22569,0.0268,0.03,1,365296,364867,429
8854901,72.1289,18.5308,497,22663,0.04536,0.05,1,365378,364881,497
8857821,71.2258,63.7062,493,22757,0.017072,0.03,1,365449,364956,493
8860741,55.8452,68.7412,475,22850,0.0434144,0.03,1,365501,365026,475
8863661,71.169,54.5482,499,22943,0.0966829,0.03,1,365576,365077,499
8866581,67.8338,72.5097,489,23035,0.0273366,0.03,1,365643,365154,489
8869501,50.3668,68.1019,468,23127,0.0294673,0.01,1,365689,365221,468
8872421,35.6734,51.2204,453,23219,0.0298935,0.03,1,365721,365268,453
8875341,71.9347,32.6441,506,23310,0.0619787,0.05,1,365802,365296,506
8878261,70.3869,72.1288,494,23401,0.0843957,0.01,1,365872,365378,494
8881181,55.6774,71.2258,475,23492,0.104879,0.05,1,365924,365449,475
8884101,70.3355,55.8452,497,23582,0.108976,0.11,1,365998,365501,497
8887021,66.8671,71.169,488,23672,0.0777952,0.01,1,366064,365576,488
8889941,50.1734,67.8338,467,23762,0.039559,0.03,1,366110,365643,467
8892861,37.2347,50.3668,455,23851,0.0319118,0.03,1,366144,365689,455
8895781,73.0469,35.6734,505,23940,0.0303824,0.07,1,366226,365721,505
8898701,16.2094,71.9347,426,24029,0.0300765,0.09,1,366228,365802,426
8901621,59.2419,70.3869,426,24117,0.126015,0.11,1,366298,365872,426
8904541,54.2484,55.6774,427,24205,0.145203,0.11,1,366351,365924,427
8907461,68.4497,70.3355,425,24293,0.181041,0.07,1,366423,365998,425
8910381,64.8899,66.8671,423,24380,0.236208,0.03,1,366487,366064,423
8913301,49.778,50.1734,423,24467,0.0552416,0.03,1,366533,366110,423
8916221,37.1556,37.2347,423,24554,0.0350483,0.03,1,366567,366144,423
8919141,73.0311,73.0469,423,24640,0.0310097,0.03,1,366649,366226,423
8922061,16.2062,16.2094,423,24726,0.0622019,0.15,1,366651,366228,423
8924981,63.2412,59.2419,428,24812,0.0364404,0.15,1,366726,366298,428
8927901,54.2483,54.2484,427,24897,0.0312881,0.19,1,366778,366351,427
8930821,72.4497,68.4497,432,24982,0.0462576,0.25,1,366855,366423,432
8933741,65.6899,64.8899,432,25067,0.0812515,0.01,1,366919,366487,432
8936661,41.938,49.778,422,25152,0.12025,0.03,1,366955,366533,422
8939581,37.1876,37.1556,424,25236,0.14405,0.03,1,366991,366567,424
8942501,72.2375,73.0311,423,25320,0.11681,0.07,1,367072,366649,423
8945421,16.0475,16.2062,423,25404,0.111362,0.03,1,367074,366651,423
8948341,62.4095,63.2412,422,25487,0.0942724,0.03,1,367148,366726,422
8951261,54.0819,12.6482,474,25570,0.106854,0.03,1,367200,366726,474
8954181,74.0164,44.1297,501,25653,0.109371,0.05,1,367279,366778,501
8957101,66.8033,70.4259,489,25736,0.141874,0.09,1,367344,366855,489
8960021,42.1607,65.2852,461,25818,0.164375,0.13,1,367380,366919,461
8962941,38.0321,41.857,462,25900,0.168875,0.15,1,367417,366955,462
8965861,70.8064,37.1714,505,25982,0.185775,0.11,1,367496,366991,505
8968781,15.7613,72.2343,426,26064,0.189155,0.11,1,367498,367072,426
8971701,62.3523,16.0469,498,26145,0.237831,0.09,1,367572,367074,498
8974621,55.6705,62.4094,478,26226,0.247566,0.11,1,367626,367148,478
8977541,74.3341,54.0819,505,26307,0.297513,0.11,1,367705,367200,505
8980461,68.4668,74.0164,493,26388,0.371503,0.15,1,367772,367279,493
8983381,43.2934,66.8033,465,26468,0.402301,0.17,1,367809,367344,465
8986301,38.2587,42.1607,466,26548,0.39246,0.17,1,367846,367380,466
8989221,71.6517,38.0321,509,26628,0.422492,0.19,1,367926,367417,509
8992141,15.9303,70.8064,432,26708,0.428498,0.19,1,367928,367496,432
8995061,64.7861,15.7613,507,26787,0.4777,0.25,1,368005,367498,507
8997981,56.9572,62.3523,488,26866,0.53554,0.25,1,368060,367572,488
9000901,12.9914,55.6705,436,26945,0.547108,0.31,1,368062,367626,436
9003821,67.3983,74.3341,438,27024,0.581422,0.39,1,368143,367705,438
9006741,70.2797,68.4668,442,27102,0.636284,0.41,1,368214,367772,442
9009661,43.6559,43.2934,442,27180,0.663257,0.39,1,368251,367809,442
9012581,37.5312,38.2587,441,27258,0.684651,0.43,1,368287,367846,441
9015501,73.1062,71.6517,443,27336,0.70493,0.43,1,368369,367926,443
9018421,16.2212,15.9303,443,27413,0.740986,0.49,1,368371,367928,443
9021341,67.2442,64.7861,446,27490,0.748197,0.55,1,368451,368005,446
9024261,59.8489,56.9572,449,27567,0.781639,0.55,2,368509,368060,449
9027181,13.5698,12.9914,449,27644,0.788328,0.59,2,368511,368062,449
9030101,67.514,67.3983,449,27721,0.821666,0.65,2,368592,368143,449
9033021,74.3028,70.2797,454,27797,0.780333,0.67,2,368668,368214,454
9035941,45.2606,43.6559,455,27873,0.820067,0.69,2,368706,368251,455
9038861,38.6521,37.5312,456,27949,0.780013,0.71,2,368743,368287,456
9041781,74.1304,73.1062,457,28025,0.836003,0.75,2,368826,368369,457
9044701,16.4261,16.2212,457,28101,0.895201,0.75,2,368828,368371,457
9047621,68.8852,67.2442,459,28176,0.90704,0.79,2,368910,368451,459
9050541,62.577,59.8489,462,28251,0.877408,0.79,2,368971,368509,462
9053461,14.1154,13.5698,462,28326,0.871482,0.83,2,368973,368511,462
9056381,66.8231,67.514,461,28401,0.886296,0.83,2,369053,368592,461
9059301,73.3646,13.5028,536,28476,0.873259,0.77,2,369128,368592,536
9062221,45.0729,63.5006,498,28550,0.886652,0.83,2,369166,368668,498
9065141,38.6146,43.1001,497,28624,0.93733,0.77,2,369203,368706,497
9068061,77.3229,38.22,547,28698,0.947466,0.85,2,369290,368743,547
9070981,17.0646,74.044,466,28772,0.949493,0.91,2,369292,368826,466
9164421,37,29,499,31039,0.57,1,1,370910,370411,499
9167341,45.8,55.4,485,31107,0.538,1,1,370958,370473,485
9170261,65.96,71.08,481,31175,0.2756,1,1,371029,370548,481
9173181,37.992,37.416,483,31243,0.06312,1,1,371060,370577,483
9176101,35.5984,31.4832,488,31311,0.020624,1,1,371095,370607,488
9179021,23.1197,6.29664,508,31379,0.0281248,1,1,371115,370607,508
9181941,69.4239,22.0593,563,31446,0.061625,0.94,1,371196,370633,563
9184861,33.8848,73.2119,502,31513,0.068325,1,1,371221,370719,502
9187781,45.977,37.8424,522,31580,0.053665,0.89,1,371270,370748,522
9190701,54.7954,55.5685,519,31647,0.034733,0.65,1,371327,370808,519
9193621,38.9591,63.1137,489,31714,0.0469466,0.57,1,371362,370873,489
9196541,38.9918,42.2227,491,31781,0.0493893,0.53,1,371401,370910,491
9199461,52.5984,46.8445,499,31848,0.00987786,0.21,1,371457,370958,499
9202381,31.3197,66.1689,454,31914,0.0579756,0.01,1,371483,371029,454
9205301,33.4639,38.0338,457,31980,0.0995951,0.01,1,371517,371060,457
9208221,21.8928,35.6068,441,32046,0.059919,0.03,1,371536,371095,441
9211141,72.3786,23.1214,506,32112,0.147984,0.07,1,371621,371115,506
9214061,32.0757,69.4243,447,32178,0.165597,0.07,1,371643,371196,447
9216981,45.6151,33.8849,471,32244,0.105119,0.05,1,371692,371221,471
9219901,53.923,45.977,478,32310,0.109024,0.03,1,371748,371270,478
9222821,39.5846,54.7954,457,32375,0.0298048,0.05,1,371784,371327,457
9225741,40.7169,38.9591,463,32440,0.077961,0.05,1,371825,371362,463
9228661,52.1434,38.9918,479,32505,0.0555922,0,1,371880,371401,479
9231581,30.4287,52.5984,448,32570,0.0831184,0.07,1,371905,371457,448
9234501,33.2857,31.3197,456,32635,0.0566237,0.11,1,371939,371483,456
9237421,21.0571,33.4639,440,32700,0.0193247,0.05,1,371957,371517,440
9240341,79.4114,21.8928,515,32765,0.107865,0.17,1,372051,371536,515
9243261,17.4823,72.3786,432,32830,0.125573,0.17,1,372053,371621,432
9246181,19.4965,32.0757,430,32894,0.177115,0.09,1,372073,371643,430
9249101,41.4993,45.6151,428,32958,0.171423,0.11,1,372120,371692,428
9252021,49.0999,53.923,423,33022,0.154285,0.01,1,372171,371748,423
9254941,41.02,39.5846,426,33086,0.182857,0.09,1,372210,371784,426
9257861,39.404,40.7169,424,33150,0.220571,0.05,1,372249,371825,424
9260781,51.8808,52.1434,424,33214,0.228114,0.09,1,372304,371880,424
9263701,31.9762,30.4287,426,33278,0.245623,0.05,1,372331,371905,426
9266621,31.9952,33.2857,424,33342,0.265125,0.01,1,372363,371939,424
9269541,19.999,21.0571,423,33405,0.285025,0.13,1,372380,371957,423
9272461,83.1998,79.4114,428,33468,0.113005,0.13,1,372479,372051,428
9275381,18.24,17.4823,428,33531,0.046601,0.19,1,372481,372053,428
9278301,20.448,19.4965,429,33594,0.0653202,0.17,1,372502,372073,429
9281221,42.4896,41.4993,430,33657,0.069064,0.15,1,372550,372120,430
9284141,48.4979,49.0999,429,33720,0.149813,0.19,1,372600,372171,429
9287061,40.8996,41.02,429,33783,0.165963,0.23,1,372639,372210,429
9289981,40.9799,39.404,431,33846,0.217193,0.23,1,372680,372249,431
9292901,53.796,51.8808,433,33908,0.243438,0.25,1,372737,372304,433
9295821,33.1592,31.9762,434,33970,0.264688,0.27,1,372765,372331,434
9298741,33.0318,31.9952,435,34032,0.252938,0.29,1,372798,372363,435
9301661,19.4064,19.999,434,34094,0.250587,0.07,1,372814,372380,434
9304581,74.2813,83.1998,423,34156,0.314117,0.03,1,372902,372479,423
9307501,16.4563,18.24,423,34218,0.326824,0.03,1,372904,372481,423
9310421,20.8913,3.64799,445,34280,0.329365,0.07,1,372926,372481,445
9313341,43.3783,17.5296,473,34342,0.329873,0.07,1,372975,372502,473
9316261,52.6756,41.9059,480,34404,0.329975,0.17,1,373030,372550,480
9319181,41.7351,48.3812,469,34465,0.281995,0.17,1,373069,372600,469
9322101,42.747,40.8762,473,34526,0.288399,0.23,1,373112,372639,473
9325021,55.7494,40.9752,491,34587,0.28968,0.25,1,373171,372680,491
9327941,33.5499,53.7951,462,34648,0.305936,0.27,1,373199,372737,462
9330861,32.31,33.159,466,34709,0.325187,0.25,1,373231,372765,466
9333781,19.262,33.0318,449,34770,0.329037,0.25,1,373247,372798,449
9336701,77.4524,19.4064,525,34831,0.329807,0.33,1,373339,372814,525
9339621,17.0905,74.2813,439,34892,0.329961,0.33,1,373341,372902,439
9342541,21.0181,16.4563,459,34953,0.329992,0.33,1,373363,372904,459
9345461,44.2036,20.8913,487,35013,0.345998,0.33,1,373413,372926,487
9348381,50.4407,43.3783,490,35073,0.3652,0.33,1,373465,372975,490
9351301,42.0881,52.6756,475,35133,0.41704,0.27,1,373505,373030,475
9354221,42.0176,41.7351,478,35193,0.427408,0.29,1,373547,373069,478
9357141,55.6035,42.747,494,35253,0.477482,0.29,1,373606,373112,494
9360061,35.1207,55.7494,465,35313,0.535496,0.31,1,373636,373171,465
9362981,32.6241,33.5499,469,35373,0.515099,0.33,1,373668,373199,469
9365901,19.3248,32.31,453,35433,0.52702,0.33,1,373684,373231,453
9368821,77.465,19.262,529,35493,0.561404,0.33,1,373776,373247,529
9371741,17.093,77.4524,439,35553,0.568281,0.33,1,373778,373339,439
9374661,21.0186,17.0905,459,35612,0.569656,0.33,1,373800,373341,459
9377581,45.0037,21.0181,488,35671,0.569931,0.35,1,373851,373363,488
9380501,10.6007,44.2036,440,35730,0.569986,0.37,1,373853,373413,440
9383421,44.5202,50.4407,441,35789,0.617997,0.43,1,373906,373465,441
9386341,42.504,42.0881,443,35848,0.659599,0.43,1,373948,373505,443
9389261,43.7008,42.0176,445,35907,0.66792,0.49,1,373992,373547,445
9392181,56.7402,55.6035,446,35966,0.701584,0.55,1,374052,373606,446
9395101,36.148,35.1207,447,36025,0.708317,0.51,1,374083,373636,447
9398021,33.6296,32.6241,448,36084,0.725663,0.53,1,374116,373668,448
9400941,19.5259,19.3248,448,36143,0.761133,0.57,2,374132,373684,448
9403861,79.1052,77.465,450,36201,0.816227,0.57,2,374226,373776,450
9406781,17.421,17.093,450,36259,0.795245,0.57,2,374228,373778,450
9409701,21.0842,21.0186,450,36317,0.807049,0.57,2,374250,373800,450
9412621,45.0168,45.0037,450,36375,0.82541,0.57,2,374301,373851,450
9415541,10.6034,10.6007,450,36433,0.829082,0.63,2,374303,373853,450
9418461,46.9207,44.5202,453,36491,0.829816,0.67,2,374359,373906,453
9421381,42.9841,42.504,453,36549,0.861963,0.67,2,374401,373948,453
9605341,36,39,492,40027,0.85,1,2,376830,376338,492
9608261,35.2,33.4,495,40080,0.69,1,1,376865,376370,495
9611181,36.64,6.68,532,40133,0.61,1,1,376902,376370,532
9614101,37.728,40.536,521,40186,0.562,1,1,376940,376419,521
9617021,28.3456,36.9072,511,40239,0.4564,1,1,376966,376455,511
9619941,36.0691,27.3814,524,40291,0.35528,1,1,377004,376480,524
9622861,71.2138,29.4763,574,40343,0.255056,1,1,377084,376510,574
9625781,40.6428,81.0953,513,40395,0.235011,1,1,377117,376604,513
9628701,40.1286,48.2191,513,40447,0.135002,1,1,377157,376644,513
9631621,28.0257,36.8438,504,40499,0.0670004,0.96,1,377182,376678,504
9634541,22.4051,28.1688,499,40551,0.0694001,1,1,377203,376704,499
9637461,26.881,26.4338,501,40603,0.06988,0.89,1,377231,376730,501
9640381,31.7762,30.8868,502,40655,0.053976,0.91,1,377264,376762,502
9643301,30.3552,31.7774,500,40707,0.0507952,0.85,1,377294,376794,500
9646221,27.671,35.1555,491,40759,0.066159,0.65,1,377321,376830,491
9649141,29.5342,35.0311,486,40811,0.0532318,0.59,1,377351,376865,486
9652061,37.9068,36.6062,489,40863,0.0186464,0.55,1,377391,376902,489
9654981,22.7814,37.7212,470,40915,0.0757293,0.43,1,377410,376940,470
9657901,32.5563,28.3442,479,40967,0.103146,0.33,1,377445,376966,479
9660821,58.5113,36.0688,506,41019,0.124629,0.23,1,377510,377004,506
9663741,35.7023,71.2138,456,41070,0.144926,0.23,1,377540,377084,456
9666661,41.5405,40.6428,466,41121,0.180985,0.11,1,377583,377117,466
9669581,29.1081,40.1286,452,41172,0.140197,0.05,1,377609,377157,452
9672501,21.8216,28.0257,447,41223,0.148039,0.07,1,377629,377182,447
9675421,25.1643,22.4051,452,41274,0.133608,0.07,1,377655,377203,452
9678341,29.0329,26.881,454,41325,0.162722,0.05,1,377685,377231,454
9681261,31.4066,31.7762,453,41376,0.136544,0.05,1,377717,377264,453
9684181,27.0813,30.3552,449,41427,0.147309,0.07,1,377743,377294,449
9687101,30.2163,27.671,453,41478,0.181462,0.05,1,377774,377321,453
9690021,37.2433,29.5342,462,41529,0.188292,0.01,1,377813,377351,462
9692941,9.04865,37.9068,424,41580,0.157658,0.09,1,377815,377391,424
9695861,17.8097,22.7814,425,41631,0.151532,0.11,1,377835,377410,425
9698781,32.3619,32.5563,426,41682,0.214306,0.13,1,377871,377445,426
9701701,60.0724,58.5113,428,41733,0.242861,0.15,1,377938,377510,428
9704621,36.8145,35.7023,429,41784,0.264572,0.19,1,377969,377540,429
9707541,42.5629,41.5405,430,41835,0.316914,0.13,1,378013,377583,430
9710461,29.3126,29.1081,430,41885,0.343383,0.15,1,378039,377609,430
9713381,21.0625,21.8216,429,41935,0.348677,0.13,1,378058,377629,429
9716301,25.0125,25.1643,429,41985,0.349735,0.17,1,378084,377655,429
9719221,29.8025,29.0329,430,42035,0.381947,0.13,1,378115,377685,430
9722141,31.5605,31.4066,430,42085,0.404389,0.15,1,378147,377717,430
9725061,26.3121,27.0813,429,42135,0.424878,0.19,1,378172,377743,429
9727981,32.4624,30.2163,432,42185,0.428976,0.19,1,378206,377774,432
9730901,35.2925,37.2433,429,42235,0.429795,0.15,1,378242,377813,429
9733821,8.6585,9.04865,429,42285,0.429959,0.15,1,378244,377815,429
9736741,17.7317,17.8097,429,42335,0.461992,0.23,1,378264,377835,429
9739661,33.9463,32.3619,431,42385,0.452398,0.25,1,378302,377871,431
9742581,62.7893,60.0724,434,42435,0.43448,0.27,1,378372,377938,434
9745501,36.5579,36.8145,433,42485,0.510896,0.33,1,378402,377969,433
9748421,45.7116,42.5629,437,42535,0.558179,0.35,1,378450,378013,437
9751341,30.7423,29.3126,438,42585,0.583636,0.35,1,378477,378039,438
9754261,20.5485,21.0625,437,42635,0.588727,0.35,1,378495,378058,437
9757181,26.5097,25.0125,439,42684,0.557745,0.39,1,378523,378084,439
9760101,30.1019,29.8025,439,42733,0.567549,0.41,1,378554,378115,439
9763021,32.4204,31.5605,440,42782,0.60151,0.43,1,378587,378147,440
9765941,27.2841,26.3121,441,42831,0.624302,0.43,1,378613,378172,441
9768861,34.2568,32.4624,443,42880,0.64486,0.43,1,378649,378206,443
9771781,35.6514,35.2925,443,42929,0.664972,0.43,1,378685,378242,443
9774701,8.73027,8.6585,443,42978,0.700994,0.47,1,378687,378244,443
9777621,17.7461,17.7317,443,43027,0.676199,0.47,1,378707,378264,443
9780541,33.9492,3.54634,481,43076,0.67124,0.45,1,378745,378264,481
9783461,62.7898,31.1093,513,43125,0.750248,0.43,2,378815,378302,513
9786381,38.158,62.2219,475,43174,0.78205,0.53,2,378847,378372,475
9789301,49.2316,36.4444,497,43223,0.75641,0.57,2,378899,378402,497
9792221,30.6463,45.6889,475,43272,0.751282,0.59,2,378925,378450,475
9795141,20.5293,30.7378,466,43321,0.766256,0.59,2,378943,378477,466
9798061,26.5059,20.5476,476,43370,0.769251,0.55,2,378971,378495,476
9800981,31.7012,26.5095,481,43419,0.76985,0.57,2,379004,378523,481
9803901,33.5402,30.1019,484,43468,0.80197,0.61,2,379038,378554,484
9806821,28.308,32.4204,478,43517,0.792394,0.63,2,379065,378587,478
9809741,35.2616,27.2841,489,43565,0.790479,0.65,2,379102,378613,489
9812661,36.6523,34.2568,490,43613,0.774096,0.67,2,379139,378649,490
9815581,8.93046,35.6514,456,43661,0.770819,0.71,2,379141,378685,456
9818501,17.7861,8.73027,474,43709,0.770164,0.67,2,379161,378687,474
9821421,33.9572,17.7461,492,43757,0.770033,0.67,2,379199,378707,492
9824341,65.1914,33.9492,527,43805,0.802007,0.77,2,379272,378745,527
9827261,41.0383,62.7898,492,43853,0.824401,0.79,2,379307,378815,492
9830181,48.2077,38.158,510,43901,0.86088,0.75,2,379357,378847,510
9833101,31.2415,49.2316,485,43949,0.884176,0.75,2,379384,378899,485
9836021,20.6483,30.6463,477,43997,0.872835,0.77,2,379402,378925,477
9838941,26.5297,20.5293,487,44045,0.886567,0.77,2,379430,378943,487
9841861,32.5059,26.5059,493,44093,0.889313,0.77,2,379464,378971,493
9844781,34.5012,31.7012,495,44141,0.905863,0.81,2,379499,379004,495
9847701,27.7002,33.5402,487,44189,0.909173,0.79,2,379525,379038,487
9850621,35.14,28.308,497,44237,0.893835,0.79,2,379562,379065,497
9853541,35.828,35.2616,496,44285,0.906767,0.77,2,379598,379102,496
9856461,8.7656,36.6523,461,44333,0.909353,0.77,2,379600,379139,461
9859381,17.7531,8.93046,479,44381,0.925871,0.77,2,379620,379141,479
9862301,33.9506,17.7861,497,44429,0.929174,0.77,2,379658,379161,497
9865221,8.39012,33.9572,461,44476,0.929835,0.81,2,379660,379199,461
10017061,22,32,500,46876,0.89,1,2,381350,380850,500
10019981,34.8,25.6,514,46921,0.778,1,2,381388,380874,514
10022901,32.56,42.72,499,46966,0.7716,1,2,381420,380921,499
10025821,39.312,28.544,515,47011,0.64232,1,1,381461,380946,515
10028741,33.4624,32.9088,513,47056,0.616464,1,1,381493,380980,513
10031661,34.6925,40.9818,505,47101,0.563293,1,1,381528,381023,505
10034581,31.7385,28.1964,511,47146,0.504659,1,1,381559,381048,511
10037501,27.9477,25.6393,513,47191,0.476932,1,1,381586,381073,513
10040421,29.5895,33.9279,507,47236,0.407386,1,1,381616,381109,507
10043341,28.3179,30.7856,505,47281,0.425477,1,1,381644,381139,505
10046261,30.4636,26.9571,510,47326,0.381095,0.91,1,381675,381165,510
10049181,34.8927,29.3914,516,47371,0.420219,0.96,1,381711,381195,516
10052101,15.7785,38.6783,486,47415,0.476044,0.97,1,381722,381236,486
10055021,19.9557,34.9357,473,47459,0.455209,0.95,1,381743,381270,473
10057941,25.5911,29.3871,472,47503,0.451042,0.87,1,381770,381298,472
10060861,25.9182,29.8774,468,47547,0.466208,0.89,1,381796,381328,468
10063781,19.5836,23.5755,464,47591,0.485242,0.75,1,381814,381350,464
10066701,30.3167,35.1151,459,47635,0.441048,0.77,1,381847,381388,459
10069621,30.8633,32.623,458,47679,0.49621,0.61,1,381878,381420,458
10072541,36.5727,39.3246,455,47723,0.491242,0.61,1,381916,381461,455
10075461,31.3145,33.4649,453,47767,0.522248,0.55,1,381946,381493,453
10078381,33.4629,34.693,452,47811,0.56045,0.49,1,381980,381528,452
10081301,25.0926,31.7386,444,47855,0.56809,0.47,1,382003,381559,444
10084221,25.0185,27.9477,442,47899,0.617618,0.39,1,382028,381586,442
10087141,28.2037,29.5895,441,47943,0.611524,0.43,1,382057,381616,441
10090061,28.0407,28.3179,441,47987,0.658305,0.37,1,382085,381644,441
10092981,30.4081,30.4636,441,48031,0.651661,0.43,1,382116,381675,441
10095901,38.0816,34.8927,445,48075,0.698332,0.49,1,382156,381711,445
10098821,14.8163,15.7785,443,48119,0.691666,0.45,1,382165,381722,443
10101741,20.5633,19.9557,444,48163,0.706333,0.45,1,382187,381743,444
10104661,24.9127,25.5911,443,48207,0.693267,0.47,1,382213,381770,443
10107581,26.5825,25.9182,444,48251,0.706653,0.49,1,382240,381796,444
10110501,19.7165,19.5836,444,48295,0.741331,0.43,1,382258,381814,444
10113421,29.5433,30.3167,443,48339,0.748266,0.51,1,382290,381847,443
10116341,32.3087,30.8633,445,48383,0.749653,0.49,1,382323,381878,445
10119261,39.2617,36.5727,448,48427,0.733931,0.53,1,382364,381916,448
10122181,31.8523,31.3145,448,48471,0.746786,0.57,1,382394,381946,448
10125101,33.5705,33.4629,448,48514,0.829357,0.57,2,382428,381980,448
10128021,26.7141,25.0926,450,48557,0.797871,0.63,2,382453,382003,450
10130941,26.1428,25.0185,451,48600,0.791574,0.61,2,382479,382028,451
10133861,29.2286,28.2037,452,48643,0.806315,0.67,2,382509,382057,452
10136781,29.0457,28.0407,453,48686,0.825263,0.65,2,382538,382085,453
10139701,29.8091,30.4081,452,48729,0.861053,0.71,2,382568,382116,452
10142621,40.3618,38.0816,455,48772,0.868211,0.69,2,382611,382156,455
10145541,15.2724,14.8163,455,48815,0.853642,0.71,2,382620,382165,455
10148461,20.6545,20.5633,455,48858,0.882728,0.71,2,382642,382187,455
10151381,24.9309,4.11265,481,48901,0.856546,0.69,2,382668,382187,481
10154301,27.3862,21.6225,483,48944,0.867309,0.71,2,382696,382213,483
10157221,19.8772,25.9245,474,48987,0.901462,0.75,2,382714,382240,474
10160141,29.5754,19.5849,488,49030,0.924292,0.75,2,382746,382258,488
10163061,32.3151,29.517,489,49073,0.944858,0.75,2,382779,382290,489
10174741,24,34,485,49245,0.91,0.79,2,382913,382428,485
10177661,25.6,26.8,486,49288,0.91,0.79,2,382939,382453,486
10352861,33,28,499,51790,0.95,1,2,384665,384166,499
10355781,35.4,5.6,535,51831,0.918,1,2,384701,384166,535
10358701,28.68,24.32,533,51872,0.8636,1,2,384728,384195,533
10360161,28.136,27.264,533,51913,0.66072,1,1,384756,384223,533
10414181,387.227,457.453,445,23360,0.140144,0.27,1,385233,384788,445
10417101,128.645,125.091,467,24178,0.132029,0.03,1,385297,384830,467
10420021,91.3291,89.8181,468,24266,0.0344058,0.01,1,385379,384911,468
10422941,63.0658,73.9636,454,24353,0.00688115,0.05,1,385435,384981,454
10425861,57.4132,67.5927,444,24440,0.00937623,0,1,385491,385047,444
10428781,36.2826,42.3185,439,24527,0.0258752,0.01,1,385522,385083,439
10431701,79.2565,46.8637,481,24613,0.045175,0.07,1,385612,385131,481
10434621,30.2513,68.5727,425,24699,0.081035,0.03,1,385630,385205,425
10437541,26.0503,28.1145,432,24785,0.040207,0.13,1,385655,385223,432
10440461,59.6101,64.8229,426,24871,0.0960414,0.01,1,385723,385297,426
10443381,78.322,78.5646,427,24956,0.0432083,0,1,385806,385379,427
10446301,57.2644,60.5129,423,25041,0.0166417,0.01,1,385858,385435,423
10449221,55.4529,56.9026,422,25126,0.0273283,0.03,1,385913,385491,422
10452141,35.8906,36.1805,422,25210,0.0134657,0.05,1,385944,385522,422
10455061,80.7781,79.2361,424,25294,0.0426931,0.09,1,386036,385612,424
10457981,30.5556,30.2472,424,25378,0.0805386,0.03,1,386054,385630,424
10460901,25.3111,26.0494,423,25461,0.0881077,0.03,1,386078,385655,423
10463821,61.0622,5.20989,493,25544,0.0736215,0.11,1,386148,385655,493
10466741,75.4124,55.442,504,25627,0.0227243,0.03,1,386227,385723,504
10469661,56.6825,77.4884,473,25710,0.0125449,0.01,1,386279,385806,473
10472581,55.3365,57.0977,476,25792,0.026509,0.03,1,386334,385858,476
10475501,35.8673,55.4195,452,25874,0.0133018,0.01,1,386365,385913,452
10478421,83.9735,35.8839,517,25956,0.0266604,0.05,1,386461,385944,517
10481341,31.1947,80.7768,443,26038,0.0453321,0.09,1,386479,386036,443
10484261,23.8389,30.5554,447,26119,0.0490664,0.09,1,386501,386054,447
10487181,60.7678,25.3111,493,26200,0.0818133,0.07,1,386571,386078,493
10490101,74.5536,61.0622,501,26281,0.0723627,0.01,1,386649,386148,501
10493021,56.5107,75.4124,474,26362,0.0224725,0.01,1,386701,386227,474
10495941,56.1021,56.6825,478,26442,0.0444945,0.03,1,386757,386279,478
10498861,35.2204,55.3365,453,26522,0.0328989,0.01,1,386787,386334,453
10501781,84.6441,35.8673,519,26602,0.0145798,0.03,1,386884,386365,519
10504701,31.3288,83.9735,441,26682,0.042916,0.05,1,386902,386461,441
10507621,23.8658,31.1947,445,26761,0.0485832,0.05,1,386924,386479,445
10510541,62.3732,23.8389,495,26840,0.0497166,0.09,1,386996,386501,495
10513461,14.0746,60.7678,427,26919,0.0499433,0.07,1,386998,386571,427
10516381,63.6149,74.5536,425,26998,0.113989,0.01,1,387074,386649,425
10519301,52.723,56.5107,423,27076,0.0627977,0.05,1,387124,386701,423
10522221,54.5446,56.1021,422,27154,0.0525595,0.03,1,387179,386757,422
10525141,35.7089,35.2204,423,27232,0.0185119,0.01,1,387210,386787,423
10528061,85.5418,84.6441,424,27310,0.0917024,0.05,1,387308,386884,424
10530981,31.5084,31.3288,424,27388,0.0743405,0.05,1,387326,386902,424
10533901,23.9017,23.8658,424,27465,0.0708681,0.05,1,387348,386924,424
10536821,62.3803,62.3732,424,27542,0.0861736,0.05,1,387420,386996,424
10539741,14.0761,14.0746,424,27619,0.0892347,0.13,1,387422,386998,424
10542661,65.2152,63.6149,426,27696,0.121847,0.05,1,387500,387074,426
10545581,50.643,52.723,423,27772,0.144369,0.05,1,387547,387124,423
10548501,54.9286,54.5446,424,27848,0.196874,0.01,1,387603,387179,424
10551421,34.1857,35.7089,422,27924,0.127375,0.11,1,387632,387210,422
10554341,86.0371,85.5418,423,28000,0.145475,0.07,1,387731,387308,423
10557261,31.6074,31.5084,423,28076,0.149095,0.07,1,387749,387326,423
10560181,23.9215,23.9017,423,28151,0.149819,0.09,1,387771,387348,423
10563101,63.1843,62.3803,424,28226,0.229964,0.09,1,387844,387420,424
10566021,14.2369,14.0761,424,28301,0.245993,0.13,1,387846,387422,424
10568941,66.8474,65.2152,426,28376,0.297199,0.13,1,387926,387500,426
10571861,52.5695,13.043,475,28451,0.29144,0.15,1,387975,387500,475
10574781,56.1139,40.2086,485,28525,0.290288,0.21,1,388032,387547,485
10577701,30.4228,52.8417,453,28599,0.290058,0.11,1,388056,387603,453
10580621,88.4846,33.7683,527,28673,0.354012,0.15,1,388159,387632,527
10583541,32.0969,85.9537,446,28747,0.382802,0.15,1,388177,387731,446
10586461,24.0194,31.5907,450,28821,0.40456,0.15,1,388199,387749,450
10589381,65.6039,23.9181,504,28894,0.440912,0.25,1,388275,387771,504
10592301,14.7208,63.1836,433,28967,0.448182,0.25,1,388277,387844,433
10595221,70.9442,14.2367,516,29040,0.513636,0.31,1,388362,387846,516
10598141,53.3888,66.8473,485,29113,0.510727,0.29,1,388411,387926,485
10601061,55.4778,52.5695,492,29186,0.510145,0.29,1,388467,387975,492
10603981,30.2956,56.1139,459,29259,0.526029,0.29,1,388491,388032,459
10606901,91.6591,30.4228,542,29331,0.513206,0.37,1,388598,388056,542
10609821,34.3318,88.4846,459,29403,0.526641,0.39,1,388618,388159,459
10612741,24.4664,32.0969,463,29475,0.529328,0.41,1,388640,388177,463
10615661,67.2933,24.0194,519,29547,0.529866,0.45,1,388718,388199,519
10618581,15.0587,65.6039,445,29619,0.529973,0.45,1,388720,388275,445
10621501,74.2117,14.7208,532,29690,0.513995,0.53,1,388809,388277,532
10624421,53.2423,70.9442,495,29761,0.542799,0.51,1,388857,388362,495
10627341,55.4485,53.3888,502,29832,0.56456,0.51,1,388913,388411,502
10630261,12.6897,55.4778,448,29903,0.568912,0.53,1,388915,388467,448
10633181,22.5379,30.2956,449,29974,0.585782,0.51,1,388940,388491,449
10636101,89.3076,91.6591,448,30045,0.669156,0.53,1,389046,388598,448
10639021,33.8615,34.3318,448,30115,0.669831,0.53,1,389066,388618,448
10641941,24.3723,24.4664,448,30185,0.733966,0.53,1,389088,388640,448
10644861,67.2745,67.2933,448,30255,0.730793,0.53,1,389166,388718,448
10647781,15.0549,15.0587,448,30325,0.762159,0.51,2,389168,388720,448
10650701,73.411,74.2117,447,30395,0.752432,0.55,2,389256,388809,447
10653621,54.6822,53.2423,449,30465,0.766486,0.57,2,389306,388857,449
10656541,56.5364,55.4485,450,30534,0.801297,0.57,2,389363,388913,450
10659461,12.9073,12.6897,450,30603,0.808259,0.59,2,389365,388915,450
10662381,23.3815,22.5379,451,30672,0.809652,0.69,2,389391,388940,451
10665301,91.8763,89.3076,454,30741,0.92193,0.67,2,389500,389046,454
10668221,35.9753,33.8615,456,30810,0.944386,0.75,2,389522,389066,456
10671141,25.5951,24.3723,457,30879,0.932877,0.73,2,389545,389088,457
10846341,33,48,511,34749,0.85,1,2,392289,391778,511
10849261,41,39.2,517,34810,0.802,1,2,392332,391815,517
10852181,58.6,47.04,531,34871,0.8084,0.99,2,392395,391864,531
10855101,42.12,55.808,511,34932,0.80968,1,2,392433,391922,511
10858021,31.624,41.5616,502,34993,0.825936,0.94,2,392462,391960,502
10860941,26.3248,31.5123,498,35053,0.813187,1,2,392487,391989,498
10863861,19.665,27.9025,489,35113,0.810637,1,2,392505,392016,489
10866781,31.933,21.5805,504,35173,0.826127,0.98,2,392540,392036,504
10869701,68.7866,33.1161,546,35233,0.829226,0.95,2,392618,392072,546
10872621,55.3573,69.8232,519,35293,0.861845,0.93,2,392670,392151,519
10875541,50.2715,57.1646,514,35353,0.820369,0.89,2,392719,392205,514
10878461,33.2543,52.2329,492,35413,0.876074,0.85,2,392748,392256,492
10881381,39.4509,36.8466,500,35473,0.871215,0.79,2,392789,392289,500
10884301,63.0902,41.7693,526,35533,0.854243,0.81,2,392858,392332,526
10887221,41.418,58.7539,499,35592,0.914849,0.81,2,392894,392395,499
10890141,30.6836,42.1508,489,35651,0.92697,0.83,2,392922,392433,489
10893061,7.73672,31.6302,462,35710,0.929394,0.81,2,392924,392462,462
11033221,29,31,502,38448,0.61,1,1,394853,394351,502
11036141,26.6,26.2,503,38503,0.53,1,1,394879,394376,503
11039061,30.12,22.84,512,38558,0.418,1,1,394910,394398,512
11041981,30.024,26.168,515,38613,0.3316,1,1,394940,394425,515
11044901,26.8048,21.2336,521,38668,0.26632,1,1,394966,394445,521
11047821,18.961,34.6467,500,38723,0.237264,1,1,394983,394483,500
11050741,48.5922,74.1293,472,38778,0.0874528,1,1,395039,394567,472
11053661,48.9184,43.6259,485,38832,0.0574906,1,1,395088,394603,485
11056581,33.7837,33.5252,484,38886,0.0194981,1,1,395118,394634,484
11059501,29.1567,37.905,473,38940,0.0278996,0.99,1,395146,394673,473
11062421,53.0313,61.981,464,38994,0.0455799,0.77,1,395205,394741,464
11065341,37.0063,43.5962,458,39048,0.017116,0.65,1,395238,394780,458
11068261,38.6013,43.9192,453,39102,0.0434232,0.61,1,395277,394824,453
11071181,26.1202,31.9838,447,39156,0.0486846,0.51,1,395300,394853,447
11074101,25.224,27.1968,446,39210,0.0177369,0.39,1,395325,394879,446
11077021,24.2448,30.2394,439,39264,0.0275474,0.31,1,395349,394910,439
11079941,27.249,30.0479,437,39318,0.0135095,0.25,1,395377,394940,437
11082861,23.0498,26.8096,433,39372,0.0027019,0.23,1,395399,394966,433
11085781,16.61,18.9619,431,39426,0.0725404,0.05,1,395414,394983,431
11088701,44.122,48.5924,426,39480,0.0385081,0.05,1,395465,395039,426
11091621,48.0244,48.9185,426,39533,0.0157016,0.01,1,395514,395088,426
11094541,32.0049,33.7837,424,39586,0.0591403,0.03,1,395542,395118,424
11097461,27.201,29.1567,422,39639,0.0358281,0.05,1,395568,395146,422
11100381,53.4402,53.0313,423,39692,0.0471656,0.01,1,395628,395205,423
11103301,36.288,37.0063,422,39745,0.0174331,0.05,1,395660,395238,422
11106221,38.4576,38.6013,422,39798,0.0114866,0.05,1,395699,395277,422
11109141,26.0915,26.1202,422,39851,0.0262973,0.01,1,395722,395300,422
11112061,26.0183,25.224,423,39904,0.0932595,0.03,1,395748,395325,423
11114981,23.6037,24.2448,422,39957,0.0906519,0.01,1,395771,395349,422
11117901,27.9207,27.249,423,40010,0.0901304,0,1,395800,395377,423
11120821,22.3841,23.0498,422,40063,0.0420261,0,1,395821,395399,422
11123741,16.4768,4.60996,437,40116,0.0324052,0.09,1,395836,395399,437
11126661,44.0954,12.922,473,40169,0.046481,0.03,1,395887,395414,473
11129581,47.2191,43.3844,470,40222,0.0332962,0.01,1,395935,395465,470
11132501,34.2438,47.8769,452,40274,0.0466592,0.07,1,395966,395514,452
11135421,25.2488,31.9754,447,40326,0.0813319,0.03,1,395989,395542,447
11138341,53.0498,27.1951,481,40378,0.0882664,0.05,1,396049,395568,481
11141261,36.21,53.439,453,40430,0.0736533,0.01,1,396081,395628,453
11144181,38.442,36.2878,460,40482,0.0547307,0.01,1,396120,395660,460
11147101,26.8884,38.4576,445,40534,0.0989461,0.03,1,396144,395699,445
11150021,27.7777,26.0915,450,40586,0.0757892,0.11,1,396172,395722,450
11152941,23.1555,26.0183,446,40638,0.0711578,0.09,1,396194,395748,446
11155861,27.8311,23.6037,452,40690,0.0862316,0.09,1,396223,395771,452
11158781,20.7662,27.9207,442,40742,0.105246,0.03,1,396242,395800,442
11161701,16.9532,22.3841,437,40794,0.0770493,0.03,1,396258,395821,437
11164621,44.9907,16.4768,474,40846,0.10341,0.05,1,396310,395836,474
11167541,45.7981,44.0954,469,40898,0.140682,0.03,1,396356,395887,469
11170461,36.3596,47.2191,455,40950,0.0681364,0.05,1,396390,395935,455
11173381,24.8719,34.2438,446,41002,0.0216273,0.09,1,396412,395966,446
11176301,52.9744,25.2488,483,41053,0.0923255,0.09,1,396472,395989,483
11179221,36.9949,53.0498,456,41104,0.0904651,0.07,1,396505,396049,456
11182141,39.399,36.21,464,41155,0.106093,0.05,1,396545,396081,464
11185061,27.8798,38.442,450,41206,0.125219,0.11,1,396570,396120,450
11187981,26.376,26.8884,452,41257,0.145044,0.07,1,396596,396144,452
11190901,22.8752,27.7777,446,41308,0.149009,0.07,1,396618,396172,446
11193821,28.575,23.1555,454,41359,0.165802,0.09,1,396648,396194,454
11196741,20.115,27.8311,443,41410,0.18516,0.11,1,396666,396223,443
11199661,17.623,20.7662,441,41461,0.173032,0.07,1,396683,396242,441
11202581,45.9246,16.9532,478,41512,0.170606,0.11,1,396736,396258,478
11205501,10.7849,44.9907,428,41563,0.170121,0.15,1,396738,396310,428
11208421,36.557,45.7981,425,41614,0.186024,0.05,1,396781,396356,425
11211341,33.7114,36.3596,424,41665,0.205205,0.01,1,396814,396390,424
11214261,24.3423,24.8719,424,41716,0.177041,0.11,1,396836,396412,424
11217181,55.2685,52.9744,427,41767,0.219408,0.09,1,396899,396472,427
11220101,36.6537,36.9949,426,41818,0.259882,0.11,1,396931,396505,426
11223021,40.1307,39.399,427,41868,0.267976,0.13,1,396972,396545,427
11225941,28.8261,27.8798,428,41918,0.317595,0.15,1,396998,396570,428
11228861,27.3652,26.376,429,41968,0.279519,0.15,1,397025,396596,429
11231781,23.073,22.8752,429,42018,0.303904,0.17,1,397047,396618,429
11234701,29.4146,28.575,430,42068,0.308781,0.19,1,397078,396648,430
11237621,21.0829,20.115,431,42118,0.309756,0.17,1,397097,396666,431
11240541,17.0166,17.623,430,42168,0.341951,0.17,1,397113,396683,430
11243461,45.8033,45.9246,430,42218,0.33239,0.17,1,397166,396736,430
11246381,10.7607,10.7849,430,42268,0.330478,0.19,1,397168,396738,430
11249301,37.3521,36.557,431,42318,0.362096,0.21,1,397212,396781,431
11252221,33.0704,33.7114,430,42368,0.432419,0.17,1,397244,396814,430
11255141,24.2141,24.3423,430,42418,0.446484,0.23,1,397266,396836,430
11258061,57.6428,55.2685,433,42468,0.449297,0.27,1,397332,396899,433
11260981,38.7286,36.6537,435,42518,0.449859,0.27,1,397366,396931,435
11263901,41.3457,40.1307,436,42568,0.497972,0.33,1,397408,396972,436
11266821,29.0691,28.8261,436,42618,0.475594,0.27,1,397434,396998,436
11269741,26.6138,27.3652,435,42668,0.503119,0.31,1,397460,397025,435
11272661,22.9228,23.073,435,42717,0.508624,0.31,1,397482,397047,435
11275581,31.7846,29.4146,438,42766,0.477725,0.31,1,397516,397078,438
11278501,20.7569,21.0829,437,42815,0.487545,0.35,1,397534,397097,437
11281421,16.9514,17.0166,437,42864,0.553509,0.33,1,397550,397113,437
11284341,46.5903,45.8033,438,42913,0.598702,0.33,1,397604,397166,438
11287261,10.9181,10.7607,438,42962,0.57574,0.37,1,397606,397168,438
11290181,39.7836,37.3521,441,43011,0.619148,0.37,1,397653,397212,441
11293101,33.5567,7.47043,473,43060,0.59583,0.45,1,397685,397212,473
11296021,24.3113,27.0941,463,43109,0.591166,0.45,1,397707,397244,463
11298941,59.2623,23.0188,509,43158,0.574233,0.45,1,397775,397266,509
11301861,39.0525,57.4038,477,43207,0.570847,0.45,1,397809,397332,477
11304781,42.2105,38.6808,486,43256,0.586169,0.51,1,397852,397366,486
11307701,29.2421,41.3362,470,43305,0.605234,0.47,1,397878,397408,470
11310621,26.6484,29.0672,470,43354,0.625047,0.51,1,397904,397434,470
11313541,22.9297,26.6134,466,43403,0.645009,0.51,1,397926,397460,466
11316461,32.5859,22.9227,479,43452,0.665002,0.47,1,397961,397482,479
11319381,21.7172,31.7845,464,43501,0.685,0.49,1,397980,397516,464
11322301,17.9434,20.7569,463,43550,0.705,0.57,1,397997,397534,463
11325221,48.3887,16.9514,503,43598,0.741,0.61,1,398053,397550,503
11328141,11.2777,46.5903,451,43646,0.7482,0.57,1,398055,397604,451
11331061,40.6555,10.9181,497,43694,0.74964,0.63,1,398103,397606,497
11333981,33.7311,39.7836,482,43742,0.765928,0.59,2,398135,397653,482
11336901,24.3462,33.5567,472,43790,0.801186,0.59,2,398157,397685,472
11339821,58.4692,24.3113,517,43838,0.808237,0.57,2,398224,397707,517
11342741,38.8938,59.2623,483,43886,0.825647,0.57,2,398258,397775,483
11345661,42.9788,39.0525,493,43934,0.861129,0.59,2,398302,397809,493
11348581,30.9958,42.2105,478,43982,0.868226,0.61,2,398330,397852,478
11351501,26.9992,29.2421,478,44030,0.837645,0.63,2,398356,397878,478
11354421,24.5998,26.6484,476,44078,0.831529,0.65,2,398380,397904,476
11357341,34.52,22.9297,491,44126,0.878306,0.67,2,398417,397926,491
11360261,21.304,32.5859,474,44174,0.903661,0.69,2,398435,397961,474
11363181,18.6608,21.7172,473,44222,0.908732,0.71,2,398453,397980,473
11830381,84,55,526,23541,0.59,1,1,403515,402989,526
11833301,72,80.6,508,23631,0.446,1,1,403584,403076,508
11836221,78.4,72.92,517,23721,0.4332,0.92,1,403664,403147,517
11839141,59.68,78.584,492,23810,0.44664,0.91,1,403719,403227,492
11842061,54.336,49.3168,503,23899,0.433328,0.79,1,403772,403269,503
11844981,38.8672,61.8634,473,23988,0.462666,0.83,1,403807,403334,473
11847901,26.1734,37.9727,464,24076,0.484533,0.55,1,403830,403366,464
11850821,48.4347,59.5945,453,24164,0.472907,0.59,1,403884,403431,453
11853741,73.6869,79.1189,449,24252,0.502581,0.41,1,403964,403515,449
11856661,69.9374,71.0238,449,24339,0.556516,0.43,1,404033,403584,449
11859581,71.5875,78.2048,441,24426,0.615303,0.45,1,404105,403664,441
11862501,59.1175,59.641,442,24513,0.627061,0.43,1,404161,403719,442
11865421,53.4235,54.3282,441,24599,0.645412,0.47,1,404213,403772,441
11868341,41.8847,38.8656,445,24685,0.665082,0.49,1,404252,403807,445
11871261,24.3769,26.1731,442,24771,0.669016,0.47,1,404272,403830,442
11874181,50.4754,48.4346,445,24857,0.685803,0.51,1,404329,403884,445
11877101,74.0951,73.6869,445,24942,0.753161,0.57,2,404409,403964,445
11880021,74.019,69.9374,450,25027,0.782632,0.63,2,404483,404033,450
11882941,74.0038,71.5875,452,25112,0.820526,0.63,2,404557,404105,452
11885861,60.4008,59.1175,453,25196,0.812105,0.65,2,404614,404161,453
11888781,54.4802,53.4235,454,25280,0.794421,0.67,2,404667,404213,454
11891701,42.896,41.8847,455,25364,0.806884,0.67,2,404707,404252,455
11894621,24.5792,24.3769,455,25448,0.841377,0.67,2,404727,404272,455
11897541,51.3158,4.87539,513,25531,0.848275,0.69,2,404785,404272,513
11900461,75.0632,46.5751,537,25614,0.865655,0.77,2,404866,404329,537
11903381,76.6126,73.315,534,25697,0.885131,0.79,2,404943,404409,534
12139901,61,40,532,31680,0.79,1,2,409132,408600,532
12142821,65,58.4,535,31747,0.63,1,1,409198,408663,535
12145741,41.8,52.48,520,31814,0.502,1,1,409234,408714,520
12148661,77.16,41.696,567,31881,0.4284,0.93,1,409320,408753,567
12151581,37.832,80.3392,505,31947,0.42968,1,1,409348,408843,505
12154501,34.7664,45.6678,502,32013,0.365936,1,1,409382,408880,502
12157421,33.3533,32.3336,506,32079,0.369187,0.92,1,409415,408909,506
12160341,37.8707,39.2667,504,32145,0.321837,0.95,1,409454,408950,504
12163261,50.7741,38.2533,520,32211,0.296367,0.83,1,409508,408988,520
12166181,26.9548,50.8507,487,32277,0.259273,0.79,1,409529,409042,487
12169101,54.191,33.3701,519,32343,0.203855,0.79,1,409590,409071,519
12172021,58.8382,55.474,518,32408,0.144771,0.59,1,409650,409132,518
12174941,36.5676,63.8948,483,32473,0.116954,0.47,1,409681,409198,483
12177861,72.1135,41.579,528,32538,0.143391,0.41,1,409762,409234,528
12180781,32.8227,77.1158,465,32603,0.148678,0.43,1,409785,409320,465
12183701,32.9645,37.8232,470,32668,0.133736,0.35,1,409818,409348,470
12186621,33.7929,34.7646,470,32733,0.162747,0.37,1,409852,409382,470
12189541,8.35858,33.3529,439,32798,0.168549,0.31,1,409854,409415,439
12192461,31.2717,37.8706,437,32862,0.20171,0.29,1,409891,409454,437
12195381,47.0543,50.7741,434,32926,0.256342,0.25,1,409942,409508,434
12198301,24.6109,26.9548,432,32990,0.283268,0.19,1,409961,409529,432
12201221,52.9222,54.191,431,33054,0.352654,0.13,1,410021,409590,431
12204141,56.1844,58.8382,428,33118,0.366531,0.11,1,410078,409650,428
12207061,35.2369,36.5676,427,33182,0.369306,0.15,1,410108,409681,427
12209981,71.8474,72.1135,427,33246,0.417861,0.15,1,410189,409762,427
12212901,34.3695,32.8227,429,33310,0.411572,0.13,1,410214,409785,429
12215821,32.4739,32.9645,428,33373,0.426314,0.17,1,410246,409818,428
12218741,35.2948,33.7929,430,33436,0.445263,0.17,1,410282,409852,430
12221661,8.65896,8.35858,430,33499,0.497053,0.21,1,410284,409854,430
12224581,31.3318,31.2717,430,33562,0.491411,0.27,1,410321,409891,430
12227501,50.2664,47.0543,434,33625,0.474282,0.29,1,410376,409942,434
12230421,25.2533,24.6109,434,33688,0.518856,0.37,1,410395,409961,434
12233341,54.6507,52.9222,436,33751,0.575771,0.37,1,410457,410021,436
12236261,59.7301,56.1844,440,33814,0.603154,0.37,1,410518,410078,440
12239181,35.946,35.2369,440,33877,0.608631,0.43,1,410548,410108,440
12242101,72.7892,71.8474,441,33939,0.625726,0.41,1,410630,410189,441
12245021,36.1578,34.3695,443,34001,0.645145,0.43,1,410657,410214,443
12247941,32.8316,32.4739,443,34063,0.649029,0.45,1,410689,410246,443
12250861,36.9663,35.2948,445,34125,0.649806,0.51,1,410727,410282,445
12253781,8.99326,8.65896,445,34187,0.617961,0.49,1,410729,410284,445
12256701,30.5987,31.3318,444,34249,0.627592,0.49,1,410765,410321,444
12259621,50.1197,6.26636,499,34311,0.661518,0.47,1,410820,410321,499
12262541,26.8239,45.2533,465,34373,0.652304,0.53,1,410841,410376,465
12265461,56.5648,24.2507,510,34435,0.714461,0.59,1,410905,410395,510
12268381,60.913,54.4501,510,34496,0.758892,0.61,2,410967,410457,510
12271301,36.1826,59.69,479,34557,0.783778,0.61,2,410997,410518,479
12274221,75.2365,35.938,534,34618,0.836756,0.63,2,411082,410548,534
12277141,37.4473,72.7876,480,34679,0.863351,0.65,2,411110,410630,480
12280061,33.0895,36.1575,485,34740,0.88467,0.65,2,411142,410657,485
12282981,35.4179,32.8315,489,34801,0.904934,0.65,2,411178,410689,489
12285901,8.68358,36.9663,453,34862,0.908987,0.61,2,411180,410727,453
12288821,31.3367,8.99326,488,34923,0.893797,0.63,2,411217,410729,488
12291741,51.8673,30.5987,509,34984,0.922759,0.67,2,411274,410765,509
12318021,2,36,468,35524,0.91,0.91,2,411646,411178,468
12320941,29.2,8.8,502,35584,0.91,0.89,2,411682,411180,502
12452341,35,45,511,38165,0.75,1,2,413517,413006,511
12455261,33.4,34.6,512,38220,0.638,1,1,413550,413038,512
12458181,39.48,30.12,524,38275,0.4556,1,1,413591,413067,524
12461101,24.696,38.024,505,38330,0.40312,1,1,413612,413107,505
12464021,30.5392,31.6048,507,38385,0.360624,1,1,413644,413137,507
12466941,30.9078,34.321,503,38440,0.176125,1,1,413675,413172,503
12469861,36.5816,29.2642,513,38495,0.059225,1,1,413713,413200,513
12472781,29.7163,32.2528,508,38550,0.019845,1,1,413741,413233,508
12475701,30.7433,33.6506,505,38605,0.059969,1,1,413772,413267,505
12478621,26.1487,33.9301,496,38660,0.0679938,1,1,413797,413301,496
12481541,30.0297,49.986,473,38715,0.0535988,0.89,1,413828,413355,473
12484461,69.2059,81.9972,462,38770,0.0507198,0.77,1,413907,413445,462
12487381,40.2412,45.9994,458,38824,0.0501439,0.75,1,413940,413482,458
12490301,33.6482,37.1999,455,38878,0.0660288,0.61,1,413972,413517,455
12493221,27.5296,33.84,448,38932,0.0212058,0.41,1,413998,413550,448
12496141,31.9059,39.568,440,38986,0.0762412,0.39,1,414031,413591,440
12499061,23.9812,24.7136,441,39040,0.103248,0.35,1,414053,413612,441
12501981,25.5962,30.5427,435,39094,0.12465,0.13,1,414079,413644,435
12504901,23.5192,30.9085,427,39148,0.16093,0.03,1,414102,413675,427
12507821,31.9038,36.5817,423,39202,0.120186,0.01,1,414136,413713,423
12510741,28.7808,29.7163,423,39256,0.0240372,0.07,1,414164,413741,423
12513661,30.5562,30.7433,423,39310,0.0128074,0.07,1,414195,413772,423
12516581,27.7112,26.1487,425,39364,0.0265615,0.05,1,414222,413797,425
12519501,27.9422,30.0297,422,39418,0.0453123,0.05,1,414250,413828,422
12522421,68.7884,69.2059,422,39472,0.0490625,0.05,1,414329,413907,422
12525341,40.9577,40.2412,423,39526,0.0498125,0.07,1,414363,413940,423
12528261,34.5915,33.6482,424,39579,0.0659625,0.01,1,414396,413972,424
12531181,26.1183,27.5296,422,39632,0.0371925,0.09,1,414420,413998,422
12534101,33.2237,31.9059,424,39685,0.111439,0.11,1,414455,414031,424
12537021,24.2447,23.9812,424,39738,0.0622877,0.13,1,414477,414053,424
12539941,28.8489,25.5962,428,39791,0.116458,0.17,1,414507,414079,428
12542861,22.5698,23.5192,426,39844,0.143292,0.11,1,414528,414102,426
12545781,30.914,31.9038,425,39897,0.164658,0,1,414561,414136,425
12548701,26.1828,28.7808,422,39950,0.152932,0.01,1,414586,414164,422
12551621,31.6366,30.5562,424,40003,0.134586,0.03,1,414619,414195,424
12554541,27.1273,27.7112,423,40056,0.146917,0.05,1,414645,414222,423
12557461,27.8255,27.9422,423,40109,0.0853835,0.05,1,414673,414250,423
12560381,67.1651,5.58845,500,40162,0.0250767,0.05,1,414750,414250,500
12563301,40.633,64.3177,455,40215,0.0130153,0.05,1,414784,414329,455
12566221,35.3266,40.0635,455,40268,0.0106031,0.07,1,414818,414363,455
12569141,25.4653,34.4127,445,40320,0.0421206,0.03,1,414841,414396,445
12572061,34.6931,26.0825,458,40372,0.0324241,0.13,1,414878,414420,458
12574981,25.3386,33.2165,446,40424,0.0304848,0.05,1,414901,414455,446
12577901,31.4677,24.2433,457,40476,0.030097,0.13,1,414934,414477,457
12580821,23.8935,28.8487,449,40528,0.0460194,0.15,1,414956,414507,449
12583741,31.9787,22.5697,462,40580,0.0652039,0.17,1,414990,414528,462
12586661,25.5957,30.9139,453,40632,0.101041,0.15,1,415014,414561,453
12589581,30.7191,26.1828,460,40684,0.108208,0.13,1,415046,414586,460
12592501,24.5438,31.6366,450,40736,0.109642,0.15,1,415069,414619,450
12595421,27.3088,27.1273,452,40788,0.109928,0.07,1,415097,414645,452
12598341,66.2618,27.8255,500,40840,0.0779857,0.01,1,415173,414673,500
12601261,39.6523,67.1651,456,40892,0.0555971,0.01,1,415206,414750,456
12604181,35.1305,40.633,456,40944,0.0831194,0.01,1,415240,414784,456
12607101,24.6261,35.3266,444,40996,0.0726239,0.05,1,415262,414818,444
12610021,35.3252,25.4653,459,41047,0.0385248,0.03,1,415300,414841,459
12612941,26.265,34.6931,446,41098,0.015705,0.03,1,415324,414878,446
12615861,30.853,25.3386,455,41149,0.043141,0.03,1,415356,414901,455
12618781,24.5706,31.4677,445,41200,0.0326282,0.05,1,415379,414934,445
12621701,32.9141,23.8935,458,41251,0.0465256,0.07,1,415414,414956,458
12624621,27.3828,31.9787,450,41302,0.0493051,0.11,1,415440,414990,450
12627541,31.8766,25.5957,459,41353,0.081861,0.11,1,415473,415014,459
12630461,23.9753,30.7191,449,41404,0.0563722,0.11,1,415495,415046,449
12633381,27.1951,24.5438,454,41455,0.0512744,0.11,1,415523,415069,454
12636301,64.639,27.3088,500,41506,0.0662549,0.07,1,415597,415097,500
12639221,14.5278,66.2618,426,41557,0.069251,0.05,1,415599,415173,426
12642141,27.7056,39.6523,424,41608,0.11785,0.09,1,415630,415206,424
12645061,33.5411,35.1305,425,41659,0.12757,0.07,1,415665,415240,425
12647981,24.3082,24.6261,425,41710,0.097514,0.03,1,415687,415262,425
12650901,34.4616,35.3252,424,41761,0.139503,0.01,1,415724,415300,424
12653821,26.0923,26.265,424,41812,0.179901,0.05,1,415748,415324,424
12656741,30.8185,30.853,424,41862,0.18798,0.03,1,415780,415356,424
12659661,23.7637,24.5706,423,41912,0.173596,0.05,1,415802,415379,423
12662581,33.5527,32.9141,424,41962,0.218719,0.05,1,415838,415414,424
12665501,28.3105,27.3828,425,42012,0.259744,0.09,1,415865,415440,425
12668421,31.2621,31.8766,424,42062,0.299949,0.05,1,415897,415473,424
12671341,23.8524,23.9753,424,42112,0.32399,0.05,1,415919,415495,424
12674261,27.1705,27.1951,424,42162,0.360798,0.07,1,415947,415523,424
12677181,65.4341,64.639,425,42212,0.41616,0.07,1,416022,415597,425
12680101,14.6868,14.5278,425,42262,0.427232,0.13,1,416024,415599,425
12683021,29.3374,27.7056,427,42312,0.429446,0.13,1,416057,415630,427
12685941,33.0675,33.5411,426,42362,0.429889,0.09,1,416091,415665,426
12688861,25.0135,24.3082,427,42412,0.445978,0.15,1,416114,415687,427
12691781,36.2027,34.4616,429,42462,0.465196,0.19,1,416153,415724,429
12694701,26.4405,26.0923,429,42512,0.437039,0.19,1,416177,415748,429
12697621,31.6881,30.8185,430,42562,0.463408,0.17,1,416210,415780,430
12700541,23.9376,23.7637,430,42612,0.484682,0.23,1,416232,415802,430
12703461,35.9875,33.5527,433,42662,0.488936,0.27,1,416271,415838,433
12706381,30.3975,28.3105,435,42711,0.505787,0.31,1,416300,415865,435
12709301,34.0795,31.2621,438,42760,0.541157,0.33,1,416335,415897,438
12712221,24.4159,23.8524,438,42809,0.580231,0.37,1,416357,415919,438
12715141,27.2832,27.1705,438,42858,0.604046,0.43,1,416385,415947,438
12718061,67.8566,65.4341,441,42907,0.576809,0.43,1,416463,416022,441
12720981,15.1713,14.6868,441,42956,0.603362,0.43,1,416465,416024,441
12723901,29.4343,29.3374,441,43005,0.592672,0.43,1,416498,416057,441
12726821,33.8869,5.86747,476,43054,0.590534,0.43,1,416533,416057,476
12729741,24.3774,28.3735,464,43103,0.590107,0.45,1,416555,416091,464
12732661,36.8755,24.0747,481,43152,0.638021,0.47,1,416595,416114,481
12735581,26.5751,36.0149,466,43201,0.647604,0.43,1,416619,416153,466
12738501,34.115,26.403,478,43250,0.649521,0.47,1,416655,416177,478
12741421,24.423,31.6806,467,43299,0.649904,0.49,1,416677,416210,467
12744341,36.0846,23.9361,484,43348,0.649981,0.49,1,416716,416232,484
12747261,29.6169,35.9872,473,43397,0.649996,0.51,1,416744,416271,473
12750181,37.1234,30.3974,483,43446,0.649999,0.55,1,416783,416300,483
12753101,25.0247,34.0795,470,43495,0.666,0.59,1,416805,416335,470
12756021,28.2049,24.4159,477,43544,0.6692,0.61,1,416834,416357,477
12758941,68.041,27.2832,527,43592,0.71784,0.57,1,416912,416385,527
12761861,15.2082,67.8566,451,43640,0.727568,0.61,1,416914,416463,451
12764781,31.0416,15.1713,484,43688,0.745514,0.59,1,416949,416465,484
12767701,33.4083,29.4343,485,43736,0.749103,0.59,1,416983,416498,485
12770621,25.0817,33.8869,473,43784,0.765821,0.59,2,417006,416533,473
12773541,38.6163,24.3774,493,43832,0.801164,0.65,2,417048,416555,493
12776461,26.9233,36.8755,477,43880,0.808233,0.65,2,417072,416595,477
12779381,34.1847,26.5751,489,43928,0.809647,0.65,2,417108,416619,489
12782301,25.2369,34.115,476,43976,0.825929,0.65,2,417131,416655,476
12785221,35.4474,24.423,492,44024,0.813186,0.65,2,417169,416677,492
12788141,29.4895,36.0846,481,44072,0.810637,0.65,2,417197,416716,481
12791061,37.0979,29.6169,492,44120,0.794127,0.65,2,417236,416744,492
12793981,25.8196,37.1234,476,44168,0.790825,0.67,2,417259,416783,476
12796901,28.3639,25.0247,483,44216,0.774165,0.67,2,417288,416805,483
12799821,70.4728,28.2049,535,44264,0.818833,0.73,2,417369,416834,535
12802741,15.6946,68.041,459,44312,0.827767,0.73,2,417371,416912,459
12805661,30.3389,15.2082,491,44360,0.845553,0.75,2,417405,416914,491
12808581,34.8678,31.0416,492,44408,0.849111,0.75,2,417441,416949,492
12811501,26.1736,33.4083,482,44456,0.865822,0.77,2,417465,416983,482
12814421,6.83471,25.0817,461,44503,0.869164,0.81,2,417467,417006,461
12817341,35.7669,38.6163,462,44550,0.917833,0.81,2,417510,417048,462
12820261,26.3534,26.9233,462,44597,0.943567,0.81,2,417534,417072,462
13008601,130,68,556,22093,0.61,0.91,1,419724,419168,556
13011521,85.2,112.8,506,22189,0.674,0.83,1,419798,419292,506
13014441,69.04,84.96,493,22285,0.7508,0.71,2,419863,419370,493
13017361,44.208,56.992,481,22380,0.79816,0.63,2,419901,419420,481
13020281,55.2416,67.3984,469,22475,0.807632,0.67,2,419959,419490,469
13023201,30.2483,36.6797,464,22569,0.825526,0.59,2,419983,419519,464
13026121,55.6497,28.1359,500,22663,0.861105,0.69,2,420045,419545,500
13029041,115.13,44.8272,581,22757,0.900221,0.61,2,420175,419594,581
13031961,87.026,112.965,531,22850,0.924044,0.69,2,420255,419724,531
13148761,102,71,565,26307,0.55,1,1,422718,422153,565
13151681,49.2,79,520,26388,0.438,1,1,422754,422234,520
13154601,56.24,43.8,543,26468,0.4316,1,1,422812,422269,543
13157521,28.848,58.36,503,26548,0.35032,1,1,422834,422331,503
13160441,32.1696,35.672,506,26628,0.350064,1,1,422867,422361,506
13163361,65.6339,37.5344,542,26708,0.270013,1,1,422941,422399,542
13166281,72.3268,64.3069,545,26787,0.254003,0.87,1,423015,422470,545
13169201,54.4654,81.6614,509,26866,0.250801,0.63,1,423065,422556,509
13172121,12.4931,64.3323,451,26945,0.25016,0.55,1,423067,422616,451
13175041,82.4986,94.4665,449,27024,0.250032,0.41,1,423167,422718,449
13177961,42.8997,47.6933,446,27102,0.298006,0.43,1,423200,422754,446
13180881,50.1799,55.9387,440,27180,0.291601,0.33,1,423252,422812,440
13183801,23.636,28.7877,435,27258,0.27432,0.35,1,423269,422834,435
13186721,33.5272,32.1575,438,27336,0.334864,0.25,1,423305,422867,438
13189641,62.7054,65.6315,434,27413,0.346973,0.25,1,423375,422941,434
13192561,71.7411,72.3263,434,27490,0.397395,0.25,1,423449,423015,434
13195481,54.3482,54.4653,434,27567,0.439479,0.25,1,423499,423065,434
13198401,12.4696,12.4931,434,27644,0.447896,0.25,1,423501,423067,434
13201321,82.4939,82.4986,434,27721,0.545579,0.31,1,423601,423167,434
13204241,43.6988,42.8997,435,27797,0.581116,0.29,1,423635,423200,435
13207161,49.5398,50.1799,434,27873,0.588223,0.27,1,423686,423252,434
13210081,24.308,23.636,435,27949,0.589645,0.35,1,423704,423269,435
13213001,36.8616,33.5272,439,28025,0.589929,0.35,1,423744,423305,439
13215921,64.1723,62.7054,440,28101,0.637986,0.41,1,423815,423375,440
13218841,74.4345,71.7411,443,28176,0.711597,0.45,1,423892,423449,443
13221761,55.6869,54.3482,444,28251,0.726319,0.45,1,423943,423499,444
13224681,12.7374,12.4696,444,28326,0.729264,0.57,1,423945,423501,444
13227601,85.7475,82.4939,448,28401,0.761853,0.57,2,424049,423601,448
13230521,44.3495,16.4988,482,28476,0.736371,0.59,1,424083,423601,482
13233441,51.2699,30.4998,501,28550,0.747274,0.59,1,424136,423635,501
13236361,24.654,46.9,468,28624,0.765455,0.59,2,424154,423686,468
13239281,36.9308,23.78,490,28698,0.769091,0.59,2,424194,423704,490
13242201,66.5862,36.756,524,28772,0.817818,0.65,2,424268,423744,524
13245121,78.1172,64.1512,534,28846,0.843564,0.73,2,424349,423815,534
13248041,56.4234,74.4302,508,28919,0.912713,0.73,2,424400,423892,508
13250961,12.8847,55.686,459,28992,0.926543,0.73,2,424402,423943,459
13373601,26,30,502,31914,0.73,1,1,426466,425964,502
13376521,34.8,27.6,512,31980,0.682,1,1,426503,425991,512
13379441,31.76,29.52,513,32046,0.6244,1,1,426534,426021,513
13382361,34.352,29.904,518,32112,0.53288,1,1,426569,426051,518
13385281,50.8704,31.5808,541,32178,0.498576,1,1,426624,426083,541
13388201,77.3741,67.1162,549,32244,0.347715,1,1,426708,426159,549
13391121,60.2748,76.6232,526,32310,0.189543,1,1,426764,426238,526
13394041,36.855,59.3246,502,32375,0.125909,0.91,1,426795,426293,502
13396961,66.571,37.4649,544,32440,0.0971817,0.85,1,426869,426325,544
13399881,32.5142,71.493,488,32505,0.107436,0.73,1,426893,426405,488
13402801,27.3028,42.2986,479,32570,0.0454873,0.73,1,426919,426440,479
13405721,32.6606,29.2597,487,32635,0.0330975,0.67,1,426953,426466,487
13408641,28.1321,35.4519,477,32700,0.0466195,0.61,1,426980,426503,477
13411561,32.0264,31.8904,479,32765,0.0173239,0.51,1,427013,426534,479
13414481,8.00528,34.3781,446,32830,0.0114648,0.49,1,427015,426569,446
13417401,38.4011,50.8756,437,32894,0.026293,0.31,1,427061,426624,437
13420321,73.2802,77.3751,435,32958,0.0452586,0.15,1,427143,426708,435
13423241,53.856,60.275,428,33022,0.0650517,0.11,1,427192,426764,428
13426161,34.7712,36.855,427,33086,0.11701,0.09,1,427222,426795,427
13429081,65.3542,66.571,426,33150,0.127402,0.11,1,427295,426869,426
13432001,30.6708,32.5142,424,33214,0.14548,0.03,1,427317,426893,424
13434921,26.9342,27.3028,424,33278,0.229096,0.03,1,427343,426919,424
13437841,32.5868,32.6606,424,33342,0.213819,0.05,1,427377,426953,424
13440761,28.1174,28.1321,424,33405,0.226764,0.01,1,427404,426980,424
13443681,30.4235,32.0264,422,33468,0.277353,0.01,1,427435,427013,422
13446601,7.68469,8.00528,422,33531,0.287471,0.03,1,427437,427015,422
13449521,39.9369,38.4011,424,33594,0.273494,0.05,1,427485,427061,424
13452441,73.5874,73.2802,424,33657,0.302699,0.07,1,427567,427143,424
13455361,54.7175,53.856,425,33720,0.35654,0.13,1,427617,427192,425
13458281,37.3435,34.7712,428,33783,0.351308,0.13,1,427650,427222,428
13461201,66.6687,65.3542,429,33846,0.414262,0.15,1,427724,427295,429
13464121,32.5337,30.6708,431,33908,0.426852,0.25,1,427748,427317,431
13467041,28.1067,26.9342,432,33970,0.44537,0.21,1,427775,427343,432
13469961,32.8214,32.5868,432,34032,0.465074,0.23,1,427809,427377,432
13472881,27.3643,28.1174,431,34094,0.501015,0.29,1,427835,427404,431
13475801,32.6729,30.4235,434,34156,0.508203,0.29,1,427869,427435,434
13478721,8.13457,7.68469,434,34218,0.509641,0.29,1,427871,427437,434
13481641,40.8269,1.53694,483,34280,0.493928,0.27,1,427920,427437,483
13484561,74.5654,38.7074,518,34342,0.490786,0.31,1,428003,427485,518
13487481,55.7131,73.3415,487,34404,0.522157,0.37,1,428054,427567,487
13490401,38.3426,54.6683,471,34465,0.528431,0.35,1,428088,427617,471
13493321,68.4685,37.3337,514,34526,0.577686,0.43,1,428164,427650,514
13496241,34.4937,66.6667,466,34587,0.587537,0.43,1,428190,427724,466
13499161,29.2987,32.5333,470,34648,0.605507,0.45,1,428218,427748,470
13502081,33.8597,28.1067,478,34709,0.657102,0.47,1,428253,427775,478
13505001,27.572,32.8213,470,34770,0.68342,0.51,1,428279,427809,470
13507921,34.3144,27.3643,480,34831,0.736684,0.51,1,428315,427835,480
13510841,8.46288,32.6729,448,34892,0.747337,0.51,1,428317,427869,448
13513761,40.8926,8.13457,495,34953,0.749467,0.49,1,428366,427871,495
13516681,73.7785,40.8269,528,35013,0.749893,0.49,1,428448,427920,528
13519601,57.1557,74.5654,498,35073,0.765979,0.53,2,428501,428003,498
13522521,38.6311,55.7131,481,35133,0.769196,0.53,2,428535,428054,481
13525441,70.9262,38.3426,526,35193,0.801839,0.59,2,428614,428088,526
13528361,34.9852,68.4685,476,35253,0.808368,0.59,2,428640,428164,476
13531281,30.997,34.4937,480,35313,0.809674,0.61,2,428670,428190,480
13534201,36.5994,29.2987,490,35373,0.809935,0.67,2,428708,428218,490
13537121,28.9199,33.8597,482,35433,0.761987,0.69,2,428735,428253,482
13540041,36.184,27.572,494,35493,0.784397,0.75,2,428773,428279,494
13542961,8.83679,34.3144,460,35553,0.788879,0.75,2,428775,428315,460
13545881,40.9674,8.46288,507,35612,0.773776,0.75,2,428824,428317,507
13548801,73.7935,40.8926,540,35671,0.770755,0.75,2,428906,428366,540
13551721,16.3587,73.7785,460,35730,0.770151,0.77,2,428908,428448,460
13554641,45.6717,57.1557,460,35789,0.83403,0.77,2,428961,428501,460
13557561,37.1343,38.6311,461,35848,0.830806,0.81,2,428996,428535,461
13560481,71.4269,70.9262,462,35907,0.830161,0.81,2,429076,428614,462
13563401,35.0854,34.9852,462,35966,0.878032,0.81,2,429102,428640,462
13566321,29.4171,30.997,460,36025,0.903606,0.81,2,429130,428670,460
13569241,36.2834,36.5994,460,36084,0.876721,0.75,2,429168,428708,460
13572161,29.6567,28.9199,461,36143,0.903344,0.79,2,429196,428735,461
13575081,36.3313,36.184,461,36201,0.924669,0.79,2,429234,428773,461
13578001,8.86627,8.83679,461,36259,0.944934,0.77,2,429236,428775,461
13724001,21,35,487,39065,0.85,1,2,431201,430714,487
13726921,57,63.8,482,39119,0.658,1,1,431267,430785,482
13729841,41,42.36,482,39173,0.5396,1,1,431304,430822,482
13732761,45,38.872,490,39227,0.45192,1,1,431350,430860,490
13735681,36.2,30.1744,496,39281,0.306384,1,1,431384,430888,496
13738601,36.84,31.6349,501,39335,0.197277,1,1,431421,430920,501
13741521,30.568,38.327,490,39389,0.207455,1,1,431450,430960,490
13744441,36.5136,38.8654,489,39443,0.0814911,1,1,431488,430999,489
13747361,32.1027,39.7731,480,39497,0.0562982,1,1,431519,431039,480
13750281,32.8205,36.7546,477,39550,0.0192596,0.99,1,431552,431075,477
13753201,27.3641,29.7509,475,39603,0.0598519,0.91,1,431578,431103,475
13756121,31.0728,37.1502,468,39656,0.0359704,0.85,1,431610,431142,468
13759041,34.2146,37.83,465,39709,0.0471941,0.85,1,431645,431180,465
13761961,18.0429,24.366,458,39762,0.0814388,0.61,1,431659,431201,458
13764881,50.0086,57.6732,450,39815,0.0562878,0.51,1,431717,431267,450
13767801,37.2017,41.1346,447,39868,0.0992576,0.43,1,431751,431304,447
13770721,38.6403,45.0269,440,39921,0.0918515,0.27,1,431790,431350,440
13773641,29.3281,36.2054,433,39974,0.12237,0.17,1,431817,431384,433
13776561,29.8656,36.8411,426,40027,0.0964741,0.21,1,431847,431421,426
13779481,29.9731,30.5682,427,40080,0.123295,0.21,1,431877,431450,427
13782401,33.1946,6.11364,461,40133,0.112659,0.05,1,431911,431450,461
13785321,29.8389,31.6227,452,40186,0.0785318,0.05,1,431940,431488,452
13788241,33.1678,31.1245,455,40239,0.0877064,0.01,1,431974,431519,455
13791161,26.6336,32.6249,447,40291,0.0735413,0.07,1,431999,431552,447
13794081,30.9267,27.325,453,40343,0.0707083,0.03,1,432031,431578,453
13797001,35.7853,31.065,458,40395,0.0541417,0.05,1,432068,431610,458
13799921,18.3571,34.213,437,40447,0.0508283,0.09,1,432082,431645,437
13802841,50.0714,18.0426,481,40499,0.0661657,0.05,1,432140,431659,481
13805761,38.0143,50.0085,458,40551,0.101233,0.11,1,432175,431717,458
13808681,39.6029,37.2017,464,40603,0.156247,0.09,1,432215,431751,464
13811601,28.7206,38.6403,451,40655,0.199249,0.13,1,432241,431790,451
13814521,31.3441,29.3281,456,40707,0.19185,0.09,1,432273,431817,456
13817441,27.8688,29.8656,453,40759,0.27037,0.13,1,432300,431847,453
13820361,35.1738,29.9731,460,40811,0.270074,0.11,1,432337,431877,460
13823281,27.0348,33.1946,451,40863,0.254015,0.07,1,432362,431911,451
13826201,33.407,29.8389,457,40915,0.218803,0.09,1,432397,431940,457
13829121,25.0814,33.1678,446,40967,0.195761,0.07,1,432420,431974,446
13832041,31.4163,26.6336,454,41019,0.159152,0.07,1,432453,431999,454
13834961,36.6833,30.9267,460,41070,0.16783,0.05,1,432491,432031,460
13837881,19.3367,35.7853,438,41121,0.185566,0.05,1,432506,432068,438
13840801,50.2673,18.3571,482,41172,0.221113,0.07,1,432564,432082,482
13843721,39.6535,50.0714,461,41223,0.228223,0.11,1,432601,432140,461
13846641,42.3307,38.0143,469,41274,0.245645,0.17,1,432644,432175,469
13849561,30.0661,39.6029,456,41325,0.233129,0.21,1,432671,432215,456
13852481,34.0132,28.7206,465,41376,0.214626,0.19,1,432706,432241,465
13855401,30.0026,31.3441,462,41427,0.194925,0.29,1,432735,432273,462
13858321,34.8005,27.8688,471,41478,0.190985,0.27,1,432771,432300,471
13861241,26.1601,35.1738,458,41529,0.190197,0.25,1,432795,432337,458
13864161,6.83202,27.0348,435,41580,0.190039,0.21,1,432797,432362,435
13867081,26.9664,33.407,432,41631,0.238008,0.19,1,432829,432397,432
13870001,23.7933,25.0814,432,41682,0.247602,0.15,1,432852,432420,432
13872921,29.5587,31.4163,430,41733,0.26552,0.17,1,432883,432453,430
13875841,36.3117,36.6833,430,41784,0.301104,0.19,1,432921,432491,430
13878761,20.8623,19.3367,432,41835,0.292221,0.23,1,432938,432506,432
13881681,51.3725,50.2673,433,41885,0.258444,0.23,1,432997,432564,433
13884601,39.8745,39.6535,433,41935,0.267689,0.25,1,433034,432601,433
13887521,43.1749,42.3307,434,41985,0.253538,0.23,1,433078,432644,434
13890441,29.435,30.0661,433,42035,0.266708,0.21,1,433104,432671,433
13893361,33.087,34.0132,432,42085,0.333342,0.19,1,433138,432706,432
13896281,29.0174,30.0026,431,42135,0.314668,0.19,1,433166,432735,431
13899201,34.6035,34.8005,431,42185,0.342934,0.19,1,433202,432771,431
13902121,26.1207,26.1601,431,42235,0.412587,0.19,1,433226,432795,431
13905041,6.82414,6.83202,431,42285,0.394517,0.25,1,433228,432797,431
13907961,27.7648,26.9664,432,42335,0.406903,0.25,1,433261,432829,432
13910881,25.553,23.7933,434,42385,0.457381,0.27,1,433286,432852,434
13913801,30.7106,29.5587,435,42435,0.467476,0.31,1,433318,432883,435
13916721,36.5421,36.3117,435,42485,0.533495,0.29,1,433356,432921,435
13919641,20.1084,20.8623,434,42535,0.514699,0.25,1,433372,432938,434
13922561,51.2217,51.3725,434,42585,0.49494,0.27,1,433431,432997,434
13925481,39.0443,39.8745,433,42635,0.522988,0.25,1,433467,433034,433
13928401,43.8089,43.1749,434,42684,0.528598,0.27,1,433512,433078,434
13931321,31.1618,29.435,436,42733,0.57772,0.35,1,433540,433104,436
13934241,34.2324,33.087,437,42782,0.587544,0.31,1,433575,433138,437
13937161,29.2465,29.0174,437,42831,0.589509,0.35,1,433603,433166,437
13940081,37.8493,34.6035,441,42880,0.653902,0.43,1,433643,433202,441
13943001,26.7699,26.1207,441,42929,0.69878,0.39,1,433667,433226,441
13945921,6.95397,6.82414,441,42978,0.675756,0.41,1,433669,433228,441
13948841,28.5908,27.7648,442,43027,0.671151,0.41,1,433703,433261,442
13951761,27.3182,5.55297,469,43076,0.70223,0.47,1,433730,433261,469
13954681,31.8636,21.1106,477,43125,0.692446,0.47,1,433763,433286,477
13957601,37.5727,29.8221,484,43174,0.674489,0.55,1,433802,433318,484
13960521,20.3145,36.3644,462,43223,0.686898,0.51,1,433818,433356,462
13963441,50.4629,20.0729,504,43272,0.70538,0.49,1,433876,433372,504
13966361,39.6926,51.2146,482,43321,0.693076,0.53,1,433913,433431,482
13969281,45.5385,39.0429,493,43370,0.738615,0.53,1,433960,433467,493
13972201,31.5077,43.8086,476,43419,0.763723,0.59,2,433988,433512,476
13975121,34.3015,31.1617,483,43468,0.768745,0.59,2,434023,433540,483
13978041,29.2603,34.2323,476,43517,0.769749,0.59,2,434051,433575,476
13980961,42.6521,29.2465,494,43565,0.81795,0.67,2,434097,433603,494
13983881,27.7304,37.8493,478,43613,0.87559,0.71,2,434121,433643,478
13986801,7.14608,26.7699,456,43661,0.887118,0.67,2,434123,433667,456
13989721,28.6292,6.95397,488,43709,0.921424,0.67,2,434157,433669,488
13992641,28.9258,28.5908,483,43757,0.928285,0.71,2,434186,433703,483
14245221,74,39,457,21270,0.09,0.03,1,437317,436860,457
14248141,63.6,59.8,453,21370,0.074,0.07,1,437378,436925,453
14251061,75.92,72.76,456,21469,0.0548,0.05,1,437457,437001,456
14253981,86.384,65.752,481,21568,0.03496,0.05,1,437546,437065,481
14256901,40.4768,68.3504,441,21666,0.094992,0.05,1,437575,437134,441
14259821,49.6954,42.4701,457,21764,0.106998,0.03,1,437627,437170,457
14262741,41.1391,66.894,423,21861,0.1894,0.09,1,437666,437243,423
14265661,68.2278,72.5788,424,21958,0.0778799,0.07,1,437741,437317,424
14268581,61.6456,63.3158,423,22055,0.039576,0.05,1,437801,437378,423
14271501,75.5291,75.8632,423,22151,0.0319152,0.03,1,437880,437457,423
14274421,87.1058,86.3726,424,22247,0.062383,0.11,1,437970,437546,424
14277341,43.0212,40.4745,427,22342,0.0844766,0.11,1,438002,437575,427
14280261,53.4042,49.6949,431,22437,0.136895,0.21,1,438058,437627,431
14283181,41.0808,41.139,430,22532,0.147379,0.21,1,438096,437666,430
14286101,62.6162,8.2278,498,22626,0.181476,0.05,1,438164,437666,498
14289021,60.5232,61.6456,483,22720,0.172295,0.03,1,438224,437741,483
14291941,74.5046,60.3291,501,22813,0.122459,0.03,1,438302,437801,501
14294861,89.3009,75.2658,515,22906,0.0964918,0.07,1,438395,437880,515
14297781,43.4602,87.0532,457,22999,0.107298,0.09,1,438427,437970,457
14300701,54.292,43.0106,482,23091,0.15746,0.15,1,438484,438002,482
14303621,42.8584,53.4021,466,23183,0.167492,0.15,1,438524,438058,466
14306541,64.5717,41.0804,498,23274,0.169498,0.19,1,438594,438096,498
14309461,60.9143,62.6161,490,23365,0.2179,0.17,1,438654,438164,490
14312381,71.3829,60.5232,504,23456,0.19558,0.11,1,438728,438224,504
14315301,87.8766,74.5046,518,23546,0.223116,0.09,1,438820,438302,518
14318221,43.9753,89.3009,458,23636,0.212623,0.11,1,438853,438395,458
14321141,56.7951,43.4602,486,23726,0.242525,0.17,1,438913,438427,486
14324061,43.359,54.292,469,23815,0.216505,0.17,1,438953,438484,469
14326981,64.6718,42.8584,499,23904,0.243301,0.17,1,439023,438524,499
14329901,14.5344,64.5717,431,23993,0.24866,0.23,1,439025,438594,431
14332821,50.9069,60.9143,431,24081,0.313732,0.19,1,439085,438654,431
14335741,70.1814,71.3829,432,24169,0.326746,0.23,1,439160,438728,432
14338661,88.4363,87.8766,433,24257,0.409349,0.21,1,439253,438820,433
14341581,43.2873,43.9753,432,24344,0.40987,0.25,1,439285,438853,432
14344501,58.2575,56.7951,434,24431,0.441974,0.21,1,439347,438913,434
14347421,42.0515,43.359,432,24518,0.448395,0.25,1,439385,438953,432
14350341,67.6103,64.6718,436,24604,0.529679,0.25,1,439459,439023,436
14353261,15.1221,14.5344,436,24690,0.545936,0.33,1,439461,439025,436
14356181,51.0244,50.9069,436,24776,0.565187,0.33,1,439521,439085,436
14359101,71.8049,70.1814,438,24862,0.617037,0.43,1,439598,439160,438
14362021,91.961,88.4363,442,24947,0.675407,0.41,1,439695,439253,442
14364941,43.9922,43.2873,442,25032,0.655082,0.45,1,439727,439285,442
14367861,58.3984,58.2575,442,25117,0.731016,0.45,1,439789,439347,442
14370781,42.8797,42.0515,443,25201,0.730203,0.55,1,439828,439385,443
14373701,72.5759,67.6103,449,25285,0.714041,0.55,1,439908,439459,449
14376621,16.1152,15.1221,449,25369,0.710808,0.57,1,439910,439461,449
14379541,52.823,51.0244,451,25453,0.790162,0.57,2,439972,439521,451
14382461,71.3646,10.2049,527,25536,0.838032,0.63,2,440048,439521,527
14385381,94.2729,63.641,550,25619,0.815606,0.69,2,440148,439598,550
14388301,44.4546,90.3282,485,25702,0.827121,0.65,2,440180,439695,485
14391221,60.8909,43.6656,518,25784,0.877424,0.75,2,440245,439727,518
14394141,43.3782,58.3331,495,25866,0.871485,0.73,2,440284,439789,495
14516781,46,31,515,29105,0.21,1,1,442595,442080,515
14519701,37.2,30.2,520,29178,0.114,1,1,442630,442110,520
14522621,36.24,38.04,516,29251,0.0628,1,1,442666,442150,516
14525541,68.048,35.608,557,29323,0.06856,1,1,442742,442185,557
14528461,38.4096,68.7216,511,29395,0.037712,1,1,442773,442262,511
14531381,33.2819,38.5443,512,29467,0.0635424,1,1,442805,442293,512
14534301,61.8564,37.3089,544,29539,0.0367085,0.95,1,442874,442330,544
14537221,81.1713,68.2618,554,29611,0.0313417,0.49,1,442960,442406,554
14540141,37.0343,100.852,471,29682,0.0142683,0.37,1,442986,442515,471
14543061,37.0069,47.3705,474,29753,0.0588537,0.21,1,443023,442549,474
14545981,33.0014,46.2741,460,29824,0.0517707,0.09,1,443055,442595,460
14548901,8.20027,37.2548,427,29895,0.0503541,0.05,1,443057,442630,427
14551821,28.8401,36.251,425,29966,0.0660708,0.07,1,443091,442666,425
14554741,64.968,68.0502,423,30037,0.0532142,0.03,1,443165,442742,423
14557661,40.1936,38.41,426,30107,0.0826428,0.07,1,443199,442773,426
14560581,34.4387,33.282,427,30177,0.0245286,0.03,1,443232,442805,427
14563501,59.6877,61.8564,424,30247,0.0289057,0.03,1,443298,442874,424
14566421,80.7376,81.1713,424,30317,0.0777811,0.01,1,443384,442960,424
14569341,36.9475,37.0343,424,30387,0.0875562,0.07,1,443410,442986,424
14572261,36.1895,37.0069,423,30457,0.0895113,0.05,1,443446,443023,423
14575181,33.6379,33.0014,424,30526,0.105902,0.05,1,443479,443055,424
14578101,8.32758,8.20027,424,30595,0.0771804,0.07,1,443481,443057,424
14581021,27.2655,28.8401,422,30664,0.103436,0.05,1,443513,443091,422
14583941,64.6531,64.968,422,30733,0.0286872,0.09,1,443587,443165,422
14586861,42.5306,40.1936,425,30802,0.0297374,0.01,1,443624,443199,425
14589781,34.1061,34.4387,424,30871,0.0139475,0.03,1,443656,443232,424
14592701,58.0212,59.6877,422,30940,0.0267895,0.09,1,443720,443298,422
14595621,82.0042,80.7376,424,31008,0.0453579,0.09,1,443808,443384,424
14598541,38.8008,36.9475,426,31076,0.0490716,0.09,1,443836,443410,426
14601461,34.9602,36.1895,424,31144,0.0338143,0.11,1,443870,443446,424
14604381,34.192,33.6379,425,31212,0.0467629,0.07,1,443904,443479,425
14607301,8.43841,8.32758,425,31280,0.0813526,0.07,1,443906,443481,425
14610221,26.4877,1.66552,456,31348,0.0882705,0.11,1,443937,443481,456
14613141,62.8975,25.9331,496,31415,0.0256541,0.01,1,444009,443513,496
14616061,42.1795,64.3866,459,31482,0.0291308,0.03,1,444046,443587,459
14618981,33.2359,42.4773,453,31549,0.0298262,0.01,1,444077,443624,453
14621901,57.8472,34.0955,485,31616,0.0299652,0.03,1,444141,443656,485
14624821,81.9694,58.0191,509,31683,0.109993,0.05,1,444229,443720,509
14627741,38.7939,82.0038,449,31750,0.157999,0.05,1,444257,443808,449
14630661,35.7588,38.8008,456,31817,0.1516,0.03,1,444292,443836,456
14633581,35.1518,34.9602,457,31883,0.13432,0.05,1,444327,443870,457
14636501,8.63035,34.192,425,31949,0.130864,0.09,1,444329,443904,425
14639421,28.1261,8.43841,456,32015,0.162173,0.09,1,444362,443906,456
14642341,60.0252,26.4877,493,32081,0.184435,0.01,1,444430,443937,493
14645261,42.405,62.8975,459,32147,0.108887,0.03,1,444468,444009,459
14648181,34.081,42.1795,454,32213,0.0777774,0.03,1,444500,444046,454
14651101,57.2162,33.2359,486,32279,0.0235555,0.03,1,444563,444077,486
14654021,86.6432,57.8472,516,32345,0.0607111,0.13,1,444657,444141,516
14656941,40.5286,81.9694,457,32410,0.100142,0.17,1,444686,444229,457
14659861,35.3057,38.7939,463,32475,0.124028,0.15,1,444720,444257,463
14662781,34.2611,35.7588,462,32540,0.128806,0.13,1,444754,444292,462
14665701,8.45223,35.1518,429,32605,0.129761,0.13,1,444756,444327,429
14668621,29.6904,8.63035,462,32670,0.113952,0.17,1,444791,444329,462
14671541,61.1381,28.1261,498,32735,0.11079,0.19,1,444860,444362,498
14674461,13.8276,60.0252,432,32800,0.126158,0.09,1,444862,444430,432
14677381,28.3655,42.405,426,32864,0.145232,0.07,1,444894,444468,426
14680301,28.0731,34.081,422,32928,0.181046,0.01,1,444922,444500,422
14683221,57.6146,57.2162,424,32992,0.156209,0.07,1,444987,444563,424
14686141,89.1229,86.6432,427,33056,0.199242,0.11,1,445084,444657,427
14689061,41.0246,40.5286,427,33120,0.207848,0.13,1,445113,444686,427
14691981,36.2049,35.3057,428,33184,0.28957,0.13,1,445148,444720,428
14694901,34.441,34.2611,428,33248,0.337914,0.13,1,445182,444754,428
14697821,8.4882,8.45223,428,33312,0.315583,0.11,1,445184,444756,428
14700741,29.6976,29.6904,428,33375,0.343117,0.11,1,445219,444791,428
14703661,61.1395,61.1381,428,33438,0.364623,0.13,1,445288,444860,428
14706581,13.8279,13.8276,428,33501,0.400925,0.15,1,445290,444862,428
14709501,29.1656,28.3655,429,33564,0.360185,0.19,1,445323,444894,429
14712421,28.2331,28.0731,429,33627,0.384037,0.15,1,445351,444922,429
14715341,57.6466,57.6146,429,33690,0.436807,0.21,1,445416,444987,429
14718261,89.9293,89.1229,430,33753,0.495361,0.21,1,445514,445084,430
14721181,43.5859,41.0246,433,33816,0.539072,0.31,1,445546,445113,433
14724101,38.3172,36.2049,435,33879,0.515814,0.35,1,445583,445148,435
14727021,36.4634,34.441,437,33941,0.479163,0.31,1,445619,445182,437
14729941,8.89269,8.4882,437,34003,0.503833,0.35,1,445621,445184,437
14732861,31.3785,29.6976,439,34065,0.492767,0.37,1,445658,445219,439
14735781,62.2757,61.1395,440,34127,0.506553,0.41,1,445728,445288,440
14738701,14.0551,13.8279,440,34189,0.509311,0.35,1,445730,445290,440
14741621,28.411,29.1656,439,34251,0.557862,0.35,1,445762,445323,439
14744541,29.6822,5.83312,469,34313,0.535572,0.39,1,445792,445323,469
14747461,58.7364,23.5666,507,34375,0.563115,0.45,1,445858,445351,507
14750381,92.5473,56.7133,543,34437,0.568623,0.51,1,445959,445416,543
14753301,44.9095,89.7427,478,34498,0.585725,0.55,1,445992,445514,478
14756221,38.5819,43.5485,483,34559,0.605145,0.51,1,446029,445546,483
14759141,34.9164,38.3097,480,34620,0.625029,0.47,1,446063,445583,480
14762061,8.58328,36.4619,446,34681,0.629006,0.51,1,446065,445619,446
14764981,32.1167,8.89239,482,34742,0.645801,0.49,1,446103,445621,482
14767901,63.2233,31.3785,516,34803,0.66516,0.51,1,446174,445658,516
14770821,14.2447,62.2757,448,34864,0.669032,0.51,1,446176,445728,448
14773741,29.2489,14.0551,479,34925,0.653806,0.57,1,446209,445730,479
14776661,31.4498,28.411,479,34986,0.650761,0.53,1,446241,445762,479
14779581,57.49,29.6822,513,35046,0.714152,0.57,1,446305,445792,513
14782501,95.498,58.7364,552,35106,0.75883,0.57,2,446410,445858,552
14785421,44.6996,92.5473,483,35166,0.767766,0.59,2,446442,445959,483
14788341,39.3399,44.9095,488,35226,0.753553,0.61,2,446480,445992,488
14791261,35.868,38.5819,486,35286,0.782711,0.63,2,446515,446029,486
14794181,8.7736,34.9164,454,35346,0.788542,0.63,2,446517,446063,454
14797101,33.7547,8.58328,492,35406,0.805708,0.65,2,446557,446065,492
14800021,63.5509,32.1167,525,35466,0.857142,0.67,2,446628,446103,525
14802941,14.3102,63.2233,456,35526,0.867428,0.67,2,446630,446174,456
14805861,28.462,14.2447,486,35586,0.869486,0.65,2,446662,446176,486
14808781,31.2924,29.2489,485,35645,0.869897,0.65,2,446694,446209,485
14811701,7.85848,31.4498,455,35704,0.869979,0.73,2,446696,446241,455
14814621,55.1717,57.49,458,35763,0.869996,0.77,2,446763,446305,458
15179621,117,110,495,19203,0.07,0.33,1,451599,451104,495
15182541,89.8,94.8,487,19314,0.118,0.01,1,451682,451195,487
15185461,68.36,93.36,457,19424,0.1116,0.09,1,451745,451288,457
15188381,46.472,76.272,426,19533,0.03032,0.05,1,451786,451360,426
15191301,30.8944,30.4544,434,19642,0.030064,0.01,1,451813,451379,434
15194221,80.5789,27.6909,500,19750,0.126013,0.05,1,451906,451406,500
15197141,110.516,66.3382,542,19857,0.193203,0.07,1,452024,451482,542
15200061,91.7032,106.868,512,19964,0.222641,0.13,1,452111,451599,512
15202981,64.7406,87.7735,487,20070,0.228528,0.11,1,452169,451682,487
15205901,43.3481,67.9547,462,20176,0.229706,0.01,1,452207,451745,462
15208821,30.2696,46.3909,448,20281,0.213941,0.03,1,452234,451786,448
15211741,86.8539,30.8782,522,20386,0.210788,0.15,1,452335,451813,522
15214661,113.371,80.5756,549,20490,0.194158,0.21,1,452455,451906,549
15217581,93.0742,110.515,519,20594,0.254832,0.23,1,452543,452024,519
15220501,65.0148,91.703,490,20697,0.266966,0.23,1,452601,452111,490
15223421,43.403,64.7406,470,20799,0.269393,0.23,1,452639,452169,470
15226341,30.2806,43.3481,459,20901,0.285879,0.21,1,452666,452207,459
15229261,86.0561,30.2696,532,21002,0.289176,0.21,1,452766,452234,532
15232181,18.8112,86.8539,433,21103,0.289835,0.19,1,452768,452335,433
15235101,98.1622,113.371,431,21204,0.401967,0.27,1,452886,452455,431
15238021,93.2324,93.0742,435,21304,0.520393,0.27,1,452978,452543,435
15240941,65.0465,65.0148,435,21404,0.560079,0.27,1,453036,452601,435
15243861,43.4093,43.403,435,21503,0.568016,0.29,1,453074,452639,435
15246781,31.0819,30.2806,436,21602,0.569603,0.29,1,453102,452666,436
15249701,86.2164,86.0561,436,21700,0.633921,0.29,1,453202,452766,436
15252621,18.8433,18.8112,436,21798,0.614784,0.43,1,453204,452768,436
15255541,102.969,98.1622,442,21895,0.658957,0.55,1,453328,452886,442
15258461,100.594,93.2324,450,21992,0.763791,0.57,2,453428,452978,450
15261381,66.5187,65.0465,450,22088,0.832758,0.57,2,453486,453036,450
15264301,43.7037,43.4093,450,22184,0.814552,0.57,2,453524,453074,450
15267221,31.9407,31.0819,451,22280,0.82691,0.65,2,453553,453102,451
15270141,87.9881,86.2164,453,22375,0.797382,0.61,2,453655,453202,453
15273061,19.1976,18.8433,453,22470,0.791476,0.67,2,453657,453204,453
15275981,104.64,102.969,455,22564,0.822295,0.67,2,453783,453328,455
15278901,104.128,20.5937,559,22658,0.924459,0.79,2,453887,453328,559
15281821,68.8256,84.1187,519,22752,0.896892,0.85,2,453947,453428,519
15284741,44.1651,63.2237,499,22845,0.891378,0.81,2,453985,453486,499
15287661,31.233,43.0447,489,22938,0.906276,0.83,2,454013,453524,489
15290581,87.8466,31.809,562,23030,0.941255,0.79,2,454115,453553,562
15389861,117,87,576,25977,0.53,1,1,456242,455666,576
15392781,65.8,110.2,513,26059,0.562,1,1,456295,455782,513
15395701,42.76,50.04,515,26140,0.5044,1,1,456332,455817,515
15398621,33.352,38.008,511,26221,0.49288,1,1,456363,455852,511
15401541,33.0704,32.4016,513,26302,0.442576,1,1,456396,455883,513
15404461,80.2141,35.2803,569,26383,0.384515,1,1,456488,455919,569
15407381,49.6428,85.4561,513,26463,0.404903,0.85,1,456530,456017,513
15410301,52.3286,51.4912,523,26543,0.424981,0.8,1,456583,456060,523
15413221,96.8657,62.2982,566,26623,0.428996,0.53,1,456691,456125,566
15416141,63.3731,106.06,504,26703,0.445799,0.57,1,456746,456242,504
15419061,39.0746,63.6119,484,26782,0.43316,0.49,1,456779,456295,484
15421981,29.4149,42.3224,474,26861,0.446632,0.49,1,456806,456332,474
15424901,7.48298,33.2645,445,26940,0.449326,0.43,1,456808,456363,445
15427821,29.4966,33.0529,447,27019,0.449865,0.37,1,456843,456396,447
15430741,73.8993,80.2106,440,27097,0.577973,0.41,1,456928,456488,440
15433661,48.3799,49.6421,440,27175,0.619595,0.43,1,456970,456530,440
15436581,52.876,52.3284,441,27253,0.643919,0.43,1,457024,456583,441
15439501,100.175,96.8657,445,27331,0.664784,0.45,1,457136,456691,445
15442421,63.235,63.3731,444,27408,0.700957,0.43,1,457190,456746,444
15445341,38.247,39.0746,443,27485,0.660191,0.45,1,457222,456779,443
15448261,30.0494,29.4149,444,27562,0.684038,0.45,1,457250,456806,444
15451181,7.60988,7.48298,444,27639,0.720808,0.45,1,457252,456808,444
15454101,29.522,29.4966,444,27716,0.712161,0.61,1,457287,456843,444
15457021,79.5044,73.8993,451,27792,0.774432,0.63,2,457379,456928,451
15459941,49.5009,48.3799,451,27868,0.802886,0.65,2,457421,456970,451
15462861,53.9002,52.876,452,27944,0.856577,0.67,2,457476,457024,452
15465781,102.78,100.175,455,28020,0.867315,0.71,2,457591,457136,455
15468701,63.756,63.235,455,28096,0.869463,0.65,2,457645,457190,455
15471621,38.3512,38.247,455,28171,0.901893,0.69,2,457677,457222,455
15658501,54,41,521,32630,0.89,1,2,460783,460262,521
15661421,26.8,34.6,508,32695,0.762,1,2,460803,460295,508
15664341,84.56,34.92,572,32760,0.5764,1,1,460902,460330,572
15667261,46.512,84.584,512,32825,0.47528,1,1,460939,460427,512
15670181,54.9024,76.1168,495,32889,0.263056,1,1,460996,460501,495
15673101,31.7805,38.4234,492,32953,0.188611,1,1,461022,460530,492
15676021,30.3561,29.2847,495,33017,0.109722,0.93,1,461052,460557,495
15678941,34.8712,38.6569,490,33081,0.157944,1,1,461088,460598,490
15681861,27.7742,33.3314,484,33145,0.0555889,0.88,1,461114,460630,484
15684781,46.3548,57.8663,471,33209,0.0511178,0.91,1,461165,460694,471
15687701,36.471,39.5733,470,33273,0.0342236,0.89,1,461199,460729,470
15690621,43.2942,51.1147,461,33337,0.0308447,0.73,1,461244,460783,461
15693541,23.8588,26.2229,460,33400,0.0461689,0.53,1,461263,460803,460
15696461,71.1718,84.4446,444,33463,0.0972338,0.45,1,461346,460902,444
15699381,41.4344,46.4889,441,33526,0.107447,0.21,1,461380,460939,441
15702301,42.6869,54.8978,427,33589,0.109489,0.17,1,461423,460996,427
15705221,27.7374,31.7796,425,33652,0.173898,0.09,1,461447,461022,425
15708141,29.5475,30.3559,425,33715,0.13878,0.17,1,461477,461052,425
15711061,34.7095,34.8712,425,33778,0.211756,0.03,1,461513,461088,425
15713981,25.3419,27.7742,422,33841,0.178351,0.05,1,461536,461114,422
15716901,45.8684,46.3548,422,33903,0.10767,0.03,1,461587,461165,422
15719821,36.3737,36.471,422,33965,0.109534,0.03,1,461621,461199,422
15722741,43.2747,43.2942,422,34027,0.0459068,0.05,1,461666,461244,422
15725661,23.8549,23.8588,422,34089,0.0651814,0.11,1,461685,461263,422
15728581,73.571,71.1718,425,34151,0.117036,0.11,1,461771,461346,425
15731501,41.1142,41.4344,424,34213,0.143407,0.11,1,461804,461380,424
15734421,45.0228,8.28687,470,34275,0.116681,0.11,1,461850,461380,470
15737341,27.4046,36.0574,450,34337,0.127336,0.19,1,461873,461423,450
15740261,30.2809,26.4115,457,34399,0.129467,0.13,1,461904,461447,457
15743181,35.6562,29.2823,464,34460,0.113893,0.23,1,461941,461477,464
15746101,25.5312,34.6565,451,34521,0.206779,0.17,1,461964,461513,451
15749021,43.5062,25.3313,476,34582,0.209356,0.09,1,462012,461536,476
15751941,35.1012,45.8663,458,34643,0.225871,0.11,1,462045,461587,458
15754861,40.6203,36.3733,466,34704,0.213174,0.03,1,462087,461621,466
15757781,23.324,43.2746,440,34765,0.226635,0.07,1,462106,461666,440
15760701,78.2648,23.8549,513,34826,0.229327,0.13,1,462198,461685,513
15763621,42.853,73.571,461,34887,0.245865,0.15,1,462232,461771,461
15766541,45.3706,41.1142,474,34948,0.265173,0.11,1,462278,461804,474
15769461,26.6741,45.0228,450,35008,0.269035,0.13,1,462300,461850,450
15772381,30.1348,27.4046,458,35068,0.285807,0.13,1,462331,461873,458
15775301,38.027,30.2809,467,35128,0.305161,0.11,1,462371,461904,467
15778221,26.0054,35.6562,453,35188,0.261032,0.23,1,462394,461941,453
15781141,44.4011,25.5312,479,35248,0.236206,0.21,1,462443,461964,479
15784061,36.0802,43.5062,465,35308,0.247241,0.23,1,462477,462012,465
15786981,41.616,35.1012,475,35368,0.233448,0.21,1,462520,462045,475
15789901,22.7232,40.6203,451,35428,0.23069,0.23,1,462538,462087,451
15792821,78.9446,23.324,525,35488,0.310138,0.23,1,462631,462106,525
15795741,42.9889,78.2648,467,35548,0.294028,0.25,1,462665,462198,467
15798661,46.1978,42.853,480,35607,0.306806,0.27,1,462712,462232,480
15801581,26.8396,45.3706,456,35666,0.309361,0.27,1,462734,462278,456
15804501,6.96791,26.6741,436,35725,0.309872,0.29,1,462736,462300,436
15807421,26.1936,30.1348,436,35784,0.325974,0.31,1,462767,462331,436
15810341,36.4387,38.027,435,35843,0.393195,0.25,1,462806,462371,435
15813261,24.8877,26.0054,434,35902,0.374639,0.23,1,462828,462394,434
15816181,43.3775,44.4011,433,35961,0.450928,0.25,1,462876,462443,433
15819101,36.6755,36.0802,434,36020,0.418186,0.23,1,462911,462477,434
15822021,40.9351,41.616,433,36079,0.427637,0.23,1,462953,462520,433
15824941,22.587,22.7232,433,36138,0.461527,0.33,1,462971,462538,433
15827861,81.3174,78.9446,436,36196,0.452305,0.29,1,463067,462631,436
15830781,43.4635,42.9889,436,36254,0.450461,0.31,1,463101,462665,436
15833701,47.0927,46.1978,437,36312,0.530092,0.31,1,463149,462712,437
15836621,27.0185,26.8396,437,36370,0.546018,0.31,1,463171,462734,437
15839541,7.00371,6.96791,437,36428,0.549204,0.33,1,463173,462736,437
15842461,27.0007,26.1936,438,36486,0.517841,0.41,1,463205,462767,438
15845381,38.2001,36.4387,440,36544,0.591568,0.37,1,463246,462806,440
15848301,25.24,24.8877,440,36602,0.574314,0.47,1,463268,462828,440
15851221,45.848,43.3775,443,36660,0.650863,0.41,1,463319,462876,443
15854141,36.3696,36.6755,442,36718,0.666173,0.43,1,463353,462911,442
15857061,41.6739,40.9351,443,36776,0.717234,0.47,1,463396,462953,443
15859981,22.7348,22.587,443,36833,0.695447,0.45,1,463414,462971,443
15862901,80.547,81.3174,442,36890,0.723089,0.45,1,463509,463067,442
15865821,44.1094,43.4635,443,36947,0.776618,0.55,2,463544,463101,443
15868741,50.4219,47.0927,447,37004,0.835324,0.55,2,463596,463149,447
15871661,27.6844,27.0185,447,37061,0.895065,0.55,2,463618,463171,447
15874581,7.13687,7.00371,447,37118,0.907013,0.51,2,463620,463173,447
15877501,27.0274,27.0007,447,37175,0.909403,0.51,2,463652,463205,447
15880421,39.8055,5.40015,490,37232,0.86188,0.61,2,463695,463205,490
15883341,25.5611,33.88,471,37289,0.852376,0.57,2,463717,463246,471
15886261,49.9122,24.376,505,37346,0.866475,0.67,2,463773,463268,505
15889181,37.1824,45.6752,488,37403,0.901295,0.67,2,463807,463319,488
15892101,42.6365,36.335,498,37459,0.924259,0.73,2,463851,463353,498
15895021,22.9273,41.667,473,37515,0.928852,0.69,2,463869,463396,473
16074601,78,48,507,18366,0.07,0.91,1,466422,465915,507
16077521,96.4,100.8,494,18482,0.054,0.61,1,466523,466029,494
16080441,56.88,85.76,459,18597,0.0988,0.63,1,466570,466111,459
16083361,23.376,29.152,459,18711,0.10776,0.45,1,466585,466126,459
16086281,47.8752,33.0304,479,18824,0.125552,0.35,1,466639,466160,479
16089201,113.575,71.4061,528,18937,0.14511,0.07,1,466769,466241,528
16092121,85.915,159.081,426,19049,0.181022,0.05,1,466848,466422,426
16095041,97.983,112.616,426,19160,0.188204,0.11,1,466949,466523,426
16097961,58.7966,60.1232,428,19271,0.205641,0.11,1,466998,466570,428
16100881,22.1593,24.0246,426,19381,0.241128,0.13,1,467011,466585,426
16103801,49.2319,48.0049,428,19490,0.280226,0.15,1,467067,466639,428
16106721,113.846,113.601,428,19599,0.368045,0.15,1,467197,466769,428
16109641,87.5693,22.7202,509,19707,0.417609,0.19,1,467278,466769,509
16112561,99.9139,67.744,533,19815,0.475522,0.19,1,467381,466848,533
16115481,59.1828,94.3488,481,19922,0.471104,0.21,1,467430,466949,481
16118401,23.0366,58.0698,446,20028,0.502221,0.25,1,467444,466998,446
16121321,49.4073,22.014,489,20134,0.572444,0.29,1,467500,467011,489
16124241,119.481,49.2028,570,20239,0.618489,0.39,1,467637,467067,570
16127161,90.2963,113.841,523,20344,0.659698,0.43,1,467720,467197,523
16130081,102.859,87.5681,548,20448,0.69994,0.49,1,467826,467278,548
16133001,60.5719,99.9136,495,20552,0.739988,0.47,1,467876,467381,495
16135921,24.1144,59.1827,461,20655,0.731998,0.51,1,467891,467430,461
16138841,52.0229,23.0365,506,20758,0.7784,0.59,2,467950,467444,506
16141761,121.605,49.4073,589,20860,0.80368,0.63,2,468089,467500,589
16144681,93.1209,119.481,538,20962,0.808736,0.67,2,468175,467637,538
16147601,20.2242,90.2963,457,21063,0.809747,0.71,2,468177,467720,457
16150521,89.6448,102.859,458,21164,0.857949,0.75,2,468284,467826,458
16153441,58.729,60.5719,459,21264,0.81959,0.73,2,468335,467876,459
16156361,22.9458,24.1144,458,21364,0.827918,0.79,2,468349,467891,458
16159281,54.1892,52.0229,461,21463,0.877584,0.81,2,468411,467950,461
16162201,122.838,121.605,462,21562,0.887517,0.81,2,468551,468089,462
16165121,94.1676,93.1209,463,21660,0.889503,0.81,2,468638,468175,463
16168041,20.4335,20.2242,463,21758,0.889901,0.87,2,468640,468177,463
16249801,96,90,492,24338,0.23,1,1,470542,470050,492
16252721,47.2,41.2,498,24425,0.278,0.92,1,470577,470079,498
16255641,59.84,73.84,479,24512,0.2076,1,1,470640,470161,479
16258561,49.568,50.768,481,24598,0.17752,1,1,470687,470206,481
16261481,22.7136,31.7536,470,24684,0.203504,0.98,1,470703,470233,470
16264401,21.3427,27.9507,464,24770,0.128701,0.79,1,470724,470260,464
16267321,48.2685,54.3901,458,24856,0.0977402,0.47,1,470779,470321,458
16270241,95.2537,110.878,440,24941,0.059548,0.23,1,470886,470446,440
16273161,93.4507,98.9756,437,25026,0.0679096,0.29,1,470979,470542,437
16276081,44.2901,47.7951,434,25111,0.0695819,0.19,1,471011,470577,434
16279001,55.258,59.959,429,25195,0.133916,0.17,1,471069,470640,429
16281921,51.0516,49.5918,432,25279,0.178783,0.21,1,471119,470687,432
16284841,18.2103,22.7184,426,25363,0.187757,0.11,1,471129,470703,426
16287761,21.2421,21.3437,427,25447,0.157551,0.11,1,471151,470724,427
16290681,45.8484,4.26873,479,25530,0.21551,0.09,1,471203,470724,479
16293601,92.3697,44.8537,528,25613,0.259102,0.05,1,471307,470779,528
16296521,93.6739,94.5707,515,25696,0.33182,0.07,1,471401,470886,515
16299441,45.9348,93.3141,456,25778,0.362364,0.07,1,471435,470979,456
16302361,58.787,44.2628,486,25860,0.368473,0.15,1,471497,471011,486
16305281,53.3574,55.2526,480,25942,0.353695,0.19,1,471549,471069,480
16308201,18.6715,51.0505,440,26024,0.350739,0.19,1,471559,471119,440
16311121,19.7343,18.2101,450,26105,0.350148,0.15,1,471579,471129,450
16314041,48.7469,21.242,484,26186,0.39803,0.23,1,471635,471151,484
16316961,96.1494,45.8484,540,26267,0.423606,0.27,1,471743,471203,540
16319881,96.0299,92.3697,532,26348,0.492721,0.35,1,471839,471307,532
16322801,47.206,93.6739,473,26428,0.522544,0.37,1,471874,471401,473
16325721,59.0412,45.9348,501,26508,0.544509,0.37,1,471936,471435,501
16328641,52.6082,58.787,490,26588,0.532902,0.35,1,471987,471497,490
16331561,18.5216,53.3574,448,26668,0.54658,0.35,1,471997,471549,448
16334481,19.7043,18.6715,458,26747,0.565316,0.35,1,472017,471559,458
16337401,51.1409,19.7343,497,26826,0.553063,0.41,1,472076,471579,497
16340321,97.4282,48.7469,550,26905,0.598613,0.43,1,472185,471635,550
16343241,21.0856,96.1494,444,26984,0.607723,0.51,1,472187,471743,444
16346161,83.4171,96.0299,447,27062,0.673545,0.53,1,472286,471839,447
16349081,45.4834,47.206,448,27140,0.718709,0.55,1,472322,471874,448
16352001,59.4967,59.0412,449,27218,0.711742,0.53,1,472385,471936,449
16354921,52.6993,52.6082,449,27296,0.710348,0.55,1,472436,471987,449
16357841,19.3399,18.5216,450,27374,0.72607,0.57,1,472447,471997,450
16360761,19.868,19.7043,450,27451,0.777214,0.55,2,472467,472017,450
16363681,51.9736,51.1409,451,27528,0.755443,0.61,2,472527,472076,451
16366601,98.3947,97.4282,452,27605,0.799089,0.61,2,472637,472185,452
16369521,21.2789,21.0856,452,27682,0.775818,0.69,2,472639,472187,452
16372441,85.8558,83.4171,455,27759,0.771164,0.73,2,472741,472286,455
16375361,46.7712,45.4834,456,27835,0.754233,0.71,2,472778,472322,456
16378281,58.9542,59.4967,455,27911,0.814847,0.71,2,472840,472385,455
16381201,54.1908,52.6993,457,27987,0.858969,0.73,2,472893,472436,457
16384121,20.4382,19.3399,458,28063,0.867794,0.79,2,472905,472447,458
16387041,20.8876,19.868,459,28138,0.869559,0.75,2,472926,472467,459
16389961,50.5775,51.9736,457,28213,0.917912,0.81,2,472984,472527,457
16498001,35,19,508,30866,0.53,1,1,474883,474375,508
16500921,35.8,30.2,511,30935,0.418,1,1,474919,474408,511
16503841,78.36,97.24,486,31003,0.2036,1,1,475008,474522,486
16506761,42.072,44.248,488,31071,0.08072,0.92,1,475041,474553,488
16509681,53.2144,64.8496,474,31139,0.056144,0.95,1,475097,474623,474
16512601,45.0429,52.9699,467,31207,0.0112288,0.82,1,475140,474673,467
16515521,32.2086,36.994,463,31275,0.0102458,0.91,1,475169,474706,463
16518441,27.2417,32.1988,458,31343,0.00204915,0.91,1,475195,474737,458
16521361,70.2483,6.43976,539,31411,0.0724098,0.77,1,475276,474737,539
16524281,33.2497,64.488,484,31478,0.102482,0.63,1,475300,474816,484
16527201,29.0499,38.4976,480,31545,0.124496,0.53,1,475328,474848,480
16530121,29.81,35.6995,475,31612,0.0808993,0.39,1,475358,474883,475
16533041,65.962,35.9399,514,31679,0.13618,0.15,1,475433,474919,514
16535961,37.9924,78.388,456,31746,0.131236,0.05,1,475464,475008,456
16538881,51.5985,42.0776,478,31813,0.0822472,0.05,1,475519,475041,478
16541801,44.7197,53.2155,465,31880,0.0724494,0,1,475562,475097,465
16544721,31.3439,45.0431,450,31946,0.0704899,0.01,1,475590,475140,450
16547641,27.0688,32.2086,447,32012,0.022098,0,1,475616,475169,447
16550561,73.4138,27.2417,506,32078,0.0284196,0.09,1,475701,475195,506
16553481,35.4828,70.2483,451,32144,0.125684,0.11,1,475727,475276,451
16556401,28.6966,33.2497,454,32210,0.177137,0.13,1,475754,475300,454
16559321,29.7393,29.0499,456,32276,0.219427,0.07,1,475784,475328,456
16562241,67.5479,29.81,503,32342,0.195885,0.15,1,475861,475358,503
16565161,37.5096,65.962,458,32407,0.191177,0.13,1,475891,475433,458
16568081,49.1019,37.9924,479,32472,0.222235,0.07,1,475943,475464,479
16571001,45.8204,51.5985,469,32537,0.228447,0.07,1,475988,475519,469
16573921,28.3641,44.7197,450,32602,0.261689,0.07,1,476012,475562,450
16576841,26.4728,31.3439,448,32667,0.204338,0.01,1,476038,475590,448
16579761,76.4946,27.0688,511,32732,0.0968676,0.03,1,476127,475616,511
16582681,16.8989,73.4138,428,32797,0.0753735,0.15,1,476129,475701,428
16585601,25.7798,35.4828,430,32861,0.0550747,0.19,1,476157,475727,430
16588521,29.156,28.6966,433,32925,0.0830149,0.23,1,476187,475754,433
16591441,29.8312,29.7393,433,32989,0.072603,0.19,1,476217,475784,433
16594361,65.9662,67.5479,431,33053,0.0865206,0.19,1,476292,475861,431
16597281,37.1932,37.5096,431,33117,0.121304,0.23,1,476322,475891,431
16600201,50.6386,49.1019,433,33181,0.128261,0.23,1,476376,475943,433
16603121,47.7277,45.8204,435,33245,0.0976522,0.27,1,476423,475988,435
16606041,28.7455,28.3641,435,33309,0.0915304,0.19,1,476447,476012,435
16608961,23.3491,26.4728,431,33372,0.0903061,0.07,1,476469,476038,431
16611881,69.4698,76.4946,423,33435,0.154061,0.07,1,476550,476127,423
16614801,15.494,16.8989,423,33498,0.166812,0.05,1,476552,476129,423
16617721,24.6988,25.7798,422,33561,0.153362,0.09,1,476579,476157,422
16620641,30.5398,29.156,424,33624,0.182672,0.07,1,476611,476187,424
16623561,30.908,29.8312,425,33687,0.172535,0.09,1,476642,476217,425
16626481,66.9816,65.9662,426,33750,0.250507,0.13,1,476718,476292,426
16629401,37.3963,37.1932,426,33813,0.250101,0.13,1,476748,476322,426
16632321,50.6793,50.6386,426,33876,0.26602,0.09,1,476802,476376,426
16635241,47.7359,47.7277,426,33938,0.317204,0.09,1,476849,476423,426
16638161,28.7472,28.7455,426,34000,0.359441,0.09,1,476873,476447,426
16641081,23.3494,23.3491,426,34062,0.367888,0.17,1,476895,476469,426
16644001,71.0699,69.4698,428,34124,0.385578,0.17,1,476978,476550,428
16646921,15.814,15.494,428,34186,0.421116,0.15,1,476980,476552,428
16649841,23.9628,24.6988,427,34248,0.444223,0.15,1,477006,476579,427
16652761,31.1926,4.93976,460,34310,0.432845,0.19,1,477039,476579,460
16655681,31.0385,26.588,459,34372,0.462569,0.17,1,477070,476611,459
16658601,71.0077,30.1176,509,34434,0.548514,0.27,1,477151,476642,509
16661521,38.2015,66.8235,463,34495,0.597703,0.25,1,477181,476718,463
16664441,51.6403,37.3647,488,34556,0.591541,0.27,1,477236,476748,488
16667361,50.3281,50.6729,484,34617,0.622308,0.33,1,477286,476802,484
16670281,29.2656,47.7346,461,34678,0.628462,0.37,1,477310,476849,461
16673201,24.2531,28.7469,460,34739,0.645692,0.37,1,477333,476873,460
16676121,73.6506,23.3494,524,34800,0.665138,0.39,1,477419,476895,524
16679041,16.3301,71.0699,443,34861,0.669028,0.43,1,477421,476978,443
16681961,24.066,15.814,467,34922,0.669806,0.45,1,477447,476980,467
16684881,32.0132,23.9628,475,34983,0.669961,0.43,1,477481,477006,475
16687801,32.8026,31.1926,475,35043,0.685992,0.47,1,477514,477039,475
16690721,76.1605,31.0385,531,35103,0.689198,0.57,1,477601,477070,531
16693641,40.0321,71.0077,481,35163,0.75384,0.61,2,477632,477151,481
16696561,52.0064,38.2015,506,35223,0.782768,0.59,2,477687,477181,506
16699481,51.2013,51.6403,502,35283,0.788554,0.63,2,477738,477236,502
16702401,29.4403,50.3281,476,35343,0.789711,0.63,2,477762,477286,476
16705321,25.0881,29.2656,476,35403,0.789942,0.65,2,477786,477310,476
16708241,74.6176,24.2531,540,35463,0.821988,0.67,2,477873,477333,540
16711161,16.5235,73.6506,456,35523,0.828398,0.67,2,477875,477419,456
16714081,24.1047,16.3301,480,35583,0.82968,0.67,2,477901,477421,480
16717001,32.0209,24.066,488,35642,0.845936,0.67,2,477935,477447,488
16719921,8.00419,32.0132,456,35701,0.849187,0.69,2,477937,477481,456
16722841,28.0008,32.8026,456,35760,0.849837,0.69,2,477970,477514,456
16725761,76.8002,76.1605,458,35819,0.865968,0.77,2,478059,477601,458
16728681,42.56,40.0321,461,35878,0.917194,0.79,2,478093,477632,461
16731601,53.312,52.0064,462,35937,0.895439,0.79,2,478149,477687,462
16734521,50.6624,51.2013,461,35996,0.923088,0.79,2,478199,477738,461
16737441,29.3325,29.4403,461,36055,0.896618,0.79,2,478223,477762,461
16740361,25.0665,25.0881,461,36114,0.891324,0.83,2,478247,477786,461
16743281,76.2133,74.6176,463,36173,0.938265,0.83,2,478336,477873,463
16746201,16.8427,16.5235,463,36231,0.947653,0.83,2,478338,477875,463
16749121,24.9685,24.1047,464,36289,0.933531,0.85,2,478365,477901,464
16752041,32.1937,32.0209,464,36347,0.930706,0.85,2,478399,477935,464
16754961,8.03874,8.00419,464,36405,0.930141,0.85,2,478401,477937,464
16905341,80,110,498,17761,0.01,0.75,1,480589,480091,498
16908261,104.8,80.4,536,17881,0.074,0.47,1,480700,480164,536
16911181,58.56,108.88,467,18000,0.0548,0.17,1,480747,480280,467
16914101,39.712,67.376,445,18118,0.05096,0.13,1,480782,480337,445
16917021,31.9424,38.2752,444,18235,0.098192,0.05,1,480812,480368,444
16919941,102.388,120.455,423,18351,0.0436384,0.01,1,480932,480509,423
16922861,83.6777,88.091,422,18467,0.0487277,0.09,1,481011,480589,422
16925781,108.736,106.418,426,18582,0.0817455,0.05,1,481126,480700,426
16928701,60.1471,58.8836,427,18696,0.152349,0.05,1,481174,480747,427
16931621,38.4294,39.7767,425,18810,0.15047,0.11,1,481207,480782,425
16934541,34.8859,31.9553,429,18923,0.134094,0.03,1,481241,480812,429
16937461,97.3772,102.391,422,19035,0.114819,0.05,1,481354,480932,422
16940381,83.4754,83.6782,423,19146,0.0469638,0.09,1,481434,481011,423
16943301,109.495,108.736,424,19257,0.0813928,0.17,1,481550,481126,424
16946221,63.499,60.1471,428,19367,0.120279,0.15,1,481602,481174,428
16949141,38.2998,38.4294,427,19477,0.128056,0.13,1,481634,481207,427
16952061,37.26,34.8859,430,19586,0.145611,0.13,1,481671,481241,430
16954981,93.052,6.97718,537,19694,0.117122,0.11,1,481778,481241,537
16957901,81.0104,91.7954,502,19802,0.0474244,0.03,1,481856,481354,502
16960821,111.402,82.3591,541,19909,0.0334849,0.09,1,481975,481434,541
16963741,65.4804,109.272,479,20016,0.046697,0.13,1,482029,481550,479
16966661,38.6961,63.4544,459,20122,0.0653394,0.13,1,482061,481602,459
16969581,34.9392,38.2909,461,20227,0.117068,0.15,1,482095,481634,461
16972501,94.1878,37.2582,533,20332,0.191414,0.11,1,482204,481671,533
16975421,78.0376,93.0516,500,20436,0.190283,0.03,1,482278,481778,500
16978341,110.808,81.0103,541,20540,0.206057,0.03,1,482397,481856,541
16981261,66.1615,111.402,477,20643,0.209211,0.05,1,482452,481975,477
16984181,39.6323,65.4804,456,20746,0.241842,0.07,1,482485,482029,456
16987101,37.5265,38.6961,461,20848,0.232368,0.13,1,482522,482061,461
16990021,97.9053,34.9392,540,20950,0.294474,0.21,1,482635,482095,540
16992941,77.9811,94.1878,504,21051,0.338895,0.19,1,482708,482204,504
16995861,17.1962,78.0376,432,21152,0.347779,0.21,1,482710,482278,432
16998781,99.4392,110.808,433,21252,0.413556,0.21,1,482830,482397,433
17001701,63.0878,66.1615,432,21352,0.474711,0.25,1,482884,482452,432
17004621,40.6176,39.6323,434,21451,0.486942,0.23,1,482919,482485,434
17007541,36.9235,37.5265,433,21550,0.505388,0.31,1,482955,482522,433
17010461,101.785,97.9053,438,21648,0.605078,0.35,1,483073,482635,438
17013381,79.5569,77.9811,439,21746,0.641016,0.35,1,483147,482708,439
17016301,17.5114,17.1962,439,21844,0.648203,0.43,1,483149,482710,439
17019221,102.702,99.4392,443,21941,0.681641,0.49,1,483273,482830,443
17022141,64.5405,63.0878,444,22038,0.720328,0.49,1,483328,482884,444
17025061,42.5081,40.6176,446,22134,0.712066,0.51,1,483365,482919,446
17027981,38.1016,36.9235,447,22230,0.742413,0.63,1,483402,482955,447
17030901,105.22,101.785,451,22325,0.716483,0.65,1,483524,483073,451
17033821,82.6441,79.5569,454,22420,0.823296,0.65,2,483601,483147,454
17036741,18.1288,17.5114,454,22515,0.844659,0.65,2,483603,483149,454
17039661,103.626,3.50228,579,22609,0.816932,0.69,2,483728,483149,579
17042581,66.3252,99.9005,512,22703,0.811386,0.73,2,483785,483273,512
17045501,42.065,63.9801,493,22796,0.810277,0.71,2,483821,483328,493
17048421,39.613,42.396,495,22889,0.810055,0.75,2,483860,483365,495
17051341,104.723,38.0792,579,22982,0.874011,0.71,2,483981,483402,579
17054261,85.7445,105.216,538,23074,0.918802,0.85,2,484062,483524,538
17057181,18.7489,82.6432,463,23166,0.92776,0.85,2,484064,483601,463
17150621,104,28,599,25932,0.69,1,1,486115,485516,599
17153541,49.6,100.8,516,26014,0.674,1,1,486151,485635,516
17156461,31.52,50.56,505,26095,0.6708,1,1,486178,485673,505
17159381,29.504,34.112,504,26176,0.60616,0.97,1,486207,485703,504
17162301,25.9008,24.4224,507,26257,0.609232,1,1,486232,485725,507
17165221,94.7802,30.4845,587,26338,0.641846,0.98,1,486344,485757,587
17168141,93.356,99.6969,563,26418,0.664369,0.77,1,486437,485874,563
17171061,48.2712,102.339,497,26498,0.700874,0.79,1,486474,485977,497
17173981,88.0542,47.6679,561,26578,0.740175,0.69,1,486572,486011,561
17176901,45.6108,92.7336,492,26658,0.764035,0.67,2,486607,486115,492
17179821,29.9222,47.3467,482,26737,0.784807,0.67,2,486633,486151,482
17182741,25.1844,31.0693,479,26816,0.756961,0.59,2,486657,486178,479
17185661,29.0369,29.4139,480,26895,0.751392,0.61,2,486687,486207,480
17188581,7.40738,25.8828,457,26974,0.750278,0.65,2,486689,486232,457
17191501,89.4815,94.7766,455,27053,0.798056,0.67,2,486799,486344,455
17194421,93.0963,93.3553,456,27131,0.871611,0.71,2,486893,486437,456
17197341,49.0193,48.2711,457,27209,0.934322,0.75,2,486931,486474,457
17363781,48,55,489,31337,0.73,1,1,489839,489350,489
17366701,36.8,11,523,31405,0.618,1,1,489873,489350,523
17369621,76.96,33.4,571,31472,0.5796,1,1,489960,489389,571
17372541,58.592,91.48,519,31539,0.49192,0.91,1,490014,489495,519
17375461,38.9184,50.296,513,31606,0.426384,1,1,490048,489535,513
17378381,39.7837,46.0592,508,31673,0.349277,1,1,490088,489580,508
17381301,35.1567,41.2118,502,31740,0.365855,0.93,1,490122,489620,502
17384221,21.4313,29.8424,493,31807,0.369171,0.99,1,490140,489647,493
17387141,56.2863,25.1685,534,31874,0.321834,0.84,1,490205,489671,534
17390061,45.6573,61.0337,507,31940,0.344367,0.87,1,490248,489741,507
17392981,48.3315,52.2067,506,32006,0.364873,0.73,1,490297,489791,506
17395901,36.0663,48.8413,491,32072,0.336975,0.59,1,490330,489839,491
17398821,69.6133,36.9683,535,32138,0.427395,0.57,1,490408,489873,535
17401741,53.1227,76.9937,497,32204,0.461479,0.47,1,490457,489960,497
17404661,36.2245,58.5987,475,32270,0.452296,0.41,1,490489,490014,475
17407581,39.2449,38.9197,481,32336,0.498459,0.33,1,490529,490048,481
17410501,34.249,39.7839,474,32401,0.507692,0.37,1,490562,490088,474
17413421,20.4498,35.1568,457,32466,0.493538,0.37,1,490579,490122,457
17416341,54.49,21.4314,502,32531,0.538708,0.31,1,490642,490140,502
17419261,45.298,56.2863,480,32596,0.563742,0.35,1,490685,490205,480
17422181,49.8596,45.6573,488,32661,0.520748,0.37,1,490736,490248,488
17425101,34.7719,48.3315,470,32726,0.56015,0.33,1,490767,490297,470
17428021,8.55438,36.0663,439,32791,0.56803,0.45,1,490769,490330,439
17430941,66.5109,69.6133,442,32856,0.601606,0.47,1,490850,490408,442
17433861,54.1022,53.1227,444,32920,0.608321,0.45,1,490901,490457,444
17436781,36.4204,36.2245,444,32984,0.657664,0.51,1,490933,490489,444
17439701,40.0841,39.2449,445,33048,0.699533,0.51,1,490974,490529,445
17442621,36.0168,34.249,447,33112,0.691907,0.49,1,491009,490562,447
17445541,20.0034,20.4498,446,33176,0.706381,0.55,1,491025,490579,446
17448461,56.8007,54.49,449,33240,0.725276,0.57,1,491091,490642,449
17451381,44.9601,45.298,448,33304,0.713055,0.51,1,491133,490685,448
17454301,48.992,49.8596,447,33368,0.710611,0.57,1,491183,490736,447
17457221,37.7984,34.7719,451,33431,0.758122,0.57,2,491218,490767,451
17460141,9.15968,8.55438,451,33494,0.767624,0.61,2,491220,490769,451
17463061,66.6319,66.5109,451,33557,0.769525,0.61,2,491301,490850,451
17465981,54.9264,54.1022,452,33620,0.769905,0.67,2,491353,490901,452
17468901,37.3853,36.4204,453,33683,0.801981,0.71,2,491386,490933,453
17471821,41.8771,40.0841,455,33746,0.808396,0.69,2,491429,490974,455
17474741,35.5754,36.0168,454,33809,0.841679,0.71,2,491463,491009,454
17477661,20.7151,20.0034,455,33872,0.800336,0.73,2,491480,491025,455
17480581,57.743,56.8007,456,33934,0.856067,0.71,2,491547,491091,456
17483501,45.9486,44.9601,457,33996,0.883214,0.71,2,491590,491133,457
17486421,50.7897,48.992,459,34058,0.936643,0.77,2,491642,491183,459
17623661,41,39,483,36864,0.65,1,1,493586,493103,483
17626581,33.8,29.4,488,36921,0.586,1,1,493618,493130,488
17629501,43.56,51.48,477,36978,0.5092,1,1,493664,493187,477
17632421,55.912,52.696,483,37035,0.41384,1,1,493723,493240,483
17635341,43.1824,36.1392,491,37092,0.378768,1,1,493763,493272,491
17638261,34.2365,40.0278,482,37149,0.323754,1,1,493795,493313,482
17641181,22.0473,8.00557,501,37206,0.232751,0.93,1,493814,493313,501
17644101,30.0095,26.4011,502,37263,0.19855,1,1,493846,493344,502
17647021,27.6019,28.4802,500,37320,0.12771,1,1,493873,493373,500
17649941,33.5204,31.296,503,37377,0.177542,0.92,1,493908,493405,503
17652861,57.9041,33.4592,533,37434,0.107508,0.85,1,493972,493439,533
17655781,36.3808,61.0918,496,37490,0.0615017,0.77,1,494003,493507,496
17658701,32.0762,42.6184,489,37546,0.0203003,0.65,1,494034,493545,489
17661621,32.0152,41.3237,480,37602,0.0760601,0.57,1,494066,493586,480
17664541,36.803,33.8647,486,37658,0.087212,0.49,1,494104,493618,486
17667461,52.1606,43.5729,496,37714,0.137442,0.39,1,494160,493664,496
17670381,42.4321,55.9146,477,37770,0.163488,0.37,1,494200,493723,477
17673301,30.0864,43.1829,464,37826,0.184698,0.31,1,494227,493763,464
17676221,19.6173,34.2366,449,37882,0.18894,0.21,1,494244,493795,449
17679141,30.3235,22.0473,463,37938,0.205788,0.19,1,494277,493814,463
17682061,26.8647,30.0095,457,37994,0.273158,0.11,1,494303,493846,457
17684981,33.3729,27.6019,465,38050,0.286632,0.19,1,494338,493873,465
17687901,53.0746,33.5204,488,38106,0.305326,0.09,1,494396,493908,488
17690821,34.6149,57.9041,454,38161,0.309065,0.05,1,494426,493972,454
17693741,32.523,36.3808,455,38216,0.309813,0.01,1,494458,494003,455
17696661,32.9046,32.0762,457,38271,0.309963,0.09,1,494491,494034,457
17699581,38.5809,32.0152,465,38326,0.309993,0.09,1,494531,494066,465
17702501,51.7162,36.803,482,38381,0.309999,0.15,1,494586,494104,482
17705421,44.7432,52.1606,469,38436,0.326,0.17,1,494629,494160,469
17708341,29.7486,42.4321,455,38491,0.3452,0.19,1,494655,494200,455
17711261,21.1497,30.0864,447,38546,0.33304,0.19,1,494674,494227,447
17714181,32.2299,19.6173,465,38601,0.330608,0.21,1,494709,494244,465
17717101,8.04599,30.3235,434,38656,0.346122,0.29,1,494711,494277,434
17720021,22.4092,26.8647,434,38711,0.413224,0.29,1,494737,494303,434
17722941,34.0818,33.3729,436,38766,0.378645,0.31,1,494774,494338,436
17725861,54.0164,53.0746,437,38820,0.435729,0.31,1,494833,494396,437
17728781,34.8033,34.6149,437,38874,0.447146,0.31,1,494863,494426,437
17731701,31.7607,32.523,436,38928,0.433429,0.31,1,494894,494458,436
17734621,33.5521,32.9046,437,38982,0.430686,0.31,1,494928,494491,437
17737541,39.5104,38.5809,438,39036,0.494137,0.31,1,494969,494531,438
17740461,51.1021,51.7162,437,39090,0.490827,0.33,1,495023,494586,437
17743381,45.4204,44.7432,438,39144,0.490165,0.35,1,495067,494629,438
17746301,30.6841,29.7486,439,39198,0.474033,0.33,1,495094,494655,439
17749221,20.5368,21.1497,438,39252,0.518807,0.33,1,495112,494674,438
17752141,34.5074,32.2299,441,39306,0.463761,0.35,1,495150,494709,441
17755061,8.50147,8.04599,441,39360,0.484752,0.43,1,495152,494711,441
17757981,22.5003,22.4092,441,39414,0.50495,0.37,1,495178,494737,441
17760901,33.3001,34.0818,440,39468,0.54099,0.45,1,495214,494774,440
17763821,55.46,54.0164,442,39522,0.564198,0.45,1,495275,494833,442
17766741,35.092,34.8033,442,39575,0.58484,0.43,1,495305,494863,442
17769661,32.6184,31.7607,443,39628,0.556968,0.43,1,495337,494894,443
17772581,33.7237,33.5521,443,39681,0.615394,0.51,1,495371,494928,443
17775501,41.1447,39.5104,445,39734,0.643079,0.49,1,495414,494969,445
17778421,52.2289,51.1021,446,39787,0.664616,0.49,1,495469,495023,446
17781341,44.0458,45.4204,444,39840,0.636923,0.47,1,495511,495067,444
17784261,31.2092,30.6841,445,39893,0.631385,0.53,1,495539,495094,445
17787181,21.4418,20.5368,446,39946,0.694277,0.45,1,495558,495112,446
17790101,33.8884,34.5074,445,39999,0.722855,0.49,1,495595,495150,445
17793021,8.37767,8.50147,445,40052,0.728571,0.51,1,495597,495152,445
17795941,23.2755,22.5003,446,40105,0.745714,0.51,1,495624,495178,446
17798861,33.4551,4.50006,482,40158,0.733143,0.55,1,495660,495178,482
17801781,57.091,29.7,509,40211,0.762629,0.57,2,495723,495214,509
17804701,35.4182,54.74,478,40264,0.800526,0.59,2,495753,495275,478
17807621,34.2836,34.948,482,40316,0.824105,0.55,2,495787,495305,482
17810541,34.0567,32.5896,484,40368,0.844821,0.63,2,495821,495337,484
17813461,42.0113,33.7179,494,40420,0.848964,0.65,2,495865,495371,494
17816381,53.2023,41.1436,507,40472,0.881793,0.67,2,495921,495414,507
17819301,44.2405,52.2287,494,40524,0.904359,0.63,2,495963,495469,494
17822221,32.0481,44.0457,481,40576,0.940872,0.63,2,495992,495511,481
18213501,28,16,543,47034,0.71,1,1,500491,499948,543
18214961,32.8,32,541,47079,0.646,1,1,500525,499984,541
18264601,394.56,466.4,451,21900,0.1852,0.55,1,501010,500559,451
18267521,130.912,121.28,481,21997,0.07704,0.41,1,501075,500594,481
18270441,86.9824,93.056,471,22093,0.071408,0.31,1,501151,500680,471
18273361,52.5965,70.6112,450,22189,0.102282,0.17,1,501195,500745,450
18276281,83.3193,72.5222,468,22285,0.0924563,0.09,1,501286,500818,468
18279201,67.8639,73.7044,458,22380,0.170491,0.13,1,501350,500892,458
18282121,55.9728,61.1409,453,22475,0.218098,0.07,1,501403,500950,453
18285041,19.9946,37.0282,433,22569,0.24362,0.07,1,501414,500981,433
18287961,71.1989,30.6056,488,22663,0.280724,0.05,1,501498,501010,488
18290881,78.2398,58.1211,503,22757,0.336145,0.07,1,501578,501075,503
18293801,50.048,72.4242,470,22850,0.331229,0.11,1,501621,501151,470
18296721,84.4096,49.6848,519,22943,0.346246,0.09,1,501714,501195,519
18299641,69.6819,82.737,494,23035,0.365249,0.19,1,501780,501286,494
18302561,57.9364,67.7474,485,23127,0.36905,0.23,1,501835,501350,485
18305481,19.5873,55.9495,442,23219,0.36981,0.25,1,501845,501403,442
18308401,74.3175,19.9899,519,23310,0.401962,0.29,1,501933,501414,519
18311321,81.2635,71.198,518,23401,0.440392,0.35,1,502016,501498,518
18314241,49.8527,78.2396,480,23492,0.448078,0.33,1,502058,501578,480
18317161,86.7705,50.0479,533,23582,0.513616,0.35,1,502154,501621,533
18320081,69.3541,84.4096,505,23672,0.526723,0.37,1,502219,501714,505
18323001,57.8708,69.6819,494,23762,0.513345,0.37,1,502274,501780,494
18325921,19.5742,57.9364,449,23851,0.510669,0.37,1,502284,501835,449
18328841,75.9148,19.5873,529,23940,0.606134,0.41,1,502374,501845,529
18331761,16.783,74.3175,443,24029,0.625227,0.45,1,502376,501933,443
18334681,70.5566,81.2635,444,24117,0.661045,0.45,1,502460,502016,444
18337601,47.7113,49.8527,444,24205,0.700209,0.53,1,502502,502058,444
18340521,89.5423,86.7705,448,24293,0.740042,0.53,1,502602,502154,448
18343441,69.9085,69.3541,448,24380,0.732008,0.51,1,502667,502219,448
18346361,57.1817,57.8708,447,24467,0.762402,0.51,2,502721,502274,447
18349281,21.0363,19.5742,449,24554,0.78448,0.63,2,502733,502284,449
18352201,79.4073,75.9148,453,24640,0.868896,0.63,2,502827,502374,453
18355121,17.4815,16.783,453,24726,0.885779,0.67,2,502829,502376,453
18358041,70.6963,70.5566,453,24812,0.857156,0.71,2,502913,502460,453
18360961,49.3393,47.7113,455,24897,0.915431,0.75,2,502957,502502,455
18486521,34,28,494,28326,0.71,1,1,505376,504882,494
18489441,62,66.4,487,28401,0.55,1,1,505445,504958,487
18492361,78.8,13.28,570,28476,0.31,1,1,505528,504958,570
18495281,39.76,71.456,514,28550,0.182,1,1,505558,505044,514
18498201,42.352,39.0912,526,28624,0.0444,1,1,505601,505075,526
18501121,61.2704,50.2182,539,28698,0.06488,1,1,505667,505128,539
18504041,50.6541,62.0436,522,28772,0.116976,1,1,505715,505193,522
18506961,52.5308,51.6087,526,28846,0.0633952,0.85,1,505768,505242,526
18509881,34.5062,60.7217,493,28919,0.020679,0.77,1,505798,505305,493
18512801,35.7012,41.7443,492,28992,0.0441358,0.71,1,505834,505342,492
18515721,49.5402,35.5489,511,29065,0.0648272,0.51,1,505887,505376,511
18518641,65.908,62.3098,512,29138,0.0529654,0.25,1,505957,505445,512
18521561,31.5816,78.862,452,29211,0.0665931,0.15,1,505980,505528,452
18524481,40.7163,39.7724,465,29283,0.0533186,0.01,1,506023,505558,465
18527401,60.1433,42.3545,487,29355,0.0346637,0.07,1,506088,505601,487
18530321,51.2287,61.2709,470,29427,0.0469327,0.13,1,506137,505667,470
18533241,53.4457,50.6542,476,29499,0.0173865,0.05,1,506191,505715,476
18536161,35.4891,52.5308,454,29571,0.0754773,0.01,1,506222,505768,454
18539081,34.2978,34.5062,458,29643,0.0550955,0.05,1,506256,505798,458
18542001,50.8596,35.7012,477,29714,0.0670191,0.07,1,506311,505834,477
18544921,66.9719,49.5402,495,29785,0.0374038,0.05,1,506382,505887,495
18547841,14.9944,65.908,427,29856,0.0314808,0.07,1,506384,505957,427
18550761,20.5989,31.5816,426,29927,0.0142962,0.05,1,506406,505980,426
18553681,36.1198,40.7163,423,29998,0.106859,0.03,1,506446,506023,423
18556601,58.424,60.1433,422,30069,0.0533718,0.05,1,506510,506088,422
18559521,53.2848,51.2287,425,30139,0.0346744,0.01,1,506562,506137,425
18562441,53.057,53.4457,424,30209,0.00693487,0.09,1,506615,506191,424
18565361,35.4114,35.4891,424,30279,0.025387,0.05,1,506646,506222,424
18568281,35.0823,34.2978,425,30349,0.0290774,0.07,1,506681,506256,425
18571201,51.0165,50.8596,425,30419,0.0298155,0.03,1,506736,506311,425
18574121,64.6033,66.9719,422,30489,0.0939631,0.03,1,506804,506382,422
18577041,14.5207,14.9944,422,30558,0.106793,0.01,1,506806,506384,422
18579961,20.5041,20.5989,422,30627,0.125359,0.13,1,506828,506406,422
18582881,37.7008,36.1198,424,30696,0.193072,0.04,1,506870,506446,424
18585801,57.9402,58.424,423,30765,0.0786143,0.03,1,506933,506510,423
18588721,52.388,53.2848,422,30834,0.0717229,0,1,506984,506562,422
18591641,52.8776,53.057,422,30903,0.0543446,0.03,1,507037,506615,422
18594561,36.1755,35.4114,423,30971,0.0668689,0.03,1,507069,506646,423
18597481,34.4351,35.0823,422,31039,0.0693738,0.03,1,507103,506681,422
18600401,51.687,51.0165,423,31107,0.0698748,0.11,1,507159,506736,423
18603321,67.1374,64.6033,426,31175,0.085975,0.11,1,507230,506804,426
18606241,15.0275,14.5207,426,31243,0.089195,0.13,1,507232,506806,426
18609161,21.4055,20.5041,427,31311,0.105839,0.13,1,507255,506828,427
18612081,39.4811,4.10083,471,31379,0.125168,0.21,1,507299,506828,471
18615001,53.4962,34.4202,486,31446,0.209034,0.05,1,507356,506870,486
18617921,50.6992,57.284,473,31513,0.257807,0.07,1,507406,506933,473
18620841,51.7399,52.2568,474,31580,0.267561,0.05,1,507458,506984,474
18623761,36.748,52.8514,454,31647,0.253512,0.07,1,507491,507037,454
18626681,34.5496,36.1703,456,31714,0.250702,0.07,1,507525,507069,456
18629601,51.7099,34.4341,478,31781,0.26614,0.07,1,507581,507103,478
18632521,69.542,51.6868,496,31848,0.301228,0.09,1,507655,507159,496
18635441,15.5084,67.1374,427,31914,0.308246,0.09,1,507657,507230,427
18638361,22.3017,15.0275,449,31980,0.309649,0.11,1,507681,507232,449
18641281,40.4603,21.4055,471,32046,0.32593,0.13,1,507726,507255,471
18644201,57.6921,39.4811,489,32112,0.329186,0.23,1,507788,507299,489
18647121,53.1384,53.4962,484,32178,0.361837,0.27,1,507840,507356,484
18650041,52.2277,50.6992,486,32244,0.384367,0.27,1,507892,507406,486
18652961,36.0455,51.7399,466,32310,0.404873,0.25,1,507924,507458,466
18655881,34.4091,36.748,467,32375,0.408975,0.25,1,507958,507491,467
18658801,52.4818,34.5496,490,32440,0.409795,0.27,1,508015,507525,490
18661721,71.2964,51.7099,510,32505,0.441959,0.31,1,508091,507581,510
18664641,15.8593,69.542,438,32570,0.448392,0.31,1,508093,507655,438
18667561,23.1719,15.5084,461,32635,0.465678,0.31,1,508118,507657,461
18670481,41.4344,22.3017,483,32700,0.453136,0.33,1,508164,507681,483
18673401,57.0869,40.4603,499,32765,0.434627,0.33,1,508225,507726,499
18676321,13.0174,57.6921,439,32830,0.430925,0.37,1,508227,507788,439
18679241,45.0035,53.1384,440,32894,0.494185,0.39,1,508280,507840,440
18682161,52.2007,52.2277,442,32958,0.490837,0.41,1,508334,507892,442
18685081,36.0401,36.0455,442,33022,0.458167,0.41,1,508366,507924,442
18688001,34.408,34.4091,442,33086,0.483633,0.41,1,508400,507958,442
18690921,52.4816,52.4818,442,33150,0.472727,0.45,1,508457,508015,442
18693841,72.8963,71.2964,444,33214,0.550545,0.45,1,508535,508091,444
18696761,16.1793,15.8593,444,33278,0.566109,0.47,1,508537,508093,444
18699681,22.4359,23.1719,443,33342,0.569222,0.45,1,508561,508118,443
18702601,40.4872,41.4344,442,33405,0.601844,0.43,1,508606,508164,442
18705521,58.4974,57.0869,444,33468,0.624369,0.43,1,508669,508225,444
18708441,13.2995,13.0174,444,33531,0.628874,0.51,1,508671,508227,444
18711361,45.8599,45.0035,445,33594,0.693775,0.49,1,508725,508280,445
18714281,51.572,52.2007,444,33657,0.706755,0.45,1,508778,508334,444
18717201,35.9144,36.0401,444,33720,0.741351,0.49,1,508810,508366,444
18720121,34.3829,34.408,444,33783,0.78027,0.47,2,508844,508400,444
18723041,54.0766,52.4816,446,33846,0.788054,0.57,2,508903,508457,446
18725961,74.8153,72.8963,448,33908,0.805611,0.57,2,508983,508535,448
18728881,16.5631,16.1793,448,33970,0.841122,0.57,2,508985,508537,448
18731801,22.5126,22.4359,448,34032,0.816224,0.61,2,509009,508561,448
18734721,42.1025,40.4872,450,34094,0.843245,0.63,2,509056,508606,450
18737641,59.6205,58.4974,451,34156,0.880649,0.63,2,509120,508669,451
18740561,13.5241,13.2995,451,34218,0.88813,0.63,2,509122,508671,451
18933281,63,51,538,38080,0.39,1,1,511865,511327,538
18936201,38.2,63.8,503,38135,0.262,1,1,511897,511394,503
18939121,34.04,34.36,509,38190,0.0604,1,1,511930,511421,509
18942041,36.408,36.472,509,38245,0.06808,1,1,511967,511458,509
18944961,38.4816,34.4944,514,38300,0.069616,1,1,512006,511492,514
18947881,45.2963,44.4989,514,38355,0.0699232,1,1,512053,511539,514
18950801,37.0593,40.0998,510,38410,0.0379846,1,1,512088,511578,510
18953721,33.0119,37.62,505,38465,0.0475969,1,1,512120,511615,505
18956641,34.6024,35.524,505,38520,0.0655194,0.98,1,512155,511650,505
18959561,48.5205,31.9048,526,38575,0.0131039,1,1,512207,511681,526
18962481,11.3041,51.981,471,38630,0.0266208,0.73,1,512209,511738,471
18965401,20.6608,34.3962,464,38685,0.0133242,0.63,1,512232,511768,464
18968321,25.7322,34.0792,457,38740,0.0266648,0.39,1,512259,511802,457
18971241,37.9464,57.2158,435,38795,0.061333,0.23,1,512300,511865,435
18974161,27.5893,37.0432,428,38849,0.0842666,0.01,1,512325,511897,428
18977081,27.1179,33.8086,422,38903,0.0408533,0.07,1,512352,511930,422
18980001,35.8236,36.3617,423,38957,0.0641707,0.07,1,512390,511967,423
18982921,37.5647,38.4723,422,39011,0.0208341,0.07,1,512428,512006,422
18985841,47.5129,45.2945,425,39065,0.00416683,0.03,1,512478,512053,425
18988761,37.5026,37.0589,425,39119,0.0248334,0.05,1,512513,512088,425
18991681,31.5005,33.0118,423,39173,0.0129667,0.07,1,512543,512120,423
18994601,36.7001,34.6024,426,39227,0.0585933,0,1,512581,512155,426
18997521,45.74,48.5205,422,39281,0.131719,0.03,1,512629,512207,422
19000441,10.748,11.3041,422,39335,0.146344,0.01,1,512631,512209,422
19003361,20.5496,20.6608,422,39389,0.133269,0.03,1,512654,512232,422
19006281,26.5099,25.7322,423,39443,0.146654,0.07,1,512682,512259,423
19009201,37.302,37.9464,422,39497,0.0853307,0.09,1,512722,512300,422
19012121,28.2604,27.5893,423,39550,0.0730661,0.03,1,512748,512325,423
19015041,26.4521,27.1179,422,39603,0.0706132,0.07,1,512774,512352,422
19017961,36.4904,35.8236,423,39656,0.0381226,0.01,1,512813,512390,423
19020881,36.8981,37.5647,422,39709,0.0156245,0,1,512850,512428,422
19023801,48.9796,47.5129,424,39762,0.0271249,0.03,1,512902,512478,424
19026721,36.1959,37.5026,422,39815,0.029425,0.01,1,512935,512513,422
19029641,31.2392,31.5005,422,39868,0.013885,0.07,1,512965,512543,422
19032561,39.0478,36.7001,425,39921,0.026777,0.15,1,513006,512581,425
19035481,47.8096,45.74,427,39974,0.0613554,0.15,1,513056,512629,427
19038401,11.1619,10.748,427,40027,0.116271,0.13,1,513058,512631,427
19041321,19.8324,20.5496,426,40080,0.127254,0.13,1,513080,512654,426
19044241,26.3665,4.10992,454,40133,0.129451,0.15,1,513108,512654,454
19047161,35.6733,23.222,464,40186,0.12989,0.07,1,513146,512682,464
19050081,26.3347,36.6444,448,40239,0.129978,0.07,1,513170,512722,448
19053001,25.2669,28.1289,447,40291,0.113996,0.07,1,513195,512748,447
19055921,37.8534,26.4258,462,40343,0.0467991,0.03,1,513236,512774,462
19058841,36.3707,36.4852,459,40395,0.0173598,0.01,1,513272,512813,459
19061761,48.0741,36.897,473,40447,0.027472,0.03,1,513323,512850,473
19064681,37.6148,48.9794,456,40499,0.0134944,0.03,1,513358,512902,456
19067601,29.923,36.1959,451,40551,0.0266989,0.01,1,513386,512935,451
19070521,39.5846,31.2392,463,40603,0.0133398,0.03,1,513428,512965,463
19073441,50.3169,39.0478,475,40655,0.00266795,0.07,1,513481,513006,475
19076361,11.6634,47.8096,427,40707,0.00853359,0.13,1,513483,513056,427
19079281,21.5327,11.1619,449,40759,0.00970672,0.13,1,513507,513058,449
19082201,26.7065,19.8324,455,40811,0.0419413,0.13,1,513535,513080,455
19085121,35.7413,26.3665,465,40863,0.0803883,0.13,1,513573,513108,465
19088041,26.3483,35.6733,451,40915,0.136078,0.13,1,513597,513146,451
19090961,24.4697,26.3347,451,40967,0.147216,0.11,1,513621,513170,451
19093881,36.0939,25.2669,465,41019,0.0374431,0.03,1,513660,513195,465
19096801,35.2188,37.8534,459,41070,0.0314886,0.01,1,513695,513236,459
19099721,46.2438,36.3707,472,41121,0.0302977,0.03,1,513744,513272,472
19102641,38.8488,48.0741,458,41172,0.0140595,0.01,1,513781,513323,458
19105561,28.5698,37.6148,449,41223,0.0268119,0.03,1,513807,513358,449
19108481,40.114,29.923,464,41274,0.00536238,0.01,1,513850,513386,464
19111401,50.4228,39.5846,475,41325,0.0250725,0,1,513903,513428,475
19114321,11.6846,50.3169,424,41376,0.0290145,0.01,1,513905,513481,424
19117241,21.5369,11.6634,446,41427,0.0058029,0.01,1,513929,513483,446
19120161,27.5074,21.5327,451,41478,0.0571606,0.05,1,513958,513507,451
19123081,38.3015,26.7065,464,41529,0.0514321,0.09,1,513999,513535,464
19126001,9.26029,35.7413,428,41580,0.0502864,0.15,1,514001,513573,428
19128921,21.8521,26.3483,429,41631,0.130057,0.15,1,514026,513597,429
19131841,23.5704,24.4697,429,41682,0.178011,0.01,1,514050,513621,429
19134761,31.9141,36.0939,424,41733,0.155602,0.03,1,514084,513660,424
19137681,33.5828,35.2188,423,41784,0.15112,0.03,1,514118,513695,423
19140601,45.1166,46.2438,422,41835,0.0702241,0.01,1,514166,513744,422
19143521,38.6233,38.8488,422,41885,0.0220448,0.03,1,514203,513781,422
19146441,28.5247,28.5698,422,41935,0.012409,0,1,514229,513807,422
19149361,41.7049,40.114,424,41985,0.0264818,0.03,1,514274,513850,424
19152281,49.941,50.4228,423,42035,0.0292964,0.03,1,514326,513903,423
19155201,11.5882,11.6846,423,42085,0.0298593,0,1,514328,513905,423
19158121,22.3176,21.5369,424,42135,0.0139719,0.07,1,514353,513929,424
19161041,28.4635,27.5074,425,42185,0.0747944,0.05,1,514383,513958,425
19163961,38.4927,38.3015,425,42235,0.0709589,0.05,1,514424,513999,425
19166881,9.29854,9.26029,425,42285,0.0701918,0.15,1,514426,514001,425
19169801,24.2597,21.8521,428,42335,0.118038,0.19,1,514454,514026,428
19172721,24.8519,23.5704,429,42385,0.191608,0.15,1,514479,514050,429
19175641,31.3704,31.9141,428,42435,0.238322,0.15,1,514512,514084,428
19178561,34.2741,33.5828,429,42485,0.311664,0.05,1,514547,514118,429
19181481,39.6548,45.1166,422,42535,0.310333,0.01,1,514588,514166,422
19184401,37.531,38.6233,422,42585,0.246067,0.01,1,514625,514203,422
19187321,28.3062,28.5247,422,42635,0.137213,0.03,1,514651,514229,422
19190241,41.6612,41.7049,422,42684,0.0674427,0.03,1,514696,514274,422
19193161,50.7322,49.941,423,42733,0.0534885,0.03,1,514749,514326,423
19196081,11.7464,11.5882,423,42782,0.0506977,0.01,1,514751,514328,423
19199001,23.1493,22.3176,424,42831,0.0501395,0.09,1,514777,514353,424
19201921,28.6299,28.4635,424,42880,0.0340279,0.07,1,514807,514383,424
19204841,39.326,38.4927,425,42929,0.0468056,0.07,1,514849,514424,425
19207761,9.46519,9.29854,425,42978,0.0813611,0.13,1,514851,514426,425
19210681,26.693,24.2597,428,43027,0.0882722,0.13,1,514882,514454,428
19213601,26.9386,4.85194,455,43076,0.105654,0.21,1,514909,514454,455
19216521,34.9877,20.9704,467,43125,0.125131,0.25,1,514946,514479,467
19219441,35.7975,30.5941,470,43174,0.113026,0.33,1,514982,514512,470
19222361,40.7595,34.1188,477,43223,0.126605,0.31,1,515024,514547,477
19225281,31.3519,39.6238,465,43272,0.161321,0.23,1,515053,514588,465
19228201,22.2704,37.5248,448,43321,0.184264,0.11,1,515073,514625,448
19231121,39.6541,28.305,466,43370,0.0608528,0.05,1,515117,514651,466
19234041,51.9308,41.661,476,43419,0.0361706,0.05,1,515172,514696,476
19236961,11.9862,50.7322,425,43468,0.0312341,0.05,1,515174,514749,425
19239881,21.5972,11.7464,447,43517,0.0302468,0.05,1,515198,514751,447
19242801,29.9194,23.1493,453,43565,0.0460494,0.03,1,515230,514777,453
19245721,39.5839,28.6299,465,43613,0.0492099,0.05,1,515272,514807,465
19248641,9.51678,39.326,425,43661,0.049842,0.09,1,515274,514849,425
19251561,29.1034,9.46519,457,43709,0.0499684,0.09,1,515308,514851,457
19254481,27.4207,26.693,453,43757,0.0339937,0.11,1,515335,514882,453
19257401,35.0841,26.9386,463,43805,0.0467987,0.13,1,515372,514909,463
19260321,35.8168,34.9877,462,43853,0.0493597,0.11,1,515408,514946,462
19263241,42.3634,35.7975,470,43901,0.049872,0.13,1,515452,514982,470
19266161,33.2727,40.7595,459,43949,0.0179744,0.17,1,515483,515024,459
19269081,22.6545,31.3519,450,43997,0.0435949,0.19,1,515503,515053,450
19272001,33.3309,22.2704,466,44045,0.032719,0.03,1,515539,515073,466
19274921,50.6662,39.6541,477,44093,0.0305438,0.03,1,515594,515117,477
19277841,11.7332,51.9308,424,44141,0.0301088,0.03,1,515596,515172,424
19280761,21.5466,11.9862,446,44189,0.0460218,0.03,1,515620,515174,446
19283681,30.7093,21.5972,455,44237,0.0972043,0.05,1,515653,515198,455
19286601,39.7419,29.9194,465,44285,0.107441,0.05,1,515695,515230,465
19289521,9.54837,39.5839,425,44333,0.109488,0.05,1,515697,515272,425
19292441,27.5097,9.51678,455,44381,0.109898,0.05,1,515729,515274,455
19295361,27.9019,29.1034,449,44429,0.0939795,0.03,1,515757,515308,449
19298281,7.18039,27.4207,424,44476,0.0907959,0.05,1,515759,515335,424
19301201,31.0361,35.0841,424,44523,0.0741592,0.05,1,515796,515372,424
19304121,35.0072,35.8168,424,44570,0.0868318,0.05,1,515832,515408,424
19307041,40.6014,42.3634,422,44617,0.137366,0.01,1,515874,515452,422
19309961,33.7203,33.2727,423,44664,0.147473,0.05,1,515906,515483,423
19312881,23.5441,22.6545,424,44711,0.197495,0.03,1,515927,515503,424
19315801,32.7088,33.3309,423,44758,0.239499,0.03,1,515962,515539,423
19318721,50.5418,50.6662,423,44805,0.2319,0.03,1,516017,515594,423
19321641,11.7084,11.7332,423,44852,0.23038,0.05,1,516019,515596,423
19324561,23.1417,21.5466,425,44899,0.262076,0.11,1,516045,515620,425
19327481,32.6283,30.7093,427,44946,0.284415,0.11,1,516080,515653,427
19330401,40.1257,39.7419,427,44993,0.288883,0.11,1,516122,515695,427
19333321,9.62513,9.54837,427,45040,0.321777,0.11,1,516124,515697,427
19336241,28.325,27.5097,428,45087,0.312355,0.09,1,516157,515729,428
19339161,26.465,27.9019,426,45134,0.342471,0.09,1,516183,515757,426
19342081,6.893,7.18039,426,45181,0.316494,0.07,1,516185,515759,426
19345001,30.1786,31.0361,425,45228,0.343299,0.09,1,516221,515796,425
19347921,35.6357,35.0072,426,45275,0.38066,0.15,1,516258,515832,426
19350841,42.3271,40.6014,428,45322,0.404132,0.15,1,516302,515874,428
19353761,34.8654,33.7203,429,45369,0.440826,0.21,1,516335,515906,429
19356681,25.3731,23.5441,431,45415,0.496165,0.25,1,516358,515927,431
19359601,33.8746,32.7088,432,45461,0.523233,0.23,1,516394,515962,432
19362521,51.5749,50.5418,433,45507,0.576647,0.23,1,516450,516017,433
19365441,11.915,11.7084,433,45553,0.587329,0.27,1,516452,516019,433
19368361,24.783,23.1417,435,45599,0.621466,0.29,1,516480,516045,435
19371281,32.1566,32.6283,434,45645,0.628293,0.29,1,516514,516080,434
19374201,41.6313,40.1257,436,45691,0.629659,0.33,1,516558,516122,436
19377121,9.92626,9.62513,436,45737,0.661932,0.31,1,516560,516124,436
19380041,29.1853,28.325,437,45783,0.636386,0.35,1,516594,516157,437
19382961,26.6371,26.465,437,45829,0.663277,0.31,1,516620,516183,437
19385881,6.92741,6.893,437,45875,0.668655,0.35,1,516622,516185,437
19388801,30.1855,30.1786,437,45921,0.701731,0.35,1,516658,516221,437
19391721,37.2371,6.03572,476,45967,0.708346,0.39,1,516697,516221,476
19394641,44.2474,30.8071,485,46013,0.725669,0.41,1,516743,516258,485
19397561,37.6495,41.3614,477,46059,0.761134,0.45,2,516779,516302,477
19400481,27.5299,34.6723,469,46105,0.752227,0.51,2,516804,516335,469
19403401,35.106,25.3345,483,46151,0.734445,0.53,1,516841,516358,483
19406321,54.2212,33.8669,506,46197,0.778889,0.59,2,516900,516394,506
19409241,12.4442,51.5734,452,46243,0.787778,0.59,2,516902,516450,452
19412161,25.6888,11.9147,479,46289,0.789556,0.63,2,516931,516452,479
19415081,33.1378,24.7829,486,46335,0.773911,0.63,2,516966,516480,486
19418001,41.8276,32.1566,496,46381,0.786782,0.63,2,517010,516514,496
19420921,9.96551,41.6313,454,46426,0.789356,0.67,2,517012,516558,454
19423841,29.1931,9.92626,486,46471,0.797871,0.63,2,517046,516560,486
19426761,28.2386,29.1853,480,46516,0.807574,0.67,2,517074,516594,480
19429681,7.24772,26.6371,456,46561,0.825515,0.67,2,517076,516620,456
19432601,30.2495,6.92741,490,46606,0.829103,0.71,2,517112,516622,490
19435521,38.8499,30.1855,495,46651,0.813821,0.71,2,517153,516658,495
19438441,46.17,37.2371,504,46696,0.794764,0.73,2,517201,516697,504
19441361,38.834,44.2474,495,46741,0.806953,0.77,2,517238,516743,495
19444281,26.9668,37.6495,483,46786,0.809391,0.75,2,517262,516779,483
19447201,34.1934,27.5299,494,46831,0.825878,0.73,2,517298,516804,494
19450121,57.2387,35.106,520,46876,0.829176,0.79,2,517361,516841,520
19453041,13.0477,54.2212,463,46921,0.829835,0.79,2,517363,516900,463
19455961,25.0095,12.4442,489,46966,0.813967,0.79,2,517391,516902,489
19458881,32.2019,25.6888,494,47011,0.826793,0.77,2,517425,516931,494
19461801,42.4404,33.1378,504,47056,0.813359,0.79,2,517470,516966,504
19464721,10.0881,41.8276,462,47101,0.810672,0.79,2,517472,517010,462
19467641,29.2176,9.96551,494,47146,0.842134,0.8,2,517506,517012,494
19470561,29.8435,29.1931,490,47191,0.864427,0.81,2,517536,517046,490
19473481,7.5687,28.2386,464,47236,0.868885,0.83,2,517538,517074,464
19476401,30.3137,7.24772,498,47281,0.885777,0.83,2,517574,517076,498
19479321,38.8627,30.2495,503,47326,0.873155,0.81,2,517615,517112,503
19482241,44.5725,38.8499,508,47371,0.870631,0.79,2,517661,517153,508
19485161,10.5145,46.17,462,47415,0.870126,0.81,2,517663,517201,462
19488081,31.7029,38.834,462,47459,0.902025,0.81,2,517700,517238,462
19491001,26.3406,26.9668,463,47503,0.892405,0.83,2,517725,517262,463
19674961,78,87,489,22817,0.03,0.71,1,519719,519230,489
19677881,52.4,67,473,22910,0.03,0.41,1,519765,519292,473
19680801,60.88,69.4,466,23003,0.03,0.27,1,519828,519362,466
19683721,51.376,56.28,462,23095,0.046,0,1,519877,519415,462
19686641,64.6752,89.656,432,23187,0.0172,0.01,1,519945,519513,432
19689561,40.935,39.5312,440,23278,0.02744,0.01,1,519980,519540,440
19692481,74.587,36.7062,487,23369,0.045488,0.03,1,520063,519576,487
19695401,78.1174,59.3412,501,23460,0.0490976,0.03,1,520142,519641,501
19698321,52.4235,74.2683,469,23550,0.0338195,0.03,1,520188,519719,469
19701241,61.6847,51.6536,487,23640,0.0627639,0.03,1,520252,519765,487
19704161,49.9369,60.7307,471,23730,0.0845528,0.05,1,520299,519828,471
19707081,65.1874,51.3461,491,23819,0.0409106,0.01,1,520368,519877,491
19710001,41.8375,64.6692,459,23908,0.0481821,0.03,1,520404,519945,459
19712921,9.9675,40.9338,426,23997,0.0496364,0.05,1,520406,519980,426
19715841,67.5935,74.5868,425,24085,0.0499273,0.05,1,520488,520063,425
19718761,74.3187,78.1174,422,24173,0.0179855,0.03,1,520564,520142,422
19721681,52.4637,52.4235,423,24261,0.0115971,0.07,1,520611,520188,423
19724601,63.2927,61.6847,425,24348,0.0263194,0.09,1,520677,520252,425
19727521,51.8585,49.9369,427,24435,0.0772639,0.03,1,520726,520299,427
19730441,62.3717,65.1874,423,24522,0.0234528,0.05,1,520791,520368,423
19733361,42.0743,41.8375,424,24608,0.0126906,0.05,1,520828,520404,424
19736281,10.0149,9.9675,424,24694,0.0105381,0.05,1,520830,520406,424
19739201,66.803,67.5935,423,24780,0.0581076,0.01,1,520911,520488,423
19742121,73.3606,74.3187,422,24866,0.0196215,0.01,1,520986,520564,422
19745041,52.2721,52.4637,422,24951,0.0439243,0.03,1,521033,520611,422
19747961,64.0544,63.2927,423,25036,0.0647849,0.09,1,521100,520677,423
19750881,52.8109,51.8585,424,25121,0.068957,0.01,1,521150,520726,424
19753801,60.9622,62.3717,422,25205,0.0137914,0.01,1,521213,520791,422
19756721,41.7924,42.0743,422,25289,0.0267583,0.01,1,521250,520828,422
19759641,9.95849,10.0149,422,25373,0.0293517,0.07,1,521252,520830,422
19762561,67.5917,66.803,423,25457,0.0298703,0.07,1,521334,520911,423
19765481,71.9183,13.3606,496,25540,0.0299741,0.01,1,521407,520911,496
19768401,51.9837,62.6721,468,25623,0.0619948,0.05,1,521454,520986,468
19771321,64.7967,50.1344,489,25706,0.100399,0.07,1,521522,521033,489
19774241,53.7593,63.6269,473,25788,0.15608,0.07,1,521573,521100,473
19777161,59.5519,52.7254,484,25870,0.119216,0,1,521634,521150,484
19780081,42.3104,60.9451,459,25952,0.0638432,0.03,1,521672,521213,459
19783001,10.0621,41.789,424,26034,0.0527686,0.03,1,521674,521250,424
19785921,66.8124,9.9578,503,26115,0.0505537,0.03,1,521755,521252,503
19788841,71.7625,67.5916,494,26196,0.0501107,0.03,1,521828,521334,494
19791761,55.1525,71.9183,472,26277,0.0340221,0.07,1,521879,521407,472
19794681,67.8305,51.9837,496,26358,0.0628044,0.11,1,521950,521454,496
19797601,55.1661,64.7967,480,26438,0.100561,0.17,1,522002,521522,480
19800521,54.2332,53.7593,483,26518,0.172112,0.11,1,522056,521573,483
19803441,42.0466,59.5519,461,26598,0.202422,0.05,1,522095,521634,461
19806361,10.0093,42.3104,425,26678,0.208485,0.05,1,522097,521672,425
19809281,65.2019,10.0621,502,26757,0.305697,0.05,1,522176,521674,502
19812201,71.4404,66.8124,494,26836,0.277139,0.05,1,522249,521755,494
19815121,56.6881,71.7625,474,26915,0.191428,0.03,1,522302,521828,474
19818041,12.9376,55.1525,425,26994,0.206286,0.07,1,522304,521879,425
19820961,60.9875,67.8305,427,27072,0.257257,0.11,1,522377,521950,427
19823881,53.7975,55.1661,427,27150,0.299451,0.19,1,522429,522002,427
19826801,57.1595,54.2332,431,27228,0.33989,0.21,1,522487,522056,431
19829721,45.8319,42.0466,435,27306,0.347978,0.21,1,522530,522095,435
19832641,10.7664,10.0093,435,27384,0.317596,0.33,1,522532,522097,435
19835561,67.7533,65.2019,438,27461,0.279519,0.27,1,522614,522176,438
19838481,69.5507,71.4404,435,27538,0.271904,0.17,1,522684,522249,435
19841401,54.7101,56.6881,433,27615,0.302381,0.21,1,522735,522302,433
19844321,12.542,12.9376,433,27692,0.308476,0.27,1,522737,522304,433
19847241,63.3084,60.9875,436,27768,0.341695,0.31,1,522813,522377,436
19850161,55.0617,53.7975,437,27844,0.300339,0.35,1,522866,522429,437
19853081,59.0123,57.1595,439,27920,0.324068,0.35,1,522926,522487,439
19856001,46.2025,45.8319,439,27996,0.312814,0.31,1,522969,522530,439
19858921,10.8405,10.7664,439,28072,0.310563,0.27,1,522971,522532,439
19861841,64.5681,67.7533,435,28147,0.406113,0.27,1,523049,522614,435
19864761,69.7136,69.5507,436,28222,0.457223,0.31,1,523120,522684,436
19867681,56.3427,54.7101,438,28297,0.483445,0.31,1,523173,522735,438
19870601,12.8685,12.542,438,28372,0.488689,0.31,1,523175,522737,438
19873521,61.7737,2.5084,512,28447,0.473738,0.35,1,523249,522737,512
19876441,53.9547,61.3017,488,28521,0.470748,0.29,1,523301,522813,488
19879361,58.7909,54.6603,495,28595,0.48615,0.33,1,523361,522866,495
19882281,46.9582,58.9321,479,28669,0.50523,0.31,1,523405,522926,479
19885201,10.9916,46.1864,438,28743,0.509046,0.31,1,523407,522969,438
19888121,69.3983,10.8373,520,28817,0.573809,0.43,1,523491,522971,520
19891041,70.6797,64.5675,513,28890,0.634762,0.47,1,523562,523049,513
19893961,58.1359,69.7135,497,28963,0.694952,0.49,1,523617,523120,497
19896881,13.2272,56.3427,446,29036,0.70699,0.49,1,523619,523173,446
19899801,61.8454,12.8685,518,29109,0.677398,0.47,1,523693,523175,518
19902721,53.9691,61.7737,496,29182,0.67148,0.47,1,523745,523249,496
19905641,60.3938,53.9547,506,29255,0.702296,0.49,1,523807,523301,506
19908561,47.2788,58.7909,490,29327,0.740459,0.51,1,523851,523361,490
19911481,11.0558,46.9582,448,29399,0.748092,0.51,1,523853,523405,448
19914401,74.2112,10.9916,536,29471,0.845618,0.59,2,523943,523407,536
20060401,27,26,499,32868,0.79,1,2,526261,525762,499
20063321,53.4,63.6,486,32932,0.598,1,1,526321,525835,486
20066241,46.68,54.32,479,32996,0.6876,1,1,526366,525887,479
20069161,74.936,74.064,482,33060,0.60952,1,1,526448,525966,482
20072081,38.9872,42.0128,478,33124,0.609904,0.96,1,526478,526000,478
20075001,50.9974,45.2026,486,33188,0.481981,1,1,526532,526046,486
20077921,35.7995,38.6405,481,33252,0.408396,1,1,526564,526083,481
20080841,34.3599,34.1281,482,33316,0.425679,0.95,1,526598,526116,482
20083761,33.272,47.6256,464,33379,0.397136,0.83,1,526631,526167,464
20086681,30.6544,35.9251,461,33442,0.391427,0.87,1,526661,526200,461
20089601,33.3309,34.385,461,33505,0.374285,0.79,1,526695,526234,461
20092521,27.4662,28.477,460,33568,0.370857,0.55,1,526721,526261,460
20095441,49.4932,53.6954,455,33631,0.386171,0.71,1,526776,526321,455
20098361,44.2986,46.7391,453,33694,0.405234,0.59,1,526819,526366,453
20101281,72.8597,74.9478,451,33757,0.377047,0.61,1,526899,526448,451
20104201,36.9719,38.9896,449,33820,0.403409,0.45,1,526927,526478,449
20107121,45.7944,50.9979,443,33883,0.440682,0.39,1,526975,526532,443
20110041,35.5589,35.7996,444,33945,0.480136,0.43,1,527008,526564,444
20112961,31.9118,34.3599,441,34007,0.520027,0.39,1,527039,526598,441
20115881,31.1824,33.272,439,34069,0.480005,0.39,1,527070,526631,439
20118801,31.8365,30.6544,441,34131,0.520001,0.37,1,527102,526661,441
20121721,32.7673,33.3309,440,34193,0.528,0.37,1,527135,526695,440
20124641,28.1535,27.4662,441,34255,0.5136,0.37,1,527162,526721,441
20127561,48.8307,5.49324,495,34317,0.51072,0.39,1,527216,526721,495
20130481,43.3661,45.0986,482,34379,0.510144,0.41,1,527258,526776,482
20133401,72.6732,43.4197,519,34441,0.574029,0.37,1,527338,526819,519
20136321,36.9346,72.6839,467,34502,0.602806,0.41,1,527366,526899,467
20139241,48.9869,36.9368,491,34563,0.608561,0.45,1,527418,526927,491
20142161,36.1974,45.7874,476,34624,0.625712,0.49,1,527451,526975,476
20145081,33.6395,35.5575,476,34685,0.613142,0.53,1,527484,527008,476
20148001,30.7279,31.9115,475,34746,0.610628,0.47,1,527514,527039,475
20150921,33.3456,31.1823,478,34807,0.642126,0.53,1,527548,527070,478
20153841,32.2691,31.8365,478,34868,0.664425,0.53,1,527580,527102,478
20156761,27.2538,32.7673,471,34929,0.668885,0.51,1,527606,527135,471
20159681,50.2508,28.1535,500,34990,0.717777,0.51,1,527662,527162,500
20162601,43.6502,48.8307,488,35050,0.743555,0.51,1,527704,527216,488
20165521,75.93,43.3661,530,35110,0.812711,0.59,2,527788,527258,530
20168441,38.386,72.6732,479,35170,0.842542,0.61,2,527817,527338,479
20171361,49.2772,36.9346,503,35230,0.864508,0.61,2,527869,527366,503
20174281,37.0554,48.9869,485,35290,0.900902,0.63,2,527903,527418,485
20177201,33.0111,36.1974,484,35350,0.92418,0.61,2,527935,527451,484
20180121,30.6022,33.6395,481,35410,0.928836,0.61,2,527965,527484,481
20183041,34.9204,30.7279,487,35470,0.945767,0.65,2,528001,527514,487
20343641,33,83,496,38610,0.73,1,1,530177,529681,496
20346561,28.2,39.8,494,38665,0.778,1,2,530204,529710,494
20349481,60.84,63.96,493,38720,0.7716,1,2,530273,529780,493
20352401,40.168,30.392,506,38775,0.80232,1,2,530308,529802,506
20355321,27.2336,34.0784,495,38829,0.808464,1,2,530332,529837,495
20358241,13.4467,28.4157,478,38883,0.889693,1,2,530342,529864,478
20361161,43.4893,40.8831,485,38937,0.873939,1,2,530393,529908,485
20364081,34.2979,37.7766,480,38991,0.854788,0.98,2,530425,529945,480
20367001,30.0596,33.1553,477,39045,0.898958,0.95,2,530454,529977,477
20369921,34.8119,39.4311,472,39099,0.875791,0.97,2,530490,530018,472
20372841,34.1624,36.6862,470,39153,0.871158,0.87,2,530524,530054,470
20375761,29.2325,30.5372,469,39207,0.870232,0.79,2,530552,530083,469
20399121,49,51,466,39636,0.93,0.85,2,530859,530393,466
20402041,37,35.8,468,39689,0.93,0.91,2,530893,530425,468
20550961,35,25,507,42315,0.45,1,1,532742,532235,507
20553881,28.6,25.8,508,42365,0.498,1,1,532769,532261,508
20599141,393.72,451.56,435,18980,0.1236,0.11,1,533254,532819,435
20602061,141.944,136.712,456,19818,0.03272,0.05,1,533333,532877,456
20604981,101.989,100.142,457,19925,0.078544,0.05,1,533425,532968,457
20607901,89.1978,77.6285,471,20031,0.0717088,0.03,1,533511,533040,471
20610821,71.4396,86.7257,449,20137,0.0543418,0,1,533578,533129,449
20613741,57.4879,62.9451,446,20242,0.0348684,0.05,1,533632,533186,446
20616661,37.8976,42.989,441,20347,0.0469737,0.03,1,533665,533224,441
20619581,79.5795,32.5978,501,20451,0.0813947,0.01,1,533755,533254,501
20622501,88.7159,69.7196,513,20555,0.0402789,0.09,1,533846,533333,513
20625421,89.7432,87.5439,511,20658,0.0160558,0.07,1,533936,533425,511
20628341,68.3486,86.3088,488,20761,0.0592112,0.05,1,533999,533511,488
20631261,56.8697,70.8618,475,20863,0.0518422,0.03,1,534053,533578,475
20634181,38.5739,57.3724,455,20965,0.0663684,0.05,1,534087,533632,455
20637101,9.31479,37.8745,424,21066,0.0372737,0.09,1,534089,533665,424
20640021,73.063,79.5749,423,21167,0.0794547,0.03,1,534178,533755,423
20642941,88.2126,88.715,424,21267,0.0558909,0.01,1,534270,533846,424
20645861,89.6425,89.743,424,21367,0.0671782,0.07,1,534360,533936,424
20648781,69.1285,68.3486,425,21466,0.133436,0.05,1,534424,533999,425
20651701,55.4257,56.8697,423,21565,0.0506871,0.07,1,534476,534053,423
20654621,38.2851,38.5739,423,21663,0.0501374,0.03,1,534510,534087,423
20657541,9.25703,9.31479,423,21761,0.0180275,0.09,1,534512,534089,423
20660461,74.6514,73.063,425,21858,0.0276055,0.05,1,534603,534178,425
20663381,86.1303,88.2126,422,21955,0.0615211,0.07,1,534692,534270,422
20666301,90.0261,89.6425,423,22052,0.0203042,0.15,1,534783,534360,423
20669221,72.4052,69.1285,427,22148,0.0440608,0.03,1,534851,534424,427
20672141,52.081,55.4257,422,22244,0.0808122,0.05,1,534898,534476,422
20675061,37.6162,38.2851,422,22339,0.0561624,0.01,1,534932,534510,422
20677981,9.12324,9.25703,422,22434,0.0832325,0.03,1,534934,534512,422
20680901,75.4246,74.6514,423,22529,0.104647,0.03,1,535026,534603,423
20683821,85.4849,14.9303,511,22623,0.0449293,0.07,1,535114,534603,511
20686741,89.097,74.1861,512,22717,0.0329859,0.01,1,535204,534692,512
20689661,73.8194,87.6372,491,22810,0.0465972,0.05,1,535274,534783,491
20692581,52.3639,71.9274,470,22903,0.113319,0.09,1,535321,534851,470
20695501,37.6728,51.9855,457,22996,0.126664,0.05,1,535355,534898,457
20698421,9.13455,37.5971,425,23088,0.145333,0.09,1,535357,534932,425
20701341,77.0269,9.11942,517,23180,0.213067,0.11,1,535451,534934,517
20704261,84.2054,75.4239,511,23271,0.114613,0.03,1,535537,535026,511
20707181,88.0411,85.4848,512,23362,0.0629227,0.03,1,535626,535114,512
20710101,74.4082,89.097,493,23453,0.0525845,0.05,1,535697,535204,493
20713021,55.6816,73.8194,474,23543,0.0825169,0.13,1,535748,535274,474
20715941,39.9363,52.3639,463,23633,0.104503,0.13,1,535784,535321,463
20718861,9.58727,37.6728,431,23723,0.108901,0.15,1,535786,535355,431
20721781,77.9175,9.13455,524,23812,0.15778,0.23,1,535881,535357,524
20724701,81.9835,77.0269,513,23901,0.215556,0.09,1,535964,535451,513
20727621,17.9967,84.2054,429,23990,0.227111,0.05,1,535966,535537,429
20730541,70.7993,88.0411,424,24078,0.325422,0.05,1,536050,535626,424
20733461,70.9599,74.4082,424,24166,0.361084,0.09,1,536121,535697,424
20736381,57.392,55.6816,427,24254,0.352217,0.11,1,536175,535748,427
20739301,41.0784,39.9363,428,24341,0.366443,0.11,1,536212,535784,428
20742221,9.81568,9.58727,428,24428,0.369289,0.17,1,536214,535786,428
20745141,79.5631,77.9175,430,24515,0.401858,0.23,1,536311,535881,430
20748061,84.7126,81.9835,433,24601,0.472372,0.23,1,536397,535964,433
20750981,18.5425,17.9967,433,24687,0.486474,0.35,1,536399,535966,433
20753901,74.1085,70.7993,437,24773,0.489295,0.37,1,536487,536050,437
20756821,72.4217,70.9599,438,24859,0.505859,0.35,1,536559,536121,438
20759741,57.6843,57.392,438,24944,0.525172,0.37,1,536613,536175,438
20762661,42.7369,41.0784,440,25029,0.529034,0.37,1,536652,536212,440
20765581,10.1474,9.81568,440,25114,0.561807,0.41,1,536654,536214,440
20768501,81.2295,79.5631,442,25198,0.584361,0.49,1,536753,536311,442
20771421,86.6459,84.7126,444,25282,0.620872,0.49,1,536841,536397,444
20774341,18.9292,18.5425,444,25366,0.596174,0.49,1,536843,536399,444
20777261,75.7858,74.1085,446,25450,0.639235,0.49,1,536933,536487,446
20780181,73.5572,14.8217,519,25533,0.663847,0.51,1,537006,536487,519
20783101,56.3114,60.5643,499,25616,0.668769,0.53,1,537058,536559,499
20786021,44.0623,55.3129,486,25699,0.701754,0.53,1,537099,536613,486
20788941,10.4125,42.2626,449,25781,0.708351,0.57,1,537101,536652,449
20791861,82.0825,10.0525,547,25863,0.75767,0.59,2,537201,536654,547
20794781,88.4165,81.2105,538,25945,0.847534,0.63,2,537291,536753,538
20797701,19.2833,86.6421,452,26027,0.865507,0.59,2,537293,536841,452
20800621,79.0567,18.9284,544,26108,0.853101,0.65,2,537387,536843,544
20803541,74.2113,75.7857,527,26189,0.83462,0.67,2,537460,536933,527
20806461,56.4423,73.5571,506,26270,0.830924,0.67,2,537512,537006,506
20809381,45.6885,56.3114,497,26351,0.830185,0.71,2,537555,537058,497
20812301,10.7377,44.0623,458,26431,0.830037,0.71,2,537557,537099,458
20815221,84.5475,10.4125,559,26511,0.894007,0.77,2,537660,537101,559
20917421,19,24,497,29175,0.81,1,2,539493,538996,497
20920341,49.4,16.8,539,29248,0.666,1,1,539550,539011,539
20923261,85.08,52.96,571,29320,0.3812,1,1,539644,539073,571
20926181,45.816,87.392,511,29392,0.27624,1,1,539680,539169,511
20929101,60.3632,42.2784,544,29464,0.159248,1,1,539744,539200,544
20932021,81.6726,65.2557,560,29536,0.0718496,0.95,1,539831,539271,560
20934941,61.9345,81.0511,532,29608,0.15037,1,1,539888,539356,532
20937861,29.1869,63.4102,494,29679,0.070074,0.77,1,539909,539415,494
20940781,25.8374,38.282,487,29750,0.0380148,0.82,1,539934,539447,487
20943701,19.5675,29.2564,478,29821,0.031603,0.81,1,539952,539474,478
20946621,5.5135,21.0513,461,29892,0.0303206,0.63,1,539954,539493,461
20949541,41.1027,49.8103,454,29963,0.0780641,0.31,1,540004,539550,454
20952461,70.6205,85.1621,438,30034,0.103613,0.25,1,540082,539644,438
20955381,38.9241,45.8324,433,30104,0.124723,0.13,1,540113,539680,433
20958301,54.1848,60.3665,427,30174,0.208945,0.05,1,540171,539744,427
20961221,78.037,81.6733,424,30244,0.0977889,0.17,1,540255,539831,424
20964141,62.8074,61.9347,426,30314,0.0595578,0.05,1,540314,539888,426
20967061,27.7615,29.1869,424,30384,0.0679116,0.03,1,540333,539909,424
20969981,26.3523,25.8374,425,30454,0.0375823,0.03,1,540359,539934,425
20972901,19.6705,19.5675,425,30523,0.0475165,0.03,1,540377,539952,425
20975821,5.53409,5.5135,425,30592,0.0495033,0.09,1,540379,539954,425
20978741,41.1068,41.1027,425,30661,0.0819007,0.11,1,540429,540004,425
20981661,71.4214,70.6205,426,30730,0.12038,0.13,1,540508,540082,426
20984581,40.6843,38.9241,428,30799,0.144076,0.23,1,540541,540113,428
20987501,56.1369,54.1848,430,30868,0.116815,0.07,1,540601,540171,430
20990421,72.8274,78.037,423,30937,0.143363,0.05,1,540678,540255,423
20993341,62.5655,62.8074,424,31005,0.148673,0.07,1,540738,540314,424
20996261,26.9131,27.7615,423,31073,0.181735,0.03,1,540756,540333,423
20999181,25.3826,26.3523,422,31141,0.172347,0.05,1,540781,540359,422
21002101,21.0765,19.6705,424,31209,0.154469,0.05,1,540801,540377,424
21005021,5.8153,5.53409,424,31277,0.182894,0.05,1,540803,540379,424
21007941,41.9631,1.10682,475,31345,0.172579,0.09,1,540854,540379,475
21010861,71.5926,40.2214,504,31413,0.170516,0.13,1,540933,540429,504
21013781,41.5185,71.2443,459,31480,0.170103,0.15,1,540967,540508,459
21016701,56.3037,40.6489,486,31547,0.202021,0.11,1,541027,540541,486
21019621,72.8607,56.1298,503,31614,0.272404,0.15,1,541104,540601,503
21022541,64.1721,72.826,488,31681,0.334481,0.15,1,541166,540678,488
21025461,27.2344,62.5652,446,31748,0.378896,0.19,1,541184,540738,446
21028381,24.6469,26.913,452,31815,0.387779,0.17,1,541208,540756,452
21031301,21.7294,25.3826,448,31881,0.405556,0.15,1,541229,540781,448
21034221,5.94588,21.0765,430,31947,0.409111,0.19,1,541231,540801,430
21037141,42.7892,5.8153,480,32013,0.377822,0.17,1,541283,540803,480
21040061,71.7578,41.9631,508,32079,0.419564,0.17,1,541362,540854,508
21042981,41.5516,71.5926,463,32145,0.443913,0.17,1,541396,540933,463
21045901,58.7103,41.5185,492,32211,0.480783,0.21,1,541459,540967,492
21048821,75.7421,56.3037,512,32277,0.472157,0.29,1,541539,541027,512
21051741,68.7484,72.8607,502,32343,0.502431,0.35,1,541606,541104,502
21054661,28.1497,64.1721,458,32408,0.508486,0.39,1,541624,541166,458
21057581,24.8299,27.2344,464,32473,0.541697,0.39,1,541648,541184,464
21060501,22.566,24.6469,462,32538,0.548339,0.41,1,541670,541208,462
21063421,6.1132,21.7294,443,32603,0.549668,0.41,1,541672,541229,443
21066341,41.2226,5.94588,491,32668,0.581934,0.37,1,541722,541231,491
21069261,73.8445,42.7892,521,32733,0.604387,0.43,1,541804,541283,521
21072181,16.3689,71.7578,444,32798,0.608877,0.45,1,541806,541362,444
21075101,30.4738,41.5516,444,32862,0.625776,0.49,1,541840,541396,444
21078021,56.4948,58.7103,444,32926,0.677155,0.47,1,541903,541459,444
21080941,76.8989,75.7421,446,32990,0.751431,0.51,2,541985,541539,446
21083861,69.7798,68.7484,447,33054,0.750286,0.51,2,542053,541606,447
21086781,29.956,28.1497,449,33118,0.750057,0.55,2,542073,541624,449
21089701,25.1912,24.8299,449,33182,0.782011,0.55,2,542097,541648,449
21092621,22.6382,22.566,449,33246,0.756402,0.55,2,542119,541670,449
21095541,6.12765,6.1132,449,33310,0.78328,0.59,2,542121,541672,449
21098461,42.8255,41.2226,451,33373,0.756656,0.61,2,542173,541722,451
21101381,74.9651,73.8445,452,33436,0.831331,0.61,2,542256,541804,452
21104301,16.593,16.3689,452,33499,0.846266,0.63,2,542258,541806,452
21107221,31.3186,30.4738,453,33562,0.833253,0.69,2,542293,541840,453
21110141,57.4637,56.4948,454,33625,0.878651,0.77,2,542357,541903,454
21113061,80.2927,76.8989,458,33688,0.90373,0.75,2,542443,541985,458
21115981,71.2585,69.7798,459,33751,0.924746,0.75,2,542512,542053,459
21118901,30.2517,29.956,459,33814,0.928949,0.79,2,542532,542073,459
21121821,25.2503,25.1912,459,33877,0.91379,0.75,2,542556,542097,459
21124741,22.6501,22.6382,459,33939,0.910758,0.79,2,542578,542119,459
21127661,6.13001,6.12765,459,34001,0.958152,0.75,2,542580,542121,459
21256141,30,28,492,36638,0.71,1,1,544473,543981,492
21259061,26.8,22.4,497,36696,0.694,1,1,544499,544002,497
21261981,23.76,19.68,501,36754,0.6268,1,1,544522,544021,501
21264901,24.752,31.936,491,36811,0.48536,1,1,544547,544056,491
21267821,72.9504,75.1872,490,36868,0.313072,0.94,1,544632,544142,490
21270741,37.7901,39.0374,489,36925,0.230614,1,1,544661,544172,489
21273661,24.358,28.6075,484,36982,0.214123,1,1,544682,544198,484
21276581,34.4716,39.3215,479,37039,0.178825,0.99,1,544719,544240,479
21279501,28.4943,31.0643,477,37096,0.0917649,0.93,1,544746,544269,477
21282421,56.8989,66.2129,466,37153,0.074353,0.93,1,544810,544344,466
21285341,63.3798,13.2426,531,37210,0.0228706,0.77,1,544875,544344,531
21288261,35.876,58.6485,490,37267,0.0285741,0.73,1,544904,544414,490
21291181,27.1752,34.9297,486,37324,0.0297148,0.71,1,544929,544443,486
21294101,23.035,30.9859,478,37381,0.029943,0.69,1,544951,544473,478
21297021,16.607,26.9972,467,37438,0.0459886,0.61,1,544966,544499,467
21299941,22.5214,23.7994,468,37494,0.0331977,0.45,1,544990,544522,468
21302861,63.7043,24.7599,517,37550,0.0946395,0.27,1,545064,544547,517
21305781,35.9409,72.952,461,37606,0.0589279,0.21,1,545093,544632,461
21308701,22.3882,37.7904,451,37662,0.0357856,0.21,1,545112,544661,451
21311621,28.4776,24.3581,460,37718,0.0471571,0.17,1,545142,544682,460
21314541,25.6955,34.4716,448,37774,0.0974314,0.07,1,545167,544719,448
21317461,56.3391,28.4943,485,37830,0.0274863,0.07,1,545231,544746,485
21320381,64.0678,56.8989,487,37886,0.0454973,0.01,1,545297,544810,487
21323301,36.8136,63.3798,452,37942,0.0170995,0.03,1,545327,544875,452
21326221,27.3627,35.876,448,37998,0.0754199,0.03,1,545352,544904,448
21329141,23.0725,27.1752,445,38054,0.055084,0.03,1,545374,544929,445
21332061,15.0145,23.035,436,38110,0.115017,0.05,1,545387,544951,436
21334981,24.6029,16.607,448,38165,0.0950034,0.03,1,545414,544966,448
21337901,64.9206,22.5214,499,38220,0.123001,0.11,1,545489,544990,499
21340821,34.5841,63.7043,452,38275,0.1286,0.05,1,545516,545064,452
21343741,22.9168,35.9409,443,38330,0.12972,0.03,1,545536,545093,443
21346661,29.3834,22.3882,455,38385,0.145944,0.05,1,545567,545112,455
21349581,25.0767,28.4776,449,38440,0.181189,0.11,1,545591,545142,449
21352501,54.6153,25.6955,486,38495,0.156238,0.01,1,545653,545167,486
21355421,63.7231,56.3391,488,38550,0.0872476,0.05,1,545719,545231,488
21358341,35.9446,64.0678,451,38605,0.0414495,0.01,1,545748,545297,451
21361261,8.78892,36.8136,423,38660,0.0322899,0.09,1,545750,545327,423
21364181,22.5578,27.3627,424,38715,0.046458,0.05,1,545776,545352,424
21367101,24.5116,23.0725,427,38770,0.0972916,0.13,1,545801,545374,427
21370021,12.9023,15.0145,424,38824,0.0754583,0.09,1,545811,545387,424
21372941,24.1805,24.6029,424,38878,0.103092,0.13,1,545838,545414,424
21375861,66.4361,64.9206,426,38932,0.108618,0.13,1,545915,545489,426
21378781,36.4872,34.5841,428,38986,0.0937237,0.13,1,545944,545516,428
21381701,23.2974,22.9168,428,39040,0.138745,0.15,1,545964,545536,428
21384621,31.8595,29.3834,431,39094,0.147749,0.19,1,545998,545567,431
21387541,25.5719,25.0767,431,39148,0.14955,0.15,1,546022,545591,431
21390461,53.1144,54.6153,429,39202,0.19791,0.07,1,546082,545653,429
21393381,60.2229,63.7231,425,39256,0.175582,0.03,1,546144,545719,425
21396301,33.6446,35.9446,423,39310,0.187116,0.03,1,546171,545748,423
21399221,8.32891,8.78892,423,39364,0.157423,0.05,1,546173,545750,423
21402141,23.2658,22.5578,424,39418,0.135485,0.11,1,546200,545776,424
21405061,25.4532,24.5116,425,39472,0.179097,0.07,1,546226,545801,425
21407981,13.0906,12.9023,425,39526,0.155819,0.11,1,546236,545811,425
21410901,26.6181,24.1805,428,39579,0.199164,0.11,1,546266,545838,428
21413821,66.1236,66.4361,427,39632,0.271833,0.09,1,546342,545915,427
21416741,35.6247,36.4872,426,39685,0.334367,0.15,1,546370,545944,426
21419661,23.9249,23.2974,427,39738,0.362873,0.15,1,546391,545964,427
21422581,33.585,31.8595,429,39791,0.416575,0.15,1,546427,545998,429
21425501,25.917,25.5719,429,39844,0.411315,0.21,1,546451,546022,429
21428421,53.9834,53.1144,430,39897,0.442263,0.17,1,546512,546082,430
21431341,60.3967,60.2229,430,39950,0.448453,0.19,1,546574,546144,430
21434261,32.8793,33.6446,429,40003,0.417691,0.15,1,546600,546171,429
21437181,8.17587,8.32891,429,40056,0.443538,0.13,1,546602,546173,429
21440101,22.4352,23.2658,428,40109,0.448708,0.13,1,546628,546200,428
21443021,25.287,4.65316,454,40162,0.417742,0.19,1,546654,546200,454
21445941,13.8574,21.7306,439,40215,0.427548,0.15,1,546665,546226,439
21448861,27.5715,12.3461,460,40268,0.42951,0.21,1,546696,546236,460
21451781,70.3143,26.4692,511,40320,0.429902,0.29,1,546777,546266,511
21454701,38.8629,66.0938,466,40372,0.46198,0.35,1,546808,546342,466
21457621,25.3726,35.6188,460,40424,0.500396,0.37,1,546830,546370,460
21460541,35.4745,23.9238,477,40476,0.540079,0.43,1,546868,546391,477
21463461,27.0949,33.5848,466,40528,0.580016,0.41,1,546893,546427,466
21466381,53.419,25.917,502,40580,0.572003,0.45,1,546953,546451,502
21469301,60.2838,53.9834,503,40632,0.586401,0.45,1,547015,546512,503
21472221,32.8568,60.3967,467,40684,0.60528,0.41,1,547041,546574,467
21475141,8.17135,32.8793,443,40736,0.609056,0.45,1,547043,546600,443
21478061,22.4343,8.17587,467,40788,0.609811,0.45,1,547069,546602,467
21480981,25.2869,22.4352,467,40840,0.609962,0.41,1,547095,546628,467
21483901,13.8574,25.287,452,40892,0.641992,0.43,1,547106,546654,452
21486821,26.7715,13.8574,471,40944,0.648399,0.43,1,547136,546665,471
21489741,72.5543,27.5715,524,40996,0.66568,0.43,1,547220,546696,524
21492661,41.7109,70.3143,477,41047,0.669136,0.47,1,547254,546777,477
21495581,25.9422,38.8629,468,41098,0.669827,0.51,1,547276,546808,468
21498501,37.1884,25.3726,486,41149,0.701965,0.55,1,547316,546830,486
21501421,28.2377,35.4745,474,41200,0.708393,0.59,1,547342,546868,474
21504341,53.6475,27.0949,509,41251,0.741679,0.57,1,547402,546893,509
21507261,61.9295,53.419,513,41302,0.764336,0.59,2,547466,546953,513
21510181,33.1859,60.2838,477,41353,0.800867,0.61,2,547492,547015,477
21513101,8.23718,32.8568,453,41404,0.808173,0.61,2,547494,547041,453
21516021,22.4474,8.17135,477,41455,0.809635,0.61,2,547520,547043,477
21518941,25.2895,22.4343,477,41506,0.809927,0.61,2,547546,547069,477
21521861,6.6579,25.2869,453,41557,0.809985,0.65,2,547548,547095,453
21524781,10.9316,13.8574,454,41608,0.841997,0.65,2,547560,547106,454
21527701,26.1863,26.7715,454,41659,0.816399,0.67,2,547590,547136,454
21530621,73.2373,72.5543,455,41710,0.87528,0.67,2,547675,547220,455
21533541,41.8475,41.7109,455,41761,0.903056,0.67,2,547709,547254,455
21536461,25.9695,25.9422,455,41812,0.940611,0.71,2,547731,547276,455
21720421,38,33,491,44879,0.59,1,1,549911,549420,491
21723341,30,25.8,495,44926,0.558,1,1,549939,549444,495
21726261,30.8,13.16,516,44973,0.5116,1,1,549970,549454,516
21729181,26.16,5.032,538,45020,0.36632,1,1,549995,549457,538
21732101,24.432,2.6064,560,45067,0.321264,1,1,550019,549459,560
21733561,26.4864,12.5213,572,45114,0.232253,1,1,550046,549474,572
21780281,366.097,481.704,424,20440,0.150451,0.05,1,550497,550073,424
21783201,138.019,141.941,448,20544,0.0860901,0,1,550578,550130,448
21786121,80.4039,85.9882,442,20647,0.025218,0.01,1,550644,550202,442
21789041,100.881,88.3976,459,20750,0.0290436,0.03,1,550750,550291,459
21791961,88.1762,93.6795,449,20852,0.0298087,0.11,1,550835,550386,449
21794881,47.2352,53.1359,443,20954,0.0459617,0.07,1,550872,550429,443
21797801,33.447,47.4272,427,21055,0.0651923,0.13,1,550902,550475,427
21800721,23.4894,16.6854,439,21156,0.0690385,0.07,1,550923,550484,439
21803641,67.0979,78.5371,423,21256,0.0218077,0.01,1,551001,550578,423
21806561,66.2196,68.5074,423,21356,0.0443615,0.03,1,551067,550644,423
21809481,99.6439,98.5015,425,21455,0.0488723,0.03,1,551175,550750,425
21812401,86.3288,87.7003,423,21554,0.0497745,0.05,1,551258,550835,423
21815321,49.2658,47.1401,426,21652,0.0659549,0.07,1,551298,550872,426
21818241,33.8532,33.428,426,21750,0.133191,0.07,1,551328,550902,426
21821161,24.3706,23.4856,427,21848,0.146638,0.01,1,551350,550923,427
21824081,63.2741,67.0971,422,21945,0.0693276,0.05,1,551423,551001,422
21827001,65.4548,66.2194,422,22042,0.0698655,0.05,1,551489,551067,422
21829921,99.491,99.6439,422,22138,0.0699731,0.05,1,551597,551175,422
21832841,87.0982,86.3288,423,22234,0.0699946,0.07,1,551681,551258,423
21835761,52.6196,49.2658,427,22329,0.0539989,0.15,1,551725,551298,427
21838681,34.5239,33.8532,427,22424,0.0827998,0.15,1,551755,551328,427
21841601,25.3048,24.3706,428,22519,0.07256,0.15,1,551778,551350,428
21844521,59.461,4.87413,496,22613,0.054512,0.05,1,551846,551350,496
21847441,63.8922,59.3748,488,22707,0.0509024,0.07,1,551911,551423,488
21850361,100.778,64.675,532,22800,0.0981805,0.07,1,552021,551489,532
21853281,86.5557,99.335,507,22893,0.123636,0.07,1,552104,551597,507
21856201,50.9111,87.067,465,22986,0.160727,0.05,1,552146,551681,465
21859121,35.7822,52.6134,453,23078,0.168145,0.09,1,552178,551725,453
21862041,24.7564,34.5227,445,23170,0.185629,0.07,1,552200,551755,445
21864961,60.1513,25.3045,491,23261,0.221126,0.05,1,552269,551778,491
21867881,64.0303,59.4609,488,23352,0.244225,0.05,1,552334,551846,488
21870801,103.206,63.8922,536,23443,0.296845,0.11,1,552447,551911,536
21873721,89.4412,100.778,512,23533,0.307369,0.13,1,552533,552021,512
21876641,51.4882,86.5557,471,23623,0.309474,0.17,1,552575,552104,471
21879561,36.6976,50.9111,462,23713,0.325895,0.17,1,552608,552146,462
21882481,24.9395,35.7822,452,23802,0.329179,0.19,1,552630,552178,452
21885401,62.5879,24.7564,502,23891,0.409836,0.23,1,552702,552200,502
21888321,64.5176,60.1513,498,23980,0.457967,0.25,1,552767,552269,498
21891241,14.5035,64.0303,435,24068,0.467593,0.31,1,552769,552334,435
21894161,95.7007,103.206,438,24156,0.549519,0.31,1,552885,552447,438
21897081,87.1401,89.4412,437,24244,0.629904,0.31,1,552970,552533,437
21900001,51.028,51.4882,437,24331,0.613981,0.33,1,553012,552575,437
21902921,37.4056,36.6976,438,24418,0.610796,0.33,1,553046,552608,438
21905841,25.8811,24.9395,439,24505,0.626159,0.43,1,553069,552630,439
21908761,65.9762,62.5879,443,24591,0.693232,0.47,1,553145,552702,443
21911681,66.7952,64.5176,445,24677,0.754646,0.47,2,553212,552767,445
21914601,14.959,14.5035,445,24763,0.766929,0.57,2,553214,552769,445
21917521,98.1918,95.7007,448,24849,0.753386,0.65,2,553333,552885,448
21920441,90.8384,87.1401,452,24934,0.862677,0.61,2,553422,552970,452
21923361,51.7677,51.028,452,25019,0.852535,0.61,2,553464,553012,452
21926281,37.5535,37.4056,452,25104,0.850507,0.63,2,553498,553046,452
21929201,26.7107,25.8811,453,25188,0.850101,0.71,2,553522,553069,453
21932121,70.1421,65.9762,458,25272,0.86602,0.77,2,553603,553145,458
21935041,67.6284,66.7952,458,25356,0.853204,0.77,2,553670,553212,458
21937961,15.1257,14.959,458,25440,0.850641,0.77,2,553672,553214,458
21940881,98.2251,2.99181,577,25523,0.834128,0.75,2,553791,553214,577
21943801,94.845,95.7984,552,25606,0.878826,0.89,2,553885,553333,552
21946721,52.569,90.3597,505,25689,0.903765,0.85,2,553927,553422,505
22046001,25,27,487,28357,0.43,1,1,555817,555330,487
22048921,24.2,5.4,511,28432,0.27,1,1,555841,555330,511
22051841,28.04,24.28,511,28506,0.158,1,1,555870,555359,511
22054761,26.408,33.656,501,28580,0.0556,1,1,555896,555395,501
22057681,68.4816,29.1312,552,28654,0.05112,0.94,1,555975,555423,552
22060601,60.0963,68.2262,532,28728,0.034224,1,1,556033,555501,532
22063521,36.8193,63.2452,501,28802,0.0468448,0.98,1,556064,555563,501
22066441,79.3639,37.4491,560,28876,0.033369,0.79,1,556154,555594,560
22069361,79.8728,85.0898,543,28949,0.0306738,0.47,1,556234,555691,543
22072281,32.7746,97.818,463,29022,0.0781348,0.43,1,556255,555792,463
22075201,19.3549,39.5636,454,29095,0.103627,0.23,1,556271,555817,454
22078121,25.471,27.1127,457,29168,0.0767254,0.13,1,556298,555841,457
22081041,20.2942,28.6225,447,29241,0.103345,0.03,1,556317,555870,447
22083961,69.6588,26.5245,503,29313,0.108669,0.05,1,556399,555896,503
22086881,57.9318,68.5049,479,29385,0.0777338,0.03,1,556454,555975,479
22089801,37.9864,60.101,454,29457,0.0555468,0.05,1,556487,556033,454
22092721,78.7973,36.8202,512,29529,0.0351094,0.03,1,556576,556064,512
22095641,79.7595,79.364,502,29601,0.0630219,0.03,1,556656,556154,502
22098561,35.9519,79.8728,447,29673,0.116604,0.09,1,556681,556234,447
22101481,18.3904,32.7746,440,29744,0.143321,0.11,1,556695,556255,440
22104401,26.8781,19.3549,453,29815,0.132664,0.07,1,556724,556271,453
22107321,6.97561,25.471,428,29886,0.130533,0.11,1,556726,556298,428
22110241,15.7951,20.2942,427,29957,0.130107,0.11,1,556744,556317,427
22113161,67.159,69.6588,425,30028,0.114021,0.07,1,556824,556399,425
22116081,55.0318,57.9318,422,30098,0.0468043,0.05,1,556876,556454,422
22119001,39.0064,37.9864,424,30168,0.0653609,0.03,1,556911,556487,424
22121921,78.2013,78.7973,423,30238,0.0690722,0.07,1,556999,556576,423
22124841,82.0403,79.7595,426,30308,0.133814,0.13,1,557082,556656,426
22127761,38.808,35.9519,429,30378,0.114763,0.15,1,557110,556681,429
22130681,18.9616,18.3904,429,30448,0.0789526,0.13,1,557124,556695,429
22133601,26.1923,26.8781,428,30518,0.103791,0.13,1,557152,556724,428
22136521,6.83846,6.97561,428,30587,0.140758,0.13,1,557154,556726,428
22139441,15.7677,15.7951,428,30656,0.116152,0.11,1,557172,556744,428
22142361,66.3535,67.159,427,30725,0.12723,0.03,1,557251,556824,427
22145281,50.8707,55.0318,422,30794,0.161446,0.07,1,557298,556876,422
22148201,38.9741,39.0064,423,30863,0.0562892,0.07,1,557334,556911,423
22151121,78.9948,78.2013,424,30932,0.0512578,0.15,1,557423,556999,424
22154041,84.599,82.0403,427,31000,0.0662516,0.11,1,557509,557082,427
22156961,37.7198,38.808,425,31068,0.0532503,0.07,1,557535,557110,425
22159881,19.544,18.9616,426,31136,0.0666501,0.11,1,557550,557124,426
22162801,27.1088,26.1923,427,31204,0.08533,0.15,1,557579,557152,427
22165721,7.02176,6.83846,427,31272,0.089066,0.11,1,557581,557154,427
22168641,15.8044,15.7677,427,31340,0.0898132,0.11,1,557599,557172,427
22171561,66.3609,3.15354,506,31408,0.0739626,0.13,1,557678,557172,506
22174481,50.8722,63.8307,474,31475,0.0867925,0.17,1,557725,557251,474
22177401,34.9744,50.3661,458,31542,0.0733585,0.03,1,557756,557298,458
22180321,77.3949,38.8732,510,31609,0.102672,0.05,1,557844,557334,510
22183241,85.079,78.9746,508,31676,0.0925343,0.07,1,557931,557423,508
22186161,38.6158,84.5949,449,31743,0.0905069,0.05,1,557958,557509,449
22189081,20.5232,37.719,439,31810,0.0901014,0.07,1,557974,557535,439
22192001,26.5046,19.5438,452,31877,0.0900203,0.09,1,558002,557550,452
22194921,6.90093,27.1088,425,31943,0.0900041,0.09,1,558004,557579,425
22197841,16.5802,7.02175,442,32009,0.138001,0.09,1,558023,557581,442
22200761,66.516,15.8044,503,32075,0.1796,0.07,1,558102,557599,503
22203681,51.7032,66.3609,472,32141,0.23592,0.09,1,558150,557678,472
22206601,34.3406,50.8722,455,32207,0.263184,0.07,1,558180,557725,455
22209521,78.8681,34.9744,514,32273,0.268637,0.11,1,558270,557756,514
22212441,84.5736,77.3949,512,32339,0.333727,0.09,1,558356,557844,512
22215361,38.5147,85.079,452,32404,0.362745,0.09,1,558383,557931,452
22218281,20.5029,38.6158,441,32469,0.368549,0.09,1,558399,557958,441
22221201,27.3006,20.5232,454,32534,0.35371,0.09,1,558428,557974,454
22224121,7.06012,26.5046,428,32599,0.350742,0.09,1,558430,558002,428
22227041,18.212,6.90093,447,32664,0.366148,0.15,1,558451,558004,447
22229961,68.4424,16.5802,509,32729,0.44923,0.19,1,558532,558023,509
22232881,15.2885,66.516,432,32794,0.465846,0.25,1,558534,558102,432
22235801,43.0577,51.7032,434,32858,0.517169,0.27,1,558584,558150,434
22238721,33.4115,34.3406,435,32922,0.543434,0.27,1,558615,558180,435
22241641,78.6823,78.8681,435,32986,0.564687,0.35,1,558705,558270,435
22244561,87.7365,84.5736,439,33050,0.584937,0.37,1,558795,558356,439
22247481,39.9473,38.5147,440,33114,0.620987,0.37,1,558823,558383,440
22250401,20.7895,20.5029,440,33178,0.628197,0.35,1,558839,558399,440
22253321,26.5579,27.3006,439,33242,0.62964,0.35,1,558867,558428,439
22256241,6.91158,7.06012,439,33306,0.661928,0.37,1,558869,558430,439
22259161,18.9823,18.212,440,33370,0.636386,0.47,1,558891,558451,440
22262081,72.5965,68.4424,445,33433,0.679277,0.47,1,558977,558532,445
22265001,16.1193,15.2885,445,33496,0.687855,0.53,1,558979,558534,445
22267921,44.0239,43.0577,446,33559,0.673571,0.55,1,559030,558584,446
22270841,34.4048,33.4115,447,33622,0.718714,0.57,1,559062,558615,447
22273761,80.481,78.6823,449,33685,0.727743,0.59,1,559154,558705,449
22276681,89.6962,87.7365,451,33748,0.777549,0.63,2,559246,558795,451
22279601,40.3392,39.9473,451,33811,0.75551,0.63,2,559274,558823,451
22282521,21.6678,20.7895,452,33874,0.783102,0.63,2,559291,558839,452
22285441,27.5336,26.5579,453,33936,0.78862,0.67,2,559320,558867,453
22288361,7.10671,6.91158,453,33998,0.789724,0.63,2,559322,558869,453
22291281,19.8213,18.9823,454,34060,0.773945,0.69,2,559345,558891,454
22294201,74.3643,72.5965,456,34122,0.770789,0.69,2,559433,558977,456
22297121,16.4729,16.1193,456,34184,0.802158,0.67,2,559435,558979,456
22300041,43.2946,44.0239,455,34246,0.792432,0.67,2,559485,559030,455
22302961,34.2589,8.80477,487,34308,0.790486,0.73,2,559517,559030,487
22305881,82.0518,27.361,549,34370,0.806097,0.73,2,559611,559062,549
22308801,90.8104,79.0722,550,34432,0.857219,0.79,2,559704,559154,550
22311721,41.3621,89.4144,487,34493,0.851444,0.75,2,559733,559246,487
22314641,21.0724,40.2829,475,34554,0.866289,0.79,2,559749,559274,475
22317561,27.4145,21.6566,487,34615,0.885258,0.79,2,559778,559291,487
22320481,7.0829,27.5313,460,34676,0.889052,0.79,2,559780,559320,460
22323401,20.6166,7.10626,482,34737,0.88981,0.77,2,559804,559322,482
22326321,74.5233,19.8213,547,34798,0.889962,0.77,2,559892,559345,547
22329241,16.5047,74.3643,461,34859,0.889992,0.81,2,559894,559433,461
22332161,44.1009,16.4728,510,34920,0.937999,0.79,2,559945,559435,510
22335081,34.4202,43.2946,492,34981,0.9476,0.79,2,559977,559485,492
22448961,31,90,514,37265,0.55,1,1,561636,561122,514
22451881,34.2,45.2,515,37322,0.486,1,1,561671,561156,515
22454801,27.64,30.64,514,37379,0.4252,1,1,561697,561183,514
22457721,24.728,27.728,511,37436,0.28504,1,1,561721,561210,511
22460641,28.1456,27.1456,513,37492,0.177008,1,1,561750,561237,513
22463561,32.8291,30.2291,516,37548,0.171402,1,1,561784,561268,516
22466481,38.5658,46.8458,505,37604,0.0742803,1,1,561824,561319,505
22469401,28.5132,31.7692,503,37660,0.0228561,1,1,561850,561347,503
22472321,34.5026,31.9538,507,37716,0.00457121,1,1,561886,561379,507
22475241,31.7005,35.1908,502,37772,0.0569142,0.89,1,561917,561415,502
22478161,65.5401,31.8382,545,37828,0.0353828,0.86,1,561991,561446,545
22481081,65.108,69.5676,531,37884,0.111077,0.69,1,562056,561525,531
22484001,35.4216,77.9135,479,37940,0.142215,0.55,1,562084,561605,479
22486921,31.8843,40.3827,479,37996,0.148443,0.47,1,562115,561636,479
22489841,22.3769,36.0765,464,38052,0.133689,0.41,1,562135,561671,464
22492761,18.8754,28.0153,456,38108,0.130738,0.25,1,562153,561697,456
22495681,26.9751,24.8031,461,38163,0.130148,0.15,1,562182,561721,461
22498601,29.395,28.1606,462,38218,0.16203,0.17,1,562212,561750,462
22501521,32.279,32.8321,461,38273,0.184406,0.05,1,562245,561784,461
22504441,30.4558,38.5664,451,38328,0.124881,0.01,1,562275,561824,451
22507361,31.6912,28.5133,457,38383,0.0489762,0,1,562307,561850,457
22510281,31.9382,34.5027,453,38438,0.0497952,0.07,1,562339,561886,453
22513201,66.3876,31.7005,497,38493,0.017959,0.03,1,562414,561917,497
22516121,67.6775,65.5401,491,38548,0.107592,0.13,1,562482,561991,491
22519041,37.5355,65.108,456,38603,0.173518,0.15,1,562512,562056,456
22521961,9.1071,35.4216,430,38658,0.186704,0.15,1,562514,562084,430
22524881,24.2214,31.8843,427,38713,0.237341,0.13,1,562542,562115,427
22527801,23.2443,22.3769,430,38768,0.231468,0.13,1,562565,562135,430
22530721,18.2489,18.8754,429,38822,0.246294,0.13,1,562582,562153,429
22533641,27.6498,26.9751,430,38876,0.265259,0.17,1,562612,562182,430
22536561,28.73,29.395,429,38930,0.269052,0.19,1,562641,562212,429
22539481,33.746,32.279,431,38984,0.25381,0.11,1,562676,562245,431
22542401,27.5492,30.4558,427,39038,0.250762,0.03,1,562702,562275,427
22545321,28.7098,31.6912,424,39092,0.282152,0.05,1,562731,562307,424
22548241,29.742,31.9382,422,39146,0.27243,0.01,1,562761,562339,422
22551161,68.3484,66.3876,425,39200,0.174486,0.13,1,562839,562414,425
22554081,72.0697,67.6775,430,39254,0.186897,0.19,1,562912,562482,430
22557001,39.2139,37.5355,431,39308,0.141379,0.19,1,562943,562512,431
22559921,9.44279,9.1071,431,39362,0.132276,0.25,1,562945,562514,431
22562841,25.0886,24.2214,432,39416,0.130455,0.23,1,562974,562542,432
22565761,24.2177,23.2443,433,39470,0.178091,0.25,1,562998,562565,433
22568681,17.6435,18.2489,432,39524,0.187618,0.27,1,563014,562582,432
22571601,28.3287,27.6498,433,39577,0.189524,0.27,1,563045,562612,433
22574521,28.8657,28.73,433,39630,0.221905,0.25,1,563074,562641,433
22577441,34.5731,33.746,434,39683,0.260381,0.25,1,563110,562676,434
22580361,27.7146,27.5492,434,39736,0.236076,0.29,1,563136,562702,434
22583281,28.7429,28.7098,434,39789,0.263215,0.27,1,563165,562731,434
22586201,28.9486,29.742,433,39842,0.252643,0.15,1,563194,562761,433
22589121,64.1897,68.3484,428,39895,0.282529,0.19,1,563267,562839,428
22592041,72.0379,72.0697,429,39948,0.304506,0.13,1,563341,562912,429
22594961,39.2076,39.2139,429,40001,0.340901,0.13,1,563372,562943,429
22597881,9.44152,9.44279,429,40054,0.34818,0.13,1,563374,562945,429
22600801,24.2883,25.0886,428,40107,0.317636,0.13,1,563402,562974,428
22603721,24.0577,5.01771,452,40160,0.327527,0.19,1,563426,562974,452
22606641,17.6115,20.2035,444,40213,0.377505,0.19,1,563442,562998,444
22609561,29.9223,16.8407,461,40266,0.387501,0.19,1,563475,563014,461
22612481,30.7845,28.1681,461,40318,0.4055,0.23,1,563506,563045,461
22615401,34.9569,28.8336,468,40370,0.4251,0.27,1,563542,563074,468
22618321,27.7914,34.5667,458,40422,0.42902,0.23,1,563568,563110,458
22621241,28.7583,27.7133,461,40474,0.461804,0.27,1,563597,563136,461
22624161,29.7517,28.7427,462,40526,0.468361,0.25,1,563627,563165,462
22627081,64.3503,28.9485,506,40578,0.469672,0.29,1,563700,563194,506
22630001,74.4701,64.1897,510,40630,0.469934,0.31,1,563777,563267,510
22632921,39.694,72.0379,467,40682,0.485987,0.35,1,563808,563341,467
22635841,9.5388,39.2076,438,40734,0.489197,0.35,1,563810,563372,438
22638761,25.1078,9.44152,465,40786,0.505839,0.31,1,563839,563374,465
22641681,25.8216,24.2883,463,40838,0.477168,0.33,1,563865,563402,463
22644601,18.7643,24.0577,456,40890,0.535434,0.39,1,563882,563426,456
22647521,30.1529,17.6115,473,40942,0.579087,0.39,1,563915,563442,473
22650441,31.6306,29.9223,472,40994,0.603817,0.41,1,563947,563475,472
22653361,35.9261,30.7845,478,41045,0.624763,0.43,1,563984,563506,478
22656281,28.7852,34.9569,469,41096,0.644953,0.43,1,564011,563542,469
22659201,29.757,27.7914,473,41147,0.616991,0.47,1,564041,563568,473
22662121,30.7514,28.7583,475,41198,0.627398,0.47,1,564072,563597,475
22665041,63.7503,29.7517,517,41249,0.62948,0.47,1,564144,563627,517
22667961,74.3501,64.3503,521,41300,0.629896,0.47,1,564221,563700,521
22670881,40.47,74.4701,476,41351,0.677979,0.49,1,564253,563777,476
22673801,9.694,39.694,447,41402,0.687596,0.49,1,564255,563808,447
22676721,24.3388,9.5388,473,41453,0.721519,0.51,1,564283,563810,473
22679641,27.2678,25.1078,472,41504,0.728304,0.47,1,564311,563839,472
22682561,7.05355,25.8216,448,41555,0.729661,0.55,1,564313,563865,448
22685481,15.8107,18.7643,449,41606,0.729932,0.59,1,564331,563882,449
22688401,31.1621,30.1529,451,41657,0.793986,0.61,2,564366,563915,451
22691321,32.6324,31.6306,452,41708,0.854797,0.63,2,564399,563947,452
22694241,36.9265,35.9261,453,41759,0.866959,0.65,2,564437,563984,453
22697161,28.1853,28.7852,452,41810,0.885392,0.61,2,564463,564011,452
22700081,29.6371,29.757,452,41860,0.921078,0.63,2,564493,564041,452
22703001,31.5274,30.7514,453,41910,0.912216,0.63,2,564525,564072,453
22705921,64.7055,63.7503,454,41960,0.942443,0.63,2,564598,564144,454
22708841,74.5411,74.3501,454,42010,0.932489,0.69,2,564675,564221,454
22723441,2,2,458,42260,0.93,0.73,2,564771,564313,458
22945361,86,28,500,20544,0.05,0.03,1,567473,566973,500
22948281,90,102.4,470,20647,0.034,0.05,1,567564,567094,470
22951201,66.8,77.28,460,20750,0.0308,0.03,1,567625,567165,460
22954121,39.76,65.056,431,20852,0.04616,0.01,1,567658,567227,431
22957041,22.352,29.0112,429,20954,0.033232,0.05,1,567676,567247,429
22959961,53.2704,25.8022,465,21055,0.0626464,0.07,1,567737,567272,465
22962881,69.8541,64.3604,465,21156,0.100529,0.05,1,567811,567346,465
22965801,82.7708,114.472,424,21256,0.204106,0.03,1,567897,567473,424
22968721,88.5542,95.6944,423,21356,0.0808212,0.03,1,567987,567564,423
22971641,65.7108,67.9389,422,21455,0.0561642,0.05,1,568047,567625,422
22974561,40.3422,39.9878,423,21554,0.0352328,0.03,1,568081,567658,423
22977481,22.4684,22.3976,423,21652,0.0150466,0.07,1,568099,567676,423
22980401,53.2937,53.2795,423,21750,0.0110093,0.11,1,568160,567737,423
22983321,71.4587,69.8559,425,21848,0.0582019,0.23,1,568236,567811,425
22986241,87.8917,82.7712,431,21945,0.21164,0.05,1,568328,567897,431
22989161,82.3784,88.5542,422,22042,0.162328,0.05,1,568409,567987,422
22992081,64.4757,65.7108,422,22138,0.136466,0.03,1,568469,568047,422
22995001,40.0951,40.3422,422,22234,0.0992931,0.01,1,568503,568081,422
22997921,22.419,22.4684,422,22329,0.0278586,0.01,1,568521,568099,422
23000841,53.2838,53.2937,422,22424,0.0135717,0.07,1,568582,568160,422
23003761,72.2568,71.4587,423,22519,0.0267143,0.07,1,568659,568236,423
23006681,94.4514,14.2917,523,22613,0.0613429,0.25,1,568759,568236,523
23009601,79.6903,76.4583,507,22707,0.0842686,0.15,1,568835,568328,507
23012521,63.1381,80.0917,485,22800,0.136854,0.13,1,568894,568409,485
23015441,38.2276,64.0183,457,22893,0.147371,0.09,1,568926,568469,457
23018361,20.4455,40.0037,439,22986,0.165474,0.01,1,568942,568503,439
23021281,52.8891,22.4007,482,23078,0.153095,0.01,1,569003,568521,482
23024201,72.9778,53.2801,499,23170,0.182619,0.03,1,569081,568582,499
23027121,96.9956,72.256,525,23261,0.188524,0.07,1,569184,568659,525
23030041,80.9991,94.4512,502,23352,0.221705,0.09,1,569261,568759,502
23032961,64.9998,79.6902,487,23443,0.292341,0.15,1,569322,568835,487
23035881,38.6,63.138,460,23533,0.306468,0.15,1,569354,568894,460
23038801,21.32,38.2276,445,23623,0.325294,0.17,1,569371,568926,445
23041721,52.264,20.4455,489,23713,0.297059,0.15,1,569431,568942,489
23044641,74.4528,52.8891,508,23802,0.291412,0.19,1,569511,569003,508
23047561,98.0906,72.9778,534,23891,0.338282,0.19,1,569615,569081,534
23050481,82.0181,96.9956,509,23980,0.395656,0.23,1,569693,569184,509
23053401,18.0036,80.9991,434,24068,0.407131,0.31,1,569695,569261,434
23056321,54.8007,64.9998,437,24156,0.425426,0.31,1,569759,569322,437
23059241,36.5601,38.6,437,24244,0.477085,0.33,1,569791,569354,437
23062161,21.712,21.32,438,24331,0.455417,0.29,1,569809,569371,438
23065081,50.7424,52.264,436,24418,0.467083,0.29,1,569867,569431,436
23068001,74.1485,74.4528,436,24505,0.549417,0.35,1,569947,569511,436
23070921,100.43,98.0906,439,24591,0.581883,0.41,1,570054,569615,439
23073841,84.8859,82.0181,442,24677,0.684377,0.41,1,570135,569693,442
23076761,18.5772,18.0036,442,24763,0.704875,0.43,1,570137,569695,442
23079681,55.7154,54.8007,443,24849,0.676975,0.49,1,570202,569759,443
23082601,37.5431,36.5601,444,24934,0.735395,0.45,1,570235,569791,444
23085521,21.9086,21.712,444,25019,0.715079,0.47,1,570253,569809,444
23088441,52.3817,50.7424,446,25104,0.727016,0.57,1,570313,569867,446
23091361,76.0763,74.1485,448,25188,0.729403,0.59,1,570395,569947,448
23094281,101.615,100.43,449,25272,0.761881,0.71,2,570503,570054,449
23097201,89.9231,84.8859,455,25356,0.752376,0.71,2,570590,570135,455
23100121,19.5846,18.5772,455,25440,0.798475,0.71,2,570592,570137,455
23103041,55.1169,3.71544,519,25523,0.775695,0.67,2,570656,570137,519
23105961,39.0234,52.7431,489,25606,0.771139,0.75,2,570691,570202,489
23108881,22.2047,36.9486,474,25689,0.786228,0.71,2,570709,570235,474
23111801,53.2409,21.7897,517,25771,0.821246,0.73,2,570770,570253,517
23114721,76.2482,52.3579,539,25853,0.844249,0.73,2,570852,570313,539
23117641,101.65,76.0716,565,25935,0.89685,0.77,2,570960,570395,565
23222761,66,108,548,28728,0.65,1,1,572932,572384,548
23225681,61.2,93.6,518,28802,0.554,1,1,572992,572474,518
23228601,37.04,42.72,519,28876,0.5188,1,1,573023,572504,519
23231521,31.408,43.744,505,28949,0.47976,1,1,573053,572548,505
23234441,45.4816,37.5488,518,29022,0.471952,1,1,573102,572584,518
23237361,28.2963,37.9098,504,29095,0.39039,1,1,573126,572622,504
23240281,24.8593,30.782,499,29168,0.438078,1,1,573150,572651,499
23243201,68.9719,30.1564,549,29241,0.479616,0.88,1,573230,572681,549
23246121,87.3944,66.0313,566,29313,0.455923,0.81,1,573322,572756,566
23249041,68.6789,101.206,520,29385,0.435185,0.65,1,573386,572866,520
23251961,56.9358,73.0412,508,29457,0.463037,0.53,1,573440,572932,508
23254881,36.1872,62.6082,479,29529,0.452607,0.51,1,573471,572992,479
23257801,28.8374,37.3217,475,29601,0.402521,0.47,1,573498,573023,475
23260721,42.5675,31.4643,491,29673,0.440504,0.47,1,573544,573053,491
23263641,26.1135,45.4929,464,29744,0.480101,0.37,1,573566,573102,464
23266561,26.0227,28.2986,466,29815,0.50402,0.45,1,573592,573126,466
23269481,6.80454,24.8597,444,29886,0.508804,0.49,1,573594,573150,444
23272401,65.3609,68.9719,444,29957,0.557761,0.45,1,573674,573230,444
23275321,85.0722,87.3944,442,30028,0.567552,0.43,1,573764,573322,442
23278241,69.0144,68.6789,443,30098,0.58551,0.47,1,573829,573386,443
23281161,57.0029,56.9358,443,30168,0.589102,0.45,1,573883,573440,443
23284081,37.0006,36.1872,444,30238,0.63782,0.39,1,573915,573471,444
23287001,28.2001,28.8374,443,30308,0.647564,0.45,1,573941,573498,443
23289921,43.24,42.5675,444,30378,0.665513,0.49,1,573988,573544,444
23292841,27.848,26.1135,446,30448,0.669103,0.51,1,574012,573566,446
23295761,27.1696,26.0227,447,30518,0.669821,0.51,1,574039,573592,447
23298681,7.03392,6.80454,447,30587,0.669964,0.57,1,574041,573594,447
23301601,67.8068,65.3609,450,30656,0.653993,0.57,1,574124,573674,450
23304521,83.9614,85.0722,448,30725,0.762799,0.59,2,574212,573764,448
23307441,71.1923,69.0144,451,30794,0.76856,0.59,2,574280,573829,451
23310361,59.0385,57.0029,453,30863,0.817712,0.65,2,574336,573883,453
23313281,38.2077,37.0006,454,30932,0.843542,0.65,2,574369,573915,454
23316201,28.4415,28.2001,454,31000,0.848709,0.67,2,574395,573941,454
23319121,42.4883,43.24,453,31068,0.849742,0.67,2,574441,573988,453
23322041,28.4977,27.848,454,31136,0.833948,0.67,2,574466,574012,454
23324961,28.0995,27.1696,455,31204,0.83079,0.67,2,574494,574039,455
23327881,7.21991,7.03392,455,31272,0.830158,0.65,2,574496,574041,455
23330801,67.844,67.8068,455,31340,0.846032,0.65,2,574579,574124,455
23333721,86.3688,13.5614,546,31408,0.897206,0.79,2,574670,574124,546
23459281,46,26,500,34184,0.63,1,1,576614,576114,500
23462201,49.2,62,479,34246,0.646,1,1,576664,576185,479
23465121,64.24,12.4,547,34308,0.5532,1,1,576732,576185,547
23468041,42.448,48.08,527,34370,0.58264,1,1,576769,576242,527
23470961,32.4896,30.416,531,34432,0.492528,1,1,576799,576268,531
23473881,33.6979,36.4832,527,34493,0.506506,1,1,576833,576306,527
23476801,29.9396,41.6966,513,34554,0.477301,1,1,576862,576349,513
23479721,14.7879,39.5393,485,34615,0.48746,1,1,576873,576388,485
23482641,37.3576,18.3079,515,34676,0.489492,0.99,1,576916,576401,515
23485561,31.4715,44.4616,494,34737,0.489898,0.89,1,576946,576452,494
23488481,66.2943,35.2923,536,34798,0.47398,0.71,1,577021,576485,536
23491401,50.0589,73.4585,499,34859,0.502796,0.63,1,577067,576568,499
23494321,48.4118,51.4917,501,34920,0.508559,0.65,1,577115,576614,501
23497241,60.0824,50.2983,514,34981,0.541712,0.53,1,577178,576664,514
23500161,40.0165,64.4597,481,35041,0.660342,0.59,1,577213,576732,481
23503081,32.0033,42.4919,474,35101,0.668068,0.47,1,577243,576769,474
23506001,33.6007,32.4984,478,35161,0.637614,0.51,1,577277,576799,478
23508921,29.9201,33.6997,473,35221,0.679523,0.47,1,577306,576833,473
23511841,17.184,29.9399,458,35281,0.655905,0.49,1,577320,576862,458
23514761,36.2368,14.788,488,35341,0.667181,0.49,1,577361,576873,488
23517681,31.2474,37.3576,475,35401,0.685436,0.49,1,577391,576916,475
23520601,67.0495,31.4715,521,35461,0.689087,0.47,1,577467,576946,521
23523521,51.8099,66.2943,494,35521,0.737817,0.51,1,577515,577021,494
23526441,47.162,50.0589,494,35581,0.763564,0.51,2,577561,577067,494
23529361,63.0324,48.4118,513,35640,0.736713,0.55,1,577628,577115,513
23532281,14.2065,60.0824,452,35699,0.731343,0.69,1,577630,577178,452
23535201,34.0413,40.0165,456,35758,0.810268,0.67,2,577669,577213,456
23538121,28.4083,32.0033,453,35817,0.810054,0.63,2,577696,577243,453
23541041,36.0817,33.6007,457,35876,0.826011,0.69,2,577734,577277,457
23543961,28.0163,29.9201,454,35935,0.797202,0.65,2,577760,577306,454
23546881,16.8033,17.184,454,35994,0.83944,0.67,2,577774,577320,454
23549801,36.9607,36.2368,455,36053,0.831888,0.69,2,577816,577361,455
23552721,32.1921,31.2474,456,36112,0.878378,0.69,2,577847,577391,456
23555641,67.2384,67.0495,456,36171,0.871675,0.75,2,577923,577467,456
23719161,33,28,510,39308,0.85,1,2,580130,579620,510
23722081,19.4,35.2,489,39362,0.882,1,2,580146,579657,489
23725001,27.88,25.44,496,39416,0.8564,1,2,580176,579680,496
23939621,129,110,526,19925,0.09,0.81,1,582960,582434,526
23942541,75.4,92.4,500,20031,0.042,0.57,1,583022,582522,500
23945461,52.68,80.08,470,20137,0.0484,0.39,1,583069,582599,470
23948381,55.336,56.816,475,20242,0.08168,0.15,1,583125,582650,475
23951301,19.0672,55.3632,430,20347,0.056336,0.13,1,583135,582705,430
23954221,99.0134,15.0726,544,20451,0.0352672,0.07,1,583254,582710,544
23957141,122.203,99.8145,551,20555,0.0470534,0.09,1,583382,582831,551
23960061,73.2405,123.163,483,20658,0.0974107,0.03,1,583443,582960,483
23962981,53.0481,74.2326,469,20761,0.0754821,0.05,1,583491,583022,469
23965901,56.2096,52.4465,479,20863,0.0870964,0.09,1,583548,583069,479
23968821,17.6419,55.2893,431,20965,0.0894193,0.05,1,583556,583125,431
23971741,5.12838,19.0579,423,21066,0.105884,0.03,1,583558,583135,423
23974661,97.8257,99.0116,425,21167,0.0611768,0.05,1,583679,583254,425
23977581,121.165,122.202,424,21267,0.0122354,0.11,1,583806,583382,424
23980501,75.433,73.2405,427,21367,0.0424471,0.07,1,583870,583443,427
23983421,51.8866,53.0481,425,21466,0.0484894,0.09,1,583916,583491,425
23986341,57.5773,56.2096,427,21565,0.0656979,0.09,1,583975,583548,427
23989261,17.9155,17.6419,427,21663,0.0691396,0.11,1,583983,583556,427
23992181,5.18309,5.12838,427,21761,0.0378279,0.05,1,583985,583558,427
23995101,93.8366,97.8257,422,21858,0.0635656,0,1,584101,583679,422
23998021,120.367,121.165,422,21955,0.0127131,0.05,1,584228,583806,422
24000941,76.8735,75.433,424,22052,0.106543,0.05,1,584294,583870,424
24003861,52.1747,51.8866,424,22148,0.157309,0.07,1,584340,583916,424
24006781,56.8349,57.5773,423,22244,0.199462,0.07,1,584398,583975,423
24009701,17.767,17.9155,423,22339,0.207892,0.03,1,584406,583983,423
24012621,5.1534,5.18309,423,22434,0.177578,0.07,1,584408,583985,423
24015541,95.4307,93.8366,425,22529,0.219516,0.07,1,584526,584101,425
24018461,117.486,18.7673,548,22623,0.147903,0,1,584649,584101,548
24021381,80.2972,105.353,492,22717,0.149581,0.13,1,584720,584228,492
24024301,53.6594,73.8707,473,22810,0.181916,0.17,1,584767,584294,473
24027221,58.7319,51.5741,487,22903,0.188383,0.21,1,584827,584340,487
24030141,18.1464,56.7148,437,22996,0.189677,0.21,1,584835,584398,437
24033061,5.22928,17.743,431,23088,0.189935,0.17,1,584837,584406,431
24035981,97.8459,5.14859,550,23180,0.221987,0.23,1,584958,584408,550
24038901,113.969,95.4297,550,23271,0.228397,0.13,1,585076,584526,550
24041821,80.3938,117.486,499,23362,0.293679,0.15,1,585148,584649,499
24044741,55.2788,80.2972,477,23453,0.338736,0.19,1,585197,584720,477
24047661,59.0558,53.6594,490,23543,0.379747,0.19,1,585257,584767,490
24050581,18.2111,58.7319,438,23633,0.387949,0.19,1,585265,584827,438
24053501,5.24223,18.1464,432,23723,0.38959,0.19,1,585267,584835,432
24056421,99.4484,5.22928,553,23812,0.437918,0.23,1,585390,584837,553
24059341,114.29,97.8459,550,23901,0.511584,0.23,1,585508,584958,550
24062261,24.4579,113.969,434,23990,0.526317,0.31,1,585510,585076,434
24065181,64.8916,80.3938,437,24078,0.593263,0.35,1,585585,585148,437
24068101,53.7783,55.2788,439,24166,0.622653,0.39,1,585636,585197,439
24071021,60.3557,59.0558,441,24254,0.612531,0.39,1,585698,585257,441
24073941,18.4711,18.2111,441,24341,0.610506,0.39,1,585706,585265,441
24076861,5.29423,5.24223,441,24428,0.610101,0.45,1,585708,585267,441
24079781,101.859,99.4484,444,24515,0.62602,0.53,1,585834,585390,444
24082701,117.972,114.29,448,24601,0.597204,0.53,1,585956,585508,448
24085621,25.1944,24.4579,448,24687,0.591441,0.61,1,585958,585510,448
24088541,66.6389,64.8916,450,24773,0.590288,0.63,1,586035,585585,450
24091461,56.5278,53.7783,453,24859,0.670058,0.61,1,586089,585636,453
24094381,60.1056,60.3557,452,24944,0.702011,0.61,1,586150,585698,452
24097301,18.4211,18.4711,452,25029,0.708402,0.61,1,586158,585706,452
24100221,5.28422,5.29423,452,25114,0.67768,0.63,1,586160,585708,452
24103141,101.057,101.859,451,25198,0.751536,0.59,2,586285,585834,451
24106061,117.811,117.972,451,25282,0.878307,0.59,2,586407,585956,451
24108981,25.1623,25.1944,451,25366,0.903661,0.59,2,586409,585958,451
24111901,66.6325,66.6389,451,25450,0.892732,0.59,2,586486,586035,451
24114821,58.1265,13.3278,507,25533,0.858546,0.69,2,586542,586035,507
24117741,61.2253,45.8656,515,25616,0.899709,0.71,2,586604,586089,515
24120661,18.6451,57.9731,462,25699,0.907942,0.71,2,586612,586150,462
24123581,5.32901,17.9946,456,25781,0.909588,0.67,2,586614,586158,456
24211181,35,52,479,28140,0.73,0.96,1,588386,587907,479
24214101,65.4,54.4,497,28215,0.458,1,1,588459,587962,497
24217021,42.68,59.68,473,28290,0.3716,1,1,588496,588023,473
24219941,44.536,35.136,489,28365,0.29032,1,1,588541,588052,489
24222861,28.1072,7.0272,513,28440,0.178064,1,1,588565,588052,513
24225781,32.0214,27.0054,514,28514,0.139613,1,1,588598,588084,514
24228701,49.6043,27.8011,540,28588,0.0679226,0.94,1,588652,588112,540
24231621,107.521,55.9602,599,28662,0.0695845,0.94,1,588774,588175,599
24234541,49.5042,118.392,500,28736,0.0699169,0.88,1,588809,588309,500
24237461,33.1008,57.2784,487,28810,0.117983,0.73,1,588838,588351,487
24240381,58.6202,39.4557,517,28883,0.0795967,0.39,1,588903,588386,517
24243301,36.524,66.2911,475,28956,0.119919,0.35,1,588934,588459,475
24246221,38.5048,42.8582,477,29029,0.111984,0.27,1,588973,588496,477
24249141,23.701,44.5716,452,29102,0.158397,0.15,1,588993,588541,452
24252061,30.3402,28.1143,460,29175,0.135679,0.13,1,589025,588565,460
24254981,45.268,32.0229,476,29248,0.131136,0.05,1,589074,588598,476
24257901,108.254,49.6046,546,29320,0.0822272,0.07,1,589198,588652,546
24260821,49.6507,107.521,459,29392,0.120445,0.07,1,589233,588774,459
24263741,35.5301,49.5042,456,29464,0.144089,0.13,1,589265,588809,456
24266661,56.706,33.1008,489,29536,0.180818,0.07,1,589327,588838,489
24269581,38.5412,58.6202,458,29608,0.204164,0.13,1,589361,588903,458
24272501,40.5082,36.524,468,29679,0.256833,0.11,1,589402,588934,468
24275421,24.1016,38.5048,449,29750,0.283367,0.17,1,589422,588973,449
24278341,28.8203,23.701,459,29821,0.288673,0.13,1,589452,588993,459
24281261,7.36407,30.3402,429,29892,0.289735,0.13,1,589454,589025,429
24284181,41.4728,45.268,430,29963,0.321947,0.07,1,589504,589074,430
24287101,104.295,108.254,426,30034,0.376389,0.13,1,589624,589198,426
24290021,51.2589,49.6507,429,30104,0.355278,0.15,1,589662,589233,429
24292941,36.6518,35.5301,430,30174,0.351056,0.19,1,589695,589265,430
24295861,57.7304,56.706,431,30244,0.366211,0.21,1,589758,589327,431
24298781,40.3461,38.5412,433,30314,0.337242,0.27,1,589794,589361,433
24301701,42.4692,40.5082,435,30384,0.347448,0.29,1,589837,589402,435
24304621,25.2938,24.1016,436,30454,0.33349,0.29,1,589858,589422,436
24307541,29.0588,28.8203,436,30523,0.346698,0.29,1,589888,589452,436
24310461,7.41175,7.36407,436,30592,0.34934,0.33,1,589890,589454,436
24313381,43.0824,41.4728,438,30661,0.365868,0.39,1,589942,589504,438
24316301,105.416,104.295,439,30730,0.401174,0.35,1,590063,589624,439
24319221,49.8833,51.2589,437,30799,0.440235,0.35,1,590099,589662,437
24322141,37.9767,36.6518,439,30868,0.432047,0.37,1,590134,589695,439
24325061,57.1953,57.7304,438,30937,0.494409,0.33,1,590196,589758,438
24327981,38.6391,40.3461,436,31005,0.554882,0.35,1,590230,589794,436
24330901,42.9278,42.4692,437,31073,0.598976,0.33,1,590274,589837,437
24333821,25.3856,25.2938,437,31141,0.591795,0.35,1,590295,589858,437
24336741,29.0771,29.0588,437,31209,0.590359,0.35,1,590325,589888,437
24339661,7.41542,7.41175,437,31277,0.590072,0.35,1,590327,589890,437
24342581,43.0831,1.48235,489,31345,0.574014,0.37,1,590379,589890,489
24345501,107.017,41.8965,560,31413,0.650803,0.41,1,590502,589942,560
24348421,51.8033,105.179,477,31480,0.714161,0.45,1,590540,590063,477
24351341,39.9607,49.8359,478,31547,0.726832,0.43,1,590577,590099,478
24354261,59.1921,37.9672,507,31614,0.745366,0.51,1,590641,590134,507
24357181,40.6384,57.1934,481,31681,0.781073,0.57,2,590677,590196,481
24360101,44.9277,38.6387,493,31748,0.788215,0.61,2,590723,590230,493
24363021,24.9855,42.9277,469,31815,0.789643,0.59,2,590743,590274,469
24365941,28.9971,25.3855,478,31881,0.789929,0.59,2,590773,590295,478
24368861,7.39942,29.0771,450,31947,0.789986,0.59,2,590775,590325,450
24371781,43.8799,7.41542,501,32013,0.821997,0.57,2,590828,590327,501
24374701,111.176,43.0831,577,32079,0.844399,0.67,2,590956,590379,577
24377621,55.8352,107.017,496,32145,0.88088,0.73,2,590998,590502,496
24380541,41.567,51.8033,496,32211,0.888176,0.73,2,591036,590540,496
24383461,60.3134,39.9607,524,32277,0.889635,0.75,2,591101,590577,524
24386381,40.8627,59.1921,496,32343,0.937927,0.79,2,591137,590641,496
24520701,33,33,507,35224,0.83,1,2,593103,592596,507
24523621,33.8,29,513,35284,0.654,1,1,593137,592624,513
24526541,31.56,37.8,504,35344,0.5708,1,1,593168,592664,504
24529461,33.512,24.36,517,35404,0.52216,1,1,593202,592685,517
24532381,85.9024,30.472,584,35464,0.288432,1,1,593301,592717,584
24535301,56.3805,103.694,511,35524,0.241686,1,1,593350,592839,511
24538221,34.4761,46.3389,508,35584,0.136337,0.99,1,593379,592871,508
24541141,24.4952,35.6678,497,35643,0.0832675,1,1,593401,592904,497
24544061,19.299,27.9336,489,35702,0.104653,1,1,593419,592930,489
24546981,29.4598,45.5867,471,35761,0.0769307,0.85,1,593451,592980,471
24549901,50.692,57.1173,467,35820,0.0553861,0.83,1,593507,593040,467
24552821,31.7384,35.4235,464,35879,0.0670772,0.83,1,593534,593070,464
24555741,28.7477,33.4847,459,35938,0.0134154,0.61,1,593562,593103,459
24558661,28.9495,33.8969,454,35997,0.0586831,0.55,1,593591,593137,454
24561581,28.1899,31.5794,451,36056,0.0517366,0.51,1,593619,593168,451
24564501,30.438,33.5159,448,36115,0.0663473,0.23,1,593650,593202,448
24567421,74.0876,85.9032,434,36174,0.0372695,0.23,1,593735,593301,434
24570341,50.8175,56.3806,430,36232,0.0794539,0.11,1,593780,593350,430
24573261,28.5635,34.4761,424,36290,0.103891,0.07,1,593803,593379,424
24576181,26.5127,24.4952,428,36348,0.0447782,0.11,1,593829,593401,428
24579101,15.7025,19.299,423,36406,0.0489556,0.07,1,593842,593419,423
24582021,29.5405,29.4598,424,36464,0.0977911,0.05,1,593875,593451,424
24584941,49.9081,50.692,423,36522,0.0435582,0.07,1,593930,593507,423
24587861,30.7816,31.7384,422,36580,0.0487116,0,1,593956,593534,422
24590781,29.3563,28.7477,423,36638,0.0817423,0.07,1,593985,593562,423
24593701,28.2713,28.9495,422,36696,0.0403485,0.05,1,594013,593591,422
24596621,28.8543,28.1899,423,36754,0.0320697,0.07,1,594042,593619,423
24599541,31.3709,30.438,424,36811,0.0304139,0.03,1,594074,593650,424
24602461,72.6742,74.0876,422,36868,0.158083,0.09,1,594157,593735,422
24605381,52.1348,50.8175,424,36925,0.135617,0.11,1,594204,593780,424
24608301,29.627,28.5635,425,36982,0.163123,0.03,1,594228,593803,425
24611221,25.1254,26.5127,423,37039,0.184625,0.05,1,594252,593829,423
24614141,14.6251,15.7025,422,37096,0.156925,0.11,1,594264,593842,422
24617061,31.725,29.5405,425,37153,0.151385,0.11,1,594300,593875,425
24619981,47.145,5.9081,476,37210,0.182277,0.03,1,594351,593875,476
24622901,32.629,45.1816,450,37267,0.236455,0.05,1,594380,593930,450
24625821,27.3258,29.8363,450,37324,0.247291,0.09,1,594406,593956,450
24628741,28.6652,29.1673,450,37381,0.233458,0.03,1,594435,593985,450
24631661,28.933,28.2335,451,37438,0.214692,0.03,1,594464,594013,451
24634581,32.1866,28.8467,455,37494,0.178938,0.03,1,594497,594042,455
24637501,76.8373,31.3693,511,37550,0.299788,0.19,1,594585,594074,511
24640421,52.1675,72.6739,474,37606,0.323958,0.13,1,594631,594157,474
24643341,29.6335,52.1348,451,37662,0.328791,0.17,1,594655,594204,451
24646261,25.9267,29.627,452,37718,0.377758,0.19,1,594680,594228,452
24649181,14.7853,25.1254,440,37774,0.387552,0.15,1,594692,594252,440
24652101,31.7571,14.6251,464,37830,0.38951,0.15,1,594728,594264,464
24655021,48.7514,31.725,481,37886,0.373902,0.19,1,594781,594300,481
24657941,35.3503,47.145,462,37942,0.37078,0.25,1,594813,594351,462
24660861,27.8701,32.629,459,37998,0.386156,0.25,1,594839,594380,459
24663781,27.974,27.3258,461,38054,0.405231,0.23,1,594867,594406,461
24666701,27.9948,28.6652,460,38110,0.409046,0.21,1,594895,594435,460
24669621,31.199,28.933,463,38165,0.441809,0.17,1,594927,594464,463
24672541,82.2398,32.1866,525,38220,0.448362,0.33,1,595022,594497,525
24675461,53.248,76.8373,483,38275,0.465672,0.33,1,595068,594585,483
24678381,29.8496,52.1675,461,38330,0.485134,0.33,1,595092,594631,461
24681301,28.3699,29.6335,465,38385,0.489027,0.39,1,595120,594655,465
24684221,15.274,25.9267,452,38440,0.489805,0.39,1,595132,594680,452
24687141,31.8548,14.7853,476,38495,0.505961,0.39,1,595168,594692,476
24690061,49.571,31.7571,494,38550,0.509192,0.37,1,595222,594728,494
24692981,33.9142,48.7514,471,38605,0.525838,0.37,1,595252,594781,471
24695901,8.38284,35.3503,441,38660,0.529168,0.39,1,595254,594813,441
24698821,23.2766,27.8701,442,38715,0.561834,0.41,1,595281,594839,442
24701741,27.0553,27.974,442,38770,0.584367,0.41,1,595309,594867,442
24704661,27.8111,27.9948,442,38824,0.604873,0.45,1,595337,594895,442
24707581,31.1622,31.199,442,38878,0.608975,0.45,1,595369,594927,442
24710501,83.8324,82.2398,444,38932,0.609795,0.47,1,595466,595022,444
24713421,54.3665,53.248,445,38986,0.657959,0.49,1,595513,595068,445
24716341,30.8733,29.8496,446,39040,0.619592,0.49,1,595538,595092,446
24719261,28.5747,28.3699,446,39094,0.643918,0.49,1,595566,595120,446
24722181,15.3149,15.274,446,39148,0.648784,0.51,1,595578,595132,446
24725101,32.663,31.8548,447,39202,0.649757,0.51,1,595615,595168,447
24728021,50.5326,49.571,448,39256,0.649951,0.53,1,595670,595222,448
24730941,34.1065,33.9142,448,39310,0.66599,0.53,1,595700,595252,448
24733861,8.4213,8.38284,448,39364,0.669198,0.57,1,595702,595254,448
24736781,23.2843,23.2766,448,39418,0.68584,0.59,1,595729,595281,448
24739701,28.6569,27.0553,450,39472,0.721168,0.61,1,595759,595309,450
24742621,28.1314,27.8111,450,39526,0.760234,0.61,2,595787,595337,450
24745541,31.2263,31.1622,450,39579,0.736047,0.61,1,595819,595369,450
24748461,84.6453,83.8324,451,39632,0.699209,0.67,1,595917,595466,451
24751381,56.1291,54.3665,453,39685,0.755842,0.61,2,595966,595513,453
24754301,30.4258,30.8733,452,39738,0.815168,0.65,2,595990,595538,452
24757221,28.4852,28.5747,452,39791,0.843034,0.65,2,596018,595566,452
24760141,16.097,15.3149,453,39844,0.832607,0.65,2,596031,595578,453
24763061,32.0194,32.663,452,39897,0.830521,0.65,2,596067,595615,452
24765981,51.2039,50.5326,453,39950,0.878104,0.67,2,596123,595670,453
24768901,34.2408,34.1065,453,40003,0.887621,0.67,2,596153,595700,453
24771821,8.44815,8.4213,453,40056,0.889524,0.69,2,596155,595702,453
24774741,24.0896,23.2843,454,40109,0.857905,0.69,2,596183,595729,454
24777661,31.2179,4.65685,487,40162,0.883581,0.73,2,596216,595729,487
24780581,28.6436,24.9314,485,40215,0.888716,0.77,2,596244,595759,485
24783501,31.3287,27.3863,489,40268,0.921743,0.73,2,596276,595787,489
24952861,37,59,514,43201,0.61,1,1,598372,597858,514
24955781,35.4,35,520,43250,0.562,1,1,598407,597887,520
24958701,33.48,33.4,520,43299,0.4884,1,1,598440,597920,520
24961621,31.496,32.28,519,43348,0.37768,1,1,598471,597952,519
24964541,35.0992,32.856,522,43397,0.339536,1,1,598507,597985,522
24967461,43.0198,36.1712,530,43446,0.315907,1,1,598552,598022,530
24970381,28.604,44.0342,509,43495,0.311181,0.99,1,598577,598068,509
24973301,26.5208,34.4068,503,43544,0.198236,1,1,598603,598100,503
24976221,26.1042,18.0814,515,43592,0.207647,1,1,598629,598114,515
24979141,21.2208,31.6163,500,43640,0.257529,1,1,598649,598149,500
24982061,19.4442,27.9233,492,43688,0.203506,0.87,1,598668,598176,492
24984981,19.0888,21.5847,491,43736,0.208701,0.97,1,598687,598196,491
24987901,31.0178,22.7169,502,43784,0.19374,0.95,1,598721,598219,502
24990821,58.2036,35.7434,528,43832,0.174748,0.69,1,598786,598258,528
24993741,38.0407,68.7487,484,43880,0.23495,0.61,1,598819,598335,484
24996661,35.6081,43.3497,482,43928,0.21499,0.55,1,598854,598372,482
24999581,31.1216,36.6699,477,43976,0.258998,0.47,1,598884,598407,477
25002501,25.4243,33.734,468,44024,0.2838,0.35,1,598908,598440,468
25005421,33.0849,31.5468,472,44072,0.25676,0.33,1,598943,598471,472
25008341,41.017,35.1094,479,44120,0.283352,0.31,1,598986,598507,479
25011261,29.0034,43.0219,460,44168,0.27267,0.31,1,599012,598552,460
25014181,21.8007,28.6044,455,44216,0.334534,0.17,1,599032,598577,455
25017101,28.3601,26.5209,459,44264,0.314907,0.21,1,599062,598603,459
25020021,21.672,26.1042,453,44312,0.310981,0.27,1,599082,598629,453
25022941,18.7344,21.2208,451,44360,0.278196,0.19,1,599100,598649,451
25025861,18.1469,19.4442,450,44408,0.271639,0.21,1,599118,598668,450
25028781,30.0294,19.0888,464,44456,0.286328,0.19,1,599151,598687,464
25031701,7.60587,31.0178,432,44503,0.289266,0.17,1,599153,598721,432
25034621,52.7212,58.2036,431,44550,0.337853,0.25,1,599217,598786,431
25037541,38.5442,38.0407,433,44597,0.347571,0.21,1,599252,598819,433
25040461,35.7088,35.6081,433,44644,0.381514,0.27,1,599287,598854,433
25043381,33.5418,31.1216,436,44691,0.452303,0.29,1,599320,598884,436
25046301,25.1084,25.4243,435,44738,0.450461,0.25,1,599343,598908,435
25049221,32.2217,33.0849,434,44785,0.450092,0.29,1,599377,598943,434
25052141,41.6443,41.017,435,44832,0.418018,0.27,1,599421,598986,435
25055061,29.9289,29.0034,436,44879,0.427604,0.35,1,599448,599012,436
25057981,22.7858,21.8007,437,44926,0.477521,0.31,1,599469,599032,437
25060901,28.5572,28.3601,437,44973,0.455504,0.31,1,599499,599062,437
25063821,20.1114,21.672,435,45020,0.483101,0.27,1,599517,599082,435
25066741,18.4223,18.7344,435,45067,0.47262,0.27,1,599535,599100,435
25069661,18.0845,18.1469,435,45114,0.502524,0.29,1,599553,599118,435
25072581,29.2169,30.0294,434,45161,0.508505,0.29,1,599585,599151,434
25075501,7.44338,7.60587,434,45208,0.509701,0.35,1,599587,599153,434
25078421,55.0887,52.7212,437,45255,0.55794,0.35,1,599654,599217,437
25081341,41.4177,38.5442,440,45302,0.583588,0.39,1,599692,599252,440
25084261,36.2835,35.7088,440,45349,0.620718,0.47,1,599727,599287,440
25087181,36.0567,33.5418,443,45396,0.596144,0.45,1,599763,599320,443
25090101,24.8113,25.1084,442,45442,0.591229,0.45,1,599785,599343,442
25093021,32.1623,32.2217,442,45488,0.622246,0.41,1,599819,599377,442
25095941,40.8325,41.6443,441,45534,0.612449,0.43,1,599862,599421,441
25098861,31.3665,29.9289,443,45580,0.65849,0.49,1,599891,599448,443
25101781,23.8733,22.7858,444,45626,0.731698,0.45,1,599913,599469,444
25104701,28.7747,28.5572,444,45672,0.71434,0.49,1,599943,599499,444
25107621,20.1549,20.1114,444,45718,0.710868,0.47,1,599961,599517,444
25110541,19.231,18.4223,445,45764,0.726174,0.51,1,599980,599535,445
25113461,18.2462,18.0845,445,45810,0.777235,0.51,2,599998,599553,445
25116381,29.2492,29.2169,445,45856,0.755447,0.51,2,600030,599585,445
25119301,7.44985,7.44338,445,45902,0.751089,0.57,2,600032,599587,445
25122221,57.49,55.0887,448,45948,0.734218,0.57,1,600102,599654,448
25125141,44.298,11.0177,489,45994,0.762844,0.59,2,600143,599654,489
25128061,36.0596,32.6035,485,46040,0.784569,0.63,2,600177,599692,485
25130981,34.4119,34.5207,484,46086,0.788914,0.59,2,600211,599727,484
25133901,24.4824,35.7041,470,46132,0.789783,0.59,2,600233,599763,470
25136821,33.6965,24.7408,484,46178,0.837957,0.63,2,600269,599785,484
25139741,41.9393,32.1482,494,46224,0.847591,0.61,2,600313,599819,494
25142661,34.7879,40.8296,484,46270,0.913518,0.67,2,600346,599862,484
25145581,25.3576,31.3659,478,46316,0.910704,0.75,2,600369,599891,478
25148501,29.0715,23.8732,486,46362,0.926141,0.71,2,600399,599913,486
25151421,20.2143,28.7746,474,46407,0.929228,0.71,2,600417,599943,474
25154341,20.8429,20.1549,477,46452,0.929846,0.73,2,600438,599961,477
25157261,18.5686,19.231,476,46497,0.929969,0.79,2,600456,599980,476
25160181,29.3137,18.2462,490,46542,0.929994,0.75,2,600488,599998,490
25163101,7.46274,29.2492,460,46587,0.929999,0.75,2,600490,600030,460
25166021,56.6925,7.44985,527,46632,0.914,0.73,2,600559,600032,527
25168941,46.5385,57.49,501,46677,0.8948,0.77,2,600603,600102,501
25171861,36.5077,44.298,494,46722,0.92296,0.79,2,600637,600143,494
25174781,34.5015,36.0596,494,46767,0.928592,0.79,2,600671,600177,494
25177701,26.1003,34.4119,484,46812,0.945718,0.79,2,600695,600211,484
25347061,29,30,513,49356,0.85,1,2,602441,601928,513
25349981,33,22,527,49399,0.738,1,1,602475,601948,527
25352901,39.4,43.6,519,49442,0.5236,1,1,602516,601997,519
25355821,24.68,33.52,509,49485,0.38472,1,1,602537,602028,509
25358741,29.736,28.304,513,49528,0.308944,1,1,602568,602055,513
25361661,36.3472,28.8608,522,49571,0.149789,1,1,602606,602084,522
25364581,30.4694,32.1722,518,49614,0.0699578,1,1,602635,602117,518
25367501,32.4939,32.8344,518,49656,0.0539916,1,1,602668,602150,518
25370421,30.4988,26.5669,523,49698,0.0107983,1,1,602698,602175,523
25373341,29.2998,27.7134,524,49740,0.00215966,1,1,602727,602203,524
25376261,25.86,32.7427,515,49782,0.0244319,1,1,602752,602237,515
25379181,26.772,31.3485,511,49824,0.108886,1,1,602779,602268,511
25382101,19.7544,31.0697,498,49866,0.109777,1,1,602797,602299,498
25385021,27.1509,26.2139,502,49908,0.0779555,1,1,602826,602324,502
25387941,19.8302,29.2428,490,49950,0.0235911,0.9,1,602844,602354,490
25390861,27.166,23.4486,497,49992,0.0607182,0.8,1,602873,602376,497
25393781,25.4332,33.4897,486,50034,0.0681436,0.85,1,602898,602412,486
25396701,27.4866,29.8979,485,50076,0.133629,0.71,1,602926,602441,485
25399621,28.6973,33.1796,480,50118,0.146726,0.47,1,602955,602475,480
25402541,19.3395,39.4359,456,50160,0.133345,0.35,1,602972,602516,456
25405461,25.4679,24.6872,462,50202,0.178669,0.29,1,602999,602537,462
25408381,31.4936,29.7374,464,50244,0.155734,0.11,1,603032,602568,464
25411301,25.4987,36.3475,450,50286,0.151147,0.05,1,603056,602606,450
25414221,6.69974,30.4695,423,50328,0.150229,0.05,1,603058,602635,423
25417141,28.5399,32.4939,424,50370,0.0700459,0,1,603092,602668,424
25420061,28.908,30.4988,423,50412,0.0140092,0,1,603121,602698,423
25422981,32.1816,29.2998,427,50454,0.0108018,0.03,1,603154,602727,427
25425901,24.0363,25.86,424,50496,0.0421604,0.13,1,603176,602752,424
25428821,27.2073,26.772,425,50538,0.112432,0.11,1,603204,602779,425
25431741,19.0415,19.7544,424,50580,0.110486,0.07,1,603221,602797,424
25434661,27.0083,27.1509,424,50622,0.126097,0.01,1,603250,602826,424
25437581,18.2017,19.8302,422,50664,0.129219,0.07,1,603266,602844,422
25440501,30.8403,27.166,427,50706,0.0818439,0.07,1,603300,602873,427
25443421,25.3681,25.4332,426,50748,0.0723688,0.15,1,603324,602898,426
25446341,29.0736,27.4866,428,50790,0.118474,0.15,1,603354,602926,428
25449261,27.4147,28.6973,426,50831,0.159695,0.13,1,603381,602955,426
25452181,20.6829,19.3395,428,50872,0.151939,0.19,1,603400,602972,428
25455101,26.5366,25.4679,429,50913,0.118388,0.15,1,603428,602999,429
25458021,31.7073,31.4936,429,50954,0.159678,0.15,1,603461,603032,429
25460941,24.7415,25.4987,428,50995,0.151936,0.15,1,603484,603056,428
25463861,6.54829,6.69974,428,51036,0.150387,0.05,1,603486,603058,428
25466781,23.7097,28.5399,422,51077,0.150077,0,1,603514,603092,422
25469701,30.3419,28.908,425,51118,0.0540155,0.01,1,603546,603121,425
25472621,30.0684,32.1816,422,51159,0.0348031,0.05,1,603576,603154,422
25475541,26.8137,24.0363,426,51200,0.0149606,0.13,1,603602,603176,426
25478461,29.3627,27.2073,428,51241,0.0429921,0.11,1,603632,603204,428
25481381,17.0725,19.0415,425,51282,0.0485984,0.13,1,603646,603221,425
25484301,27.4145,27.0083,426,51323,0.0817197,0.13,1,603676,603250,426
25487221,16.6829,18.2017,424,51364,0.120344,0.07,1,603690,603266,424
25490141,31.3366,30.8403,425,51405,0.112069,0.07,1,603725,603300,425
25493061,26.2673,25.3681,426,51446,0.110414,0.13,1,603750,603324,426
25495981,30.8535,29.0736,428,51487,0.126083,0.17,1,603782,603354,428
25498901,27.7707,27.4147,428,51528,0.161217,0.15,1,603809,603381,428
25501821,21.5541,20.6829,429,51569,0.168243,0.11,1,603829,603400,429
25504741,25.1108,26.5366,427,51610,0.169649,0.17,1,603855,603428,427
25507661,32.2222,31.7073,428,51651,0.16993,0.15,1,603889,603461,428
25510581,25.6444,24.7415,429,51692,0.169986,0.15,1,603913,603484,429
25513501,6.72889,6.54829,429,51733,0.169997,0.15,1,603915,603486,429
25516421,22.9458,23.7097,428,51774,0.201999,0.15,1,603942,603514,428
25519341,26.1892,4.74193,455,51815,0.1924,0.03,1,603969,603514,455
25522261,27.6378,26.5484,451,51856,0.15848,0.03,1,603997,603546,451
25525181,26.3276,29.3097,447,51897,0.167696,0.01,1,604023,603576,447
25528101,30.8655,26.6619,453,51938,0.185539,0.05,1,604055,603602,453
25531021,18.1731,29.3324,438,51979,0.173108,0.05,1,604070,603632,438
25533941,28.4346,17.0665,455,52020,0.170622,0.09,1,604101,603646,455
25536861,16.8869,27.4133,439,52060,0.186124,0.13,1,604115,603676,439
25539781,30.5774,16.6827,459,52100,0.189225,0.11,1,604149,603690,459
25542701,28.5155,31.3365,452,52140,0.205845,0.11,1,604177,603725,452
25545621,31.3031,26.2673,459,52180,0.225169,0.13,1,604209,603750,459
25548541,29.4606,30.8535,456,52220,0.229034,0.17,1,604238,603782,456
25551461,21.8921,27.7707,449,52260,0.229807,0.17,1,604258,603809,449
25554381,25.1784,21.5541,455,52300,0.245961,0.17,1,604284,603829,455
25557301,32.2357,25.1108,463,52340,0.249192,0.17,1,604318,603855,463
25560221,26.4471,32.2222,454,52380,0.265838,0.17,1,604343,603889,454
25563141,6.88943,25.6444,432,52420,0.269168,0.17,1,604345,603913,432
25566061,23.7779,6.72889,458,52460,0.237834,0.21,1,604373,603915,458
25568981,25.5556,22.9458,457,52500,0.231567,0.19,1,604399,603942,457
25571901,26.7111,26.1892,457,52540,0.246313,0.15,1,604426,603969,457
25574821,24.5422,27.6378,453,52580,0.265263,0.17,1,604450,603997,453
25577741,32.9084,26.3276,462,52620,0.301053,0.19,1,604485,604023,462
25580661,17.7817,30.8655,444,52660,0.308211,0.17,1,604499,604055,444
25583581,29.1563,18.1731,461,52700,0.373642,0.17,1,604531,604070,461
25586501,17.0313,28.4346,444,52740,0.386728,0.19,1,604545,604101,444
25589421,31.4063,16.8869,465,52780,0.405346,0.19,1,604580,604115,465
25592341,28.6812,30.5774,459,52820,0.409069,0.21,1,604608,604149,459
25595261,32.9363,28.5155,465,52860,0.441814,0.23,1,604642,604177,465
25598181,28.9872,31.3031,461,52900,0.432363,0.23,1,604670,604209,461
25601101,21.7974,29.4606,452,52940,0.462473,0.23,1,604690,604238,452
25604021,25.9595,21.8921,459,52980,0.468495,0.25,1,604717,604258,459
25606941,32.3919,25.1784,467,53020,0.485699,0.25,1,604751,604284,467
25609861,25.6784,32.2357,457,53060,0.48914,0.27,1,604775,604318,457
25612781,6.73568,26.4471,434,53100,0.489828,0.27,1,604777,604343,434
25615701,23.7471,6.88943,460,53140,0.489966,0.23,1,604805,604345,460
25618621,25.5494,23.7779,458,53180,0.489993,0.23,1,604831,604373,458
25621541,27.5099,25.5556,460,53220,0.489999,0.25,1,604859,604399,460
25624461,7.10198,26.7111,435,53260,0.49,0.27,1,604861,604426,435
25627381,21.4204,24.5422,436,53300,0.522,0.31,1,604886,604450,436
25630301,33.0841,32.9084,437,53339,0.5444,0.31,1,604922,604485,437
25633221,17.8168,17.7817,437,53378,0.54888,0.39,1,604936,604499,437
25636141,32.3634,29.1563,441,53417,0.549776,0.39,1,604972,604531,441
25639061,17.6727,17.0313,441,53456,0.549955,0.41,1,604986,604545,441
25641981,32.3345,31.4063,442,53495,0.549991,0.41,1,605022,604580,442
25644901,28.8669,28.6812,442,53534,0.581998,0.45,1,605050,604608,442
25647821,33.7734,32.9363,443,53573,0.5884,0.43,1,605085,604642,443
25650741,29.9547,28.9872,444,53612,0.60568,0.47,1,605114,604670,444
25653661,22.7909,21.7974,445,53651,0.673136,0.47,1,605135,604690,445
25656581,26.9582,25.9595,446,53690,0.686627,0.49,1,605163,604717,446
25659501,32.5916,32.3919,446,53729,0.737325,0.49,1,605197,604751,446
25662421,25.7183,25.6784,446,53768,0.715465,0.49,1,605221,604775,446
25665341,6.74367,6.73568,446,53807,0.711093,0.49,1,605223,604777,446
25668261,23.7487,23.7471,446,53846,0.710219,0.49,1,605251,604805,446
25671181,25.5497,25.5494,446,53885,0.710044,0.49,1,605277,604831,446
25674101,28.3099,27.5099,447,53924,0.726009,0.49,1,605306,604859,447
25677021,7.26199,7.10198,447,53963,0.729202,0.53,1,605308,604861,447
25679941,20.6524,21.4204,446,54002,0.72984,0.55,1,605332,604886,446
25682861,33.7305,33.0841,447,54041,0.729968,0.55,1,605369,604922,447
25685781,17.9461,17.8168,447,54080,0.729994,0.55,1,605383,604936,447
25688701,32.3892,32.3634,447,54119,0.793999,0.55,2,605419,604972,447
25691621,17.6778,17.6727,447,54158,0.8228,0.55,2,605433,604986,447
25694541,33.9356,32.3345,449,54197,0.78056,0.59,2,605471,605022,449
25697461,29.1871,28.8669,449,54236,0.772112,0.59,2,605499,605050,449
25700381,33.8374,33.7734,449,54275,0.786422,0.61,2,605534,605085,449
25703301,33.1675,29.9547,453,54314,0.805285,0.69,2,605567,605114,453
25706221,24.2335,22.7909,454,54353,0.809057,0.69,2,605589,605135,454
25709141,28.8467,26.9582,456,54392,0.841811,0.75,2,605619,605163,456
25712061,33.7693,32.5916,457,54431,0.864362,0.71,2,605654,605197,457
25714981,25.9539,25.7183,457,54470,0.900872,0.71,2,605678,605221,457
25717901,6.79077,6.74367,457,54509,0.908175,0.71,2,605680,605223,457
25720821,23.7582,23.7487,457,54548,0.909635,0.71,2,605708,605251,457
25723741,25.5516,25.5497,457,54587,0.909927,0.73,2,605734,605277,457
25726661,27.5103,28.3099,456,54626,0.909985,0.73,2,605762,605306,456
25729581,7.10206,7.26199,456,54665,0.941997,0.73,2,605764,605308,456
25732501,20.6204,20.6524,456,54703,0.948399,0.73,2,605788,605332,456
25735421,34.5241,4.13048,494,54741,0.91768,0.73,2,605826,605332,494
25738341,18.1048,30.4261,471,54779,0.911536,0.73,2,605840,605369,471
25741261,34.021,17.2852,495,54817,0.926307,0.81,2,605878,605383,495
25744181,18.8042,32.257,474,54855,0.945261,0.83,2,605893,605419,474
25955881,69,86,444,26280,0.03,0.29,1,608247,607803,444
25982161,80.2,90.8,435,26280,0.03,0.25,1,608330,607895,435
25985081,80.04,57.36,466,26361,0.014,0,1,608410,607944,466
25988001,66.408,68.272,458,26441,0.1068,0.03,1,608473,608015,458
25990921,70.8816,63.2544,468,26521,0.06136,0.01,1,608545,608077,468
25993841,57.3763,68.6509,452,26601,0.052272,0.05,1,608599,608147,452
25996761,27.4753,38.5302,441,26681,0.0184544,0.01,1,608619,608178,441
25999681,35.0951,47.706,428,26760,0.0436909,0.03,1,608656,608228,428
26002601,31.019,24.7412,439,26839,0.0327382,0.05,1,608686,608247,439
26005521,26.2038,19.3482,446,26918,0.0465476,0.05,1,608711,608265,446
26008441,39.6408,38.2696,446,26997,0.0493095,0.01,1,608754,608308,446
26011361,71.9282,89.2539,424,27075,0.0818619,0.13,1,608834,608410,424
26014281,66.3856,68.2508,426,27153,0.0723724,0.05,1,608899,608473,426
26017201,69.2771,71.2502,424,27231,0.0384745,0.05,1,608969,608545,424
26020121,56.2554,57.45,423,27309,0.0956949,0.01,1,609022,608599,423
26023041,29.6511,27.49,426,27387,0.123139,0.05,1,609045,608619,426
26025961,33.9302,35.098,424,27464,0.144628,0.03,1,609080,608656,424
26028881,29.986,31.0196,423,27541,0.148926,0.05,1,609109,608686,423
26031801,25.9972,26.2039,423,27618,0.133785,0.05,1,609134,608711,423
26034721,40.3994,39.6408,424,27695,0.130757,0.09,1,609178,608754,424
26037641,74.4799,71.9282,427,27771,0.194151,0.07,1,609261,608834,427
26040561,63.696,66.3856,423,27847,0.15883,0.03,1,609322,608899,423
26043481,68.7392,69.2771,423,27923,0.071766,0.11,1,609392,608969,423
26046401,57.7478,56.2554,425,27999,0.0703532,0.13,1,609447,609022,425
26049321,32.3496,29.6511,428,28075,0.0380706,0.15,1,609473,609045,428
26052241,33.6699,33.9302,427,28150,0.111614,0.15,1,609507,609080,427
26055161,29.934,29.986,427,28225,0.110323,0.13,1,609536,609109,427
26058081,25.1868,25.9972,426,28300,0.142065,0.13,1,609560,609134,426
26061001,42.6374,40.3994,429,28375,0.148413,0.13,1,609607,609178,429
26063921,74.9275,8.07989,512,28450,0.149683,0.21,1,609690,609178,512
26066841,61.3855,68.016,487,28524,0.165937,0.15,1,609748,609261,487
26069761,65.8771,62.4032,493,28598,0.201187,0.05,1,609815,609322,493
26072681,56.3754,68.4806,477,28672,0.240237,0.07,1,609869,609392,477
26075601,32.0751,57.6961,448,28746,0.248047,0.03,1,609895,609447,448
26078521,36.015,32.3392,459,28820,0.201609,0.13,1,609932,609473,459
26081441,31.203,33.6678,455,28893,0.192322,0.11,1,609962,609507,455
26084361,25.4406,29.9336,450,28966,0.206464,0.15,1,609986,609536,450
26087281,44.2881,25.1867,475,29039,0.241293,0.15,1,610035,609560,475
26090201,75.2576,42.6373,511,29112,0.280259,0.15,1,610118,609607,511
26093121,62.2515,74.9275,487,29185,0.320052,0.17,1,610177,609690,487
26096041,67.6503,61.3855,498,29258,0.39201,0.21,1,610246,609748,498
26098961,58.3301,65.8771,487,29330,0.438402,0.25,1,610302,609815,487
26101881,32.466,56.3754,459,29402,0.44768,0.25,1,610328,609869,459
26104801,33.6932,32.0751,467,29474,0.449536,0.19,1,610362,609895,467
26107721,31.5386,36.015,461,29546,0.481907,0.19,1,610393,609932,461
26110641,26.3077,31.203,456,29618,0.488381,0.21,1,610418,609962,456
26113561,46.0615,25.4406,483,29689,0.521676,0.25,1,610469,609986,483
26116481,76.4123,44.2881,518,29760,0.544335,0.29,1,610553,610035,518
26119401,64.0825,75.2576,496,29831,0.548867,0.33,1,610614,610118,496
26122321,14.4165,62.2515,439,29902,0.549773,0.41,1,610616,610177,439
26125241,60.4833,67.6503,442,29973,0.565955,0.45,1,610688,610246,442
26128161,58.4967,58.3301,444,30044,0.617191,0.45,1,610746,610302,444
26131081,32.4993,32.466,444,30114,0.643438,0.45,1,610772,610328,444
26134001,33.6999,33.6932,444,30184,0.664688,0.49,1,610806,610362,444
26136921,33.14,31.5386,446,30254,0.652938,0.49,1,610839,610393,446
26139841,28.228,26.3077,448,30324,0.666588,0.53,1,610866,610418,448
26142761,46.4456,46.0615,448,30394,0.765318,0.55,2,610917,610469,448
26145681,77.2891,76.4123,449,30464,0.801064,0.55,2,611002,610553,449
26148601,64.2578,64.0825,449,30533,0.840213,0.55,2,611063,610614,449
26151521,14.4516,14.4165,449,30602,0.816043,0.57,2,611065,610616,449
26154441,62.0903,60.4833,451,30671,0.843208,0.63,2,611139,610688,451
26157361,58.8181,58.4967,451,30740,0.896642,0.65,2,611197,610746,451
26160281,33.3636,32.4993,452,30809,0.891328,0.67,2,611224,610772,452
26163201,34.6727,33.6999,453,30878,0.922266,0.65,2,611259,610806,453
26166121,34.1345,33.14,454,30947,0.896453,0.67,2,611293,610839,454
26169041,30.0269,28.228,456,31015,0.923291,0.79,2,611322,610866,456
26171961,49.2054,46.4456,459,31083,0.896658,0.81,2,611376,610917,459
26297521,86,85,483,33886,0.69,0.97,1,613357,612874,483
26300441,73.2,68.2,489,33948,0.626,1,1,613427,612938,489
26303361,35.44,32.04,492,34010,0.6292,1,1,613453,612961,492
26306281,41.488,56.808,472,34072,0.56584,1,1,613496,613024,472
26309201,64.2976,64.9616,475,34134,0.489168,0.95,1,613566,613091,475
26312121,37.6595,36.1923,477,34196,0.377834,0.95,1,613597,613120,477
26315041,22.7319,26.4385,472,34258,0.371567,0.95,1,613616,613144,472
26317961,19.7464,5.28769,491,34320,0.322313,0.99,1,613635,613144,491
26320881,27.9493,17.0575,501,34382,0.312463,0.91,1,613665,613164,501
26323801,26.3899,29.0115,495,34443,0.278493,0.82,1,613691,613196,495
26326721,38.878,30.6023,506,34504,0.319699,0.87,1,613733,613227,506
26329641,69.3756,41.3205,539,34565,0.32794,0.69,1,613810,613271,539
26332561,66.6751,77.0641,519,34626,0.297588,0.61,1,613876,613357,519
26335481,35.735,71.4128,477,34687,0.355518,0.63,1,613904,613427,477
26338401,35.947,35.0826,487,34748,0.383104,0.55,1,613940,613453,487
26341321,61.5894,41.4165,512,34809,0.404621,0.47,1,614008,613496,512
26344241,34.7179,64.2833,470,34870,0.408924,0.35,1,614036,613566,470
26347161,20.5436,37.6567,456,34931,0.425785,0.37,1,614053,613597,456
26350081,18.5087,22.7313,455,34992,0.397157,0.31,1,614071,613616,455
26353001,26.9017,19.7463,465,35052,0.391431,0.31,1,614100,613635,465
26355921,26.1803,27.9493,461,35112,0.422286,0.27,1,614126,613665,461
26358841,39.6361,26.3899,478,35172,0.444457,0.33,1,614169,613691,478
26361761,69.5272,38.878,513,35232,0.496891,0.33,1,614246,613733,513
26364681,68.3054,69.3756,504,35292,0.555378,0.29,1,614314,613810,504
26367601,35.2611,66.6751,465,35352,0.551076,0.37,1,614341,613876,465
26370521,38.2522,35.735,476,35412,0.534215,0.39,1,614380,613904,476
26373441,62.8504,35.947,509,35472,0.578843,0.41,1,614449,613940,509
26376361,34.9701,61.5894,469,35532,0.587769,0.41,1,614477,614008,469
26379281,19.794,34.7179,457,35591,0.605554,0.43,1,614493,614036,457
26382201,19.9588,20.5436,460,35650,0.625111,0.39,1,614513,614053,460
26385121,5.59176,18.5087,444,35709,0.629022,0.39,1,614515,614071,444
26388041,23.5184,26.9017,443,35768,0.661804,0.43,1,614543,614100,443
26390961,26.3037,26.1803,444,35827,0.668361,0.45,1,614570,614126,444
26393881,42.0607,39.6361,447,35886,0.685672,0.51,1,614616,614169,447
26396801,70.0121,69.5272,447,35945,0.689134,0.57,1,614693,614246,447
26399721,69.2024,68.3054,448,36004,0.753827,0.55,2,614762,614314,448
26402641,36.2405,35.2611,449,36063,0.750765,0.53,2,614790,614341,449
26405561,38.4481,38.2522,449,36122,0.766153,0.59,2,614829,614380,449
26408481,64.4896,62.8504,451,36181,0.833231,0.59,2,614900,614449,451
26411401,36.0979,34.9701,452,36239,0.862646,0.61,2,614929,614477,452
26414321,20.8196,19.794,453,36297,0.852529,0.63,2,614946,614493,453
26417241,20.1639,19.9588,453,36355,0.882506,0.63,2,614966,614513,453
26420161,5.63278,5.59176,453,36413,0.888501,0.67,2,614968,614515,453
26423081,24.3266,23.5184,454,36471,0.8737,0.67,2,614997,614543,454
26426001,27.2653,26.3037,455,36529,0.85474,0.69,2,615025,614570,455
26428921,41.4531,42.0607,454,36587,0.850948,0.69,2,615070,614616,454
26431841,71.4906,70.0121,456,36645,0.91419,0.77,2,615149,614693,456
26595361,37,33,492,39744,0.69,1,1,617346,616854,492
26598281,31.4,25.8,498,39797,0.626,1,1,617376,616878,498
26601201,32.68,21.96,510,39850,0.6452,1,1,617409,616899,510
26604121,28.936,16.392,523,39903,0.56904,1,1,617437,616914,523
26607041,15.3872,30.4784,501,39956,0.569808,1,1,617449,616948,501
26609961,27.8774,34.0957,497,40009,0.441962,1,1,617480,616983,497
26612881,31.1755,30.0191,500,40062,0.384392,1,1,617512,617012,500
26615801,28.6351,6.00383,528,40115,0.308878,1,1,617540,617012,528
26618721,57.727,32.4008,554,40168,0.357776,0.98,1,617605,617051,554
26621641,35.5454,72.8802,501,40221,0.335555,1,1,617635,617134,501
26624561,35.9091,40.976,504,40273,0.347111,0.97,1,617671,617167,504
26627481,55.1818,38.5952,526,40325,0.269422,0.75,1,617731,617205,526
26630401,34.2364,63.719,485,40377,0.285884,0.65,1,617760,617275,485
26633321,36.4473,39.9438,488,40429,0.273177,0.69,1,617797,617309,488
26636241,28.8895,37.5888,478,40481,0.222635,0.61,1,617824,617346,478
26639161,30.5779,31.5178,479,40533,0.244527,0.65,1,617855,617376,479
26642081,29.3156,32.7035,475,40585,0.232905,0.55,1,617884,617409,475
26645001,14.6631,28.9407,458,40637,0.294581,0.57,1,617895,617437,458
26647921,23.7326,15.3881,472,40689,0.258916,0.41,1,617921,617449,472
26650841,30.3465,27.8776,473,40741,0.267783,0.37,1,617953,617480,473
26653761,27.6693,31.1755,468,40793,0.285557,0.29,1,617980,617512,468
26656681,55.1339,28.6351,502,40845,0.305111,0.37,1,618042,617540,502
26659601,34.2268,57.727,466,40897,0.325022,0.33,1,618071,617605,466
26662521,36.4454,35.5454,473,40949,0.361004,0.35,1,618108,617635,473
26665441,53.6891,35.9091,495,41001,0.352201,0.25,1,618166,617671,495
26668361,32.3378,55.1818,462,41052,0.33444,0.29,1,618193,617731,462
26671281,37.6676,34.2364,472,41103,0.298888,0.27,1,618232,617760,472
26674201,26.7335,36.4473,459,41154,0.355778,0.21,1,618256,617797,459
26677121,30.1467,28.8895,463,41205,0.367156,0.25,1,618287,617824,463
26680041,31.6293,30.5779,464,41256,0.417431,0.23,1,618319,617855,464
26682961,14.3259,29.3156,445,41307,0.427486,0.31,1,618329,617884,445
26685881,23.6652,14.6631,460,41358,0.429497,0.25,1,618355,617895,460
26688801,30.333,23.7326,466,41409,0.397899,0.27,1,618387,617921,466
26691721,29.2666,30.3465,463,41460,0.37558,0.29,1,618416,617953,463
26694641,55.4533,27.6693,498,41511,0.419116,0.31,1,618478,617980,498
26697561,12.6907,55.1339,438,41562,0.427823,0.33,1,618480,618042,438
26700481,27.3381,34.2268,440,41613,0.461565,0.37,1,618511,618071,440
26703401,33.4676,36.4454,438,41664,0.484313,0.35,1,618546,618108,438
26706321,53.8935,53.6891,439,41715,0.440863,0.33,1,618605,618166,439
26709241,31.5787,32.3378,438,41766,0.432173,0.29,1,618631,618193,438
26712161,39.1157,37.6676,440,41817,0.510435,0.37,1,618672,618232,440
26715081,25.4231,26.7335,438,41867,0.494087,0.37,1,618694,618256,438
26718001,34.6846,30.1467,444,41917,0.506817,0.43,1,618731,618287,444
26720921,31.7369,31.6293,443,41967,0.541363,0.43,1,618762,618319,443
26723841,14.3474,14.3259,443,42017,0.548273,0.43,1,618772,618329,443
26726761,22.0695,23.6652,441,42067,0.565655,0.39,1,618796,618355,441
26729681,30.0139,30.333,441,42117,0.585131,0.37,1,618828,618387,441
26732601,30.0028,29.2666,442,42167,0.605026,0.43,1,618858,618416,442
26735521,57.2006,55.4533,444,42217,0.689005,0.43,1,618922,618478,444
26738441,13.0401,12.6907,444,42267,0.705801,0.47,1,618924,618480,444
26741361,26.608,27.3381,443,42317,0.70916,0.49,1,618954,618511,443
26744281,34.1216,33.4676,444,42367,0.693832,0.43,1,618990,618546,444
26747201,53.2243,53.8935,443,42417,0.738766,0.43,1,619048,618605,443
26750121,32.2449,31.5787,444,42467,0.763753,0.53,2,619075,618631,444
26753041,40.849,39.1157,446,42517,0.816751,0.49,2,619118,618672,446
26755961,25.7698,25.4231,446,42567,0.81135,0.51,2,619140,618694,446
26758881,35.554,34.6846,447,42617,0.81027,0.55,2,619178,618731,447
26761801,33.5108,31.7369,449,42667,0.826054,0.55,2,619211,618762,449
26764721,14.7022,14.3474,449,42716,0.829211,0.57,2,619221,618772,449
26767641,22.9404,22.0695,450,42765,0.829842,0.59,2,619246,618796,450
26770561,31.7881,30.0139,452,42814,0.845968,0.61,2,619280,618828,452
26773481,30.3576,30.0028,452,42863,0.881194,0.71,2,619310,618858,452
26966201,25,0,521,45998,0.63,1,1,621514,620993,521
26969121,35.4,18.4,536,46044,0.454,1,1,621552,621016,536
26972041,31.08,27.68,536,46090,0.3868,1,1,621582,621046,536
26974961,32.616,32.736,535,46136,0.30936,1,1,621615,621080,535
26977881,19.3232,28.1472,524,46182,0.245872,1,1,621631,621107,524
26979341,31.0646,23.2294,536,46228,0.169174,1,1,621665,621129,536
27027521,368.613,456.646,424,20440,0.0578349,0.01,1,622118,621694,424
27030441,150.523,144.929,453,21270,0.035567,0.03,1,622214,621761,453
27033361,106.905,93.7858,468,21370,0.0631134,0.05,1,622310,621842,468
27036281,66.9809,81.9572,446,21469,0.0526227,0.05,1,622367,621921,446
27039201,54.9962,53.1914,452,21568,0.0825245,0.03,1,622419,621967,452
27042121,61.3992,53.8383,461,21666,0.0245049,0.03,1,622482,622021,461
27045041,37.0798,65.9677,423,21764,0.028901,0.01,1,622513,622090,423
27047961,29.816,25.9935,435,21861,0.0617802,0.03,1,622541,622106,435
27050881,82.7632,91.5987,423,21958,0.132356,0.07,1,622637,622214,423
27053801,93.3526,95.1197,423,22055,0.0824712,0.05,1,622733,622310,423
27056721,65.0705,64.6239,424,22151,0.0724942,0.09,1,622791,622367,424
27059641,54.6141,54.5248,424,22247,0.118499,0.01,1,622843,622419,424
27062561,59.7228,61.305,422,22342,0.0316998,0.03,1,622904,622482,422
27065481,36.7446,37.061,422,22437,0.06234,0.07,1,622935,622513,422
27068401,32.1489,29.8122,425,22532,0.068468,0.07,1,622966,622541,425
27071321,83.2298,5.96244,521,22626,0.0376936,0.15,1,623062,622541,521
27074241,91.046,77.9925,518,22720,0.0475387,0.07,1,623155,622637,518
27077161,66.2092,92.3985,482,22813,0.0335077,0.07,1,623215,622733,482
27080081,55.6418,64.8797,477,22906,0.0787016,0.13,1,623268,622791,477
27083001,57.5284,54.5759,483,22999,0.0557403,0.01,1,623326,622843,483
27085921,35.5057,59.7152,452,23091,0.0511481,0.07,1,623356,622904,452
27088841,33.5011,36.743,454,23183,0.0342296,0.07,1,623389,622935,454
27091761,84.3002,32.1486,520,23274,0.0468459,0.03,1,623486,622966,520
27094681,91.26,83.2297,517,23365,0.0653692,0.05,1,623579,623062,517
27097601,64.652,91.0459,482,23456,0.133074,0.03,1,623637,623155,482
27100521,57.7304,66.2092,478,23546,0.210615,0.09,1,623693,623215,478
27103441,57.9461,55.6418,483,23636,0.226123,0.05,1,623751,623268,483
27106361,33.9892,57.5284,453,23726,0.245225,0.05,1,623779,623326,453
27109281,32.3978,35.5057,455,23815,0.249045,0.03,1,623811,623356,455
27112201,85.6796,33.5011,521,23904,0.153809,0.05,1,623910,623389,521
27115121,18.7359,84.3002,426,23993,0.134762,0.07,1,623912,623486,426
27118041,78.9472,91.26,427,24081,0.146952,0.15,1,624006,623579,427
27120961,64.5894,64.652,430,24169,0.16539,0.23,1,624067,623637,430
27123881,60.1179,57.7304,433,24257,0.217078,0.23,1,624126,623693,433
27126801,59.2236,57.9461,434,24344,0.243416,0.25,1,624185,623751,434
27129721,34.2447,33.9892,434,24431,0.248683,0.25,1,624213,623779,434
27132641,32.4489,32.3978,434,24518,0.249737,0.13,1,624245,623811,434
27135561,80.8898,85.6796,428,24604,0.233947,0.13,1,624338,623910,428
27138481,17.778,18.7359,428,24690,0.230789,0.15,1,624340,623912,428
27141401,78.7556,78.9472,428,24776,0.278158,0.17,1,624434,624006,428
27144321,66.1511,64.5894,430,24862,0.383632,0.23,1,624497,624067,430
27147241,61.2302,60.1179,431,24947,0.452726,0.25,1,624557,624126,431
27150161,60.246,59.2236,432,25032,0.482545,0.25,1,624617,624185,432
27153081,34.4492,34.2447,432,25117,0.488509,0.25,1,624645,624213,432
27156001,32.4898,32.4489,432,25201,0.489702,0.23,1,624677,624245,432
27158921,80.098,80.8898,431,25285,0.53794,0.23,1,624769,624338,431
27161841,17.6196,17.778,431,25369,0.547588,0.29,1,624771,624340,431
27164761,83.5239,78.7556,437,25453,0.613518,0.29,1,624871,624434,437
27167681,68.7048,15.7511,502,25536,0.626704,0.41,1,624936,624434,502
27170601,64.141,53.5502,502,25619,0.597341,0.47,1,624999,624497,502
27173521,61.6282,58.71,503,25702,0.623468,0.49,1,625060,624557,503
27176441,34.7256,59.742,471,25784,0.628694,0.49,1,625088,624617,471
27179361,32.5451,34.3484,475,25866,0.645739,0.49,1,625120,624645,475
27182281,82.509,32.4697,538,25948,0.665148,0.55,1,625215,624677,538
27185201,18.1018,80.0939,448,26030,0.66903,0.55,1,625217,624769,448
27188121,86.8204,17.6188,550,26111,0.701806,0.63,1,625321,624771,550
27191041,70.9641,83.5238,517,26192,0.708361,0.63,1,625388,624871,517
27193961,62.9928,68.7048,513,26273,0.773672,0.59,2,625449,624936,513
27196881,62.9986,64.141,513,26354,0.818734,0.63,2,625512,624999,513
27199801,35.7997,61.6282,481,26434,0.811747,0.63,2,625541,625060,481
27202721,32.7599,34.7256,485,26514,0.858349,0.65,2,625573,625088,485
27205641,83.352,32.5451,549,26594,0.89967,0.67,2,625669,625120,549
27208561,18.2704,82.509,456,26674,0.907934,0.67,2,625671,625215,456
27211481,88.4541,18.1018,560,26753,0.941587,0.71,2,625777,625217,560
27214401,71.2908,86.8204,523,26832,0.932317,0.71,2,625844,625321,523
27217321,67.0582,70.9641,522,26911,0.930463,0.79,2,625910,625388,522
27220241,15.0116,62.9928,463,26990,0.898093,0.83,2,625912,625449,463
27328281,39,35,513,29753,0.61,1,1,627877,627364,513
27331201,32.6,33.4,511,29824,0.498,1,1,627908,627397,511
27334121,34.52,29.08,518,29895,0.4596,1,1,627943,627425,518
27337041,28.504,29.816,515,29966,0.38792,1,1,627970,627455,515
27339961,64.1008,90.7632,482,30037,0.261584,1,1,628043,627561,482
27342881,38.4202,42.9526,483,30107,0.220317,1,1,628075,627592,483
27345801,74.084,75.7905,482,30177,0.228063,1,1,628158,627676,482
27348721,29.2168,40.7581,468,30247,0.229613,0.79,1,628176,627708,468
27351641,77.8434,84.1516,463,30317,0.213923,0.69,1,628266,627803,463
27354561,38.7687,44.8303,457,30387,0.178785,0.61,1,628295,627838,457
27357481,30.9537,40.1661,447,30457,0.235757,0.47,1,628324,627877,447
27360401,30.1907,32.8332,446,30526,0.215151,0.45,1,628354,627908,446
27363321,29.2381,34.5666,440,30595,0.24303,0.37,1,628383,627943,440
27366241,25.0476,28.5133,437,30664,0.280606,0.23,1,628407,627970,437
27369161,63.4095,64.1027,437,30733,0.320121,0.21,1,628480,628043,437
27372081,35.0819,38.4205,433,30802,0.328024,0.23,1,628508,628075,433
27375001,70.2164,74.0841,429,30871,0.409605,0.23,1,628587,628158,429
27377921,30.8433,29.2168,432,30940,0.409921,0.21,1,628608,628176,432
27380841,75.7687,77.8434,429,31008,0.473984,0.17,1,628695,628266,429
27383761,39.1537,38.7687,430,31076,0.502797,0.25,1,628725,628295,430
27386681,33.4307,30.9537,433,31144,0.540559,0.21,1,628757,628324,433
27389601,30.6861,30.1907,433,31212,0.548112,0.25,1,628787,628354,433
27392521,32.5372,29.2381,437,31280,0.565622,0.25,1,628820,628383,437
27395441,23.3074,5.84763,458,31348,0.537124,0.29,1,628841,628383,458
27398361,65.4615,20.3695,510,31415,0.579425,0.33,1,628917,628407,510
27401281,35.4923,62.4739,465,31482,0.587885,0.33,1,628945,628480,465
27404201,72.6985,34.8948,519,31549,0.557577,0.43,1,629027,628508,519
27407121,32.1397,70.179,462,31616,0.567515,0.41,1,629049,628587,462
27410041,77.6279,30.8358,530,31683,0.617503,0.49,1,629138,628608,530
27412961,40.3256,75.7672,474,31750,0.611501,0.51,1,629169,628695,474
27415881,35.2651,39.1534,478,31817,0.6103,0.55,1,629203,628725,478
27418801,32.653,33.4307,478,31883,0.62606,0.55,1,629235,628757,478
27421721,30.5306,30.6861,478,31949,0.661212,0.57,1,629265,628787,478
27424641,24.5061,32.5372,468,32015,0.684242,0.53,1,629288,628820,468
27427561,68.1012,23.3074,526,32081,0.752849,0.59,2,629367,628841,526
27430481,36.0202,65.4615,478,32147,0.78257,0.59,2,629395,628917,478
27433401,72.0041,35.4923,531,32213,0.868514,0.55,2,629476,628945,531
27436321,32.0008,72.6985,471,32279,0.885703,0.57,2,629498,629027,471
27439241,80.0002,32.1397,541,32345,0.905141,0.63,2,629590,629049,541
27442161,40,77.6279,482,32410,0.957028,0.61,2,629620,629138,482
27582321,33,33,514,35406,0.73,1,1,631650,631136,514
27585241,54.6,28.2,547,35466,0.698,1,1,631710,631163,547
27588161,37.32,72.84,496,35526,0.7236,1,1,631743,631247,496
27591081,40.264,34.568,512,35586,0.64872,1,1,631784,631272,512
27594001,45.6528,30.9136,529,35645,0.665744,1,1,631831,631302,529
27596921,25.9306,51.7827,493,35704,0.717149,1,1,631852,631359,493
27599841,16.3861,38.3565,472,35763,0.75943,0.92,2,631866,631394,472
27602761,71.2772,75.6713,472,35822,0.671886,0.95,1,631951,631479,472
27605681,39.0554,42.3343,469,35881,0.702377,0.97,1,631982,631513,469
27608601,37.4111,41.2669,465,35940,0.692475,0.87,1,632019,631554,465
27611521,25.8822,29.0534,462,35999,0.706495,0.79,1,632042,631580,462
27614441,30.7764,35.4107,457,36058,0.677299,0.73,1,632074,631617,457
27617361,29.3553,33.4821,453,36117,0.70346,0.69,1,632103,631650,453
27620281,55.4711,54.6964,455,36176,0.708692,0.73,1,632165,631710,455
27623201,35.0942,37.3393,452,36234,0.709738,0.63,1,632195,631743,452
27626121,43.0188,40.2679,456,36292,0.693948,0.67,1,632240,631784,456
27629041,45.4038,45.6536,455,36350,0.738789,0.73,1,632286,631831,455
27631961,28.2808,25.9307,458,36408,0.747758,0.77,1,632310,631852,458
27634881,15.2562,16.3861,456,36466,0.717552,0.65,1,632322,631866,456
27637801,67.8512,71.2772,452,36524,0.77551,0.71,2,632403,631951,452
27640721,42.3702,39.0554,457,36582,0.787102,0.69,2,632439,631982,457
27643641,37.2741,37.4111,456,36640,0.85342,0.71,2,632475,632019,456
27646561,25.0548,25.8822,455,36698,0.866684,0.67,2,632497,632042,455
27649481,29.811,30.7764,454,36756,0.869337,0.71,2,632528,632074,454
27652401,31.5622,29.3553,457,36813,0.869867,0.71,2,632560,632103,457
27655321,54.3124,55.4711,455,36870,0.901973,0.71,2,632620,632165,455
27807161,55,43,496,39740,0.69,1,1,634612,634116,496
27810081,38.2,48.6,480,39793,0.626,1,1,634646,634166,480
27813001,29.24,28.92,483,39846,0.6452,1,1,634673,634190,483
27815921,29.048,23.384,490,39899,0.55304,1,1,634702,634212,490
27818841,59.4096,67.0768,479,39952,0.566608,1,1,634769,634290,479
27821761,35.8819,39.8154,476,40005,0.537322,1,1,634799,634323,476
27824681,32.7764,26.3631,485,40058,0.547464,1,1,634831,634346,485
27827601,25.7553,5.27261,509,40111,0.549493,1,1,634855,634346,509
27830521,31.5511,32.2545,503,40164,0.533899,0.87,1,634888,634385,503
27833441,31.1102,34.4509,499,40217,0.49878,0.92,1,634919,634420,499
27836361,23.822,31.6902,490,40270,0.523756,0.95,1,634941,634451,490
27839281,43.9644,22.338,519,40322,0.480751,0.87,1,634990,634471,519
27842201,30.3929,47.6676,492,40374,0.45615,0.83,1,635017,634525,492
27845121,46.0786,35.1335,510,40426,0.45123,0.69,1,635067,634557,510
27848041,35.6157,51.0267,488,40478,0.386246,0.61,1,635100,634612,488
27850961,24.7231,37.4053,476,40530,0.389249,0.65,1,635122,634646,476
27853881,27.3446,29.0811,477,40582,0.34185,0.53,1,635150,634673,477
27856801,58.2689,29.0162,514,40634,0.31637,0.57,1,635216,634702,514
27859721,35.6538,59.4032,477,40686,0.327274,0.53,1,635246,634769,477
27862641,35.9308,35.8806,483,40738,0.313455,0.55,1,635282,634799,483
27865561,24.7862,32.7761,473,40790,0.326691,0.55,1,635304,634831,473
27868481,30.5572,25.7552,481,40842,0.377338,0.53,1,635336,634855,481
27871401,30.1114,31.551,478,40894,0.387468,0.49,1,635366,634888,478
27874321,22.8223,31.1102,468,40946,0.405493,0.53,1,635387,634919,468
27877241,41.3645,23.822,492,40998,0.425099,0.47,1,635433,634941,492
27880161,29.0729,43.9644,469,41049,0.47702,0.45,1,635459,634990,469
27883081,45.8146,30.3929,492,41100,0.503404,0.45,1,635509,635017,492
27886001,33.9629,46.0786,473,41151,0.492681,0.37,1,635540,635067,473
27888921,24.3926,35.6157,462,41202,0.490536,0.39,1,635562,635100,462
27891841,24.8785,24.7231,465,41253,0.538107,0.33,1,635587,635122,465
27894761,59.3757,27.3446,505,41304,0.563621,0.31,1,635655,635150,505
27897681,32.6751,58.2689,465,41355,0.568724,0.33,1,635681,635216,465
27900601,36.135,35.6538,472,41406,0.585745,0.31,1,635718,635246,472
27903521,25.627,35.9308,459,41457,0.605149,0.33,1,635741,635282,459
27906441,31.5254,24.7862,470,41508,0.62503,0.39,1,635774,635304,470
27909361,7.90508,30.5572,440,41559,0.629006,0.39,1,635776,635336,440
27912281,27.981,30.1114,443,41610,0.629801,0.41,1,635809,635366,443
27915201,21.5962,22.8223,442,41661,0.66196,0.43,1,635829,635387,442
27918121,41.9192,41.3645,443,41712,0.700392,0.49,1,635876,635433,443
27921041,29.9838,29.0729,444,41763,0.692078,0.51,1,635903,635459,444
27923961,46.7968,45.8146,445,41814,0.674416,0.49,1,635954,635509,445
27926881,34.9594,33.9629,446,41864,0.670883,0.49,1,635986,635540,446
27929801,24.5919,24.3926,446,41914,0.686177,0.55,1,636008,635562,446
27932721,27.3184,24.8785,449,41964,0.721235,0.57,1,636036,635587,449
27935641,60.6637,59.3757,450,42014,0.760247,0.57,2,636105,635655,450
27938561,32.9327,32.6751,450,42064,0.736049,0.59,1,636131,635681,450
27941481,36.9865,36.135,451,42114,0.77921,0.61,2,636169,635718,451
27944401,27.3973,25.627,453,42164,0.771842,0.63,2,636194,635741,453
27947321,31.8795,31.5254,453,42214,0.802368,0.63,2,636227,635774,453
27950241,7.97589,7.90508,453,42264,0.808474,0.63,2,636229,635776,453
27953161,27.9952,27.981,453,42314,0.825695,0.67,2,636262,635809,453
27956081,21.599,21.5962,453,42364,0.909139,0.71,2,636282,635829,453
27959001,43.5198,41.9192,455,42414,0.893828,0.69,2,636331,635876,455
27961921,31.104,29.9838,456,42464,0.890766,0.67,2,636359,635903,456
27964841,46.2208,46.7968,455,42514,0.922153,0.67,2,636409,635954,455
27967761,35.6442,34.9594,456,42564,0.944431,0.69,2,636442,635986,456
27970681,24.7288,24.5919,456,42614,0.948886,0.73,2,636464,636008,456
28180921,28,34,513,46041,0.89,1,2,638841,638328,513
28183841,33.6,35.6,512,46087,0.842,1,2,638876,638364,512
28186761,38.72,33.52,519,46133,0.8324,1,2,638916,638397,519
28189681,38.944,37.904,519,46179,0.75048,1,2,638955,638436,519
28192601,37.3888,40.3808,515,46225,0.654096,1,1,638992,638477,515
28195521,33.8778,32.8762,517,46271,0.634819,1,1,639025,638508,517
28198441,33.9756,37.7752,512,46317,0.550964,1,1,639059,638547,512
28201361,23.5951,33.155,501,46363,0.374193,1,1,639080,638579,501
28204281,27.919,32.231,498,46408,0.290839,1,1,639109,638611,498
28207201,42.3838,32.0462,512,46453,0.242168,0.88,1,639155,638643,512
28210121,22.8768,32.8092,497,46498,0.200434,0.92,1,639173,638676,497
28213041,20.5754,23.3618,496,46543,0.160087,0.97,1,639193,638697,496
28215961,27.3151,25.4724,499,46588,0.0400173,1,1,639222,638723,499
28218881,31.863,29.0945,502,46633,0.0800035,0.8,1,639255,638753,502
28221801,28.7726,33.0189,496,46678,0.0880007,0.85,1,639283,638787,496
28224721,27.3545,27.4038,497,46723,0.0736001,0.89,1,639310,638813,497
28227641,31.8709,27.8808,502,46768,0.08672,0.83,1,639343,638841,502
28230561,32.7742,33.5762,500,46813,0.041344,0.83,1,639376,638876,500
28233481,31.3548,38.7152,491,46858,0.0482688,0.73,1,639407,638916,491
28236401,35.071,38.943,488,46903,0.0336538,0.63,1,639443,638955,488
28239321,33.4142,37.3886,484,46948,0.0947307,0.63,1,639476,638992,484
28242241,28.2828,33.8777,478,46993,0.0269461,0.53,1,639503,639025,478
28245161,16.0566,33.9755,457,47038,0.0613892,0.33,1,639516,639059,457
28248081,24.0113,23.5951,462,47083,0.0522778,0.27,1,639542,639080,462
28251001,40.8023,27.919,478,47128,0.114456,0.23,1,639587,639109,478
28253921,19.3605,42.3838,446,47173,0.126891,0.19,1,639601,639155,446
28256841,21.4721,22.8768,450,47218,0.129378,0.15,1,639623,639173,450
28259761,22.6944,20.5754,453,47263,0.113876,0.01,1,639646,639193,453
28262681,31.7389,27.3151,458,47308,0.110775,0.09,1,639680,639222,458
28265601,28.7478,31.863,453,47353,0.142155,0.09,1,639708,639255,453
28268521,7.34955,28.7726,427,47398,0.148431,0.07,1,639710,639283,427
28271441,19.8699,27.3545,423,47442,0.165686,0.09,1,639733,639310,423
28274361,31.174,31.8709,424,47486,0.185137,0.03,1,639767,639343,424
28277281,31.8348,32.7742,423,47530,0.173027,0.05,1,639799,639376,423
28280201,30.367,31.3548,422,47574,0.138605,0.03,1,639829,639407,422
28283121,34.8734,35.071,422,47618,0.131721,0.11,1,639865,639443,422
28286041,34.9747,33.4142,424,47662,0.130344,0.01,1,639900,639476,424
28288961,28.5949,28.2828,424,47706,0.130069,0.07,1,639927,639503,424
28291881,16.919,16.0566,425,47750,0.146014,0.05,1,639941,639516,425
28294801,24.9838,24.0113,426,47794,0.165203,0.13,1,639968,639542,426
28297721,42.5968,40.8023,428,47838,0.201041,0.13,1,640015,639587,428
28300641,19.7194,19.3605,428,47882,0.208208,0.13,1,640029,639601,428
28303561,21.5439,21.4721,428,47926,0.177642,0.11,1,640051,639623,428
28306481,21.9088,22.6944,427,47970,0.203528,0.11,1,640073,639646,427
28309401,31.5818,31.7389,427,48014,0.208706,0.15,1,640107,639680,427
28312321,28.7164,28.7478,427,48058,0.241741,0.15,1,640135,639708,427
28315241,7.34327,7.34955,427,48102,0.248348,0.17,1,640137,639710,427
28318161,20.6687,19.8699,428,48146,0.23367,0.19,1,640161,639733,428
28321081,32.9337,31.174,430,48190,0.294734,0.17,1,640197,639767,430
28324001,30.5867,31.8348,428,48234,0.322947,0.13,1,640227,639799,428
28326921,28.5173,30.367,426,48278,0.328589,0.13,1,640255,639829,426
28329841,32.9035,34.8734,424,48322,0.361718,0.13,1,640289,639865,424
28332761,38.5807,34.9747,429,48366,0.336344,0.13,1,640329,639900,429
28335681,29.3161,28.5949,429,48410,0.315269,0.15,1,640356,639927,429
28338601,17.0632,16.919,429,48454,0.311054,0.17,1,640370,639941,429
28341521,25.8126,24.9838,430,48497,0.310211,0.21,1,640398,639968,430
28344441,42.7625,42.5968,430,48540,0.262042,0.21,1,640445,640015,430
28347361,19.7525,19.7194,430,48583,0.268408,0.17,1,640459,640029,430
28350281,21.5505,21.5439,430,48626,0.317682,0.21,1,640481,640051,430
28353201,21.9101,21.9088,430,48669,0.343536,0.21,1,640503,640073,430
28356121,31.582,31.5818,430,48712,0.364707,0.25,1,640537,640107,430
28359041,30.3164,28.7164,432,48755,0.384941,0.25,1,640567,640135,432
28361961,7.66328,7.34327,432,48798,0.388988,0.23,1,640569,640137,432
28364881,21.5327,20.6687,433,48841,0.357798,0.23,1,640594,640161,433
28367801,34.7065,4.13373,471,48884,0.35156,0.31,1,640632,640161,471
28370721,31.7413,29.6267,466,48927,0.446312,0.33,1,640663,640197,466
28373641,29.5483,29.9253,465,48970,0.449262,0.33,1,640692,640227,465
28376561,33.1097,28.3851,471,49013,0.465852,0.37,1,640726,640255,471
28379481,37.0219,32.877,475,49056,0.469171,0.33,1,640764,640289,475
28382401,28.2044,38.5754,461,49099,0.469834,0.31,1,640790,640329,461
28385321,16.8409,29.3151,448,49142,0.469967,0.31,1,640804,640356,448
28388241,25.7682,17.063,462,49185,0.485993,0.31,1,640832,640370,462
28391161,42.7536,25.8126,481,49228,0.505199,0.25,1,640879,640398,481
28394081,19.7507,42.7625,448,49271,0.50904,0.27,1,640893,640445,448
28397001,22.3501,19.7525,457,49314,0.525808,0.33,1,640916,640459,457
28399921,22.87,21.5505,458,49357,0.545162,0.35,1,640939,640481,458
28402841,33.374,21.9101,472,49400,0.549032,0.37,1,640975,640503,472
28405761,31.4748,31.582,469,49443,0.549806,0.39,1,641006,640537,469
28408681,7.89496,30.3164,441,49486,0.549961,0.39,1,641008,640567,441
28411601,20.779,7.66328,463,49529,0.549992,0.35,1,641032,640569,463
28414521,36.1558,21.5327,478,49572,0.549998,0.35,1,641072,640594,478
28417441,35.2312,34.7065,475,49615,0.518,0.47,1,641107,640632,475
28420361,29.4462,31.7413,472,49657,0.5596,0.45,1,641135,640663,472
28423281,33.8892,29.5483,478,49699,0.61592,0.47,1,641170,640692,478
28426201,37.1778,33.1097,482,49741,0.627184,0.47,1,641208,640726,482
28429121,28.2356,37.0219,470,49783,0.629437,0.47,1,641234,640764,470
28432041,17.6471,28.2044,459,49825,0.613887,0.47,1,641249,640790,459
28434961,27.5294,16.8409,475,49867,0.642778,0.49,1,641279,640804,475
28437881,42.3059,25.7682,493,49909,0.680556,0.51,1,641325,640832,493
28440801,19.6612,42.7536,460,49951,0.688111,0.51,1,641339,640879,460
28443721,23.1322,19.7507,470,49993,0.689622,0.53,1,641363,640893,470
28446641,23.8264,22.3501,471,50035,0.689924,0.55,1,641387,640916,471
28449561,33.5653,22.87,484,50077,0.721985,0.55,1,641423,640939,484
28452481,31.5131,33.374,479,50119,0.760397,0.55,2,641454,640975,479
28455401,7.90261,31.4748,450,50161,0.768079,0.55,2,641456,641006,450
28458321,20.7805,7.89496,472,50203,0.801616,0.55,2,641480,641008,472
28461241,36.1561,20.779,488,50245,0.824323,0.55,2,641520,641032,488
28464161,35.2312,36.1558,483,50287,0.844865,0.51,2,641555,641072,483
28467081,8.64624,35.2312,450,50329,0.848973,0.57,2,641557,641107,450
28470001,24.9292,29.4462,451,50371,0.849795,0.63,2,641586,641135,451
28472921,34.5858,33.8892,453,50413,0.849959,0.63,2,641623,641170,453
28475841,37.3172,37.1778,453,50455,0.897992,0.63,2,641661,641208,453
28478761,28.2634,28.2356,453,50497,0.891598,0.61,2,641687,641234,453
28481681,18.4527,17.6471,454,50539,0.89032,0.65,2,641703,641249,454
28484601,29.2905,27.5294,456,50581,0.890064,0.69,2,641735,641279,456
28487521,42.6581,42.3059,456,50623,0.938013,0.69,2,641781,641325,456
28776601,77,83,457,24820,0.03,0.75,1,644681,644224,457
28779521,59.4,45.4,476,24905,0.046,0.47,1,644736,644260,476
28782441,47.08,49.08,470,24990,0.0492,0.19,1,644780,644310,470
28785361,39.816,61.816,443,25075,0.04984,0.11,1,644818,644375,443
28788281,56.7632,63.5632,440,25160,0.017968,0.01,1,644879,644439,440
28791201,40.1526,41.5126,440,25244,0.0275936,0.09,1,644915,644475,440
28794121,15.2305,29.1025,423,25328,0.0775187,0.03,1,644924,644501,423
28797041,60.6461,20.2205,477,25412,0.0715037,0.03,1,644996,644519,477
28799961,64.9292,72.0441,458,25495,0.0383007,0.03,1,645062,644604,458
28802881,90.5858,76.0088,478,25578,0.0796602,0.05,1,645159,644681,478
28805801,53.3172,59.2018,467,25661,0.087932,0.05,1,645203,644736,467
28808721,42.6634,47.0404,463,25744,0.0895864,0.05,1,645243,644780,463
28811641,55.7327,39.8081,484,25826,0.121917,0.01,1,645302,644818,484
28814561,40.7465,56.7616,460,25908,0.144383,0.03,1,645339,644879,460
28817481,14.5493,40.1523,432,25990,0.148877,0.09,1,645347,644915,432
28820401,59.7099,15.2305,494,26072,0.101775,0.07,1,645418,644924,494
28823321,63.942,60.6461,487,26153,0.0763551,0.03,1,645483,644996,487
28826241,93.5884,64.9292,522,26234,0.071271,0.09,1,645584,645062,522
28829161,53.9177,90.5858,469,26315,0.0862542,0.09,1,645628,645159,469
28832081,42.7835,53.3172,465,26396,0.0892508,0.09,1,645668,645203,465
28835001,57.3567,42.6634,486,26476,0.10585,0.13,1,645729,645243,486
28837921,41.8713,55.7327,465,26556,0.14117,0.15,1,645767,645302,465
28840841,14.7743,40.7465,436,26636,0.148234,0.15,1,645775,645339,436
28843761,55.7549,14.5493,494,26716,0.117647,0.09,1,645841,645347,494
28846681,64.751,59.7099,490,26795,0.127529,0.07,1,645908,645418,490
28849601,92.9502,63.942,525,26874,0.193506,0.07,1,646008,645483,525
28852521,20.19,93.5884,426,26953,0.206701,0.09,1,646010,645584,426
28855441,39.238,53.9177,426,27032,0.20934,0.09,1,646054,645628,426
28858361,39.8476,42.7835,426,27110,0.257868,0.11,1,646094,645668,426
28861281,58.3695,57.3567,428,27188,0.235574,0.15,1,646157,645729,428
28864201,42.8739,41.8713,429,27266,0.215115,0.15,1,646196,645767,429
28867121,14.9748,14.7743,429,27344,0.179023,0.11,1,646204,645775,429
28870041,54.195,55.7549,427,27421,0.203805,0.13,1,646268,645841,427
28872961,66.839,64.751,430,27498,0.208761,0.21,1,646338,645908,430
28875881,94.9678,92.9502,432,27575,0.273752,0.21,1,646440,646008,432
28878801,20.5936,20.19,432,27652,0.28675,0.21,1,646442,646010,432
28881721,39.3187,39.238,432,27729,0.30535,0.27,1,646486,646054,432
28884641,40.6637,39.8476,433,27805,0.35707,0.23,1,646527,646094,433
28887561,56.9327,58.3695,431,27881,0.351414,0.21,1,646588,646157,431
28890481,41.7865,42.8739,430,27957,0.382283,0.17,1,646626,646196,430
28893401,14.7573,14.9748,430,28033,0.388457,0.21,1,646634,646204,430
28896321,54.1515,54.195,430,28109,0.453691,0.21,1,646698,646268,430
28899241,68.4303,66.839,432,28184,0.466738,0.29,1,646770,646338,432
28902161,96.8861,94.9678,434,28259,0.501348,0.29,1,646874,646440,434
28905081,20.9772,20.5936,434,28334,0.508269,0.31,1,646876,646442,434
28908001,40.1954,39.3187,435,28409,0.525654,0.31,1,646921,646486,435
28910921,42.4391,7.86374,478,28484,0.529131,0.37,1,646964,646486,478
28913841,58.0878,34.3727,499,28558,0.529826,0.35,1,647026,646527,499
28916761,42.0176,55.6745,476,28632,0.561965,0.39,1,647064,646588,476
28919681,15.6035,41.5349,447,28706,0.584393,0.39,1,647073,646626,447
28922601,56.7207,14.707,506,28780,0.636879,0.47,1,647140,646634,506
28925521,70.5441,54.1414,516,28854,0.679376,0.47,1,647214,646698,516
28928441,97.3088,68.4283,548,28927,0.751875,0.51,2,647318,646770,548
28931361,21.0618,96.8857,446,29000,0.766375,0.51,2,647320,646874,446
28934281,41.8124,20.9771,491,29073,0.801275,0.53,2,647367,646876,491
28937201,43.5625,40.1954,490,29146,0.840255,0.53,2,647411,646921,490
28940121,58.3125,42.4391,509,29219,0.880051,0.53,2,647473,646964,509
28943041,43.6625,58.0878,487,29291,0.85601,0.57,2,647513,647026,487
28945961,16.7325,42.0176,459,29363,0.851202,0.59,2,647523,647064,459
28948881,59.3465,15.6035,520,29435,0.89824,0.65,2,647593,647073,520
28951801,72.6693,56.7207,529,29507,0.939648,0.69,2,647669,647140,529
29097801,20,46,495,32902,0.65,1,1,649964,649469,495
29100721,48.8,70,475,32966,0.49,1,1,650020,649545,475
29103641,90.56,98,471,33030,0.106,1,1,650121,649650,471
29106561,64.512,49.2,492,33094,0.0452,1,1,650179,649687,492
29109481,44.1024,40.24,493,33158,0.00904,1,1,650218,649725,493
29112401,36.8205,36.048,493,33222,0.001808,1,1,650253,649760,493
29115321,26.5641,35.2096,482,33286,0.0403616,0.97,1,650277,649795,482
29118241,50.1128,50.2419,484,33350,0.00807232,0.98,1,650333,649849,484
29121161,28.4226,34.0484,477,33413,0.0416145,0.88,1,650356,649879,477
29124081,23.2845,34.0097,465,33476,0.0803229,0.73,1,650378,649913,465
29127001,20.6569,31.6019,454,33539,0.0880646,0.65,1,650398,649944,454
29129921,19.3314,22.3204,453,33602,0.0576129,0.45,1,650417,649964,453
29132841,37.4663,49.2641,439,33665,0.0515226,0.01,1,650459,650020,439
29135761,77.0933,90.6528,425,33728,0.0103045,0.03,1,650546,650121,425
29138681,59.4186,64.5306,422,33791,0.0260609,0,1,650601,650179,422
29141601,43.8837,44.1061,423,33854,0.00521218,0,1,650641,650218,423
29144521,35.9767,36.8212,422,33916,0.0250424,0.05,1,650675,650253,422
29147441,26.3953,26.5642,422,33978,0.0130085,0,1,650699,650277,422
29150361,50.0791,50.1128,422,34040,0.0026017,0.05,1,650755,650333,422
29153281,30.8158,28.4226,425,34102,0.00852034,0.09,1,650781,650356,425
29156201,22.9632,23.2845,424,34164,0.0577041,0.09,1,650802,650378,424
29159121,18.9926,20.6569,422,34226,0.0195408,0.09,1,650820,650398,422
29162041,20.5985,4.13138,443,34288,0.0599082,0.05,1,650841,650398,443
29164961,36.9197,16.0263,465,34350,0.0679816,0.05,1,650882,650417,465
29167881,76.9839,36.8053,510,34412,0.0215963,0,1,650969,650459,510
29170801,57.7968,76.961,476,34473,0.0283193,0.03,1,651022,650546,476
29173721,43.5594,59.3922,461,34534,0.00566385,0,1,651062,650601,461
29176641,35.9119,43.8784,455,34595,0.0251328,0.03,1,651096,650641,455
29179561,26.3824,35.9757,445,34656,0.0290266,0.01,1,651120,650675,445
29182481,50.0765,26.3951,477,34717,0.0618053,0,1,651176,650699,477
29185401,30.8153,50.079,447,34778,0.0363611,0.01,1,651202,650755,447
29188321,22.9631,30.8158,442,34839,0.0952722,0.07,1,651223,650781,442
29191241,20.5926,22.9632,441,34900,0.0910544,0.01,1,651243,650802,441
29194161,20.1185,18.9926,443,34961,0.106211,0.07,1,651263,650820,443
29197081,38.4237,20.5985,465,35021,0.0932422,0.07,1,651306,650841,465
29200001,76.4847,36.9197,510,35081,0.138648,0.01,1,651392,650882,510
29202921,56.0969,76.9839,474,35141,0.11573,0.03,1,651443,650969,474
29205841,44.0194,57.7968,462,35201,0.0471459,0,1,651484,651022,462
29208761,35.2039,43.5594,455,35261,0.0494292,0.03,1,651517,651062,455
29211681,26.2408,35.9119,445,35321,0.0178858,0.03,1,651541,651096,445
29214601,50.0482,26.3824,477,35381,0.0115772,0.07,1,651597,651120,477
29217521,33.2096,50.0765,450,35441,0.0263154,0.03,1,651626,651176,450
29220441,23.4419,30.8153,445,35501,0.0452631,0.11,1,651647,651202,445
29223361,22.2884,22.9631,446,35561,0.0810526,0.09,1,651669,651223,446
29226281,20.4577,20.5926,446,35620,0.0562105,0.11,1,651689,651243,446
29229201,38.4915,20.1185,469,35679,0.0512421,0.09,1,651732,651263,469
29232121,9.29831,38.4237,428,35738,0.0502484,0.15,1,651734,651306,428
29235041,71.4597,76.4847,429,35797,0.14605,0.11,1,651821,651392,429
29237961,53.4919,56.0969,427,35856,0.11721,0.03,1,651870,651443,427
29240881,40.2984,44.0194,423,35915,0.063442,0.05,1,651907,651484,423
29243801,33.6597,35.2039,422,35974,0.0206884,0.01,1,651939,651517,422
29246721,25.9319,26.2408,422,36033,0.0281377,0.01,1,651963,651541,422
29249641,50.7864,50.0482,423,36092,0.0296275,0.03,1,652020,651597,423
29252561,33.3573,33.2096,423,36151,0.0139255,0.05,1,652049,651626,423
29255481,24.2715,23.4419,424,36209,0.0107851,0.09,1,652071,651647,424
29258401,22.4543,22.2884,424,36267,0.042157,0.05,1,652093,651669,424
29261321,20.4909,20.4577,424,36325,0.0964314,0.05,1,652113,651689,424
29264241,40.0982,38.4915,426,36383,0.123286,0.05,1,652158,651732,426
29267161,9.61963,9.29831,426,36441,0.128657,0.17,1,652160,651734,426
29270081,73.1239,71.4597,428,36499,0.209731,0.11,1,652249,651821,428
29273001,53.0248,53.4919,427,36557,0.257946,0.05,1,652297,651870,427
29275921,37.005,40.2984,423,36615,0.283589,0.01,1,652330,651907,423
29278841,32.201,33.6597,422,36673,0.288718,0.03,1,652361,651939,422
29281761,25.6402,25.9319,422,36731,0.225744,0.03,1,652385,651963,422
29284681,50.728,50.7864,422,36789,0.165149,0.01,1,652442,652020,422
29287601,33.3456,33.3573,422,36846,0.12103,0.01,1,652471,652049,422
29290521,24.2691,24.2715,422,36903,0.128206,0.05,1,652493,652071,422
29293441,24.0538,22.4543,424,36960,0.129641,0.11,1,652517,652093,424
29296361,22.4108,20.4909,426,37017,0.145928,0.13,1,652539,652113,426
29299281,42.0822,40.0982,428,37074,0.165186,0.13,1,652586,652158,428
29302201,10.0164,9.61963,428,37131,0.137037,0.23,1,652588,652160,428
29305121,75.6033,73.1239,431,37188,0.147407,0.23,1,652680,652249,431
29308041,55.1207,14.6248,481,37245,0.165481,0.27,1,652730,652249,481
29310961,39.0241,41.325,468,37302,0.153096,0.29,1,652765,652297,468
29313881,31.0048,34.665,464,37359,0.166619,0.29,1,652794,652330,464
29316801,22.201,31.733,453,37416,0.185324,0.21,1,652814,652361,453
29319721,47.6402,25.5466,483,37472,0.221065,0.15,1,652868,652385,483
29322641,33.528,50.7093,456,37528,0.260213,0.11,1,652898,652442,456
29325561,24.3056,33.3419,449,37584,0.268043,0.13,1,652920,652471,449
29328481,24.0611,24.2684,451,37640,0.285609,0.13,1,652944,652493,451
29331401,21.6122,24.0537,448,37696,0.305122,0.15,1,652965,652517,448
29334321,42.7224,22.4107,474,37752,0.325024,0.17,1,653013,652539,474
29337241,10.1445,42.0821,429,37808,0.329005,0.13,1,653015,652586,429
29340161,76.4289,10.0164,520,37864,0.361801,0.15,1,653108,652588,520
29343081,56.0858,75.6033,479,37920,0.38436,0.17,1,653159,652680,479
29346001,38.4172,55.1207,463,37976,0.420872,0.15,1,653193,652730,463
29348921,32.4834,39.0241,459,38032,0.460174,0.17,1,653224,652765,459
29351841,22.4967,31.0048,450,38088,0.436035,0.19,1,653244,652794,450
29354761,49.2993,22.201,486,38143,0.463207,0.23,1,653300,652814,486
29357681,35.4599,47.6402,464,38198,0.500641,0.27,1,653332,652868,464
29360601,24.692,33.528,456,38253,0.508128,0.27,1,653354,652898,456
29363521,24.9384,24.3056,459,38308,0.525626,0.29,1,653379,652920,459
29366441,22.5877,24.0611,457,38363,0.529125,0.31,1,653401,652944,457
29369361,43.7175,21.6122,485,38418,0.561825,0.33,1,653450,652965,485
29372281,10.3435,42.7224,439,38473,0.568365,0.33,1,653452,653013,439
29375201,78.8687,10.1445,533,38528,0.569673,0.37,1,653548,653015,533
29378121,56.5737,76.4289,491,38583,0.585935,0.39,1,653599,653108,491
29381041,12.9147,56.0858,442,38638,0.589187,0.43,1,653601,653159,442
29383961,30.5829,38.4172,443,38693,0.621837,0.47,1,653636,653193,443
29386881,30.9166,32.4834,443,38748,0.612367,0.43,1,653667,653224,443
29389801,22.1833,22.4967,443,38803,0.642473,0.47,1,653687,653244,443
29392721,51.6367,49.2993,446,38857,0.616495,0.51,1,653746,653300,446
29395641,36.7273,35.4599,447,38911,0.611299,0.51,1,653779,653332,447
29398561,25.7455,24.692,448,38965,0.62626,0.53,1,653802,653354,448
29401481,25.1491,24.9384,448,39019,0.581252,0.53,1,653827,653379,448
29404401,22.6298,22.5877,448,39073,0.60425,0.57,1,653849,653401,448
29407321,45.326,43.7175,450,39127,0.59285,0.57,1,653900,653450,450
29410241,10.6652,10.3435,450,39181,0.59057,0.57,1,653902,653452,450
29413161,78.933,78.8687,450,39235,0.654114,0.59,1,653998,653548,450
29416081,57.3866,56.5737,451,39289,0.666823,0.59,1,654050,653599,451
29419001,13.0773,12.9147,451,39343,0.669365,0.63,1,654052,653601,451
29421921,30.6155,30.5829,451,39397,0.701873,0.61,1,654087,653636,451
29424841,31.7231,30.9166,452,39451,0.708375,0.65,1,654119,653667,452
29427761,23.1446,22.1833,453,39505,0.757675,0.61,2,654140,653687,453
29430681,51.8289,51.6367,453,39558,0.799535,0.61,2,654199,653746,453
29433601,35.9658,36.7273,452,39611,0.839907,0.63,2,654231,653779,452
29436521,24.7932,25.7455,451,39664,0.863981,0.57,2,654253,653802,451
29439441,24.1586,25.1491,450,39717,0.868796,0.61,2,654277,653827,450
29442361,22.4317,22.6298,450,39770,0.901759,0.59,2,654299,653849,450
29454041,52,52,453,39982,0.95,0.67,2,654503,654050,453
29456961,12,12,453,40035,0.918,0.71,2,654505,654052,453
29629241,77,75,491,19203,0.03,0.55,1,656695,656204,491
29632161,91.4,64.6,524,19314,0.11,0.21,1,656790,656266,524
29635081,70.28,128.12,445,19424,0.142,0,1,656855,656410,445
29638001,62.856,88.024,428,19533,0.0844,0,1,656916,656488,428
29640921,28.5712,31.2048,431,19642,0.10488,0,1,656936,656505,431
29643841,88.1142,26.241,509,19750,0.044976,0.01,1,657039,656530,509
29646761,80.0228,75.6482,499,19857,0.0489952,0.03,1,657117,656618,499
29649681,94.4046,76.7296,520,19964,0.145799,0.13,1,657215,656695,520
29652601,73.2809,91.3459,493,20070,0.21316,0.15,1,657283,656790,493
29655521,60.2562,70.2692,485,20176,0.242632,0.07,1,657340,656855,485
29658441,26.4512,62.8538,442,20281,0.248526,0.11,1,657358,656916,442
29661361,86.8902,28.5708,524,20386,0.121705,0.03,1,657460,656936,524
29664281,82.1781,88.1142,502,20490,0.0803411,0.05,1,657541,657039,502
29667201,99.6356,80.0228,528,20594,0.0880682,0.17,1,657645,657117,528
29670121,75.9271,94.4046,500,20697,0.0576136,0.23,1,657715,657215,500
29673041,61.5854,73.2809,490,20799,0.0675227,0.25,1,657773,657283,490
29675961,26.7171,60.2562,451,20901,0.0695045,0.25,1,657791,657340,451
29678881,78.9434,26.4512,525,21002,0.117901,0.09,1,657883,657358,525
29681801,17.3887,86.8902,425,21103,0.12758,0.07,1,657885,657460,425
29684721,68.2777,82.1781,425,21204,0.193516,0.09,1,657966,657541,425
29687641,97.6555,99.6356,426,21304,0.270703,0.05,1,658071,657645,426
29690561,73.9311,75.9271,424,21404,0.366141,0.07,1,658139,657715,424
29693481,61.9862,61.5854,425,21503,0.417228,0.07,1,658198,657773,425
29696401,26.7972,26.7171,425,21602,0.427446,0.13,1,658216,657791,425
29699321,81.3594,78.9434,428,21700,0.413489,0.13,1,658311,657883,428
29702241,17.8719,17.3887,428,21798,0.410698,0.21,1,658313,657885,428
29705161,69.9744,68.2777,430,21895,0.42614,0.29,1,658396,657966,430
29708081,104.395,97.6555,438,21992,0.461228,0.39,1,658509,658071,438
29711001,77.679,73.9311,441,22088,0.500246,0.43,1,658580,658139,441
29713921,62.7358,61.9862,441,22184,0.524049,0.43,1,658639,658198,441
29716841,26.9472,26.7972,441,22280,0.52881,0.41,1,658657,658216,441
29719761,80.5894,81.3594,440,22375,0.545762,0.41,1,658751,658311,440
29722681,17.7179,17.8719,440,22470,0.597152,0.43,1,658753,658313,440
29725601,70.7436,69.9744,441,22564,0.60743,0.43,1,658837,658396,441
29728521,105.349,13.9949,555,22658,0.609486,0.47,1,658951,658396,555
29731441,81.0697,93.199,517,22752,0.657897,0.51,1,659026,658509,517
29734361,64.2139,75.4398,506,22845,0.763579,0.53,2,659086,658580,506
29737281,27.2428,62.288,465,22938,0.784716,0.53,2,659104,658639,465
29740201,82.2486,26.8576,543,23030,0.788943,0.55,2,659200,658657,543
29743121,18.0497,80.5715,451,23122,0.821789,0.61,2,659202,658751,451
29746041,72.4099,17.7143,535,23214,0.828358,0.61,2,659288,658753,535
29748961,105.682,70.7429,565,23305,0.829672,0.61,2,659402,658837,565
29751881,85.1364,105.349,531,23396,0.813934,0.67,2,659482,658951,531
29754801,68.2273,81.0697,520,23487,0.826787,0.79,2,659546,659026,520
29757721,28.0455,64.2139,478,23577,0.829357,0.79,2,659564,659086,478
29760641,84.0091,27.2428,558,23667,0.845871,0.79,2,659662,659104,558
29763561,18.4018,82.2486,464,23757,0.849174,0.83,2,659664,659200,464
29766481,72.4804,18.0497,548,23846,0.865835,0.83,2,659750,659202,548
29769401,106.496,72.4099,577,23935,0.885167,0.83,2,659865,659288,577
29772321,22.8992,105.682,465,24024,0.921033,0.81,2,659867,659402,465
29868681,48,31,531,26782,0.69,1,1,661836,661305,531
29871601,61.6,55.8,534,26861,0.418,1,1,661901,661367,534
29874521,41.12,65.56,502,26940,0.3156,1,1,661937,661435,502
29877441,33.824,32.312,510,27019,0.18312,1,1,661969,661459,510
29880361,58.7648,78.4624,485,27097,0.036624,1,1,662034,661549,485
29883281,38.153,42.0925,485,27175,0.0313248,1,1,662067,661582,485
29886201,60.4306,52.4185,496,27253,0.062265,0.79,1,662133,661637,496
29889121,86.4861,111.284,463,27331,0.036453,0.91,1,662226,661763,463
29892041,36.4972,42.2567,462,27408,0.0472906,0.69,1,662250,661788,462
29894961,36.8994,46.8513,451,27485,0.0494581,0.35,1,662287,661836,451
29897881,47.3799,61.3703,436,27562,0.0498916,0.29,1,662337,661901,436
29900801,34.276,41.0741,431,27639,0.0339783,0.15,1,662368,661937,431
29903721,29.2552,33.8148,427,27716,0.0467957,0,1,662396,661969,427
29906641,53.851,58.763,422,27792,0.0653591,0.03,1,662456,662034,422
29909561,37.1702,38.1526,422,27868,0.0370718,0.07,1,662489,662067,422
29912481,61.834,60.4305,424,27944,0.0474144,0.03,1,662557,662133,424
29915401,85.1668,86.4861,422,28020,0.0334829,0.05,1,662648,662226,422
29918321,36.2334,36.4972,422,28096,0.0306966,0.05,1,662672,662250,422
29921241,38.4467,36.8994,424,28171,0.0301393,0.05,1,662711,662287,424
29924161,46.0893,47.3799,422,28246,0.0300279,0.03,1,662759,662337,422
29927081,34.8179,34.276,423,28321,0.0460056,0.05,1,662791,662368,423
29930001,30.9636,29.2552,425,28396,0.0332011,0.05,1,662821,662396,425
29932921,53.3927,5.85104,484,28471,0.0786402,0.07,1,662880,662396,484
29935841,34.6785,49.1702,454,28545,0.087728,0.03,1,662910,662456,454
29938761,61.3357,36.234,489,28619,0.105546,0.05,1,662978,662489,489
29941681,85.0671,61.6468,512,28693,0.0931091,0.03,1,663069,662557,512
29944601,36.2134,85.1294,445,28767,0.122622,0.03,1,663093,662648,445
29947521,39.2427,36.2259,461,28841,0.112524,0.03,1,663133,662672,461
29950441,46.2485,38.4452,470,28914,0.0785049,0.03,1,663181,662711,470
29953361,34.0497,46.089,453,28987,0.039701,0.05,1,663212,662759,453
29956281,30.8099,34.8178,451,29060,0.0159402,0.03,1,663242,662791,451
29959201,56.562,30.9636,484,29133,0.059188,0.09,1,663305,662821,484
29962121,33.7124,53.3927,453,29206,0.0998376,0.09,1,663333,662880,453
29965041,63.5425,34.6785,494,29278,0.0759675,0.11,1,663404,662910,494
29967961,84.7085,61.3357,516,29350,0.0551935,0.09,1,663494,662978,516
29970881,36.1417,85.0671,449,29422,0.0510387,0.13,1,663518,663069,449
29973801,40.0283,36.2134,466,29494,0.0982077,0.11,1,663559,663093,466
29976721,44.8057,39.2427,472,29566,0.107642,0.07,1,663605,663133,472
29979641,32.1611,46.2485,453,29638,0.109528,0.03,1,663634,663181,453
29982561,29.6322,34.0497,451,29709,0.109906,0.01,1,663663,663212,451
29985481,58.7264,30.8099,487,29780,0.0779811,0.07,1,663729,663242,487
29988401,13.3453,56.562,426,29851,0.0715962,0.11,1,663731,663305,426
29991321,24.2691,33.7124,425,29922,0.0863192,0.07,1,663758,663333,425
29994241,61.6538,63.5425,425,29993,0.169264,0.05,1,663829,663404,425
29997161,83.5308,84.7085,424,30064,0.249853,0.05,1,663918,663494,424
30000081,35.9062,36.1417,424,30134,0.233971,0.11,1,663942,663518,424
30003001,42.3812,40.0283,427,30204,0.246794,0.11,1,663986,663559,427
30005921,46.0762,44.8057,428,30274,0.249359,0.11,1,664033,663605,428
30008841,32.4152,32.1611,428,30344,0.281872,0.11,1,664062,663634,428
30011761,28.883,29.6322,427,30414,0.336374,0.07,1,664090,663663,427
30014681,56.9766,58.7264,425,30484,0.347275,0.07,1,664154,663729,425
30017601,12.9953,13.3453,425,30553,0.349455,0.09,1,664156,663731,425
30020521,25.7991,24.2691,427,30622,0.349891,0.19,1,664185,663758,427
30023441,63.5598,61.6538,429,30691,0.397978,0.27,1,664258,663829,429
30026361,87.112,83.5308,433,30760,0.407596,0.23,1,664351,663918,433
30029281,36.6224,35.9062,433,30829,0.425519,0.25,1,664375,663942,433
30032201,41.7245,42.3812,432,30898,0.477104,0.25,1,664418,663986,432
30035121,47.5449,46.0762,434,30966,0.503421,0.29,1,664467,664033,434
30038041,35.109,32.4152,437,31034,0.524684,0.35,1,664499,664062,437
30040961,29.4218,28.883,437,31102,0.560937,0.35,1,664527,664090,437
30043881,57.0844,56.9766,437,31170,0.552187,0.35,1,664591,664154,437
30046801,13.0169,12.9953,437,31238,0.550437,0.35,1,664593,664156,437
30049721,25.8034,25.7991,437,31306,0.566087,0.35,1,664622,664185,437
30052641,65.1607,5.15981,512,31374,0.553218,0.41,1,664697,664185,512
30055561,89.0321,59.432,534,31441,0.598643,0.41,1,664792,664258,534
30058481,37.8064,86.2864,466,31508,0.623729,0.43,1,664817,664351,466
30061401,42.7613,36.4573,486,31575,0.660746,0.49,1,664861,664375,486
30064321,50.9523,41.6915,496,31642,0.700149,0.51,1,664914,664418,496
30067241,35.7905,47.5383,479,31709,0.70803,0.53,1,664946,664467,479
30070161,29.5581,35.1077,475,31776,0.725606,0.57,1,664974,664499,475
30073081,57.9116,29.4215,512,31843,0.729121,0.55,1,665039,664527,512
30076001,13.1823,57.0843,450,31909,0.729824,0.55,1,665041,664591,450
30078921,25.0365,13.0169,476,31975,0.729965,0.57,1,665069,664593,476
30081841,65.8073,25.8034,523,32041,0.745993,0.55,1,665145,664622,523
30084761,91.5615,65.1607,546,32107,0.765199,0.61,2,665243,664697,546
30087681,39.9123,89.0321,478,32173,0.81704,0.63,2,665270,664792,478
30090601,43.9825,37.8064,498,32239,0.811408,0.67,2,665315,664817,498
30093521,52.7965,42.7613,509,32305,0.794282,0.71,2,665370,664861,509
30096441,36.9593,50.9523,489,32370,0.822856,0.71,2,665403,664914,489
30099361,29.7919,35.7905,485,32435,0.812571,0.73,2,665431,664946,485
30102281,57.9584,29.5581,522,32500,0.826514,0.73,2,665496,664974,522
30105201,13.1917,57.9116,459,32565,0.829303,0.73,2,665498,665039,459
30108121,25.0383,13.1823,485,32630,0.829861,0.73,2,665526,665041,485
30111041,67.4077,25.0365,535,32695,0.861972,0.75,2,665604,665069,535
30113961,91.8815,65.8073,557,32760,0.916394,0.77,2,665702,665145,557
30116881,19.9763,91.5615,461,32825,0.927279,0.83,2,665704,665243,461
30119801,25.5953,39.9123,461,32889,0.913456,0.81,2,665731,665270,461
30245361,29,105,496,35548,0.69,1,1,667628,667132,496
30248281,41.8,41.8,515,35607,0.706,1,1,667673,667158,515
30251201,31.56,36.36,509,35666,0.7092,1,1,667702,667193,509
30254121,7.912,32.072,480,35725,0.67784,1,1,667704,667224,480
30257041,24.7824,28.0144,482,35784,0.655568,1,1,667733,667251,482
30259961,32.9565,35.2029,480,35843,0.683114,1,1,667768,667288,480
30262881,29.7913,34.2406,475,35902,0.704623,1,1,667797,667322,475
30265801,41.9583,47.6481,469,35961,0.740925,1,1,667842,667373,469
30268721,37.1917,39.1296,468,36020,0.780185,0.93,2,667878,667410,468
30271641,25.0383,30.2259,462,36079,0.852037,0.87,2,667900,667438,462
30274561,46.6077,46.0452,464,36138,0.834407,0.71,2,667952,667488,464
30277481,95.7215,98.009,461,36196,0.894881,0.69,2,668060,667599,461
30280401,40.7443,42.8018,459,36254,0.858976,0.71,2,668087,667628,459
30283321,40.9489,44.5604,455,36312,0.851795,0.71,2,668128,667673,455
30286241,32.1898,32.1121,456,36370,0.882359,0.67,2,668158,667702,456
30289161,8.03795,8.02241,456,36428,0.888472,0.65,2,668160,667704,456
30292081,24.8076,24.8045,456,36486,0.937694,0.69,2,668189,667733,456
30295001,35.3615,32.9609,459,36544,0.931539,0.71,2,668227,667768,459
30297921,29.4723,29.7922,458,36602,0.930308,0.75,2,668255,667797,458
30300841,42.6945,41.9584,459,36660,0.946062,0.79,2,668301,667842,459
30464361,54,55,476,39757,0.91,0.94,2,670505,670029,476
30467281,32.4,39,468,39810,0.91,1,2,670532,670064,468
30470201,26.48,27.8,468,39863,0.846,0.95,2,670557,670089,468
30473121,40.496,34.36,476,39916,0.8172,0.99,2,670601,670125,476
30476041,28.8992,34.072,468,39969,0.82744,0.95,2,670627,670159,468
30478961,30.5798,30.0144,470,40022,0.781488,0.97,2,670658,670188,470
30481881,10.916,14.0029,466,40075,0.772298,0.97,2,670664,670198,466
30484801,19.7832,2.80058,488,40128,0.73846,0.97,1,670686,670198,488
30487721,40.7566,15.7601,515,40181,0.731692,0.95,1,670732,670217,515
30490641,29.7513,39.152,497,40234,0.762338,0.88,2,670759,670262,497
30493561,32.3503,31.0304,501,40286,0.800468,0.92,2,670792,670291,501
30496481,76.8701,31.8061,557,40338,0.856094,0.9,2,670880,670323,557
30499401,44.174,79.1612,502,40390,0.867219,0.91,2,670916,670414,502
30502321,51.2348,45.4322,518,40442,0.869444,0.91,2,670969,670451,518
30505241,31.847,52.2864,491,40494,0.885889,0.91,2,670996,670505,491
30508161,23.9694,32.0573,486,40546,0.889178,0.83,2,671018,670532,486
30511081,39.9939,26.4115,505,40598,0.905836,0.81,2,671062,670557,505
30514001,27.9988,40.4823,486,40650,0.893167,0.83,2,671087,670601,486
30696501,81,99,482,19925,0.35,0.55,1,673356,672874,482
30699421,83.4,71,502,20031,0.366,0.45,1,673440,672938,502
30702341,55.08,81.4,466,20137,0.3692,0.45,1,673488,673022,466
30705261,63.016,64.28,471,20242,0.36984,0.37,1,673553,673082,471
30708181,29.4032,48.856,447,20347,0.385968,0.33,1,673574,673127,447
30711101,116.281,24.1712,567,20451,0.453194,0.33,1,673712,673145,567
30714021,88.8561,108.834,519,20555,0.514639,0.35,1,673794,673275,519
30716941,85.7712,86.5668,523,20658,0.526928,0.37,1,673879,673356,523
30719861,55.5542,84.5134,487,20761,0.561386,0.37,1,673927,673440,487
30722781,63.1108,55.3027,504,20863,0.552277,0.37,1,673992,673488,504
30725701,30.2222,63.0605,461,20965,0.566455,0.39,1,674014,673553,461
30728621,7.64443,29.4121,442,21066,0.569291,0.47,1,674016,673574,442
30731541,114.329,116.282,445,21167,0.617858,0.53,1,674157,673712,445
30734461,90.8658,88.8565,448,21267,0.659572,0.53,1,674242,673794,448
30737381,86.9732,85.7713,449,21367,0.699914,0.57,1,674328,673879,449
30740301,56.5946,55.5543,450,21466,0.755983,0.55,2,674377,673927,450
30743221,63.3189,63.1109,450,21565,0.767197,0.57,2,674442,673992,450
30746141,30.2638,30.2222,450,21663,0.769439,0.57,2,674464,674014,450
30749061,7.65276,7.64443,450,21761,0.737888,0.63,1,674466,674016,450
30751981,115.131,114.329,451,21858,0.779578,0.67,2,674608,674157,451
30754901,94.2261,90.8658,455,21955,0.851916,0.71,2,674697,674242,455
30757821,89.2452,86.9732,457,22052,0.930383,0.77,2,674785,674328,457
30857101,29,28,507,25114,0.59,1,1,676898,676391,507
30860021,62.6,84,480,25198,0.542,1,1,676969,676489,480
30862941,98.92,104,479,25282,0.4684,1,1,677077,676598,479
30865861,47.784,51.2,476,25366,0.40568,1,1,677112,676636,476
30868781,60.7568,62.24,475,25450,0.441136,1,1,677176,676701,475
30871701,36.9514,12.448,506,25533,0.416227,1,1,677207,676701,506
30874621,77.7903,32.8896,556,25616,0.459245,0.85,1,677295,676739,556
30877541,37.1581,84.1779,486,25699,0.499849,0.71,1,677322,676836,486
30880461,25.8316,43.2356,476,25781,0.49197,0.59,1,677345,676869,476
30883381,63.5663,31.8471,520,25863,0.506394,0.53,1,677418,676898,520
30886301,91.9133,63.1694,548,25945,0.573279,0.45,1,677517,676969,548
30889221,45.5827,99.0339,474,26027,0.618656,0.39,1,677551,677077,474
30892141,61.9165,47.8068,505,26108,0.595731,0.45,1,677617,677112,505
30895061,35.5833,60.7614,470,26189,0.623146,0.41,1,677646,677176,470
30897981,83.9167,36.9523,535,26270,0.676629,0.47,1,677742,677207,535
30900901,37.5833,77.7905,473,26351,0.703326,0.51,1,677768,677295,473
30903821,26.7167,37.1581,470,26431,0.708665,0.49,1,677792,677322,470
30906741,62.9433,25.8316,519,26511,0.757733,0.51,2,677864,677345,519
30909661,94.9887,63.5663,549,26591,0.735547,0.59,1,677967,677418,549
30912581,46.1977,91.9133,484,26671,0.763109,0.63,2,678001,677517,484
30915501,62.0395,45.5827,516,26750,0.784622,0.59,2,678067,677551,516
30918421,37.2079,61.9165,481,26829,0.772924,0.63,2,678098,677617,481
30921341,86.6416,35.5833,551,26908,0.850585,0.69,2,678197,677646,551
30924261,18.9283,83.9167,457,26987,0.866117,0.71,2,678199,677742,457
30927181,24.5857,37.5833,457,27065,0.869223,0.71,2,678225,677768,457
30930101,24.9171,26.7167,458,27143,0.901845,0.77,2,678250,677792,458
30933021,64.1834,62.9433,460,27221,0.908369,0.73,2,678324,677864,460
30935941,93.6367,94.9887,458,27299,0.893674,0.77,2,678425,677967,458
30938861,47.5273,46.1977,460,27377,0.842735,0.79,2,678461,678001,460
30941781,63.1055,62.0395,461,27454,0.880547,0.77,2,678528,678067,461
30944701,37.4211,37.2079,461,27531,0.904109,0.87,2,678559,678098,461
30947621,89.8842,86.6416,465,27608,0.908822,0.87,2,678662,678197,465
30950541,19.5768,18.9283,465,27685,0.909764,0.87,2,678664,678199,465
31038141,31,28,508,29892,0.85,1,2,680181,679673,508
31041061,35.8,48.8,491,29963,0.802,1,2,680218,679727,491
31043981,76.76,92.16,475,30034,0.4564,1,1,680305,679830,475
31046901,60.952,45.632,498,30104,0.17928,1,1,680362,679864,498
31049821,52.9904,65.9264,478,30174,0.075856,1,1,680413,679935,478
31052741,44.1981,37.1853,490,30244,0.0711712,0.94,1,680455,679965,490
31055661,80.8396,88.2371,479,30314,0.0142342,0.96,1,680545,680066,479
31058581,36.9679,44.8474,471,30384,0.0428468,0.94,1,680571,680100,471
31061501,26.5936,30.5695,468,30454,0.0165694,0.93,1,680595,680127,468
31064421,22.9187,24.5139,467,30523,0.0113139,0.85,1,680617,680150,467
31067341,26.1837,29.7028,463,30592,0.0262628,0.79,1,680644,680181,463
31070261,28.4367,35.5406,455,30661,0.0612526,0.37,1,680673,680218,455
31073181,63.2874,76.7081,440,30730,0.116251,0.11,1,680745,680305,440
31076101,46.2575,60.9416,425,30799,0.0632501,0.05,1,680787,680362,425
31079021,47.6515,52.9883,422,30868,0.06865,0.07,1,680835,680413,422
31081941,43.1303,44.1977,422,30937,0.03773,0,1,680877,680455,422
31084861,80.6261,80.8395,422,31005,0.031546,0.05,1,680967,680545,422
31087781,36.9252,36.9679,422,31073,0.0303092,0.01,1,680993,680571,422
31090701,26.585,26.5936,422,31141,0.0620618,0.01,1,681017,680595,422
31093621,23.717,22.9187,423,31209,0.0364124,0.03,1,681040,680617,423
31096541,25.5434,26.1837,422,31277,0.0792825,0.03,1,681066,680644,422
31099461,29.1087,5.23675,452,31345,0.0718565,0.07,1,681096,680644,452
31102381,64.2217,24.2474,496,31413,0.134371,0.13,1,681169,680673,496
31105301,44.8443,62.4495,464,31480,0.114874,0.05,1,681209,680745,464
31108221,48.1689,46.0899,471,31547,0.174975,0.07,1,681258,680787,471
31111141,41.6338,47.618,463,31614,0.122995,0.03,1,681298,680835,463
31114061,81.9268,43.1236,513,31681,0.032599,0.03,1,681390,680877,513
31116981,36.3853,80.6247,448,31748,0.0465198,0.03,1,681415,680967,448
31119901,25.6771,36.9249,445,31815,0.033304,0.07,1,681438,680993,445
31122821,24.3354,26.585,445,31881,0.0306608,0.03,1,681462,681017,445
31125741,24.8671,23.717,447,31947,0.0621322,0.09,1,681487,681040,447
31128661,31.3734,25.5434,454,32013,0.100426,0.07,1,681520,681066,454
31131581,66.2747,29.1087,499,32079,0.172085,0.15,1,681595,681096,499
31134501,45.2549,64.2217,466,32145,0.202417,0.11,1,681635,681169,466
31137421,49.851,44.8443,477,32211,0.208483,0.19,1,681686,681209,477
31140341,40.3702,48.1689,466,32277,0.209697,0.11,1,681724,681258,466
31143261,77.674,41.6338,513,32343,0.241939,0.01,1,681811,681298,513
31146181,37.1348,81.9268,448,32408,0.216388,0.05,1,681838,681390,448
31149101,24.227,36.3853,444,32473,0.211278,0.03,1,681859,681415,444
31152021,25.6454,25.6771,447,32538,0.178256,0.03,1,681885,681438,447
31154941,25.9291,24.3354,449,32603,0.171651,0.07,1,681911,681462,449
31157861,33.1858,24.8671,459,32668,0.18633,0.11,1,681946,681487,459
31160781,69.8372,31.3734,505,32733,0.253266,0.19,1,682025,681520,505
31163701,15.5674,66.2747,432,32798,0.266653,0.21,1,682027,681595,432
31166621,35.1135,45.2549,432,32862,0.301331,0.21,1,682067,681635,432
31169541,47.8227,49.851,432,32926,0.276266,0.21,1,682118,681686,432
31172461,39.9645,40.3702,432,32990,0.303253,0.25,1,682156,681724,432
31175381,77.5929,77.674,432,33054,0.244651,0.21,1,682243,681811,432
31178301,37.1186,37.1348,432,33118,0.23293,0.21,1,682270,681838,432
31181221,24.2237,24.227,432,33182,0.278586,0.17,1,682291,681859,432
31184141,24.0447,25.6454,430,33246,0.287717,0.17,1,682315,681885,430
31187061,25.6089,25.9291,430,33310,0.289543,0.19,1,682341,681911,430
31189981,33.9218,33.1858,431,33373,0.289909,0.27,1,682377,681946,431
31192901,73.1844,69.8372,435,33436,0.289982,0.27,1,682460,682025,435
31195821,16.2369,15.5674,435,33499,0.289996,0.31,1,682462,682027,435
31198741,35.2474,35.1135,435,33562,0.305999,0.27,1,682502,682067,435
31201661,47.8495,47.8227,435,33625,0.3572,0.31,1,682553,682118,435
31204581,39.9699,39.9645,435,33688,0.36744,0.23,1,682591,682156,435
31207501,76.794,77.5929,434,33751,0.385488,0.23,1,682677,682243,434
31210421,36.1588,37.1186,433,33814,0.389098,0.29,1,682703,682270,433
31213341,24.8318,24.2237,434,33877,0.42182,0.29,1,682725,682291,434
31216261,24.1664,24.0447,434,33939,0.460364,0.29,1,682749,682315,434
31219181,25.6333,25.6089,434,34001,0.484073,0.29,1,682775,682341,434
31222101,33.9267,33.9218,434,34063,0.488815,0.29,1,682811,682377,434
31225021,73.1853,73.1844,434,34125,0.585763,0.29,1,682894,682460,434
31227941,16.2371,16.2369,434,34187,0.605153,0.31,1,682896,682462,434
31230861,36.0474,35.2474,435,34249,0.577031,0.31,1,682937,682502,435
31233781,49.6095,7.04947,488,34311,0.587406,0.37,1,682990,682502,488
31236701,41.1219,42.2099,476,34373,0.605481,0.37,1,683029,682553,476
31239621,78.6244,38.842,526,34435,0.657096,0.39,1,683117,682591,526
31242541,36.5249,76.5684,466,34496,0.667419,0.39,1,683143,682677,466
31245461,25.705,36.1137,463,34557,0.685484,0.43,1,683166,682703,463
31248381,25.941,24.8227,467,34618,0.689097,0.47,1,683192,682725,467
31251301,27.5882,24.1645,471,34679,0.721819,0.49,1,683220,682749,471
31254221,34.3176,25.6329,481,34740,0.744364,0.49,1,683256,682775,481
31257141,76.4635,33.9266,532,34801,0.748873,0.61,1,683343,682811,532
31260061,16.8927,73.1853,451,34862,0.749775,0.61,1,683345,682894,451
31262981,36.9785,16.2371,491,34923,0.781955,0.57,2,683387,682896,491
31265901,49.7957,36.0474,503,34984,0.852391,0.59,2,683440,682937,503
31268821,43.5591,49.6095,492,35044,0.898478,0.61,2,683482,682990,492
31271741,79.9118,41.1219,542,35104,0.907696,0.67,2,683571,683029,542
31274661,36.7824,78.6244,480,35164,0.909539,0.67,2,683597,683117,480
31277581,26.5565,36.5249,478,35224,0.909908,0.69,2,683621,683143,478
31280501,26.1113,25.705,481,35284,0.925982,0.69,2,683647,683166,481
31432341,28,87,500,38275,0.83,1,2,685715,685215,500
31435261,33.6,35.8,512,38330,0.734,1,1,685750,685238,512
31438181,46.72,29.56,534,38385,0.7308,0.97,1,685800,685266,534
31441101,33.344,48.312,511,38440,0.68216,1,1,685830,685319,511
31444021,30.6688,27.2624,519,38495,0.608432,1,1,685860,685341,519
31446941,62.1338,34.2525,553,38550,0.465686,1,1,685930,685377,553
31449861,38.0268,74.0505,501,38605,0.405137,1,1,685962,685461,501
31452781,26.8054,36.4101,498,38660,0.441027,1,1,685986,685488,498
31455701,15.7611,34.482,477,38715,0.400205,0.96,1,685999,685522,477
31458621,25.5522,31.6964,474,38770,0.424041,1,1,686027,685553,474
31461541,27.5104,29.5393,473,38824,0.476808,0.96,1,686055,685582,473
31464461,27.9021,32.3079,468,38878,0.343362,0.83,1,686083,685615,468
31467381,59.1804,64.0616,463,38932,0.316672,0.83,1,686150,685687,463
31470301,33.4361,35.2123,462,38986,0.183334,0.71,1,686177,685715,462
31473221,35.4872,35.0425,463,39040,0.140667,0.73,1,686213,685750,463
31476141,43.0974,47.0085,458,39094,0.164133,0.67,1,686258,685800,458
31479061,27.8195,33.4017,452,39148,0.168827,0.59,1,686282,685830,452
31481981,28.7639,30.6803,451,39202,0.153765,0.43,1,686311,685860,451
31484901,55.3528,62.1361,443,39256,0.182753,0.39,1,686373,685930,443
31487821,37.4706,38.0272,444,39310,0.172551,0.45,1,686406,685962,444
31490741,22.6941,26.8054,439,39364,0.18651,0.39,1,686425,685986,439
31493661,18.9388,15.7611,444,39418,0.189302,0.43,1,686443,685999,444
31496581,24.5878,25.5522,442,39472,0.23786,0.49,1,686469,686027,442
31499501,26.5176,27.5104,441,39526,0.263572,0.31,1,686496,686055,441
31502421,24.5035,27.9021,437,39579,0.268714,0.31,1,686520,686083,437
31505341,55.3007,59.1804,433,39632,0.301743,0.15,1,686583,686150,433
31508261,29.4601,33.4361,429,39685,0.324349,0.13,1,686606,686177,429
31511181,33.892,35.4872,428,39738,0.28087,0.17,1,686641,686213,428
31514101,44.3784,43.0974,430,39791,0.400174,0.17,1,686688,686258,430
31517021,28.0757,27.8195,430,39844,0.392035,0.15,1,686712,686282,430
31519941,26.4151,28.7639,427,39897,0.390407,0.19,1,686738,686311,427
31522861,58.083,55.3528,431,39950,0.422081,0.17,1,686804,686373,431
31525781,37.2166,37.4706,430,40003,0.460416,0.19,1,686836,686406,430
31528701,23.4433,22.6941,431,40056,0.452083,0.19,1,686856,686425,431
31531621,18.2887,18.9388,430,40109,0.466417,0.19,1,686873,686443,430
31534541,26.8577,3.78776,459,40162,0.453283,0.25,1,686902,686443,459
31537461,26.1715,21.5576,459,40215,0.466657,0.27,1,686928,686469,459
31540381,25.2343,25.9115,457,40268,0.517331,0.27,1,686953,686496,457
31543301,56.2469,24.3823,497,40320,0.543466,0.31,1,687017,686520,497
31546221,30.4494,55.2765,458,40372,0.548693,0.33,1,687041,686583,458
31549141,33.2899,29.4553,469,40424,0.565739,0.27,1,687075,686606,469
31552061,49.058,33.8911,487,40476,0.601148,0.43,1,687128,686641,487
31554981,29.0116,44.3782,464,40528,0.62423,0.39,1,687152,686688,464
31557901,26.6023,28.0756,466,40580,0.628846,0.39,1,687178,686712,466
31560821,59.7205,26.4151,508,40632,0.661769,0.43,1,687246,686738,508
31563741,38.3441,58.083,475,40684,0.700354,0.47,1,687279,686804,475
31566661,23.6688,37.2166,463,40736,0.676071,0.45,1,687299,686836,463
31569581,19.1338,23.4433,461,40788,0.671214,0.47,1,687317,686856,461
31572501,27.0268,18.2887,473,40840,0.670243,0.45,1,687346,686873,473
31575421,26.2054,26.8577,470,40892,0.686049,0.47,1,687372,686902,470
31578341,27.6411,26.1715,472,40944,0.68921,0.53,1,687400,686928,472
31581261,57.5282,25.2343,512,40996,0.737842,0.55,1,687465,686953,512
31584181,30.7056,56.2469,472,41047,0.747568,0.55,1,687489,687017,472
31587101,34.1411,30.4494,483,41098,0.733514,0.57,1,687524,687041,483
31590021,51.6282,33.2899,505,41149,0.730703,0.61,1,687580,687075,505
31592941,29.5256,49.058,476,41200,0.762141,0.63,2,687604,687128,476
31595861,26.7051,29.0116,478,41251,0.800428,0.63,2,687630,687152,478
31598781,61.341,26.6023,522,41302,0.824086,0.67,2,687700,687178,522
31601701,38.6682,59.7205,487,41353,0.812817,0.71,2,687733,687246,487
31604621,23.7336,38.3441,474,41404,0.810563,0.67,2,687753,687279,474
31607541,19.9467,23.6688,473,41455,0.794113,0.67,2,687772,687299,473
31610461,26.3893,19.1338,483,41506,0.790823,0.67,2,687800,687317,483
31613381,6.87787,27.0268,456,41557,0.790164,0.69,2,687802,687346,456
31616301,22.1756,26.2054,456,41608,0.822033,0.69,2,687828,687372,456
31619221,26.8351,27.6411,456,41659,0.828407,0.75,2,687856,687400,456
31622141,59.767,57.5282,459,41710,0.845681,0.75,2,687924,687465,459
31625061,31.1534,30.7056,459,41761,0.897136,0.73,2,687948,687489,459
31627981,33.4307,34.1411,458,41812,0.891427,0.73,2,687982,687524,458
31630901,51.4861,51.6282,458,41862,0.906285,0.77,2,688038,687580,458
31633821,31.8972,29.5256,461,41912,0.909257,0.81,2,688065,687604,461
31636741,27.9794,26.7051,462,41962,0.941851,0.83,2,688092,687630,462
31782741,31,23,536,44408,0.81,1,2,689787,689251,536
31785661,31,20.6,547,44456,0.81,1,2,689818,689271,547
31832381,411.8,483.32,455,20440,0.378,0.59,1,690325,689870,455
31835301,156.76,155.064,475,20544,0.3556,0.39,1,690418,689943,475
31838221,117.752,115.013,478,20647,0.39912,0.41,1,690526,690048,478
31841141,72.3504,83.8026,463,20750,0.391824,0.33,1,690587,690124,463
31844061,48.0701,55.9605,456,20852,0.422365,0.29,1,690629,690173,456
31846981,76.814,53.5921,487,20954,0.428473,0.25,1,690713,690226,487
31849901,28.1628,53.9184,449,21055,0.445695,0.27,1,690729,690280,449
31852821,30.4326,34.7837,450,21156,0.465139,0.35,1,690760,690310,450
31855741,82.8865,93.3567,438,21256,0.517028,0.41,1,690856,690418,438
31858661,104.577,105.071,440,21356,0.575406,0.39,1,690966,690526,440
31861581,70.5155,69.8143,441,21455,0.667081,0.43,1,691028,690587,441
31864501,49.3031,47.5629,443,21554,0.685416,0.43,1,691072,690629,443
31867421,77.8606,76.7126,444,21652,0.721083,0.45,1,691157,690713,444
31870341,28.3721,28.1425,444,21750,0.696217,0.47,1,691173,690729,444
31873261,31.2744,30.4285,445,21848,0.723243,0.53,1,691205,690760,445
31876181,84.6549,82.8857,447,21945,0.776649,0.59,2,691303,690856,447
31879101,108.931,104.577,452,22042,0.78733,0.69,2,691418,690966,452
31882021,72.9862,70.5154,454,22138,0.773466,0.69,2,691482,691028,454
31884941,51.3972,49.3031,456,22234,0.818693,0.73,2,691528,691072,456
31887861,78.2794,77.8606,456,22329,0.795739,0.69,2,691613,691157,456
31890781,28.4559,28.3721,456,22424,0.823148,0.73,2,691629,691173,456
31893701,31.2912,31.2744,456,22519,0.79663,0.73,2,691661,691205,456
31896621,87.8582,6.25488,558,22613,0.775326,0.79,2,691763,691205,558
31899541,107.972,79.651,573,22707,0.867065,0.79,2,691876,691303,573
31902461,73.5943,107.93,523,22800,0.917413,0.77,2,691941,691418,523
31905381,52.3189,72.786,506,22893,0.927483,0.83,2,691988,691482,506
32156501,53,51,515,29815,0.55,1,1,696906,696391,515
32159421,34.6,41.4,506,29886,0.39,1,1,696936,696430,506
32162341,37.32,44.28,499,29957,0.23,1,1,696974,696475,499
32165261,35.464,44.056,490,30028,0.102,1,1,697009,696519,490
32168181,109.493,118.411,481,30098,0.0284,0.95,1,697137,696656,481
32171101,59.4986,64.4822,477,30168,0.04568,1,1,697184,696707,477
32174021,30.2997,34.4964,473,30238,0.017136,0.94,1,697207,696734,473
32176941,31.6599,38.8993,465,30308,0.0594272,0.76,1,697239,696774,465
32179861,33.532,40.5799,458,30378,0.0358854,0.63,1,697273,696815,458
32182781,32.3064,38.516,452,30448,0.00717709,0.55,1,697305,696853,452
32185701,43.2613,50.1032,445,30518,0.0734354,0.35,1,697351,696906,445
32188621,23.8523,34.0206,434,30587,0.0546871,0.19,1,697370,696936,434
32191541,31.9705,37.2041,430,30656,0.0669374,0.07,1,697404,696974,430
32194461,31.1941,35.4408,426,30725,0.0373875,0.01,1,697435,697009,426
32197381,106.239,109.488,423,30794,0.0074775,0.05,1,697560,697137,423
32200301,58.8478,59.4976,423,30863,0.0414955,0.01,1,697607,697184,423
32203221,29.3696,30.2995,422,30932,0.0962991,0.07,1,697629,697207,422
32206141,33.0739,31.6599,424,31000,0.0432598,0.03,1,697663,697239,424
32209061,32.2148,33.532,422,31068,0.032652,0,1,697695,697273,422
32211981,33.643,32.3064,424,31136,0.0145304,0.09,1,697729,697305,424
32214901,41.9286,43.2613,422,31204,0.0109061,0.05,1,697773,697351,422
32217821,25.1857,23.8523,424,31272,0.0421812,0.07,1,697794,697370,424
32220741,31.4371,31.9705,423,31340,0.0804363,0.07,1,697827,697404,423
32223661,30.2874,6.39409,453,31408,0.0720872,0.03,1,697857,697404,453
32226581,106.057,26.0788,547,31475,0.0384174,0,1,697982,697435,547
32229501,59.6115,105.216,470,31542,0.0316835,0.05,1,698030,697560,470
32232421,28.7223,58.6432,444,31609,0.0463367,0.11,1,698051,697607,444
32235341,32.9445,29.3286,456,31676,0.0492673,0.03,1,698085,697629,456
32238261,31.3889,33.0657,453,31743,0.0818535,0.03,1,698116,697663,453
32241181,33.4778,32.2131,455,31810,0.0243707,0.01,1,698150,697695,455
32244101,41.8956,33.6426,465,31877,0.0448741,0.01,1,698194,697729,465
32247021,27.5791,41.9285,445,31943,0.0489748,0.05,1,698218,697773,445
32249941,31.1158,25.1857,456,32009,0.097795,0.09,1,698250,697794,456
32252861,31.0232,31.4371,454,32075,0.107559,0.07,1,698281,697827,454
32255781,105.405,30.2874,548,32141,0.109512,0.03,1,698405,697857,548
32258701,58.6809,106.057,470,32207,0.0779024,0.03,1,698452,697982,470
32261621,29.3362,59.6115,444,32273,0.0715805,0.05,1,698474,698030,444
32264541,33.8672,28.7223,458,32339,0.0863161,0.05,1,698509,698051,458
32267461,30.7734,32.9445,454,32404,0.0572632,0.09,1,698539,698085,454
32270381,33.3547,31.3889,457,32469,0.0194526,0.01,1,698573,698116,457
32273301,41.8709,33.4778,467,32534,0.0278905,0.05,1,698617,698150,467
32276221,29.1742,41.8956,449,32599,0.0455781,0.05,1,698643,698194,449
32279141,33.0348,27.5791,459,32664,0.0971156,0.11,1,698677,698218,459
32282061,30.607,31.1158,457,32729,0.123423,0.11,1,698707,698250,457
32284981,7.72139,31.0232,428,32794,0.128685,0.11,1,698709,698281,428
32287901,98.3443,105.405,425,32858,0.193737,0.07,1,698830,698405,425
32290821,57.2689,58.6809,425,32922,0.190747,0.07,1,698877,698452,425
32293741,29.0538,29.3362,425,32986,0.222149,0.09,1,698899,698474,425
32296661,33.0108,33.8672,424,33050,0.26043,0.05,1,698933,698509,424
32299581,30.6022,30.7734,424,33114,0.236086,0.01,1,698963,698539,424
32302501,33.3204,33.3547,424,33178,0.231217,0.03,1,698997,698573,424
32305421,41.0641,41.8709,423,33242,0.246243,0.05,1,699040,698617,423
32308341,29.8128,29.1742,424,33306,0.249249,0.11,1,699067,698643,424
32311261,36.3626,33.0348,428,33370,0.29785,0.13,1,699105,698677,428
32314181,31.2725,30.607,428,33433,0.29157,0.13,1,699135,698707,428
32317101,7.8545,7.72139,428,33496,0.290314,0.21,1,699137,698709,428
32320021,101.571,98.3443,432,33559,0.354063,0.19,1,699262,698830,432
32322941,57.1142,57.2689,431,33622,0.366813,0.23,1,699308,698877,431
32325861,29.0228,29.0538,431,33685,0.417363,0.27,1,699330,698899,431
32328781,34.6046,33.0108,433,33748,0.363472,0.23,1,699366,698933,433
32331701,30.9209,30.6022,433,33811,0.400694,0.23,1,699396,698963,433
32334621,33.3842,33.3204,433,33874,0.376139,0.25,1,699430,698997,433
32337541,40.2768,41.0641,432,33936,0.403228,0.25,1,699472,699040,432
32340461,30.4554,29.8128,433,33998,0.376646,0.31,1,699500,699067,433
32343381,38.0911,36.3626,435,34060,0.419329,0.29,1,699540,699105,435
32346301,33.2182,31.2725,437,34122,0.395866,0.29,1,699572,699135,437
32349221,8.24364,7.8545,437,34184,0.391173,0.37,1,699574,699137,437
32352141,102.449,101.571,438,34246,0.470235,0.37,1,699700,699262,438
32355061,58.8897,20.3142,486,34308,0.454047,0.37,1,699748,699262,486
32357981,29.3779,40.8628,462,34370,0.450809,0.43,1,699770,699308,462
32360901,33.0756,25.7726,474,34432,0.450162,0.35,1,699804,699330,474
32363821,31.4151,33.9545,469,34493,0.466032,0.41,1,699835,699366,469
32366741,33.483,30.7909,473,34554,0.485206,0.37,1,699869,699396,473
32369661,40.2966,33.3582,481,34615,0.505041,0.41,1,699911,699430,481
32372581,28.8593,40.2716,465,34676,0.509008,0.37,1,699937,699472,465
32375501,40.1719,30.4543,480,34737,0.509802,0.43,1,699980,699500,480
32378421,32.0344,38.0909,470,34798,0.52596,0.39,1,700010,699540,470
32381341,8.00687,33.2182,440,34859,0.529192,0.39,1,700012,699572,440
32384261,106.401,8.24363,569,34920,0.673838,0.49,1,700143,699574,569
32387181,59.6803,102.449,491,34981,0.702768,0.45,1,700191,699700,491
32390101,29.5361,58.8897,465,35041,0.724554,0.45,1,700213,699748,465
32393021,33.1072,29.3779,477,35101,0.728911,0.45,1,700247,699770,477
32395941,32.2214,33.0756,475,35161,0.745782,0.47,1,700279,699804,475
32398861,34.4443,31.4151,479,35221,0.765157,0.49,2,700314,699835,479
32401781,41.2889,33.483,488,35281,0.817031,0.51,2,700357,699869,488
32404701,29.0578,40.2966,472,35341,0.827406,0.51,2,700383,699911,472
32407621,40.2116,28.8593,489,35401,0.813481,0.51,2,700426,699937,489
32410541,33.6423,40.1719,478,35461,0.778696,0.53,2,700458,699980,478
32413461,8.32846,32.0344,450,35521,0.803739,0.53,2,700460,700010,450
32416381,112.866,8.00687,587,35581,0.888748,0.71,2,700599,700012,587
32419301,60.9731,106.401,504,35640,0.90575,0.71,2,700647,700143,504
32422221,13.7946,59.6803,458,35699,0.90915,0.73,2,700649,700191,458
32582821,25,28,505,38822,0.84,1,2,702768,702263,505
32585741,33.8,35.2,504,38876,0.816,1,2,702804,702300,504
32588661,29.16,32.64,500,38930,0.7952,1,2,702832,702332,500
32591581,29.032,33.728,495,38984,0.79104,1,2,702861,702366,495
32594501,81.0064,92.3456,482,39038,0.774208,1,2,702955,702473,482
32597421,73.8013,75.2691,483,39092,0.690842,1,1,703027,702544,483
32600341,41.1603,43.0538,481,39146,0.674168,0.98,1,703060,702579,481
32603261,29.0321,31.8108,478,39200,0.654834,1,1,703086,702608,478
32606181,25.8064,27.1622,477,39254,0.634967,1,1,703111,702634,477
32609101,32.3613,27.8324,483,39308,0.646993,1,1,703145,702662,483
32612021,32.0723,34.3665,479,39362,0.585399,0.83,1,703177,702698,479
32614941,24.0145,32.4733,469,39416,0.54108,0.92,1,703199,702730,469
32617861,14.4029,16.8947,468,39470,0.580216,0.84,1,703211,702743,468
32620781,22.8806,23.3789,468,39524,0.572043,0.81,1,703236,702768,468
32623701,29.3761,33.4758,463,39577,0.586409,0.79,1,703267,702804,463
32626621,26.6752,29.0952,461,39630,0.589282,0.79,1,703293,702832,461
32629541,30.135,29.019,463,39683,0.605856,0.77,1,703324,702861,463
32632461,78.027,81.0038,459,39736,0.625171,0.67,1,703414,702955,459
32635381,69.2054,73.8008,454,39789,0.645034,0.67,1,703481,703027,454
32638301,37.8411,41.1602,451,39842,0.649007,0.65,1,703511,703060,451
32641221,28.3682,29.032,451,39895,0.633801,0.63,1,703537,703086,451
32644141,24.0736,25.8064,449,39948,0.64676,0.65,1,703560,703111,449
32647061,32.8147,32.3613,450,40001,0.681352,0.57,1,703595,703145,450
32649981,30.5629,32.0723,448,40054,0.70427,0.53,1,703625,703177,448
32652901,25.3126,24.0145,450,40107,0.708854,0.53,1,703649,703199,450
32655821,13.0625,4.80289,460,40160,0.741771,0.59,1,703659,703199,460
32658741,23.4125,10.5606,474,40213,0.748354,0.57,1,703685,703211,474
32661661,30.2825,22.1121,481,40266,0.765671,0.59,2,703717,703236,481
32664581,26.8565,29.2224,476,40318,0.769134,0.59,2,703743,703267,476
32667501,30.9713,26.6445,482,40370,0.737827,0.61,1,703775,703293,482
32670421,78.9943,30.1289,542,40422,0.779565,0.63,2,703866,703324,542
32673341,70.1989,78.0258,520,40474,0.787913,0.65,2,703934,703414,520
32676261,37.2398,69.2052,482,40526,0.773583,0.65,2,703963,703481,482
32679181,28.248,37.841,478,40578,0.786717,0.63,2,703989,703511,478
32682101,24.8496,28.3682,476,40630,0.837343,0.65,2,704013,703537,476
32685021,34.5699,24.0736,490,40682,0.863469,0.69,2,704050,703560,490
32687941,31.714,32.8147,486,40734,0.916694,0.71,2,704081,703595,486
32690861,27.1428,30.5629,482,40786,0.927339,0.71,2,704107,703625,482
32693781,13.4286,25.3126,468,40838,0.929468,0.75,2,704117,703649,468
32854381,28,27,516,43590,0.85,1,2,706049,705533,516
32857301,21.6,23,514,43638,0.834,1,2,706069,705555,514
32860221,17.92,19,513,43686,0.8308,1,2,706086,705573,513
32863141,18.784,26.2,504,43734,0.79816,1,2,706105,705601,504
32866061,31.7568,29.24,509,43782,0.775632,1,2,706140,705631,509
32868981,27.1514,28.248,507,43830,0.755126,1,2,706166,705659,507
32871901,58.2303,26.4496,547,43878,0.687025,1,1,706232,705685,547
32874821,69.2461,62.8899,547,43926,0.609405,1,1,706304,705757,547
32877741,43.4492,69.378,513,43974,0.657881,0.98,1,706341,705828,513
32880661,32.6898,44.2756,505,44022,0.635576,1,1,706371,705866,505
32883581,28.138,36.0551,498,44070,0.647115,1,1,706398,705900,498
32886501,27.2276,28.811,498,44118,0.633423,0.92,1,706425,705927,498
32889421,29.4455,31.3622,496,44166,0.662685,0.91,1,706455,705959,496
32892341,28.2891,29.4724,495,44214,0.604537,0.81,1,706483,705988,495
32895261,28.0578,32.2945,490,44262,0.656907,0.85,1,706511,706021,490
32898181,22.4116,28.8589,483,44310,0.635381,0.83,1,706532,706049,483
32901101,13.2823,21.7718,474,44358,0.695076,0.83,1,706543,706069,474
32904021,17.0565,17.9544,475,44406,0.675015,0.79,1,706561,706086,475
32906941,28.2113,18.7909,487,44454,0.655003,0.77,1,706592,706105,487
32909861,7.24226,31.7582,454,44501,0.683001,0.75,1,706594,706140,454
32912781,23.8485,27.1516,456,44548,0.6886,0.67,1,706622,706166,456
32915701,54.3697,58.2303,452,44595,0.70572,0.59,1,706684,706232,452
32918621,68.4739,69.2461,452,44642,0.725144,0.67,1,706756,706304,452
32921541,44.0948,43.4492,453,44689,0.777029,0.63,2,706794,706341,453
32924461,34.419,32.6898,455,44736,0.819406,0.65,2,706826,706371,455
32927381,27.6838,28.138,454,44783,0.827881,0.63,2,706852,706398,454
32930301,27.9368,27.2276,455,44830,0.829576,0.67,2,706880,706425,455
32933221,27.9874,29.4455,453,44877,0.829915,0.59,2,706908,706455,453
32936141,29.5975,28.2891,455,44924,0.845983,0.67,2,706938,706483,455
32939061,26.7195,28.0578,453,44971,0.849197,0.63,2,706964,706511,453
32941981,24.5439,22.4116,456,45018,0.817839,0.71,2,706988,706532,456
32944901,12.9088,13.2823,455,45065,0.811568,0.67,2,706998,706543,455
32947821,18.5818,17.0565,457,45112,0.826314,0.65,2,707018,706561,457
32950741,26.1164,28.2113,454,45159,0.877263,0.69,2,707046,706592,454
32953661,6.82327,7.24226,454,45206,0.855453,0.69,2,707048,706594,454
32956581,25.3647,23.8485,456,45253,0.86709,0.71,2,707078,706622,456
32959501,53.8729,54.3697,455,45300,0.901418,0.73,2,707139,706684,455
33182881,117,98,520,22093,0.59,1,1,709685,709165,520
33185801,80.2,91.6,501,22189,0.606,0.95,1,709756,709255,501
33188721,83.24,87.92,498,22285,0.5612,0.85,1,709840,709342,498
33191641,50.248,62.384,484,22380,0.60024,0.75,1,709882,709398,484
33194561,59.6496,72.4768,471,22475,0.640048,0.75,1,709944,709473,471
33197481,27.1299,37.6954,461,22569,0.66401,0.69,1,709963,709502,461
33200401,50.226,15.5391,507,22663,0.668802,0.65,1,710019,709512,507
33203321,106.045,47.9078,571,22757,0.71776,0.59,1,710139,709568,571
33206241,75.609,103.182,522,22850,0.727552,0.61,1,710207,709685,522
33209161,80.7218,77.4363,533,22943,0.77751,0.55,2,710289,709756,533
33212081,51.3444,82.6873,493,23035,0.851502,0.61,2,710333,709840,493
33215001,61.4689,50.1375,515,23127,0.8823,0.65,2,710397,709882,515
33217921,28.2938,59.6275,473,23219,0.88846,0.67,2,710417,709944,473
33220841,50.4588,27.1255,510,23310,0.905692,0.67,2,710473,709963,510
33223761,108.492,50.2251,577,23401,0.909138,0.73,2,710596,710019,577
33226681,76.8983,106.045,526,23492,0.941828,0.73,2,710665,710139,526
33229601,82.5797,75.609,542,23582,0.964366,0.79,2,710749,710207,542
33328881,72,38,538,26468,0.35,1,1,712759,712221,538
33331801,62.4,72.4,517,26548,0.35,1,1,712819,712302,517
33334721,42.08,44.08,517,26628,0.222,1,1,712856,712339,517
33337641,35.616,32.016,522,26708,0.1484,1,1,712890,712368,522
33340561,79.9232,32.8032,580,26787,0.05368,1,1,712981,712401,580
33343481,45.5846,87.3606,516,26866,0.098736,1,1,713018,712502,516
33346401,26.7169,55.0721,491,26945,0.0277472,0.75,1,713040,712549,491
33349321,62.1434,92.6144,460,27024,0.0295494,0.73,1,713111,712651,460
33352241,36.4287,47.3229,454,27102,0.0139099,0.35,1,713141,712687,454
33355161,52.0857,67.0646,438,27180,0.042782,0.35,1,713197,712759,438
33358081,54.4171,61.4129,433,27258,0.0645564,0.19,1,713252,712819,433
33361001,40.4834,41.8826,433,27336,0.0689113,0.13,1,713289,712856,433
33363921,32.0967,35.5765,429,27413,0.0537823,0.03,1,713319,712890,429
33366841,74.4193,79.9153,423,27490,0.0347565,0.11,1,713404,712981,423
33369761,48.4839,45.5831,428,27567,0.0629513,0.01,1,713446,713018,428
33372681,25.6968,26.7166,426,27644,0.0365903,0.03,1,713466,713040,426
33375601,58.7394,62.1433,422,27721,0.0633181,0.01,1,713533,713111,422
33378521,38.1479,36.4287,425,27797,0.0366636,0.05,1,713566,713141,425
33381441,50.0296,52.0857,422,27873,0.0473327,0.07,1,713619,713197,422
33384361,57.2059,54.4171,426,27949,0.0494665,0.07,1,713678,713252,426
33387281,39.4412,40.4834,424,28025,0.0338933,0.05,1,713713,713289,424
33390201,32.6882,32.0967,425,28101,0.0787787,0.03,1,713744,713319,425
33393121,72.1376,74.4193,422,28176,0.0717557,0.07,1,713826,713404,422
33396041,50.4275,48.4839,425,28251,0.0703511,0.03,1,713871,713446,425
33398961,24.4855,25.6968,423,28326,0.13407,0.07,1,713889,713466,423
33401881,58.4971,58.7394,423,28401,0.146814,0.07,1,713956,713533,423
33404801,37.2994,11.7479,455,28476,0.149363,0.03,1,713988,713533,455
33407721,49.8599,28.7496,475,28550,0.181873,0.05,1,714041,713566,475
33410641,56.372,48.1499,480,28624,0.204375,0.05,1,714099,713619,480
33413561,39.2744,56.83,456,28698,0.208875,0.03,1,714134,713678,456
33416481,34.2549,39.366,454,28772,0.193775,0.09,1,714167,713713,454
33419401,71.651,32.6732,504,28846,0.238755,0.07,1,714248,713744,504
33422321,52.7302,72.1346,470,28919,0.247751,0.07,1,714296,713826,470
33425241,26.546,50.4269,445,28992,0.26555,0.15,1,714316,713871,445
33428161,59.7092,24.4854,495,29065,0.26911,0.15,1,714384,713889,495
33431081,37.5418,58.4971,460,29138,0.285822,0.15,1,714416,713956,460
33434001,51.5084,37.2994,483,29211,0.305164,0.19,1,714471,713988,483
33436921,57.5017,49.8599,489,29283,0.341033,0.21,1,714530,714041,489
33439841,39.5003,56.372,466,29355,0.332207,0.21,1,714565,714099,466
33442761,34.3001,39.2744,464,29427,0.314441,0.19,1,714598,714134,464
33445681,73.26,34.2549,514,29499,0.342888,0.25,1,714681,714167,514
33448601,51.452,71.651,479,29571,0.348578,0.25,1,714727,714248,479
33451521,28.6904,52.7302,454,29643,0.365716,0.27,1,714750,714296,454
33454441,60.9381,26.546,503,29714,0.465143,0.27,1,714819,714316,503
33457361,37.7876,59.7092,467,29785,0.469029,0.29,1,714851,714384,467
33460281,9.15752,37.5418,437,29856,0.469806,0.31,1,714853,714416,437
33463201,45.8315,51.5084,437,29927,0.453961,0.35,1,714908,714471,437
33466121,57.9663,57.5017,439,29998,0.498792,0.33,1,714969,714530,439
33469041,38.7933,39.5003,438,30069,0.523758,0.31,1,715003,714565,438
33471961,34.9587,34.3001,439,30139,0.528752,0.35,1,715037,714598,439
33474881,73.3917,73.26,439,30209,0.59375,0.35,1,715120,714681,439
33477801,51.4783,51.452,439,30279,0.57475,0.37,1,715166,714727,439
33480721,30.2957,28.6904,441,30349,0.58695,0.49,1,715191,714750,441
33483641,63.6591,60.9381,444,30419,0.63739,0.47,1,715263,714819,444
33486561,39.1318,37.7876,445,30489,0.631478,0.47,1,715296,714851,445
33489481,9.42636,9.15752,445,30558,0.662296,0.45,1,715298,714853,445
33492401,45.0853,45.8315,444,30627,0.668459,0.51,1,715352,714908,444
33495321,58.6171,57.9663,445,30696,0.749692,0.53,1,715414,714969,445
33498241,39.7234,38.7933,446,30765,0.749938,0.53,1,715449,715003,446
33501161,35.1447,34.9587,446,30834,0.765988,0.61,2,715483,715037,446
33504081,76.6289,73.3917,450,30903,0.737198,0.57,1,715570,715120,450
33507001,52.1258,51.4783,450,30971,0.73144,0.59,1,715616,715166,450
33509921,29.6252,30.2957,449,31039,0.762288,0.65,2,715640,715191,449
33512841,67.525,63.6591,454,31107,0.768458,0.63,2,715717,715263,454
33515761,39.105,39.1318,453,31175,0.833691,0.67,2,715749,715296,453
33518681,9.421,9.42636,453,31243,0.846738,0.67,2,715751,715298,453
33521601,45.0842,45.0853,453,31311,0.897348,0.67,2,715805,715352,453
33524521,61.8168,9.01705,519,31379,0.92347,0.77,2,715871,715352,519
33655921,32,0,524,34280,0.69,1,1,717884,717360,524
33658841,56,24.8,555,34342,0.562,0.99,1,717946,717391,555
33661761,38.4,63.36,516,34404,0.4404,1,1,717980,717464,516
33664681,33.28,47.072,505,34465,0.40008,1,1,718012,717507,505
33667601,59.456,32.6144,542,34526,0.232016,1,1,718078,717536,542
33670521,47.8912,68.9229,509,34587,0.118403,1,1,718123,717614,509
33673441,38.3782,41.7846,510,34648,0.0956806,0.97,1,718159,717649,510
33676361,30.0756,33.9569,506,34709,0.0591361,0.95,1,718187,717681,506
33679281,52.4151,32.3914,532,34770,0.0518272,1,1,718245,717713,532
33682201,40.083,56.8783,506,34831,0.0183654,0.85,1,718282,717776,506
33685121,29.6166,44.9757,491,34892,0.0436731,0.75,1,718309,717818,491
33688041,26.7233,36.1951,483,34953,0.0967346,0.69,1,718335,717852,483
33690961,47.7447,32.839,504,35013,0.0593469,0.53,1,718388,717884,504
33693881,34.3489,56.1678,473,35073,0.0998694,0.41,1,718419,717946,473
33696801,30.0698,38.4336,468,35133,0.0919739,0.39,1,718448,717980,468
33699721,52.414,33.2867,494,35193,0.154395,0.19,1,718506,718012,494
33702641,43.2828,59.4573,469,35253,0.198879,0.09,1,718547,718078,469
33705561,36.6566,47.8915,459,35313,0.207776,0.09,1,718582,718123,459
33708481,29.7313,38.3783,451,35373,0.177555,0.05,1,718610,718159,451
33711401,53.1463,30.0757,482,35433,0.155511,0.05,1,718669,718187,482
33714321,39.4293,52.4151,460,35493,0.151102,0.01,1,718705,718245,460
33717241,31.0859,40.083,452,35553,0.16622,0.05,1,718734,718282,452
33720161,27.0172,29.6166,451,35612,0.169244,0.11,1,718760,718309,451
33723081,48.6034,26.7233,479,35671,0.185849,0.05,1,718814,718335,479
33726001,11.3207,47.7447,428,35730,0.18917,0.11,1,718816,718388,428
33728921,27.8641,34.3489,429,35789,0.237834,0.09,1,718848,718419,429
33731841,27.9728,30.0698,428,35848,0.215567,0.17,1,718876,718448,428
33734761,53.5946,52.414,430,35907,0.227113,0.21,1,718936,718506,430
33737681,45.1189,43.2828,432,35966,0.261423,0.21,1,718979,718547,432
33740601,35.4238,36.6566,430,36025,0.284285,0.17,1,719012,718582,430
33743521,29.4848,29.7313,430,36084,0.288857,0.15,1,719040,718610,430
33746441,50.6969,53.1463,427,36143,0.305771,0.15,1,719096,718669,427
33749361,40.5394,39.4293,429,36201,0.309154,0.17,1,719134,718705,429
33752281,32.1079,31.0859,430,36259,0.341831,0.17,1,719164,718734,430
33755201,28.8216,27.0172,432,36317,0.316366,0.19,1,719192,718760,432
33758121,48.1643,48.6034,431,36375,0.343273,0.19,1,719245,718814,431
33761041,11.2329,11.3207,431,36433,0.380655,0.25,1,719247,718816,431
33763961,28.6466,27.8641,432,36491,0.404131,0.21,1,719280,718848,432
33766881,28.1293,27.9728,432,36549,0.440826,0.23,1,719308,718876,432
33769801,52.8259,53.5946,431,36607,0.400165,0.27,1,719367,718936,431
33772721,46.5652,45.1189,433,36665,0.472033,0.29,1,719412,718979,433
33775641,36.513,35.4238,434,36723,0.454407,0.29,1,719446,719012,434
33778561,29.7026,29.4848,434,36781,0.498881,0.31,1,719474,719040,434
33781481,51.5405,50.6969,435,36838,0.507776,0.31,1,719531,719096,435
33784401,40.7081,40.5394,435,36895,0.541555,0.35,1,719569,719134,435
33787321,33.7416,32.1079,437,36952,0.548311,0.31,1,719601,719164,437
33790241,29.1483,28.8216,437,37009,0.581662,0.35,1,719629,719192,437
33793161,49.8297,48.1643,439,37066,0.572332,0.39,1,719684,719245,439
33796081,11.5659,11.2329,439,37123,0.618466,0.41,1,719686,719247,439
33799001,29.5132,28.6466,440,37180,0.659693,0.41,1,719720,719280,440
33801921,29.1026,5.72931,469,37237,0.683939,0.45,1,719749,719280,469
33804841,52.2205,23.5459,499,37294,0.704788,0.39,1,719807,719308,499
33807761,48.8441,51.9092,488,37351,0.756958,0.49,2,719855,719367,488
33810681,37.7688,46.3818,478,37408,0.767392,0.45,2,719890,719412,478
33813601,29.9538,36.4764,472,37464,0.769478,0.51,2,719918,719446,472
33816521,53.1908,29.6953,503,37520,0.753896,0.51,2,719977,719474,503
33819441,41.0381,51.5391,484,37576,0.766779,0.55,2,720015,719531,484
33822361,36.2076,40.7078,481,37632,0.753356,0.55,2,720050,719569,481
33825281,30.4415,33.7416,478,37688,0.734671,0.59,1,720079,719601,478
33828201,51.6883,29.1483,507,37744,0.746934,0.57,1,720136,719629,507
33831121,11.9377,49.8297,454,37800,0.749387,0.63,1,720138,719684,454
33834041,31.1875,11.5659,488,37856,0.797877,0.67,2,720174,719686,488
33836961,31.0375,29.5132,485,37912,0.839576,0.69,2,720205,719720,485
33839881,52.6075,29.1026,514,37968,0.895915,0.71,2,720263,719749,514
33842801,51.3215,52.2205,507,38024,0.923183,0.77,2,720314,719807,507
33845721,38.2643,48.8441,494,38080,0.928637,0.77,2,720349,719855,494
34020921,32,31,514,41274,0.73,0.96,1,722549,722035,514
34023841,32.8,31.8,515,41325,0.666,1,1,722582,722067,515
34026761,30.56,31.16,514,41376,0.6052,1,1,722612,722098,514
34029681,32.512,27.832,520,41427,0.57704,1,1,722645,722125,520
34032601,40.1024,35.1664,525,41478,0.523408,1,1,722687,722162,525
34035521,37.6205,51.8333,506,41529,0.512682,1,1,722724,722218,506
34038441,26.7241,37.5667,496,41580,0.574536,1,1,722748,722252,496
34041361,31.7448,37.1133,492,41631,0.506907,1,1,722781,722289,492
34044281,32.749,40.2227,484,41682,0.429381,1,1,722814,722330,484
34047201,34.5498,34.4445,486,41733,0.397876,0.94,1,722849,722363,486
34050121,28.51,37.2889,475,41784,0.407575,0.93,1,722876,722401,475
34053041,27.302,34.6578,468,41835,0.361515,0.91,1,722903,722435,468
34055961,31.0604,33.3316,467,41885,0.416303,0.81,1,722935,722468,467
34058881,39.0121,45.8663,459,41935,0.379261,0.73,1,722976,722517,459
34061801,32.6024,34.7733,458,41985,0.387852,0.65,1,723007,722549,458
34064721,32.1205,33.3547,457,42035,0.38957,0.59,1,723039,722582,457
34067641,28.0241,30.6709,454,42085,0.405914,0.57,1,723066,722612,454
34070561,28.8048,32.5342,450,42135,0.457183,0.51,1,723095,722645,450
34073481,40.161,40.1068,451,42185,0.467437,0.51,1,723138,722687,451
34076401,32.0322,37.6214,444,42235,0.469487,0.59,1,723168,722724,444
34079321,26.4064,26.7243,445,42285,0.453897,0.49,1,723193,722748,445
34082241,30.8813,31.7449,444,42335,0.48278,0.41,1,723225,722781,444
34085161,28.5763,32.749,439,42385,0.536556,0.39,1,723253,722814,439
34088081,35.3153,34.5498,441,42435,0.547311,0.41,1,723290,722849,441
34091001,27.8631,28.51,440,42485,0.565462,0.35,1,723316,722876,440
34093921,26.3726,27.302,439,42535,0.553092,0.43,1,723342,722903,439
34096841,32.4745,31.0604,441,42585,0.566619,0.37,1,723376,722935,441
34099761,38.4949,39.0121,440,42635,0.601324,0.39,1,723416,722976,440
34102681,31.699,32.6024,439,42684,0.624265,0.39,1,723446,723007,439
34105601,31.9398,32.1205,439,42733,0.596853,0.41,1,723478,723039,439
34108521,28.788,28.0241,440,42782,0.623371,0.47,1,723506,723066,440
34111441,31.3576,28.8048,443,42831,0.628674,0.47,1,723538,723095,443
34114361,42.2715,40.161,445,42880,0.677735,0.47,1,723583,723138,445
34117281,30.8543,32.0322,443,42929,0.687547,0.45,1,723611,723168,443
34120201,28.5709,26.4064,446,42978,0.737509,0.49,1,723639,723193,446
34123121,29.7142,30.8813,444,43027,0.715502,0.49,1,723669,723225,444
34126041,28.3428,6.17626,472,43076,0.7271,0.55,1,723697,723225,472
34128961,36.8686,23.6353,483,43125,0.79342,0.55,2,723736,723253,483
34131881,28.9737,34.3271,473,43174,0.854684,0.57,2,723763,723290,473
34134801,28.1947,27.6654,475,43223,0.834937,0.55,2,723791,723316,475
34137721,32.8389,26.3331,483,43272,0.830987,0.57,2,723825,723342,483
34140641,38.5678,32.4666,489,43321,0.830197,0.61,2,723865,723376,489
34143561,32.5136,38.4933,480,43370,0.84604,0.63,2,723896,723416,480
34146481,32.1027,31.6987,482,43419,0.849208,0.59,2,723928,723446,482
34149401,28.8205,31.9397,478,43468,0.849842,0.63,2,723956,723478,478
34152321,31.3641,28.7879,482,43517,0.849968,0.63,2,723988,723506,482
34155241,44.6728,31.3576,498,43565,0.833994,0.69,2,724036,723538,498
34158161,32.9346,42.2715,483,43613,0.846799,0.69,2,724066,723583,483
34161081,29.7869,30.8543,484,43661,0.88136,0.75,2,724095,723611,484
34164001,30.7574,28.5709,487,43709,0.872272,0.71,2,724126,723639,487
34166921,30.1515,29.7142,487,43757,0.870454,0.73,2,724156,723669,487
34169841,39.6303,28.3428,501,43805,0.918091,0.81,2,724198,723697,501
34172761,31.1261,36.8686,491,43853,0.943618,0.87,2,724227,723736,491
34410741,75,81,488,22093,0.05,0.51,1,726931,726443,488
34413661,59.8,67.4,480,22189,0.034,0.33,1,726987,726507,480
34416581,56.76,75.08,459,22285,0.0308,0.25,1,727043,726584,459
34419501,60.152,58.216,466,22380,0.04616,0.03,1,727104,726638,466
34422421,46.4304,67.6432,439,22475,0.017232,0.01,1,727147,726708,439
34425341,32.4861,36.7286,439,22569,0.0434464,0.03,1,727176,726737,439
34428261,88.0972,32.1457,510,22663,0.00868928,0.05,1,727278,726768,510
34431181,77.6194,76.8291,497,22757,0.0897379,0.05,1,727353,726856,497
34434101,60.3239,75.3658,478,22850,0.121948,0.03,1,727409,726931,478
34437021,56.8648,59.8732,478,22943,0.0643895,0.03,1,727465,726987,478
34439941,59.373,56.7746,482,23035,0.116878,0.05,1,727525,727043,482
34442861,46.2746,60.1549,464,23127,0.143376,0.01,1,727568,727104,464
34445781,34.0549,46.431,452,23219,0.0686751,0.05,1,727599,727147,452
34448701,87.611,32.4862,524,23310,0.021735,0,1,727700,727176,524
34451621,82.3222,88.0972,503,23401,0.092347,0.11,1,727781,727278,503
34454541,60.4644,77.6194,483,23492,0.122469,0.13,1,727836,727353,483
34457461,53.6929,60.3239,479,23582,0.160494,0.05,1,727888,727409,479
34460381,61.9386,56.8648,487,23672,0.136099,0.13,1,727952,727465,487
34463301,45.9877,59.373,469,23762,0.19522,0.15,1,727994,727525,469
34466221,31.5975,46.2746,454,23851,0.207044,0.05,1,728022,727568,454
34469141,86.3195,34.0549,523,23940,0.161409,0.01,1,728122,727599,523
34472061,18.8639,87.611,424,24029,0.120282,0.11,1,728124,727700,424
34474981,72.5728,82.3222,429,24117,0.128056,0.13,1,728210,727781,429
34477901,57.7146,60.4644,428,24205,0.145611,0.17,1,728264,727836,428
34480821,54.7429,53.6929,430,24293,0.213122,0.13,1,728318,727888,430
34483741,61.3486,61.9386,429,24380,0.258624,0.21,1,728381,727952,429
34486661,48.2697,45.9877,432,24467,0.235725,0.21,1,728426,727994,432
34489581,32.0539,31.5975,432,24554,0.279145,0.15,1,728454,728022,432
34492501,82.4108,86.3195,427,24640,0.303829,0.11,1,728549,728122,427
34495421,18.0822,18.8639,427,24726,0.308766,0.13,1,728551,728124,427
34498341,74.0164,72.5728,429,24812,0.293753,0.15,1,728639,728210,429
34501261,58.8033,57.7146,430,24897,0.306751,0.23,1,728694,728264,430
34504181,57.3607,54.7429,433,24982,0.30935,0.27,1,728751,728318,433
34507101,61.8721,61.3486,433,25067,0.34187,0.23,1,728814,728381,433
34510021,48.3744,48.2697,433,25152,0.332374,0.29,1,728859,728426,433
34512941,32.8749,32.0539,434,25236,0.346475,0.31,1,728888,728454,434
34515861,83.375,82.4108,435,25320,0.349295,0.31,1,728984,728549,435
34518781,18.275,18.0822,435,25404,0.381859,0.29,1,728986,728551,435
34521701,73.255,74.0164,434,25487,0.404372,0.29,1,729073,728639,434
34524621,58.651,14.8033,489,25570,0.408874,0.31,1,729128,728639,489
34527541,57.3302,46.9607,491,25653,0.441775,0.31,1,729185,728694,491
34530461,63.466,54.9921,499,25736,0.496355,0.35,1,729250,728751,499
34533381,49.4932,61.3984,482,25818,0.539271,0.33,1,729296,728814,482
34536301,33.0986,48.2797,466,25900,0.547854,0.35,1,729325,728859,466
34539221,84.2197,32.8559,534,25982,0.661571,0.35,1,729422,728888,534
34542141,18.4439,83.3712,440,26064,0.684314,0.39,1,729424,728984,440
34545061,74.0888,18.2742,526,26145,0.720863,0.41,1,729512,728986,526
34547981,60.4178,73.2548,496,26226,0.760173,0.41,2,729569,729073,496
34550901,59.2836,58.651,500,26307,0.832035,0.45,2,729628,729128,500
34553821,66.2567,57.3302,511,26388,0.862407,0.51,2,729696,729185,511
34556741,51.6513,63.466,494,26468,0.868481,0.55,2,729744,729250,494
34559661,35.1303,49.4932,479,26548,0.853696,0.55,2,729775,729296,479
34562581,89.4261,33.0986,553,26628,0.914739,0.69,2,729878,729325,553
34565501,19.4852,84.2197,458,26708,0.894948,0.69,2,729880,729422,458
34693981,40,38,483,29998,0.79,1,2,732168,731685,483
34696901,72.8,73.2,482,30069,0.566,1,1,732249,731767,482
34699821,44.96,41.84,486,30139,0.4572,1,1,732287,731801,486
34702741,68.992,65.168,490,30209,0.14744,1,1,732362,731872,490
34705661,51.3984,51.4336,489,30279,0.029488,1,1,732409,731920,489
34708581,41.4797,51.0867,477,30349,0.0458976,1,1,732448,731971,477
34711501,33.0959,35.0173,477,30419,0.0331795,0.96,1,732479,732002,477
34714421,49.0192,51.0035,475,30489,0.0306359,0.91,1,732532,732057,475
34717341,29.8038,35.0007,469,30558,0.0461272,0.85,1,732557,732088,469
34720261,35.5608,39.0001,466,30627,0.0652254,0.79,1,732594,732128,466
34723181,35.1122,39.8,461,30696,0.0370451,0.51,1,732629,732168,461
34726101,59.8224,72.76,446,30765,0.031409,0.43,1,732695,732249,446
34729021,35.9645,44.952,438,30834,0.0302818,0.07,1,732725,732287,438
34731941,57.5929,68.9904,426,30903,0.0780564,0,1,732788,732362,426
34734861,46.7186,51.3981,423,30971,0.0236113,0.05,1,732832,732409,423
34737781,40.5437,41.4796,423,31039,0.0287223,0.03,1,732871,732448,423
34740701,32.1087,33.0959,422,31107,0.0457445,0.03,1,732901,732479,422
34743621,48.8217,49.0192,422,31175,0.0491489,0.05,1,732954,732532,422
34746541,30.5644,29.8038,423,31243,0.0338298,0.07,1,732980,732557,423
34749461,34.9129,35.5608,422,31311,0.046766,0.07,1,733016,732594,422
34752381,34.9826,7.11215,457,31379,0.0813532,0.03,1,733051,732594,457
34755301,58.9965,29.4224,487,31446,0.136271,0.03,1,733116,732629,487
34758221,35.7993,58.6845,451,31513,0.0832541,0.03,1,733146,732695,451
34761141,59.1599,35.7369,486,31580,0.152651,0.09,1,733211,732725,486
34764061,46.232,57.5474,466,31647,0.21453,0.01,1,733254,732788,466
34766981,39.6464,46.7095,460,31714,0.210906,0.03,1,733292,732832,460
34769901,31.9293,40.5419,451,31781,0.162181,0.05,1,733322,732871,451
34772821,48.7859,32.1084,474,31848,0.104436,0.05,1,733375,732901,474
34775741,30.5572,48.8217,447,31914,0.0288872,0.03,1,733401,732954,447
34778661,36.5114,30.5643,459,31980,0.0457775,0.05,1,733439,732980,459
34781581,36.9023,34.9129,460,32046,0.0491555,0.09,1,733476,733016,460
34784501,61.7805,34.9826,493,32112,0.0658311,0.15,1,733544,733051,493
34787421,33.1561,58.9965,454,32178,0.0851662,0.07,1,733570,733116,454
34790341,62.6312,35.7993,494,32244,0.0890333,0.17,1,733640,733146,494
34793261,49.3262,59.1599,475,32310,0.0898067,0.23,1,733686,733211,475
34796181,40.2652,46.232,470,32375,0.0739613,0.21,1,733724,733254,470
34799101,28.053,39.6464,457,32440,0.0867923,0.15,1,733749,733292,457
34802021,43.2106,31.9293,474,32505,0.0733584,0.09,1,733796,733322,474
34804941,29.4421,48.7859,447,32570,0.0226717,0.01,1,733822,733375,447
34807861,37.8884,30.5572,461,32635,0.0445343,0.05,1,733862,733401,461
34810781,37.1777,36.5114,460,32700,0.0329069,0.05,1,733899,733439,460
34813701,62.6355,36.9023,492,32765,0.0465814,0.07,1,733968,733476,492
34816621,14.1271,61.7805,426,32830,0.0493163,0.09,1,733970,733544,426
34819541,23.6254,33.1561,426,32894,0.0978633,0.09,1,733996,733570,426
34822461,60.7251,62.6312,426,32958,0.123573,0.09,1,734066,733640,426
34825381,49.745,49.3262,427,33022,0.144715,0.07,1,734113,733686,427
34828301,38.749,40.2652,425,33086,0.148943,0.09,1,734149,733724,425
34831221,28.5498,28.053,426,33150,0.181789,0.07,1,734175,733749,426
34834141,42.51,43.2106,425,33214,0.252358,0.01,1,734221,733796,425
34837061,27.702,29.4421,423,33278,0.234472,0.05,1,734245,733822,423
34839981,38.3404,37.8884,424,33342,0.230894,0.03,1,734286,733862,424
34842901,36.4681,37.1777,423,33405,0.214179,0.05,1,734322,733899,423
34845821,64.0936,62.6355,425,33468,0.258836,0.05,1,734393,733968,425
34848741,14.4187,14.1271,425,33531,0.267767,0.11,1,734395,733970,425
34851661,23.6837,23.6254,425,33594,0.269553,0.13,1,734421,733996,425
34854581,61.5367,60.7251,426,33657,0.285911,0.15,1,734492,734066,426
34857501,50.7074,49.745,427,33720,0.337182,0.15,1,734540,734113,427
34860421,40.5415,38.749,429,33783,0.379436,0.19,1,734578,734149,429
34863341,29.7083,28.5498,430,33846,0.371887,0.27,1,734605,734175,430
34866261,45.1417,42.51,433,33908,0.386377,0.23,1,734654,734221,433
34869181,27.4283,27.702,432,33970,0.405275,0.23,1,734677,734245,432
34872101,37.4857,38.3404,431,34032,0.409055,0.21,1,734717,734286,431
34875021,37.0971,36.4681,432,34094,0.425811,0.27,1,734754,734322,432
34877941,65.0194,64.0936,433,34156,0.461162,0.27,1,734826,734393,433
34880861,14.6039,14.4187,433,34218,0.436232,0.27,1,734828,734395,433
34883781,24.5208,2.88374,460,34280,0.447246,0.27,1,734855,734395,460
34886701,60.9042,21.3767,504,34342,0.481449,0.29,1,734925,734421,504
34889621,53.7808,61.0753,485,34404,0.52029,0.35,1,734977,734492,485
34892541,41.9562,50.6151,476,34465,0.544058,0.39,1,735016,734540,476
34895461,29.1912,40.523,464,34526,0.580812,0.37,1,735042,734578,464
34898381,47.4382,29.7046,489,34587,0.620162,0.39,1,735094,734605,489
34901301,28.6876,45.1409,464,34648,0.644032,0.41,1,735118,734654,464
34904221,37.7375,27.4282,481,34709,0.680807,0.41,1,735158,734677,481
34907141,36.3475,37.4856,477,34770,0.704161,0.43,1,735194,734717,477
34910061,66.4695,37.0971,514,34831,0.740832,0.47,1,735268,734754,514
34912981,14.8939,65.0194,444,34892,0.748166,0.43,1,735270,734826,444
34915901,26.1788,14.6039,471,34953,0.733633,0.45,1,735299,734828,471
34918821,62.0358,24.5208,515,35013,0.762727,0.49,2,735370,734855,515
34921741,54.0072,60.9042,497,35073,0.800545,0.53,2,735422,734925,497
34924661,46.0014,53.7808,489,35133,0.776109,0.55,2,735466,734977,489
34927581,30.0003,41.9562,476,35193,0.771222,0.59,2,735492,735016,476
34930501,50.0001,29.1912,505,35253,0.786244,0.63,2,735547,735042,505
34933421,30,47.4382,478,35313,0.789249,0.65,2,735572,735094,478
34936341,39.6,28.6876,496,35373,0.82185,0.69,2,735614,735118,496
34939261,36.72,37.7375,492,35433,0.79637,0.71,2,735650,735158,492
34942181,68.144,36.3475,532,35493,0.791274,0.75,2,735726,735194,532
34945101,15.2288,66.4695,460,35553,0.790255,0.75,2,735728,735268,460
34948021,25.4458,14.8939,486,35612,0.790051,0.73,2,735756,735270,486
34950941,63.4892,26.1788,530,35671,0.80601,0.77,2,735829,735299,530
34953861,14.2978,62.0358,461,35730,0.809202,0.81,2,735831,735370,461
34956781,45.2596,54.0072,462,35789,0.79384,0.77,2,735884,735422,462
34959701,42.6519,46.0014,460,35848,0.790768,0.77,2,735926,735466,460
34962621,30.1304,30.0003,461,35907,0.838154,0.79,2,735953,735492,461
34965541,50.8261,50.0001,462,35966,0.831631,0.79,2,736009,735547,462
34968461,29.3652,30,461,36025,0.846326,0.83,2,736033,735572,461
34971381,39.473,39.6,461,36084,0.913265,0.79,2,736075,735614,461
34974301,36.6946,36.72,461,36143,0.910653,0.79,2,736111,735650,461
35096941,33,10,537,38520,0.76,1,2,737784,737247,537
35099861,23.4,34.8,517,38575,0.688,1,1,737805,737288,517
35102781,27.88,33.36,513,38630,0.6736,1,1,737834,737321,513
35105701,29.576,42.672,498,38685,0.52672,1,1,737864,737366,498
35108621,31.5152,44.5344,485,38740,0.545344,1,1,737896,737411,485
35111541,32.703,31.3069,490,38795,0.469069,1,1,737929,737439,490
35114461,41.7406,51.8614,477,38849,0.309814,1,1,737973,737496,477
35117381,44.3481,38.3723,487,38903,0.213963,1,1,738018,737531,487
35120301,65.6696,66.8745,484,38957,0.0667925,1,1,738089,737605,484
35123221,33.1339,38.1749,478,39011,0.0533585,1,1,738114,737636,478
35126141,38.6268,33.235,486,39065,0.0506717,0.94,1,738154,737668,486
35129061,38.1254,47.447,473,39119,0.0661343,0.91,1,738192,737719,473
35131981,27.6251,35.0894,466,39173,0.0372269,0.76,1,738217,737751,466
35134901,26.325,33.4179,459,39227,0.0154454,0.67,1,738243,737784,459
35137821,17.265,23.4836,453,39281,0.0270891,0.67,1,738258,737805,453
35140741,21.853,27.8967,447,39335,0.0134178,0.49,1,738281,737834,447
35143661,25.1706,29.5793,443,39389,0.0426836,0.55,1,738307,737864,443
35146581,30.6341,31.5159,443,39443,0.0805367,0.45,1,738339,737896,443
35149501,30.9268,32.7032,441,39497,0.0401073,0.27,1,738370,737929,441
35152421,34.1854,41.7406,432,39550,0.0640215,0.19,1,738405,737973,432
35155341,41.2371,44.3481,430,39603,0.0368043,0.03,1,738448,738018,430
35158261,60.2474,65.6696,424,39656,0.0473609,0.05,1,738513,738089,424
35161181,31.2495,33.1339,423,39709,0.0334722,0.05,1,738537,738114,423
35164101,39.8499,38.6268,425,39762,0.0786944,0.07,1,738579,738154,425
35167021,36.77,38.1254,423,39815,0.103739,0.03,1,738615,738192,423
35169941,26.554,27.6251,422,39868,0.108748,0.01,1,738639,738217,422
35172861,26.1108,26.325,422,39921,0.0457496,0.03,1,738665,738243,422
35175781,17.2222,17.265,422,39974,0.0331499,0.01,1,738680,738258,422
35178701,21.8444,21.853,422,40027,0.04663,0.05,1,738703,738281,422
35181621,25.9689,25.1706,423,40080,0.065326,0.05,1,738730,738307,423
35184541,30.7938,5.03412,455,40133,0.0370652,0.09,1,738762,738307,455
35187461,29.3588,26.6068,452,40186,0.047413,0.03,1,738791,738339,452
35190381,34.6718,30.1214,457,40239,0.0174826,0.07,1,738827,738370,457
35193301,41.3344,34.0243,465,40291,0.0274965,0.03,1,738870,738405,465
35196221,59.4669,41.2049,486,40343,0.0614993,0.05,1,738934,738448,486
35199141,31.0934,60.241,445,40395,0.0202999,0.03,1,738958,738513,445
35202061,43.0187,31.2482,467,40447,0.06006,0.09,1,739004,738537,467
35204981,36.6037,39.8496,460,40499,0.084012,0.11,1,739039,738579,460
35207901,24.9207,36.7699,446,40551,0.104802,0.11,1,739061,738615,446
35210821,24.9841,26.554,447,40603,0.12496,0.03,1,739086,738639,447
35213741,16.9968,26.1108,436,40655,0.112992,0.03,1,739101,738665,436
35216661,21.7994,17.2222,444,40707,0.0945984,0.05,1,739124,738680,444
35219581,26.7599,21.8444,449,40759,0.0429197,0.07,1,739152,738703,449
35222501,30.952,25.9689,454,40811,0.0645839,0.03,1,739184,738730,454
35225421,28.5904,30.7938,450,40863,0.116917,0.05,1,739212,738762,450
35228341,36.1181,29.3588,459,40915,0.111383,0.01,1,739250,738791,459
35231261,40.8236,34.6718,465,40967,0.0942767,0.03,1,739292,738827,465
35234181,59.3647,41.3344,486,41019,0.0908553,0.07,1,739356,738870,486
35237101,31.0729,59.4669,446,41070,0.0741711,0.01,1,739380,738934,446
35240021,44.6146,31.0934,470,41121,0.0388342,0.07,1,739428,738958,470
35242941,37.7229,43.0187,460,41172,0.0317668,0.09,1,739464,739004,460
35245861,27.5446,36.6037,450,41223,0.0623534,0.11,1,739489,739039,450
35248781,24.7089,24.9207,452,41274,0.0364707,0.13,1,739513,739061,452
35251701,16.1418,24.9841,441,41325,0.0312941,0.11,1,739527,739086,441
35254621,19.2284,16.9968,446,41376,0.0302588,0.09,1,739547,739101,446
35257541,25.4457,21.7994,450,41427,0.0300518,0.03,1,739574,739124,450
35260461,33.0891,26.7599,457,41478,0.0460104,0.07,1,739609,739152,457
35263381,30.6178,30.952,455,41529,0.0332021,0.13,1,739639,739184,455
35266301,7.72356,28.5904,429,41580,0.0306404,0.11,1,739641,739212,429
35269221,30.3447,36.1181,427,41631,0.0301281,0.09,1,739677,739250,427
35272141,38.8689,40.8236,426,41682,0.0940256,0.09,1,739718,739292,426
35275061,59.7738,59.3647,427,41733,0.0908051,0.07,1,739783,739356,427
35277981,29.5548,31.0729,425,41784,0.090161,0.03,1,739805,739380,425
35280901,42.711,44.6146,423,41835,0.106032,0.03,1,739851,739428,423
35283821,38.1422,37.7229,424,41885,0.157206,0.07,1,739888,739464,424
35286741,26.8284,27.5446,423,41935,0.167441,0.03,1,739912,739489,423
35289661,24.5657,24.7089,423,41985,0.201488,0.03,1,739936,739513,423
35292581,16.1131,16.1418,423,42035,0.224298,0.03,1,739950,739527,423
35295501,20.0226,19.2284,424,42085,0.24486,0.03,1,739971,739547,424
35298421,24.8045,25.4457,423,42135,0.264972,0.05,1,739997,739574,423
35301341,32.9609,33.0891,423,42185,0.252994,0.03,1,740032,739609,423
35304261,30.5922,30.6178,423,42235,0.186599,0.03,1,740062,739639,423
35307181,7.71844,7.72356,423,42285,0.20532,0.03,1,740064,739641,423
35310101,30.3437,30.3447,423,42335,0.209064,0.11,1,740100,739677,423
35313021,40.4687,38.8689,425,42385,0.289813,0.09,1,740143,739718,425
35315941,59.2937,59.7738,424,42435,0.321963,0.09,1,740207,739783,424
35318861,29.4587,29.5548,424,42485,0.328392,0.11,1,740229,739805,424
35321781,44.2918,42.711,426,42535,0.361679,0.17,1,740277,739851,426
35324701,41.6583,38.1422,430,42585,0.320336,0.17,1,740318,739888,430
35327621,27.5317,26.8284,430,42635,0.312067,0.21,1,740342,739912,430
35330541,25.5063,24.5657,431,42684,0.342413,0.23,1,740367,739936,431
35333461,16.3013,16.1131,431,42733,0.380483,0.25,1,740381,739950,431
35336381,20.8603,20.0226,432,42782,0.356097,0.27,1,740403,739971,432
35339301,25.7721,24.8045,433,42831,0.399219,0.25,1,740430,739997,433
35342221,32.3544,32.9609,432,42880,0.407844,0.17,1,740464,740032,432
35345141,28.8709,30.5922,430,42929,0.409569,0.21,1,740492,740062,430
35348061,7.37418,7.71844,430,42978,0.409914,0.21,1,740494,740064,430
35350981,31.8748,30.3437,432,43027,0.489983,0.21,1,740532,740100,432
35353901,42.375,6.06874,477,43076,0.489997,0.31,1,740577,740100,477
35356821,60.475,35.6137,499,43125,0.489999,0.33,1,740642,740143,499
35359741,29.695,58.3228,457,43174,0.49,0.33,1,740664,740207,457
35362661,45.939,29.2645,485,43223,0.522,0.37,1,740714,740229,485
35365581,41.1878,44.2529,477,43272,0.5444,0.31,1,740754,740277,477
35368501,28.2376,41.6506,461,43321,0.59688,0.31,1,740779,740318,461
35371421,26.4475,27.5301,463,43370,0.591376,0.35,1,740805,740342,463
35374341,16.4895,25.506,452,43419,0.590275,0.39,1,740819,740367,452
35377261,20.8979,16.3012,460,43468,0.590055,0.35,1,740841,740381,460
35380181,26.5796,20.8602,466,43517,0.622011,0.41,1,740869,740403,466
35383101,34.1159,25.772,475,43565,0.660402,0.41,1,740905,740430,475
35386021,29.2232,32.3544,469,43613,0.66808,0.41,1,740933,740464,469
35388941,7.44464,28.8709,443,43661,0.669616,0.41,1,740935,740492,443
35391861,34.2889,7.37418,482,43709,0.717923,0.51,1,740976,740494,482
35394781,43.6578,31.8748,490,43757,0.743585,0.49,1,741022,740532,490
35397701,60.7316,42.375,510,43805,0.764717,0.49,2,741087,740577,510
35400621,29.7463,60.475,467,43853,0.784943,0.49,2,741109,740642,467
35403541,47.5493,29.695,497,43901,0.804989,0.53,2,741161,740664,497
35406461,43.1099,45.939,489,43949,0.856998,0.55,2,741203,740714,489
35409381,28.622,41.1878,474,43997,0.8194,0.61,2,741228,740754,474
35412301,27.3244,28.2376,476,44045,0.82788,0.59,2,741255,740779,476
35415221,16.6649,26.4475,464,44093,0.829576,0.59,2,741269,740805,464
35418141,20.933,16.4895,472,44141,0.829915,0.59,2,741291,740819,472
35421061,28.1866,20.8979,480,44189,0.829983,0.63,2,741321,740841,480
35423981,36.0373,26.5796,490,44237,0.845997,0.67,2,741359,740869,490
35426901,30.4075,34.1159,483,44285,0.865199,0.67,2,741388,740905,483
35429821,7.68149,29.2232,457,44333,0.86904,0.67,2,741390,740933,457
35432741,35.9363,7.44464,498,44381,0.821808,0.73,2,741433,740935,498
35435661,44.7873,34.2889,504,44429,0.796362,0.75,2,741480,740976,504
35438581,10.5575,43.6578,460,44476,0.807272,0.77,2,741482,741022,460
35441501,54.1115,60.7316,460,44523,0.841454,0.79,2,741547,741087,460
35444421,29.2223,29.7463,461,44570,0.880291,0.81,2,741570,741109,461
35447341,49.0445,47.5493,463,44617,0.856058,0.87,2,741624,741161,463
35450261,43.4089,43.1099,463,44664,0.851212,0.81,2,741666,741203,463
35453181,27.8818,28.622,462,44711,0.834242,0.83,2,741690,741228,462
35456101,27.9764,27.3244,463,44758,0.862848,0.83,2,741718,741255,463
35459021,16.7953,16.6649,463,44805,0.86857,0.83,2,741732,741269,463
35461941,20.9591,20.933,463,44852,0.917714,0.83,2,741754,741291,463
35464861,28.1918,28.1866,463,44899,0.943543,0.85,2,741784,741321,463
35637141,31,25,507,47591,0.87,1,2,743657,743150,507
35640061,27.8,22.6,512,47635,0.886,1,2,743684,743172,512
35642981,21.56,24.52,507,47679,0.8732,0.99,2,743704,743197,507
35645901,25.112,38.504,491,47723,0.85464,1,2,743730,743239,491
35648821,26.6224,26.9008,494,47767,0.882928,1,2,743757,743263,494
35883881,119,141,448,23360,0.05,0.35,1,746304,745856,448
35886801,77.4,55.4,481,23451,0.05,0.05,1,746371,745890,481
35889721,77.88,76.68,477,23541,0.034,0.07,1,746449,745972,477
35892641,37.976,68.936,438,23631,0.0308,0.03,1,746477,746039,438
35895561,27.5952,38.5872,432,23721,0.06216,0.03,1,746502,746070,432
35898481,30.319,30.1174,435,23810,0.012432,0.01,1,746533,746098,435
35901401,66.0638,54.0235,450,23899,0.0424864,0,1,746608,746158,450
35904321,63.6128,56.4047,456,23988,0.0484973,0.01,1,746671,746215,456
35907241,59.1226,61.6809,451,24076,0.0656995,0.05,1,746729,746278,451
35910161,66.2245,86.7362,426,24164,0.10114,0.03,1,746797,746371,426
35913081,72.4449,79.7472,422,24252,0.044228,0.03,1,746871,746449,422
35916001,38.489,38.3494,424,24339,0.0328456,0.07,1,746901,746477,424
35918921,27.6978,27.6699,424,24426,0.0305691,0,1,746926,746502,424
35921841,29.5396,30.334,423,24513,0.0301138,0.05,1,746956,746533,423
35924761,65.1079,66.0668,422,24599,0.0300228,0.05,1,747030,746608,422
35927681,64.2216,63.6134,423,24685,0.0300046,0.07,1,747094,746671,423
35930601,61.6443,59.1227,426,24771,0.0460009,0.11,1,747155,746729,426
35933521,66.7289,66.2245,426,24857,0.0652002,0.03,1,747223,746797,426
35936441,69.3458,72.4449,422,24942,0.03704,0.03,1,747293,746871,422
35939361,37.8692,38.489,422,25027,0.031408,0.03,1,747323,746901,422
35942281,27.5738,27.6978,422,25112,0.0302816,0.03,1,747348,746926,422
35945201,29.5148,29.5396,422,25196,0.0300563,0.03,1,747378,746956,422
35948121,65.903,65.1079,423,25280,0.0140113,0.03,1,747453,747030,423
35951041,63.5806,64.2216,422,25364,0.0268023,0.05,1,747516,747094,422
35953961,61.5161,61.6443,422,25448,0.0293605,0.05,1,747577,747155,422
35956881,67.5032,12.3289,491,25531,0.0458721,0.07,1,747646,747155,491
35959801,68.7006,56.8658,492,25614,0.129174,0.03,1,747715,747223,492
35962721,36.9401,67.3732,451,25697,0.0978349,0.03,1,747744,747293,451
35965641,27.388,37.4746,446,25779,0.075567,0.03,1,747769,747323,446
35968561,29.4776,27.4949,451,25861,0.0151134,0.03,1,747799,747348,451
35971481,65.8955,29.499,496,25943,0.0270227,0.01,1,747874,747378,496
35974401,64.3791,65.8998,485,26025,0.0614045,0.03,1,747938,747453,485
35977321,61.6758,63.58,483,26106,0.0682809,0.03,1,747999,747516,483
35980241,69.1352,61.516,493,26187,0.117656,0.05,1,748070,747577,493
35983161,72.227,67.5032,497,26268,0.143531,0.15,1,748143,747646,497
35986081,32.0454,68.7006,450,26349,0.164706,0.09,1,748165,747715,450
35989001,27.2091,36.9401,447,26429,0.152941,0.07,1,748191,747744,447
35991921,29.4418,27.388,452,26509,0.0865882,0,1,748221,747769,452
35994841,66.6884,29.4776,498,26589,0.0413176,0.03,1,748297,747799,498
35997761,65.3377,65.8955,488,26669,0.0482635,0.07,1,748362,747874,488
36000681,61.8675,64.3791,485,26748,0.0976527,0.07,1,748423,747938,485
36003601,69.9735,61.6758,496,26827,0.139531,0.13,1,748495,747999,496
36006521,74.7947,69.1352,501,26906,0.179906,0.15,1,748571,748070,501
36009441,16.5589,72.227,430,26985,0.187981,0.17,1,748573,748143,430
36012361,21.7118,32.0454,431,27063,0.237596,0.15,1,748596,748165,431
36015281,23.5424,27.2091,429,27141,0.263519,0.07,1,748620,748191,429
36018201,23.9085,29.4418,423,27219,0.332704,0.03,1,748644,748221,423
36021121,66.3817,66.6884,424,27297,0.234541,0.05,1,748721,748297,424
36024041,65.2763,65.3377,424,27375,0.230908,0.11,1,748786,748362,424
36026961,64.2553,61.8675,427,27452,0.278182,0.15,1,748850,748423,427
36029881,72.0511,69.9735,429,27529,0.303636,0.19,1,748924,748495,429
36032801,76.8102,74.7947,431,27606,0.308727,0.19,1,749002,748571,431
36035721,16.962,16.5589,431,27683,0.309745,0.25,1,749004,748573,431
36038641,24.1924,21.7118,434,27760,0.261949,0.27,1,749030,748596,434
36041561,25.6385,23.5424,436,27836,0.31639,0.35,1,749056,748620,436
36044481,23.5277,23.9085,435,27912,0.343278,0.21,1,749079,748644,435
36047401,62.3055,66.3817,430,27988,0.364656,0.23,1,749151,748721,430
36050321,66.8611,65.2763,433,28064,0.400931,0.29,1,749219,748786,433
36053241,67.7722,64.2553,437,28139,0.408186,0.31,1,749287,748850,437
36056161,71.1544,72.0511,435,28214,0.425637,0.31,1,749359,748924,435
36059081,76.6309,76.8102,435,28289,0.461127,0.31,1,749437,749002,435
36062001,16.9262,16.962,435,28364,0.468226,0.31,1,749439,749004,435
36064921,24.1852,3.39241,461,28439,0.469645,0.25,1,749465,749004,461
36067841,27.237,21.4785,463,28513,0.485929,0.33,1,749493,749030,463
36070761,24.6474,25.0957,461,28587,0.521186,0.35,1,749517,749056,461
36073681,63.3295,23.4191,511,28661,0.576237,0.37,1,749590,749079,511
36076601,67.0659,62.2838,507,28735,0.587247,0.41,1,749658,749151,507
36079521,69.4132,66.8568,509,28809,0.58945,0.41,1,749728,749219,509
36082441,72.2826,67.7714,514,28882,0.58989,0.43,1,749801,749287,514
36085361,78.4565,71.1543,522,28955,0.605978,0.47,1,749881,749359,522
36088281,17.2913,76.6309,446,29028,0.609196,0.47,1,749883,749437,446
36091201,23.4583,16.9262,469,29101,0.625839,0.47,1,749908,749439,469
36094121,30.2917,24.1852,475,29174,0.629168,0.49,1,749940,749465,475
36097041,25.2583,27.237,471,29247,0.645834,0.53,1,749964,749493,471
36099961,65.8517,24.6474,523,29319,0.681167,0.59,1,750040,749517,523
36102881,67.5703,63.3295,518,29391,0.704233,0.59,1,750108,749590,518
36105801,70.3141,67.0659,521,29463,0.692847,0.59,1,750179,749658,521
36108721,71.6628,69.4132,523,29535,0.722569,0.59,1,750251,749728,523
36111641,79.1326,72.2826,531,29607,0.776514,0.61,2,750332,749801,531
36114561,17.4265,78.4565,453,29678,0.787303,0.61,2,750334,749881,453
36117481,24.2853,17.2913,477,29749,0.789461,0.63,2,750360,749883,477
36120401,30.4571,23.4583,484,29820,0.805892,0.63,2,750392,749908,484
36123321,7.69141,30.2917,454,29891,0.809178,0.65,2,750394,749940,454
36126241,20.7383,25.2583,454,29962,0.857836,0.69,2,750418,749964,454
36129161,66.5477,65.8517,456,30033,0.899567,0.71,2,750496,750040,456
36243041,33,26,517,32668,0.61,1,1,752353,751836,517
36245961,33,21.2,530,32733,0.53,1,1,752386,751856,530
36248881,29.8,42.64,511,32798,0.37,1,1,752415,751904,511
36251801,46.76,70.928,484,32862,0.306,1,1,752466,751982,484
36254721,58.152,69.3856,476,32926,0.2292,1,1,752527,752051,476
36257641,78.8304,73.8771,485,32990,0.06984,0.91,1,752611,752126,485
36260561,73.3661,81.1754,474,33054,0.037968,1,1,752683,752209,474
36263481,34.6732,37.8351,472,33118,0.0635936,0.95,1,752708,752236,472
36266401,29.3346,31.567,470,33182,0.100719,0.93,1,752736,752266,470
36269321,20.2669,27.1134,462,33246,0.108144,0.79,1,752754,752292,462
36272241,21.6534,27.8227,456,33310,0.109629,0.61,1,752776,752320,456
36275161,27.5307,31.9645,452,33373,0.0779257,0.51,1,752805,752353,452
36278081,26.3061,32.7929,445,33436,0.0875852,0.33,1,752831,752386,445
36281001,25.2612,29.7586,441,33499,0.073517,0.29,1,752856,752415,441
36283921,38.6522,46.7517,432,33562,0.0707034,0.21,1,752898,752466,432
36286841,54.9304,58.1503,430,33625,0.118141,0.03,1,752957,752527,430
36289761,71.7861,78.8301,422,33688,0.0796281,0.03,1,753033,752611,422
36292681,71.9572,73.366,422,33751,0.0399256,0.07,1,753105,752683,422
36295601,35.9914,34.6732,424,33814,0.0319851,0.11,1,753132,752708,424
36298521,31.1983,29.3346,426,33877,0.110397,0.11,1,753162,752736,426
36301441,21.4397,20.2669,427,33939,0.0780794,0.11,1,753181,752754,427
36304361,21.0879,21.6534,426,34001,0.0876159,0.07,1,753202,752776,426
36307281,25.8176,27.5307,424,34063,0.121523,0.09,1,753229,752805,424
36310201,25.9635,26.3061,424,34125,0.144305,0.07,1,753255,752831,424
36313121,25.9927,25.2612,425,34187,0.116861,0.07,1,753281,752856,425
36316041,37.1985,38.6522,423,34249,0.127372,0.07,1,753321,752898,423
36318961,57.8397,7.73045,486,34311,0.145474,0.13,1,753384,752898,486
36321881,68.3679,48.7461,498,34373,0.229095,0.07,1,753455,752957,498
36324801,70.4736,70.5492,493,34435,0.165819,0.03,1,753526,753033,493
36327721,35.6947,71.7098,448,34496,0.137164,0.03,1,753553,753105,448
36330641,34.3389,35.942,455,34557,0.0834328,0.13,1,753587,753132,455
36333561,21.2678,31.1884,443,34618,0.0726865,0.07,1,753605,753162,443
36336481,22.6536,21.4377,447,34679,0.0545373,0.09,1,753628,753181,447
36339401,26.1307,21.0875,453,34740,0.0669075,0.13,1,753655,753202,453
36342321,26.0261,25.8175,452,34801,0.0373815,0.15,1,753681,753229,452
36345241,26.0052,25.9635,452,34862,0.0474763,0.11,1,753707,753255,452
36348161,38.001,25.9927,467,34923,0.0494953,0.13,1,753748,753281,467
36351081,60.4002,37.1985,493,34984,0.0498991,0.15,1,753814,753321,493
36354001,71.28,57.8397,504,35044,0.0819798,0.25,1,753888,753384,504
36356921,65.456,68.3679,497,35104,0.104396,0.15,1,753952,753455,497
36359841,33.8912,70.4736,452,35164,0.108879,0.13,1,753978,753526,452
36362761,33.1782,35.6947,458,35224,0.0937758,0.07,1,754011,753553,458
36365681,21.0356,34.3389,442,35284,0.0907552,0.07,1,754029,753587,442
36368601,21.8071,21.2678,446,35344,0.090151,0.05,1,754051,753605,446
36371521,25.1614,22.6536,449,35404,0.10603,0.07,1,754077,753628,449
36374441,25.8323,26.1307,448,35464,0.125206,0.03,1,754103,753655,448
36377361,26.7665,26.0261,449,35524,0.177041,0.05,1,754130,753681,449
36380281,38.1533,26.0052,464,35584,0.219408,0.05,1,754171,753707,464
36383201,60.4307,38.001,489,35643,0.243882,0.05,1,754237,753748,489
36386121,13.6861,60.4002,425,35702,0.248776,0.09,1,754239,753814,425
36389041,62.7372,71.28,426,35761,0.313755,0.11,1,754314,753888,426
36391961,64.5474,65.456,427,35820,0.406751,0.11,1,754379,753952,427
36394881,33.7095,33.8912,427,35879,0.44135,0.09,1,754405,753978,427
36397801,32.3419,33.1782,426,35938,0.48027,0.09,1,754437,754011,426
36400721,20.8684,21.0356,426,35997,0.488054,0.09,1,754455,754029,426
36403641,21.7737,21.8071,426,36056,0.489611,0.11,1,754477,754051,426
36406561,25.9547,25.1614,427,36115,0.473922,0.13,1,754504,754077,427
36409481,27.5909,25.8323,429,36174,0.502784,0.19,1,754532,754103,429
36412401,28.7182,26.7665,431,36232,0.508557,0.23,1,754561,754130,431
36415321,40.1436,38.1533,433,36290,0.541711,0.25,1,754604,754171,433
36418241,61.6287,60.4307,434,36348,0.612342,0.25,1,754671,754237,434
36421161,13.9257,13.6861,434,36406,0.594468,0.33,1,754673,754239,434
36424081,66.7851,62.7372,439,36464,0.622894,0.43,1,754753,754314,439
36427001,68.557,64.5474,443,36522,0.644579,0.45,1,754822,754379,443
36429921,35.3114,33.7095,444,36580,0.632916,0.49,1,754849,754405,444
36432841,32.6623,32.3419,444,36638,0.646583,0.49,1,754881,754437,444
36435761,20.9325,20.8684,444,36696,0.649317,0.49,1,754899,754455,444
36438681,21.7865,21.7737,444,36754,0.649863,0.47,1,754921,754477,444
36441601,26.7573,25.9547,445,36811,0.681973,0.51,1,754949,754504,445
36444521,29.3515,27.5909,447,36868,0.656394,0.51,1,754979,754532,447
36447441,29.8703,28.7182,448,36925,0.667279,0.55,1,755009,754561,448
36450361,41.1741,40.1436,449,36982,0.685456,0.63,1,755053,754604,449
36453281,63.4348,61.6287,451,37039,0.721091,0.59,1,755122,754671,451
36456201,14.287,13.9257,451,37096,0.760218,0.63,2,755124,754673,451
36459121,67.6574,66.7851,452,37153,0.784044,0.63,2,755205,754753,452
36462041,69.5315,13.357,522,37210,0.804809,0.65,2,755275,754753,522
36464961,35.5063,57.8714,480,37267,0.856962,0.63,2,755302,754822,480
36467881,32.7013,33.1743,485,37324,0.835392,0.65,2,755334,754849,485
36470801,20.9403,32.2349,471,37381,0.847079,0.65,2,755352,754881,471
36473721,21.7881,20.847,475,37438,0.865416,0.65,2,755374,754899,475
36476641,26.7576,21.7694,481,37494,0.869083,0.69,2,755402,754921,481
36479561,29.3515,26.7539,483,37550,0.869817,0.65,2,755432,754949,483
36482481,30.6703,29.3508,484,37606,0.853963,0.67,2,755463,754979,484
36485401,42.9341,29.8702,500,37662,0.866793,0.69,2,755509,755009,500
36488321,64.5868,41.174,526,37718,0.853359,0.73,2,755579,755053,526
36491241,14.5174,63.4348,459,37774,0.850672,0.77,2,755581,755122,459
36494161,68.5035,14.287,539,37830,0.834134,0.79,2,755663,755124,539
36497081,72.1007,67.6574,531,37886,0.846827,0.81,2,755736,755205,531
36500001,36.8201,69.5315,489,37942,0.833365,0.87,2,755764,755275,489
36502921,32.964,35.5063,494,37998,0.846673,0.83,2,755796,755302,494
36505841,21.7928,32.7013,481,38054,0.881335,0.85,2,755815,755334,481
36508761,22.7586,20.9403,486,38110,0.904267,0.87,2,755838,755352,486
36511681,26.9517,21.7881,492,38165,0.908853,0.87,2,755866,755374,492
36514601,29.3903,26.7576,494,38220,0.909771,0.87,2,755896,755402,494
36517521,30.6781,29.3515,495,38275,0.925954,0.85,2,755927,755432,495
36520441,41.3356,30.6703,508,38330,0.897191,0.87,2,755971,755463,508
36683961,130,94,495,18366,0.33,0.37,1,758470,757975,495
36686881,120.4,123.6,482,18482,0.378,0.21,1,758588,758106,482
36689801,81.68,96.72,464,18597,0.4196,0.23,1,758660,758196,464
36692721,60.336,76.944,447,18711,0.47592,0.23,1,758715,758268,447
36695641,34.4672,32.1888,454,18824,0.487184,0.27,1,758743,758289,454
36698561,33.2934,47.2378,436,18937,0.521437,0.33,1,758776,758340,436
36701481,112.259,113.448,438,19049,0.512287,0.39,1,758908,758470,438
36704401,119.252,117.09,441,19160,0.574457,0.43,1,759029,758588,441
36707321,83.0503,81.0179,443,19271,0.554891,0.49,1,759103,758660,443
36710241,63.0101,60.2036,446,19381,0.566978,0.49,1,759161,758715,446
36713161,35.002,34.4407,446,19490,0.569396,0.53,1,759189,758743,446
36716081,33.4004,33.2881,446,19599,0.569879,0.53,1,759222,758776,446
36719001,112.28,6.65763,578,19707,0.633976,0.51,1,759354,758776,578
36721921,120.856,106.932,569,19815,0.614795,0.59,1,759477,758908,569
36724841,83.3712,118.186,522,19922,0.642959,0.55,1,759551,759029,522
36727761,63.8742,82.8373,507,20028,0.680592,0.57,1,759610,759103,507
36730681,35.1748,62.9675,477,20134,0.704118,0.57,1,759638,759161,477
36733601,33.435,34.9935,482,20239,0.692824,0.57,1,759671,759189,482
36736521,115.487,33.3987,585,20344,0.770565,0.65,2,759807,759222,585
36739441,120.697,112.28,575,20448,0.818113,0.61,2,759929,759354,575
36742361,84.1395,120.856,527,20552,0.859623,0.65,2,760004,759477,527
36745281,65.6279,83.3712,514,20655,0.915925,0.69,2,760065,759551,514
36748201,36.3256,63.8742,484,20758,0.943185,0.71,2,760094,759610,484
36815361,130,39,609,22993,0.89,1,2,761697,761088,609
36902961,34,22,525,25613,0.79,1,2,763477,762952,525
36905881,94.8,39.6,591,25696,0.822,1,2,763587,762996,591
36908801,57.36,108.72,513,25778,0.7964,0.87,2,763635,763122,513
36911721,73.072,52.944,551,25860,0.80728,1,2,763712,763161,551
36914641,96.2144,76.9888,570,25942,0.905456,1,2,763814,763244,570
36917561,42.4429,97.7978,496,26024,0.877091,0.89,2,763843,763347,496
36920481,30.8886,48.3596,488,26105,0.903418,0.77,2,763871,763383,488
36923401,31.7777,33.6719,490,26186,0.924684,0.83,2,763903,763413,490
37092761,40,60,485,30521,0.75,1,2,766955,766470,485
37095681,40,37.6,493,30590,0.686,1,1,766995,766502,493
37098601,50.4,53.92,488,30659,0.5612,1,1,767048,766560,488
37101521,108.48,110.784,486,30728,0.58424,1,1,767171,766685,486
37104441,45.696,50.1568,481,30797,0.556848,0.86,1,767201,766720,481
37107361,39.5392,42.8314,478,30866,0.48737,0.97,1,767239,766761,478
37110281,43.9078,42.9663,480,30935,0.489474,0.98,1,767284,766804,480
37113201,30.3816,38.1933,470,31003,0.425895,0.88,1,767311,766841,470
37116121,30.0763,31.6387,470,31071,0.429179,0.85,1,767341,766871,470
37119041,33.2153,41.5277,460,31139,0.445836,0.75,1,767375,766915,460
37121961,35.4431,40.3055,456,31207,0.481167,0.67,1,767411,766955,456
37124881,35.8886,40.0611,452,31275,0.488233,0.53,1,767447,766995,452
37127801,48.7777,50.4122,451,31343,0.473647,0.53,1,767499,767048,451
37130721,104.156,10.0824,569,31411,0.518729,0.59,1,767617,767048,569
37133641,43.2311,100.416,474,31478,0.527746,0.55,1,767645,767171,474
37136561,37.4462,44.0833,480,31545,0.529549,0.47,1,767681,767201,480
37139481,43.4892,39.2167,487,31612,0.59391,0.49,1,767726,767239,487
37142401,29.4978,43.8433,468,31679,0.574782,0.41,1,767752,767284,468
37145321,29.0996,30.3687,470,31746,0.586956,0.43,1,767781,767311,470
37148241,33.8199,30.0737,475,31813,0.589391,0.45,1,767816,767341,475
37151161,38.764,33.2147,481,31880,0.637878,0.49,1,767856,767375,481
37154081,34.9528,35.443,479,31946,0.647576,0.49,1,767890,767411,479
37157001,47.7906,35.8886,494,32012,0.665515,0.47,1,767941,767447,494
37159921,107.958,48.7777,565,32078,0.781103,0.53,2,768064,767499,565
37162841,43.9916,104.156,475,32144,0.836221,0.53,2,768092,767617,475
37165761,37.5983,43.2311,483,32210,0.847244,0.53,2,768128,767645,483
37168681,45.1197,37.4462,494,32276,0.913449,0.61,2,768175,767681,494
37171601,29.8239,43.4892,475,32342,0.92669,0.57,2,768201,767726,475
37174521,30.7648,29.4978,480,32407,0.913338,0.59,2,768232,767752,480
37177441,33.353,29.0996,485,32472,0.942668,0.59,2,768266,767781,485
37340961,32,39,489,35937,0.79,1,2,770656,770167,489
37343881,34.4,27.8,499,35996,0.806,1,2,770691,770192,499
37346801,28.48,33.56,491,36055,0.7292,1,1,770718,770227,491
37349721,54.496,57.112,489,36114,0.72984,1,1,770779,770290,489
37352641,104.499,107.422,486,36173,0.697968,1,1,770896,770410,486
37355561,44.0998,49.4845,480,36231,0.707594,0.94,1,770925,770445,480
37358481,34.42,34.6969,481,36289,0.693519,1,1,770957,770476,481
37361401,22.884,29.3394,473,36347,0.658704,0.95,1,770977,770504,473
37364321,28.5768,33.8679,468,36405,0.619741,1,1,771007,770539,468
37367241,32.1154,34.7736,466,36463,0.611948,0.89,1,771040,770574,466
37370161,25.6231,25.3547,467,36521,0.61039,0.78,1,771064,770597,467
37373081,24.3246,26.6709,464,36579,0.578078,0.79,1,771088,770624,464
37376001,26.4649,30.9342,459,36637,0.587616,0.81,1,771115,770656,459
37378921,34.893,34.1868,461,36695,0.605523,0.71,1,771152,770691,461
37381841,26.9786,28.4374,459,36753,0.577105,0.73,1,771177,770718,459
37384761,55.7957,54.4875,461,36810,0.539421,0.69,1,771240,770779,461
37387681,98.3591,104.497,453,36867,0.547884,0.71,1,771349,770896,453
37390601,44.4718,44.0995,455,36924,0.565577,0.69,1,771380,770925,455
37393521,35.2944,34.4199,456,36981,0.521115,0.65,1,771413,770957,456
37396441,19.8589,22.884,452,37038,0.480223,0.61,1,771429,770977,452
37399361,26.3718,28.5768,450,37095,0.536045,0.61,1,771457,771007,450
37402281,32.4744,32.1154,451,37152,0.515209,0.61,1,771491,771040,451
37405201,24.0949,6.42307,473,37209,0.511042,0.61,1,771513,771040,473
37408121,24.019,20.4846,473,37266,0.510208,0.57,1,771537,771064,473
37411041,24.0038,23.2969,473,37323,0.510042,0.59,1,771561,771088,473
37413961,36.8008,26.2594,486,37380,0.542008,0.61,1,771601,771115,486
37416881,25.7602,34.8519,472,37437,0.580402,0.57,1,771624,771152,472
37419801,55.552,26.9704,510,37493,0.63608,0.53,1,771687,771177,510
37422721,97.5104,55.7941,555,37549,0.679216,0.55,1,771795,771240,555
37425641,43.5021,98.3588,476,37605,0.687843,0.57,1,771825,771349,476
37428561,34.3004,44.4718,477,37661,0.689569,0.51,1,771857,771380,477
37431481,20.4601,35.2944,461,37717,0.705914,0.47,1,771874,771413,461
37434401,27.292,19.8589,474,37773,0.725183,0.55,1,771903,771429,474
37437321,32.6584,26.3718,480,37829,0.761037,0.51,2,771937,771457,480
37440241,24.1317,32.4744,468,37885,0.768207,0.51,2,771959,771491,468
37443161,24.0263,24.0949,470,37941,0.769642,0.51,2,771983,771513,470
37446081,24.0053,24.019,470,37997,0.817928,0.51,2,772007,771537,470
37449001,39.2011,24.0038,489,38053,0.875586,0.55,2,772050,771561,489
37451921,27.0402,36.8008,473,38109,0.919117,0.59,2,772074,771601,473
37697201,32,47,482,42511,0.67,1,1,775201,774719,482
37700121,40,36.6,490,42561,0.638,1,1,775243,774753,490
37703041,38.4,33.72,495,42611,0.5676,1,1,775281,774786,495
37705961,31.68,32.344,493,42661,0.47352,1,1,775311,774818,493
37708881,22.336,27.2688,487,42710,0.502704,1,1,775331,774844,487
37711801,33.2672,29.4538,493,42759,0.364541,1,1,775367,774874,493
37714721,33.8534,33.0908,493,42808,0.288908,1,1,775401,774908,493
37717641,27.5707,35.4182,483,42857,0.337782,1,1,775427,774944,483
37720561,27.9141,31.8836,480,42906,0.267556,0.9,1,775455,774975,480
37723481,15.9828,22.3767,473,42955,0.221511,0.95,1,775468,774995,473
37726401,41.5966,46.8753,468,43004,0.180302,0.95,1,775516,775048,468
37729321,38.7193,9.37507,506,43053,0.18806,0.97,1,775554,775048,506
37732241,26.9439,32.275,492,43102,0.125612,0.81,1,775578,775086,492
37735161,44.5888,32.855,508,43151,0.145122,0.71,1,775627,775119,508
37738081,32.9178,46.571,488,43200,0.149024,0.67,1,775657,775169,488
37741001,34.5836,34.9142,491,43249,0.149805,0.63,1,775692,775201,491
37743921,38.1167,40.5828,488,43298,0.117961,0.55,1,775731,775243,488
37746841,30.0233,38.5166,478,43347,0.111592,0.45,1,775759,775281,478
37749761,15.6047,31.7033,460,43396,0.110318,0.51,1,775771,775311,460
37752681,31.1209,22.3407,475,43445,0.0940637,0.33,1,775806,775331,475
37755601,30.2242,33.2681,469,43494,0.0908127,0.27,1,775836,775367,469
37758521,23.6448,33.8536,457,43543,0.106163,0.35,1,775858,775401,457
37761441,26.329,27.5707,458,43591,0.0612325,0.25,1,775885,775427,458
37764361,16.4658,27.9141,444,43639,0.132247,0.21,1,775899,775455,444
37767281,39.2932,15.9828,476,43687,0.178449,0.17,1,775944,775468,476
37770201,39.0586,41.5966,467,43735,0.21969,0.19,1,775983,775516,467
37773121,25.4117,38.7193,451,43783,0.259938,0.11,1,776005,775554,451
37776041,46.6823,26.9439,479,43831,0.315988,0.15,1,776057,775578,479
37778961,31.7365,44.5888,458,43879,0.343198,0.15,1,776085,775627,458
37781881,32.7473,32.9178,461,43927,0.412639,0.15,1,776118,775657,461
37784801,37.7495,34.5836,465,43975,0.410528,0.11,1,776157,775692,465
37787721,29.9499,38.1167,454,44023,0.458106,0.11,1,776185,775731,454
37790641,16.39,30.0233,439,44071,0.483621,0.11,1,776198,775759,439
37793561,29.678,15.6047,460,44119,0.456724,0.09,1,776231,775771,460
37796481,32.3356,31.1209,458,44167,0.435345,0.09,1,776264,775806,458
37799401,22.4671,30.2242,448,44215,0.431069,0.11,1,776284,775836,448
37802321,27.6934,23.6448,455,44263,0.446214,0.05,1,776313,775858,455
37805241,18.3387,26.329,444,44311,0.417243,0.15,1,776329,775885,444
37808161,39.6677,16.4658,475,44359,0.443449,0.19,1,776374,775899,475
37811081,42.3335,39.2932,473,44407,0.46469,0.23,1,776417,775944,473
37814001,26.0667,39.0586,456,44455,0.500938,0.27,1,776439,775983,456
37816921,6.81334,25.4117,436,44502,0.508188,0.33,1,776441,776005,436
37819841,44.5627,46.6823,438,44549,0.509637,0.35,1,776495,776057,438
37822761,32.9125,31.7365,440,44596,0.525927,0.43,1,776525,776085,440
37825681,35.3825,32.7473,443,44643,0.465186,0.41,1,776561,776118,443
37828601,37.4765,37.7495,442,44690,0.485037,0.47,1,776599,776157,442
37831521,32.2953,29.9499,445,44737,0.505007,0.49,1,776630,776185,445
37834441,16.0591,16.39,444,44784,0.477001,0.45,1,776642,776198,444
37837361,29.6118,29.678,444,44831,0.5354,0.43,1,776675,776231,444
37840281,31.5224,32.3356,443,44878,0.51508,0.43,1,776707,776264,443
37843201,22.3045,22.4671,443,44925,0.511016,0.45,1,776727,776284,443
37846121,26.8609,27.6934,442,44972,0.542203,0.41,1,776755,776313,442
37849041,18.1722,18.3387,442,45019,0.532441,0.45,1,776771,776329,442
37851961,42.0344,39.6677,445,45066,0.530488,0.47,1,776819,776374,445
37854881,42.8069,42.3335,445,45113,0.562098,0.51,1,776862,776417,445
37857801,27.7614,26.0667,447,45160,0.584419,0.51,1,776886,776439,447
37860721,7.15228,6.81334,447,45207,0.588884,0.51,1,776888,776441,447
37863641,44.6305,44.5627,447,45254,0.653777,0.53,1,776942,776495,447
37866561,32.1261,32.9125,446,45301,0.634755,0.45,1,776971,776525,446
37869481,33.6252,35.3825,444,45348,0.678951,0.49,1,777005,776561,444
37872401,37.125,37.4765,444,45395,0.70379,0.51,1,777043,776599,444
37875321,33.025,32.2953,445,45441,0.724758,0.47,1,777075,776630,445
37878241,16.205,16.0591,445,45487,0.728952,0.55,1,777087,776642,445
37881161,31.241,29.6118,447,45533,0.74579,0.51,1,777122,776675,447
37884081,31.8482,31.5224,447,45579,0.733158,0.51,1,777154,776707,447
37887001,22.3696,22.3045,447,45625,0.746632,0.55,1,777174,776727,447
37889921,27.6739,26.8609,448,45671,0.765326,0.53,2,777203,776755,448
37892841,18.3348,18.1722,448,45717,0.769065,0.53,2,777219,776771,448
37895761,40.467,42.0344,446,45763,0.801813,0.57,2,777265,776819,446
37898681,44.0934,42.8069,448,45809,0.824363,0.59,2,777310,776862,448
37901601,28.8187,27.7614,449,45855,0.828873,0.59,2,777335,776886,449
37904521,7.36374,7.15228,449,45901,0.829774,0.67,2,777337,776888,449
37907441,47.8727,44.6305,453,45947,0.829955,0.67,2,777395,776942,453
37910361,31.9745,8.92609,481,45993,0.797991,0.63,2,777423,776942,481
37913281,35.1949,24.9852,488,46039,0.823598,0.69,2,777459,776971,488
37916201,38.239,32.197,493,46085,0.82872,0.71,2,777498,777005,493
37919121,34.8478,36.8394,489,46131,0.861744,0.73,2,777532,777043,489
37922041,16.5696,32.9679,469,46177,0.900349,0.73,2,777544,777075,469
37924961,30.5139,16.1936,491,46223,0.90807,0.75,2,777578,777087,491
37927881,33.3028,31.2387,490,46269,0.877614,0.73,2,777612,777122,490
37930801,22.6606,31.8477,478,46315,0.871523,0.75,2,777632,777154,478
37933721,28.5321,22.3695,488,46361,0.886305,0.77,2,777662,777174,488
37936641,18.5064,27.6739,475,46406,0.889261,0.77,2,777678,777203,475
37939561,40.5013,18.3348,505,46451,0.905852,0.81,2,777724,777219,505
37942481,45.7003,40.467,506,46496,0.89317,0.83,2,777771,777265,506
37945401,28.3401,44.0934,485,46541,0.922634,0.83,2,777795,777310,485
37948321,7.26801,28.8187,462,46586,0.928527,0.83,2,777797,777335,462
38162941,512,572,470,21900,0.91,1,2,780060,779590,470
38165861,175.2,157.6,507,22724,0.894,0.93,2,780151,779644,507
38168781,83.04,97.12,485,22817,0.9068,0.95,2,780211,779726,485
38171701,61.408,53.824,498,22910,0.92536,0.89,2,780267,779769,498
38259301,66,0,541,25540,0.67,1,1,782121,781580,541
38262221,44.4,47.2,521,25623,0.718,1,1,782160,781639,521
38265141,100.88,57.44,576,25706,0.7116,1,1,782275,781699,576
38268061,80.176,96.288,545,25788,0.67832,0.92,1,782350,781805,545
38270981,48.8352,80.8576,509,25870,0.687664,0.99,1,782391,781882,509
38273901,36.167,47.3715,503,25952,0.673533,0.97,1,782424,781921,503
38276821,30.4334,38.2743,496,26034,0.734707,0.93,1,782453,781957,496
38279741,53.2867,34.0549,522,26115,0.698941,0.81,1,782512,781990,522
38282661,62.6573,58.811,522,26196,0.675788,0.67,1,782577,782055,522
38285581,43.7315,64.5622,495,26277,0.719158,0.73,1,782616,782121,495
38288501,95.9463,44.1124,565,26358,0.743832,0.71,1,782725,782160,565
38291421,82.3893,100.822,529,26438,0.764766,0.67,2,782804,782275,529
38294341,51.6779,80.1645,498,26518,0.784953,0.69,2,782848,782350,498
38297261,36.7356,48.8329,490,26598,0.788991,0.67,2,782881,782391,490
38300181,31.3471,36.1666,487,26678,0.869798,0.75,2,782911,782424,487
38303101,51.0694,30.4333,514,26757,0.91796,0.69,2,782967,782453,514
38306021,63.0139,53.2867,521,26836,0.943592,0.67,2,783033,782512,521
38425741,33,83,496,29899,0.67,1,1,785175,784679,496
38428661,50.6,58.2,499,29970,0.446,1,1,785230,784731,499
38431581,37.32,47.64,488,30041,0.3532,1,1,785264,784776,488
38434501,29.864,38.328,480,30111,0.33464,0.97,1,785292,784812,480
38437421,51.5728,42.0656,494,30181,0.186928,1,1,785349,784855,494
38440341,37.5146,52.4131,473,30251,0.0453856,1,1,785383,784910,473
38443261,72.3029,64.8826,486,30321,0.145077,0.95,1,785464,784978,486
38446181,24.0606,32.9765,473,30391,0.101015,0.83,1,785476,785003,473
38449101,47.2121,59.3953,460,30461,0.0762031,0.69,1,785529,785069,460
38452021,63.0424,70.2791,454,30530,0.103241,0.67,1,785596,785142,454
38454941,36.6085,40.4558,451,30599,0.0766481,0.39,1,785626,785175,451
38457861,42.5217,52.0912,440,30668,0.10333,0.33,1,785670,785230,440
38460781,32.5043,37.6182,436,30737,0.0766659,0.33,1,785700,785264,436
38463701,27.3009,29.9236,434,30806,0.103333,0.15,1,785726,785292,434
38466621,43.0602,51.5847,424,30875,0.0926666,0.01,1,785773,785349,424
38469541,35.012,37.5169,423,30944,0.0425333,0.17,1,785806,785383,423
38472461,74.2024,72.3034,426,31012,0.0645067,0.09,1,785890,785464,426
38475381,22.8405,24.0607,424,31080,0.100901,0.07,1,785900,785476,424
38478301,46.1681,47.2121,423,31148,0.18818,0.11,1,785952,785529,423
38481221,64.4336,63.0424,425,31216,0.221636,0.07,1,786021,785596,425
38484141,37.6867,36.6085,426,31284,0.244327,0.07,1,786052,785626,426
38487061,41.1373,7.3217,468,31352,0.248865,0.11,1,786094,785626,468
38489981,33.8275,36.6643,456,31419,0.249773,0.07,1,786126,785670,456
38492901,25.9655,31.3329,450,31486,0.249955,0.11,1,786150,785700,450
38495821,41.9931,27.0666,470,31553,0.265991,0.09,1,786196,785726,470
38498741,33.1986,43.0133,454,31620,0.349198,0.03,1,786227,785773,454
38501661,77.8397,35.0027,510,31687,0.33384,0.07,1,786316,785806,510
38504581,24.3679,74.2005,437,31754,0.314768,0.11,1,786327,785890,437
38507501,48.0736,22.8401,481,31821,0.326954,0.21,1,786381,785900,481
38510421,65.6147,46.168,499,31887,0.345391,0.23,1,786451,785952,499
38513341,40.3229,64.4336,464,31953,0.317078,0.25,1,786485,786021,464
38516261,41.6646,37.6867,475,32019,0.311416,0.25,1,786527,786052,475
38519181,33.9329,41.1373,465,32085,0.326283,0.25,1,786559,786094,465
38522101,25.9866,33.8275,457,32151,0.345257,0.25,1,786583,786126,457
38525021,43.5973,25.9655,481,32217,0.349051,0.27,1,786631,786150,481
38527941,35.9195,41.9931,469,32283,0.38181,0.37,1,786665,786196,469
38530861,75.9839,33.1986,524,32349,0.420362,0.33,1,786751,786227,524
38533781,23.1968,77.8397,445,32414,0.428072,0.31,1,786761,786316,445
38536701,50.2394,24.3679,491,32479,0.493614,0.33,1,786818,786327,491
38539621,66.8479,48.0736,508,32544,0.554723,0.35,1,786889,786381,508
38542541,38.9696,65.6147,470,32609,0.582945,0.31,1,786921,786451,470
38545461,42.1939,40.3229,479,32674,0.572589,0.31,1,786964,786485,479
38548381,34.0388,41.6646,469,32739,0.602518,0.33,1,786996,786527,469
38551301,8.40776,33.9329,439,32804,0.608504,0.35,1,786998,786559,439
38554221,20.8816,25.9866,439,32868,0.609701,0.35,1,787022,786583,439
38557141,42.5763,43.5973,439,32932,0.65794,0.39,1,787070,786631,439
38560061,38.9153,35.9195,443,32996,0.715588,0.43,1,787108,786665,443
38562981,76.5831,75.9839,443,33060,0.727118,0.43,1,787194,786751,443
38565901,24.1166,23.1968,444,33124,0.745423,0.51,1,787205,786761,444
38568821,54.4233,50.2394,449,33188,0.765085,0.57,2,787267,786818,449
38571741,68.4847,66.8479,450,33252,0.769017,0.59,2,787339,786889,450
38574661,40.0969,38.9696,451,33316,0.785803,0.57,2,787372,786921,451
38577581,42.4194,42.1939,451,33379,0.773161,0.61,2,787415,786964,451
38580501,34.8839,34.0388,452,33442,0.786632,0.61,2,787448,786996,452
38583421,8.57677,8.40776,452,33505,0.789326,0.61,2,787450,786998,452
38586341,20.9154,20.8816,452,33568,0.821865,0.67,2,787474,787022,452
38589261,43.3831,42.5763,453,33631,0.860373,0.73,2,787523,787070,453
38592181,42.2766,38.9153,457,33694,0.804075,0.73,2,787565,787108,457
38595101,78.0553,76.5831,458,33757,0.808815,0.75,2,787652,787194,458
38598021,23.6111,24.1166,457,33820,0.777763,0.77,2,787662,787205,457
38600941,55.1222,54.4233,458,33883,0.755553,0.77,2,787725,787267,458
38603861,68.6244,68.4847,458,33945,0.863111,0.79,2,787797,787339,458
38606781,40.9249,40.0969,459,34007,0.916622,0.77,2,787831,787372,459
38609701,43.385,42.4194,460,34069,0.911324,0.79,2,787875,787415,460
38612621,35.877,34.8839,461,34131,0.910265,0.79,2,787909,787448,461
38615541,8.7754,8.57677,461,34193,0.910053,0.83,2,787911,787450,461
38749861,26,27,492,36930,0.91,1,2,789856,789364,492
38752781,29.2,19.8,504,36987,0.798,1,2,789886,789382,504
38755701,19.44,35.96,481,37044,0.7596,1,2,789903,789422,481
38758621,37.488,32.792,491,37101,0.62392,1,1,789945,789454,491
38761541,36.2976,29.7584,498,37158,0.548784,1,1,789981,789483,498
38764461,38.4595,5.95168,537,37215,0.469757,1,1,790020,789483,537
38767381,34.8919,48.3903,512,37272,0.325951,0.97,1,790054,789542,512
38770301,35.7784,36.0781,515,37329,0.21719,1,1,790090,789575,515
38773221,80.7557,37.6156,569,37386,0.115438,0.91,1,790182,789613,569
38776141,40.9511,84.3231,504,37443,0.0790876,0.99,1,790213,789709,504
38779061,40.9902,44.0646,511,37499,0.0398175,0.93,1,790254,789743,511
38781981,40.198,46.4129,504,37555,0.0639635,0.83,1,790294,789790,504
38784901,28.8396,41.2826,490,37611,0.0207927,0.91,1,790320,789830,490
38787821,26.5679,29.0565,490,37667,0.0441585,0.77,1,790346,789856,490
38790741,15.7136,29.8113,473,37723,0.0328317,0.75,1,790359,789886,473
38793661,30.3427,19.5623,490,37779,0.0465663,0.59,1,790393,789903,490
38796581,33.2685,37.5125,482,37835,0.0173133,0.53,1,790427,789945,482
38799501,33.8537,36.3025,480,37891,0.0434627,0.45,1,790461,789981,480
38802421,29.9707,38.4605,470,37947,0.0966925,0.29,1,790490,790020,470
38805341,31.5941,34.8921,468,38003,0.0913385,0.19,1,790522,790054,468
38808261,74.3188,35.7784,517,38059,0.122268,0.09,1,790607,790090,517
38811181,39.6638,80.7557,456,38115,0.144454,0.07,1,790638,790182,456
38814101,38.3328,40.9511,463,38170,0.180891,0.03,1,790676,790213,463
38817021,41.2666,40.9902,464,38225,0.188178,0.07,1,790718,790254,464
38819941,27.4533,40.198,448,38280,0.157636,0.01,1,790742,790294,448
38822861,27.0907,28.8396,449,38335,0.199527,0.05,1,790769,790320,449
38825781,15.0181,26.5679,435,38390,0.223905,0.03,1,790781,790346,435
38828701,31.0036,15.7136,457,38445,0.212781,0.05,1,790816,790359,457
38831621,32.6007,30.3427,456,38500,0.258556,0.01,1,790849,790393,456
38834541,34.5201,33.2685,457,38555,0.203711,0.05,1,790884,790427,457
38837461,32.504,33.8537,455,38610,0.192742,0.11,1,790916,790461,455
38840381,8.10081,29.9707,428,38665,0.190548,0.09,1,790918,790490,428
38843301,25.6202,31.5941,426,38720,0.23811,0.13,1,790948,790522,426
38846221,74.724,74.3188,428,38775,0.199622,0.15,1,791035,790607,428
38849141,42.9448,39.6638,432,38829,0.271924,0.19,1,791070,790638,432
38852061,38.189,38.3328,431,38883,0.238385,0.19,1,791107,790676,431
38854981,41.2378,41.2666,431,38937,0.263677,0.15,1,791149,790718,431
38857901,26.6476,27.4533,430,38991,0.268735,0.21,1,791172,790742,430
38860821,29.3295,27.0907,433,39045,0.301747,0.23,1,791202,790769,433
38863741,13.8659,15.0181,431,39099,0.276349,0.21,1,791212,790781,431
38866661,31.5732,31.0036,432,39153,0.27127,0.27,1,791248,790816,432
38869581,33.5146,32.6007,433,39207,0.318254,0.19,1,791282,790849,433
38872501,33.1029,34.5201,431,39261,0.375651,0.19,1,791315,790884,431
38875421,32.2206,32.504,431,39315,0.35513,0.19,1,791347,790916,431
38878341,8.04412,8.10081,431,39369,0.351026,0.25,1,791349,790918,431
38881261,26.4088,25.6202,432,39423,0.382205,0.19,1,791380,790948,432
38884181,75.6818,74.724,433,39477,0.404441,0.29,1,791468,791035,433
38887101,43.9364,42.9448,434,39530,0.408888,0.23,1,791504,791070,434
38890021,37.5873,38.189,433,39583,0.425778,0.27,1,791540,791107,433
38892941,41.9175,41.2378,434,39636,0.413156,0.27,1,791583,791149,434
38895861,27.5835,26.6476,435,39689,0.378631,0.31,1,791607,791172,435
38898781,29.5167,29.3295,435,39742,0.371726,0.27,1,791637,791202,435
38901701,14.7033,13.8659,436,39795,0.418345,0.27,1,791648,791212,436
38904621,30.9407,31.5732,435,39848,0.459669,0.33,1,791683,791248,435
38907541,35.7881,33.5146,438,39901,0.515934,0.39,1,791720,791282,438
38910461,34.3576,33.1029,439,39954,0.559187,0.35,1,791754,791315,439
38913381,32.4715,32.2206,439,40007,0.615837,0.35,1,791786,791347,439
38916301,8.0943,8.04412,439,40060,0.595167,0.35,1,791788,791349,439
38919221,27.2189,1.60882,471,40113,0.591033,0.39,1,791820,791349,471
38922141,75.0438,25.1218,527,40166,0.622207,0.41,1,791907,791380,527
38925061,43.8088,75.4244,475,40219,0.644441,0.41,1,791943,791468,475
38927981,38.3618,43.8849,476,40271,0.680888,0.43,1,791980,791504,476
38930901,41.2724,37.577,482,40323,0.704178,0.41,1,792022,791540,482
38933821,27.4545,41.9154,463,40375,0.724836,0.37,1,792046,791583,463
38936741,31.0909,27.5831,471,40427,0.728967,0.37,1,792078,791607,471
38939661,14.2182,29.5166,451,40479,0.729793,0.43,1,792088,791637,451
38942581,34.0436,14.7033,479,40531,0.761959,0.47,2,792127,791648,479
38945501,39.6087,30.9407,485,40583,0.752392,0.53,2,792168,791683,485
38948421,35.9217,35.7881,483,40635,0.734478,0.57,1,792203,791720,483
38951341,33.5843,34.3576,482,40687,0.746896,0.63,1,792236,791754,482
38954261,8.31687,32.4715,452,40739,0.749379,0.59,1,792238,791786,452
38957181,27.2634,8.0943,482,40791,0.749876,0.59,1,792270,791788,482
38960101,76.6527,27.2189,539,40843,0.749975,0.63,1,792359,791820,539
38963021,44.9305,75.0438,489,40895,0.781995,0.65,2,792396,791907,489
38965941,40.9861,43.8088,493,40947,0.788399,0.69,2,792436,791943,493
38968861,42.5972,38.3618,499,40999,0.82168,0.71,2,792479,791980,499
38971781,27.7194,41.2724,481,41050,0.828336,0.73,2,792503,792022,481
38974701,31.1439,27.4545,489,41101,0.829667,0.73,2,792535,792046,489
38977621,14.2288,31.0909,467,41152,0.861933,0.73,2,792545,792078,467
38980541,37.2458,14.2182,500,41203,0.884387,0.77,2,792588,792088,500
38983461,37.8492,34.0436,499,41254,0.904877,0.75,2,792626,792127,499
38986381,34.7698,39.6087,492,41305,0.924976,0.73,2,792660,792168,492
38989301,34.154,35.9217,491,41356,0.928995,0.75,2,792694,792203,491
38992221,8.43079,33.5843,460,41407,0.929799,0.75,2,792696,792236,460
39152821,37,26,523,44123,0.67,1,1,794596,794073,523
39155741,30.6,38.8,510,44171,0.622,1,1,794625,794115,510
39158661,32.52,29.36,516,44219,0.4844,1,1,794658,794142,516
39161581,33.704,32.272,517,44267,0.36088,1,1,794692,794175,517
39164501,44.3408,49.6544,510,44315,0.160176,1,1,794739,794229,510
39167421,38.4682,35.5309,515,44363,0.0400352,1,1,794776,794261,515
39170341,36.4936,37.5062,513,44411,0.00800704,1,1,794812,794299,513
39173261,32.0987,31.5012,514,44458,0.0256014,1,1,794843,794329,514
39176181,24.0197,31.1002,505,44505,0.00512028,1,1,794865,794360,505
39179101,21.6039,31.0201,495,44552,0.0730241,1,1,794886,794391,495
39182021,33.9208,32.604,499,44599,0.0386048,1,1,794923,794424,499
39184941,25.9842,28.9208,495,44646,0.095721,1,1,794947,794452,495
39187861,17.1968,34.5842,474,44693,0.0591442,0.81,1,794962,794488,474
39190781,29.0394,40.5168,464,44740,0.0358288,0.77,1,794994,794530,464
39193701,22.6079,31.3034,456,44787,0.0311658,0.67,1,795015,794559,456
39196621,31.7216,35.8607,453,44834,0.0302332,0.61,1,795049,794596,453
39199541,27.1443,30.3721,450,44881,0.0140466,0.45,1,795075,794625,450
39202461,23.8289,32.4744,440,44928,0.0428093,0.33,1,795098,794658,440
39205381,24.7658,33.6949,431,44975,0.0645619,0.11,1,795123,794692,431
39208301,36.9532,44.339,424,45022,0.132912,0.01,1,795163,794739,424
39211221,35.3906,38.4678,422,45069,0.0825825,0,1,795198,794776,422
39214141,37.4781,36.4936,424,45116,0.0165165,0.03,1,795236,794812,424
39217061,31.4956,32.0987,423,45163,0.0273033,0,1,795266,794843,423
39219981,23.8991,24.0197,423,45210,0.0614607,0.09,1,795288,794865,423
39222901,20.7798,21.6039,422,45257,0.0202921,0.03,1,795308,794886,422
39225821,33.756,33.9208,422,45304,0.108058,0.11,1,795345,794923,422
39228741,25.9512,25.9842,422,45351,0.0616117,0.05,1,795369,794947,422
39231661,17.1902,17.1968,422,45398,0.0363223,0.03,1,795384,794962,422
39234581,29.838,29.0394,423,45444,0.0472645,0.03,1,795417,794994,423
39237501,21.9676,22.6079,422,45490,0.0174529,0.03,1,795437,795015,422
39240421,31.5935,31.7216,422,45536,0.0274906,0.01,1,795471,795049,422
39243341,28.7187,27.1443,424,45582,0.0454981,0.05,1,795499,795075,424
39246261,22.5437,23.8289,422,45628,0.0330996,0.07,1,795520,795098,422
39249181,25.3087,24.7658,423,45674,0.0786199,0.15,1,795546,795123,423
39252101,38.6618,36.9532,425,45720,0.135724,0.07,1,795588,795163,425
39255021,34.1323,35.3906,423,45766,0.179145,0,1,795621,795198,423
39257941,36.4265,37.4781,422,45812,0.075829,0.03,1,795658,795236,422
39260861,31.2853,31.4956,422,45858,0.0391658,0.07,1,795688,795266,422
39263781,23.8571,23.8991,422,45904,0.0158332,0.01,1,795710,795288,422
39266701,20.7714,20.7798,422,45950,0.0111666,0.01,1,795730,795308,422
39269621,32.9543,4.15596,458,45996,0.0582333,0.13,1,795766,795308,458
39272541,25.7909,30.4312,445,46042,0.0676467,0.05,1,795790,795345,445
39275461,17.1582,25.2862,436,46088,0.133529,0.03,1,795805,795369,436
39278381,29.8316,17.0572,454,46134,0.114706,0.05,1,795838,795384,454
39281301,21.9663,29.8114,441,46180,0.110941,0.01,1,795858,795417,441
39284221,31.5933,21.9623,455,46226,0.0781882,0.03,1,795892,795437,455
39287141,28.7187,31.5925,449,46272,0.0396376,0.05,1,795920,795471,449
39290061,23.3437,28.7185,443,46318,0.0479275,0.03,1,795942,795499,443
39292981,26.2687,22.5437,449,46364,0.0335855,0.09,1,795969,795520,449
39295901,42.0537,25.3087,469,46409,0.0147171,0.15,1,796015,795546,469
39298821,37.2108,38.6618,463,46454,0.0109434,0.19,1,796051,795588,463
39301741,29.8421,34.1323,458,46499,0.0421887,0.05,1,796079,795621,458
39304661,29.9684,36.4265,451,46544,0.0164377,0.03,1,796109,795658,451
39307581,23.5937,31.2853,443,46589,0.0272875,0.01,1,796131,795688,443
39310501,20.7187,23.8571,441,46634,0.0134575,0.01,1,796151,795710,441
39313421,35.3437,20.7714,460,46679,0.0586915,0.07,1,796190,795730,460
39316341,27.8688,32.9543,450,46724,0.0997383,0.07,1,796216,795766,450
39319261,17.5737,25.7909,441,46769,0.0919477,0.15,1,796231,795790,441
39322181,29.9147,17.1582,459,46814,0.12239,0.11,1,796264,795805,459
39325101,20.383,29.8316,444,46859,0.144478,0.11,1,796282,795838,444
39328021,29.6766,21.9663,456,46904,0.148896,0.07,1,796314,795858,456
39330941,28.3353,31.5933,450,46949,0.149779,0.03,1,796342,795892,450
39333861,24.0671,28.7187,445,46994,0.133956,0.05,1,796365,795920,445
39336781,25.6134,23.3437,449,47039,0.130791,0.03,1,796391,795942,449
39339701,42.7227,26.2687,469,47084,0.130158,0.01,1,796438,795969,469
39342621,36.5445,42.0537,458,47129,0.146032,0.01,1,796473,796015,458
39345541,30.5089,37.2108,451,47174,0.149206,0.05,1,796502,796051,451
39348461,28.5018,29.8421,451,47219,0.165841,0.01,1,796530,796079,451
39351381,23.3004,29.9684,443,47264,0.137168,0.03,1,796552,796109,443
39354301,20.6601,23.5937,441,47309,0.0834337,0.01,1,796572,796131,441
39357221,37.732,20.7187,463,47354,0.0246867,0.07,1,796614,796151,463
39360141,9.1464,35.3437,426,47399,0.0289373,0.11,1,796616,796190,426
39363061,23.4293,27.8688,427,47443,0.0777875,0.09,1,796643,796216,427
39365981,15.8859,17.5737,426,47487,0.0715575,0.13,1,796657,796231,426
39368901,31.9772,29.9147,429,47531,0.0703115,0.15,1,796693,796264,429
39371821,20.7954,20.383,429,47575,0.102062,0.15,1,796711,796282,429
39374741,29.7591,29.6766,429,47619,0.0924125,0.15,1,796743,796314,429
39377661,28.3518,28.3353,429,47663,0.138482,0.13,1,796771,796342,429
39380581,23.2704,24.0671,428,47707,0.163696,0.13,1,796793,796365,428
39383501,25.4541,25.6134,428,47751,0.184739,0.13,1,796819,796391,428
39386421,43.4908,42.7227,429,47795,0.156948,0.15,1,796867,796438,429
39389341,37.4982,36.5445,430,47839,0.11939,0.15,1,796903,796473,430
39392261,30.6996,30.5089,430,47883,0.127878,0.17,1,796932,796502,430
39395181,26.9399,28.5018,428,47927,0.161576,0.13,1,796958,796530,428
39398101,21.388,23.3004,426,47971,0.136315,0.07,1,796978,796552,426
39401021,18.6776,20.6601,424,48015,0.163263,0.01,1,796996,796572,424
39403941,36.5355,37.732,423,48059,0.168653,0.03,1,797037,796614,423
39406861,8.9071,9.1464,423,48103,0.169731,0.09,1,797039,796616,423
39409781,24.9814,23.4293,425,48147,0.201946,0.07,1,797068,796643,425
39412701,16.1963,15.8859,425,48191,0.192389,0.07,1,797082,796657,425
39415621,32.0393,31.9772,425,48235,0.254478,0.11,1,797118,796693,425
39418541,20.8079,20.7954,425,48279,0.282896,0.09,1,797136,796711,425
39421461,30.5616,29.7591,426,48323,0.272579,0.15,1,797169,796743,426
39424381,30.1123,28.3518,428,48367,0.286516,0.17,1,797199,796771,428
39427301,24.4225,23.2704,429,48411,0.321303,0.19,1,797222,796793,429
39430221,25.6845,25.4541,429,48455,0.328261,0.15,1,797248,796819,429
39433141,41.9369,43.4908,427,48498,0.297652,0.11,1,797294,796867,427
39436061,37.1874,37.4982,427,48541,0.32353,0.13,1,797330,796903,427
39438981,31.4375,30.6996,428,48584,0.344706,0.17,1,797360,796932,428
39441901,27.0875,26.9399,428,48627,0.380941,0.13,1,797386,796958,428
39444821,21.4175,21.388,428,48670,0.356188,0.17,1,797406,796978,428
39447741,20.2835,18.6776,430,48713,0.367238,0.17,1,797426,796996,430
39450661,37.6567,36.5355,431,48756,0.449448,0.17,1,797468,797037,431
39453581,9.13134,8.9071,431,48799,0.46589,0.21,1,797470,797039,431
39456501,24.2263,24.9814,430,48842,0.469178,0.21,1,797498,797068,430
39459421,16.0453,4.99628,444,48885,0.469836,0.19,1,797512,797068,444
39462341,33.6091,12.1993,468,48928,0.469967,0.27,1,797550,797082,468
39465261,21.9218,31.2399,451,48971,0.485993,0.29,1,797569,797118,451
39468181,29.9844,20.648,465,49014,0.489199,0.27,1,797601,797136,465
39471101,32.3969,30.5296,465,49057,0.50584,0.29,1,797634,797169,465
39474021,24.8794,30.1059,458,49100,0.557168,0.33,1,797657,797199,458
39476941,25.7759,24.4212,461,49143,0.567434,0.33,1,797683,797222,461
39479861,41.9552,25.6842,481,49186,0.585487,0.29,1,797729,797248,481
39482781,37.991,41.9368,472,49229,0.605097,0.33,1,797766,797294,472
39485701,31.5982,37.1874,466,49272,0.577019,0.35,1,797796,797330,466
39488621,28.7196,31.4375,464,49315,0.603404,0.39,1,797824,797360,464
39491541,21.7439,27.0875,458,49358,0.608681,0.35,1,797844,797386,458
39494461,21.9488,21.4175,460,49401,0.577736,0.37,1,797866,797406,460
39497381,41.1898,20.2835,486,49444,0.539547,0.47,1,797912,797426,486
39500301,9.83795,37.6567,446,49487,0.531909,0.47,1,797914,797468,446
39503221,24.3676,9.13134,472,49530,0.546382,0.47,1,797942,797470,472
39506141,16.0735,24.2263,458,49573,0.565276,0.47,1,797956,797498,458
39509061,33.6147,16.0453,482,49615,0.569055,0.47,1,797994,797512,482
39511981,22.7229,33.6091,464,49657,0.585811,0.49,1,798014,797550,464
39514901,30.9446,21.9218,478,49699,0.605162,0.49,1,798047,797569,478
39517821,34.1889,29.9844,481,49741,0.625032,0.51,1,798082,797601,481
39520741,26.0378,32.3969,472,49783,0.629007,0.57,1,798106,797634,472
39523661,26.8076,24.8794,476,49825,0.629801,0.57,1,798133,797657,476
39526581,42.1615,25.7759,496,49867,0.67796,0.59,1,798179,797683,496
39529501,37.2323,41.9552,486,49909,0.703592,0.61,1,798215,797729,486
39532421,31.4465,37.991,479,49951,0.708718,0.57,1,798245,797766,479
39535341,30.2893,31.5982,479,49993,0.709744,0.61,1,798275,797796,479
39538261,22.0579,28.7196,471,50035,0.741949,0.61,1,798295,797824,471
39541181,20.4116,21.7439,471,50077,0.76439,0.57,2,798315,797844,471
39544101,40.0823,21.9488,494,50119,0.784878,0.53,2,798360,797866,494
39547021,9.61646,41.1898,450,50161,0.756976,0.53,2,798362,797912,450
39549941,25.1233,9.83795,477,50203,0.751395,0.55,2,798391,797914,477
39552861,16.2247,24.3676,463,50245,0.750279,0.57,2,798405,797942,463
39555781,33.6449,16.0735,487,50287,0.798056,0.57,2,798443,797956,487
39558701,8.32899,33.6147,451,50329,0.807611,0.59,2,798445,797994,451
39561621,18.4658,22.7229,452,50371,0.825522,0.61,2,798466,798014,452
39564541,31.6932,30.9446,454,50413,0.781104,0.63,2,798501,798047,454
39567461,33.5386,34.1889,453,50455,0.820221,0.63,2,798535,798082,453
39570381,26.7077,26.0378,454,50497,0.812044,0.63,2,798560,798106,454
39573301,27.7415,26.8076,455,50539,0.810409,0.69,2,798588,798133,455
39576221,43.1483,42.1615,456,50581,0.858082,0.71,2,798635,798179,456
39579141,38.2297,37.2323,457,50623,0.867616,0.71,2,798672,798215,457
39582061,31.6459,31.4465,457,50665,0.917523,0.71,2,798702,798245,457
39584981,31.9292,30.2893,459,50707,0.895505,0.75,2,798734,798275,459
39587901,23.1858,22.0579,460,50749,0.907101,0.77,2,798755,798295,460
39590821,20.6372,20.4116,460,50791,0.90942,0.79,2,798775,798315,460
39593741,39.3274,40.0823,459,50832,0.893884,0.75,2,798819,798360,459
39596661,9.46549,9.61646,459,50873,0.922777,0.75,2,798821,798362,459
39599581,25.0931,25.1233,459,50914,0.912555,0.75,2,798850,798391,459
39602501,16.2186,16.2247,459,50955,0.878511,0.81,2,798864,798405,459
39958741,276,331,427,24820,0.03,0.13,1,802510,802083,427
39961661,76.8,79.8,437,25633,0.014,0.03,1,802537,802100,437
39964581,28.96,39.16,425,25716,0.0428,0.03,1,802554,802129,425
39967501,40.192,32.632,437,25798,0.00856,0.05,1,802597,802160,437
39970421,84.0384,65.7264,458,25880,0.041712,0.03,1,802692,802234,458
39973341,56.8077,59.5453,450,25962,0.0483424,0.05,1,802742,802292,450
39976261,50.5615,51.9091,449,26044,0.0336685,0.05,1,802791,802342,449
39979181,63.7123,60.7818,453,26125,0.0307337,0.07,1,802858,802405,453
39982101,29.5425,45.7564,432,26206,0.0621467,0.03,1,802879,802447,432
39985021,69.9085,59.5513,449,26287,0.0204293,0.01,1,802959,802510,449
39987941,27.5817,33.5103,439,26368,0.0280859,0.05,1,802976,802537,439
39990861,39.9163,20.3021,465,26448,0.00561717,0,1,803019,802554,465
39993781,84.7833,38.4604,518,26528,0.0411234,0.05,1,803115,802597,518
39996701,55.3567,83.6921,471,26608,0.0482247,0.05,1,803163,802692,471
39999621,51.0713,56.7384,471,26688,0.0336449,0.03,1,803213,802742,471
40002541,63.8143,50.5477,489,26767,0.094729,0.03,1,803280,802791,489
40005461,31.1629,63.7095,445,26846,0.0909458,0.07,1,803303,802858,445
40008381,7.83257,29.5419,426,26925,0.0901892,0.01,1,803305,802879,426
40011301,62.3665,69.9084,422,27004,0.0260378,0.03,1,803381,802959,422
40014221,26.8733,27.5817,423,27082,0.0132076,0,1,803399,802976,423
40017141,39.7747,39.9163,423,27160,0.00264151,0.05,1,803442,803019,423
40020061,85.5549,84.7833,424,27238,0.0885283,0.05,1,803539,803115,424
40022981,53.911,55.3567,422,27316,0.0737057,0.03,1,803585,803163,422
40025901,52.3822,51.0713,424,27394,0.0387411,0.11,1,803637,803213,424
40028821,66.4764,63.8143,427,27471,0.0477482,0.09,1,803707,803280,427
40031741,30.8953,31.1629,426,27548,0.0815496,0.09,1,803729,803303,426
40034661,7.77906,7.83257,426,27625,0.0563099,0.01,1,803731,803305,426
40037581,59.1558,62.3665,422,27702,0.083262,0.01,1,803803,803381,422
40040501,26.2312,26.8733,422,27778,0.0886524,0,1,803821,803399,422
40043421,39.6462,39.7747,422,27854,0.0257305,0.11,1,803864,803442,422
40046341,87.9292,85.5549,425,27930,0.109146,0.07,1,803964,803539,425
40049261,52.7858,53.911,423,28006,0.0938292,0.03,1,804008,803585,423
40052181,52.1572,52.3822,423,28082,0.0747658,0.05,1,804060,803637,423
40055101,67.2314,66.4764,424,28157,0.0869532,0.09,1,804131,803707,424
40058021,31.0463,30.8953,424,28232,0.121391,0.05,1,804153,803729,424
40060941,7.80926,7.77906,424,28307,0.160278,0.09,1,804155,803731,424
40063861,59.9619,59.1558,425,28382,0.152056,0.09,1,804228,803803,425
40066781,25.5924,11.8312,442,28457,0.166411,0.09,1,804245,803803,442
40069701,37.1185,16.7662,464,28531,0.185282,0.01,1,804285,803821,464
40072621,90.6237,37.7532,525,28605,0.0930564,0.13,1,804389,803864,525
40075541,53.3247,87.5506,469,28679,0.0906113,0.09,1,804433,803964,469
40078461,50.6649,52.7101,475,28753,0.138122,0.07,1,804483,804008,475
40081381,70.133,52.142,498,28827,0.115624,0.09,1,804558,804060,498
40084301,31.6266,67.2284,449,28900,0.0791249,0.13,1,804580,804131,449
40087221,7.92532,31.0457,429,28973,0.071825,0.17,1,804582,804153,429
40090141,61.5851,7.80914,502,29046,0.102365,0.15,1,804657,804155,502
40093061,25.917,59.9618,446,29119,0.092473,0.17,1,804674,804228,446
40095981,33.1834,25.5924,464,29192,0.122495,0.19,1,804709,804245,464
40098901,89.8367,37.1185,528,29265,0.192499,0.07,1,804813,804285,528
40101821,53.9673,90.6237,469,29337,0.2065,0.09,1,804858,804389,469
40104741,52.3935,53.3247,477,29409,0.2093,0.15,1,804910,804433,477
40107661,68.0787,50.6649,499,29481,0.27386,0.11,1,804982,804483,499
40110581,31.2157,70.133,446,29553,0.286772,0.07,1,805004,804558,446
40113501,7.84315,31.6266,426,29625,0.289354,0.07,1,805006,804580,426
40116421,63.1686,7.92532,501,29696,0.321871,0.11,1,805083,804582,501
40119341,25.4337,61.5851,442,29767,0.328374,0.09,1,805099,804657,442
40122261,35.4867,25.917,463,29838,0.329675,0.13,1,805137,804674,463
40125181,8.69735,33.1834,430,29909,0.361935,0.21,1,805139,804709,430
40128101,86.5395,89.8367,432,29980,0.384387,0.21,1,805245,804813,432
40131021,53.3079,53.9673,432,30051,0.404877,0.21,1,805290,804858,432
40133941,53.8616,52.3935,434,30121,0.408975,0.29,1,805344,804910,434
40136861,69.9723,68.0787,436,30191,0.441795,0.29,1,805418,804982,436
40139781,32.3945,31.2157,437,30261,0.464359,0.29,1,805441,805004,437
40142701,8.07889,7.84315,437,30331,0.468872,0.33,1,805443,805006,437
40145621,64.0158,63.1686,438,30401,0.501774,0.33,1,805521,805083,438
40148541,25.6032,25.4337,438,30471,0.508355,0.33,1,805537,805099,438
40151461,35.5206,35.4867,438,30540,0.477671,0.37,1,805575,805137,438
40154381,8.70413,8.69735,438,30609,0.519534,0.39,1,805577,805139,438
40157301,87.3408,86.5395,439,30678,0.575907,0.41,1,805684,805245,439
40160221,55.0682,53.3079,441,30747,0.587181,0.41,1,805731,805290,441
40163141,55.0136,53.8616,442,30816,0.669436,0.45,1,805786,805344,442
40166061,71.8027,69.9723,444,30885,0.653887,0.47,1,805862,805418,444
40168981,33.5605,32.3945,445,30954,0.698777,0.47,1,805886,805441,445
40171901,8.31211,8.07889,445,31022,0.707756,0.51,1,805888,805443,445
40174821,65.6624,64.0158,447,31090,0.741551,0.51,1,805968,805521,447
40177741,25.9325,25.6032,447,31158,0.73231,0.47,1,805984,805537,447
40180661,34.7865,35.5206,446,31226,0.762462,0.53,2,806021,805575,446
40183581,8.5573,8.70413,446,31294,0.768492,0.53,2,806023,805577,446
40186501,88.9115,1.74083,555,31362,0.785698,0.59,2,806132,805577,555
40189421,56.9823,85.9482,497,31429,0.82114,0.59,2,806181,805684,497
40192341,59.3965,54.7896,510,31496,0.860228,0.69,2,806241,805731,510
40195261,71.0793,54.9579,529,31563,0.868046,0.65,2,806315,805786,529
40198181,34.2159,71.7916,478,31630,0.885609,0.71,2,806340,805862,478
40201101,8.44317,33.5583,456,31697,0.889122,0.71,2,806342,805886,456
40204021,67.2886,8.31166,536,31764,0.889824,0.75,2,806424,805888,536
40206941,27.8577,65.6623,474,31831,0.889965,0.73,2,806442,805968,474
40209861,35.9715,25.9325,496,31897,0.873993,0.77,2,806480,805984,496
40212781,8.79431,34.7865,461,31963,0.870799,0.77,2,806482,806021,461
40215701,90.5589,8.5573,570,32029,0.87016,0.79,2,806593,806023,570
40218621,58.1118,88.9115,511,32095,0.934032,0.83,2,806643,806132,511
40335421,28,20,511,34633,0.83,1,2,808379,807868,511
40338341,32,31.2,510,34694,0.798,1,2,808412,807902,510
40341261,78.4,26.24,575,34755,0.5836,1,1,808502,807927,575
40344181,48.48,81.248,521,34816,0.46072,1,1,808543,808022,521
40347101,32.096,55.4496,500,34877,0.356144,1,1,808571,808071,500
40350021,40.0192,27.8899,521,34938,0.223229,1,1,808613,808092,521
40352941,61.6038,40.778,544,34999,0.100646,1,1,808680,808136,544
40355861,37.1208,68.1556,500,35059,0.0601292,1,1,808711,808211,500
40358781,33.8242,37.6311,503,35119,0.100026,0.92,1,808744,808241,503
40361701,41.1648,30.7262,517,35179,0.0440052,0.91,1,808787,808270,517
40364621,29.833,46.9452,493,35239,0.048801,0.85,1,808814,808321,493
40367541,25.9666,33.389,488,35299,0.0337602,0.83,1,808839,808351,488
40370461,29.9933,29.0778,491,35359,0.062752,0.79,1,808870,808379,491
40373381,66.7987,32.2156,534,35419,0.0845504,0.53,1,808946,808412,534
40376301,46.1597,78.4431,485,35479,0.0889101,0.43,1,808987,808502,485
40379221,23.6319,48.4886,462,35539,0.057782,0.33,1,809005,808543,462
40382141,35.1264,32.0977,472,35598,0.0835564,0.19,1,809043,808571,472
40385061,53.4253,40.0195,488,35657,0.104711,0.07,1,809101,808613,488
40387981,12.2851,61.6039,423,35716,0.140942,0.05,1,809103,808680,423
40390901,28.057,37.1208,424,35775,0.164188,0.11,1,809135,808711,424
40393821,34.4114,33.8242,427,35834,0.136838,0.03,1,809171,808744,427
40396741,39.6823,41.1648,425,35893,0.131368,0.05,1,809212,808787,425
40399661,27.9365,29.833,423,35952,0.146274,0.03,1,809237,808814,423
40402581,27.1873,25.9666,425,36011,0.213255,0.07,1,809264,808839,425
40405501,30.2375,29.9933,425,36070,0.210651,0.09,1,809295,808870,425
40408421,67.6475,66.7987,426,36129,0.24213,0.09,1,809372,808946,426
40411341,46.3295,46.1597,426,36187,0.248426,0.05,1,809413,808987,426
40414261,22.0659,23.6319,424,36245,0.281685,0.09,1,809429,809005,424
40417181,37.2132,35.1264,427,36303,0.288337,0.11,1,809470,809043,427
40420101,54.6426,53.4253,428,36361,0.305667,0.15,1,809529,809101,428
40423021,12.5285,12.2851,428,36419,0.309133,0.17,1,809531,809103,428
40425941,28.1057,28.057,428,36477,0.309827,0.13,1,809563,809135,428
40428861,35.2211,34.4114,429,36535,0.325965,0.13,1,809600,809171,429
40431781,39.0442,39.6823,428,36593,0.361193,0.15,1,809640,809212,428
40434701,31.0088,27.9365,432,36651,0.432239,0.23,1,809669,809237,432
40437621,27.0018,27.1873,431,36709,0.414448,0.21,1,809695,809264,431
40440541,31.0004,30.2375,432,36767,0.44289,0.25,1,809727,809295,432
40443461,67.8001,67.6475,432,36824,0.464578,0.25,1,809804,809372,432
40446381,47.96,46.3295,434,36881,0.516916,0.29,1,809847,809413,434
40449301,22.392,22.0659,434,36938,0.527383,0.29,1,809863,809429,434
40452221,38.8784,37.2132,436,36995,0.545477,0.31,1,809906,809470,436
40455141,54.1757,54.6426,435,37052,0.581095,0.31,1,809964,809529,435
40458061,12.4351,12.5285,435,37109,0.556219,0.31,1,809966,809531,435
40460981,28.087,28.1057,435,37166,0.551244,0.31,1,809998,809563,435
40463901,36.8174,5.62114,474,37223,0.550249,0.33,1,810037,809563,474
40466821,40.9635,30.7242,479,37280,0.56605,0.37,1,810079,809600,479
40469741,32.9927,38.1448,470,37337,0.58521,0.45,1,810110,809640,470
40472661,27.3985,30.829,467,37394,0.605042,0.41,1,810136,809669,467
40475581,31.0797,26.9658,473,37451,0.625008,0.45,1,810168,809695,473
40478501,69.4159,30.9932,520,37507,0.677002,0.47,1,810247,809727,520
40481421,49.8832,67.7986,488,37563,0.6714,0.53,1,810292,809804,488
40484341,22.7766,47.9597,461,37619,0.67028,0.53,1,810308,809847,461
40487261,40.5553,22.3919,490,37675,0.686056,0.55,1,810353,809863,490
40490181,55.3111,38.8784,506,37731,0.705211,0.59,1,810412,809906,506
40493101,12.6622,54.1757,450,37787,0.709042,0.55,1,810414,809964,450
40496021,28.1324,12.4351,480,37843,0.709808,0.55,1,810446,809966,480
40498941,36.8265,28.087,487,37899,0.693962,0.55,1,810485,809998,487
40501861,41.7653,36.8174,491,37955,0.674792,0.57,1,810528,810037,491
40504781,33.9531,40.9635,481,38011,0.718958,0.59,1,810560,810079,481
40507701,29.1906,32.9927,478,38067,0.775792,0.61,2,810588,810110,478
40510621,31.4381,27.3985,484,38122,0.755158,0.63,2,810620,810136,484
40513541,71.8876,31.0797,534,38177,0.783032,0.69,2,810702,810168,534
40516461,49.5775,69.4159,499,38232,0.804606,0.67,2,810746,810247,499
40519381,22.7155,49.8832,470,38287,0.824921,0.67,2,810762,810292,470
40522301,39.7431,22.7766,498,38342,0.828984,0.69,2,810806,810308,498
40525221,57.5486,40.5553,515,38397,0.813797,0.71,2,810868,810353,515
40528141,13.1097,55.3111,458,38452,0.810759,0.71,2,810870,810412,458
40531061,28.2219,12.6622,488,38507,0.826152,0.71,2,810902,810414,488
40533981,36.0444,28.1324,494,38562,0.86123,0.69,2,810940,810446,494
40536901,40.8089,36.8265,497,38617,0.884246,0.67,2,810982,810485,497
40539821,9.76178,41.7653,456,38672,0.888849,0.73,2,810984,810528,456
40542741,29.1524,33.9531,458,38727,0.92177,0.79,2,811018,810560,458
40545661,29.0305,29.1906,459,38782,0.912354,0.75,2,811047,810588,459
40548581,31.4061,31.4381,459,38836,0.894471,0.79,2,811079,810620,459
40682901,27,20,512,41261,0.61,1,1,812803,812291,512
40685821,29.4,28.8,511,41312,0.514,1,1,812833,812322,511
40688741,29.88,31.36,509,41363,0.4148,1,1,812863,812354,509
40691661,31.576,45.472,492,41414,0.33096,1,1,812895,812403,492
40694581,42.3152,29.0944,512,41465,0.186192,1,1,812940,812428,512
40697501,26.063,32.2189,501,41516,0.141238,1,1,812962,812461,501
40700421,26.8126,24.8438,505,41567,0.116248,1,1,812989,812484,505
40703341,26.1625,20.9688,511,41618,0.0232495,1,1,813015,812504,511
40706261,40.4325,61.7938,483,41669,0.0286499,0.96,1,813059,812576,483
40709181,28.8865,44.3587,469,41720,0.02973,0.99,1,813085,812616,469
40712101,28.1773,32.8717,467,41771,0.005946,0.99,1,813113,812646,467
40715021,30.4355,32.1743,466,41822,0.0571892,0.77,1,813144,812678,466
40717941,54.0871,58.4349,461,41872,0.0354378,0.69,1,813204,812743,461
40720861,34.8174,38.087,458,41922,0.0790876,0.61,1,813234,812776,458
40723781,20.5635,29.2174,448,41972,0.0718175,0.49,1,813251,812803,448
40726701,25.7127,29.8435,445,42022,0.102363,0.39,1,813278,812833,445
40729621,24.3425,29.9687,439,42072,0.108473,0.31,1,813302,812863,439
40732541,28.8685,31.5937,437,42122,0.141695,0.15,1,813332,812895,437
40735461,32.9737,42.3187,426,42172,0.196339,0.13,1,813366,812940,426
40738381,24.9947,26.0637,427,42222,0.191268,0.11,1,813389,812962,427
40741301,24.9989,26.8127,425,42272,0.206254,0,1,813414,812989,425
40744221,27.3998,26.1626,427,42322,0.241251,0.03,1,813442,813015,427
40747141,37.48,40.4325,423,42372,0.24825,0.03,1,813482,813059,423
40750061,27.496,28.8865,422,42422,0.16965,0,1,813507,813085,422
40752981,28.6992,28.1773,423,42472,0.10593,0.07,1,813536,813113,423
40755901,30.5398,30.4355,423,42522,0.125186,0.03,1,813567,813144,423
40758821,54.908,54.0871,424,42572,0.129037,0.09,1,813628,813204,424
40761741,36.5816,34.8174,426,42622,0.161807,0.07,1,813660,813234,426
40764661,19.3163,20.5635,424,42672,0.152361,0.11,1,813675,813251,424
40767581,26.2633,25.7127,425,42721,0.118472,0.11,1,813703,813278,425
40770501,26.0527,24.3425,427,42770,0.127694,0.15,1,813729,813302,427
40773421,31.6105,28.8685,430,42819,0.145539,0.21,1,813762,813332,430
40776341,34.3221,32.9737,431,42868,0.197108,0.19,1,813797,813366,431
40779261,25.2644,24.9947,431,42917,0.223422,0.21,1,813820,813389,431
40782181,25.8529,24.9989,432,42966,0.228684,0.25,1,813846,813414,432
40785101,25.9706,27.3998,430,43015,0.293737,0.25,1,813872,813442,430
40788021,36.3941,5.47996,469,43064,0.290747,0.25,1,813911,813442,469
40790941,24.8788,33.096,451,43113,0.290149,0.15,1,813933,813482,451
40793861,27.3758,26.6192,454,43162,0.30603,0.09,1,813961,813507,454
40796781,30.2752,28.5238,456,43211,0.325206,0.13,1,813992,813536,456
40799701,55.655,30.5048,487,43260,0.313041,0.13,1,814054,813567,487
40802621,37.531,54.901,459,43309,0.342608,0.17,1,814087,813628,459
40805541,18.7062,36.5802,441,43358,0.364522,0.15,1,814101,813660,441
40808461,26.1412,19.316,454,43407,0.384904,0.11,1,814129,813675,454
40811381,26.8282,26.2632,453,43456,0.372981,0.13,1,814156,813703,453
40814301,33.3656,26.0526,462,43505,0.354596,0.15,1,814191,813729,462
40817221,36.2731,31.6105,466,43553,0.350919,0.21,1,814228,813762,466
40820141,26.4546,34.3221,455,43601,0.350184,0.23,1,814252,813797,455
40823061,26.8909,25.2644,459,43649,0.366037,0.23,1,814279,813820,459
40825981,27.7782,25.8529,461,43697,0.369207,0.31,1,814307,813846,461
40828901,36.7556,25.9706,474,43745,0.353841,0.29,1,814346,813872,474
40831821,25.7511,36.3941,458,43793,0.366768,0.29,1,814369,813911,458
40834741,27.5502,24.8788,464,43841,0.353354,0.31,1,814397,813933,464
40837661,31.91,27.3758,469,43889,0.350671,0.33,1,814430,813961,469
40840581,54.382,30.2752,498,43937,0.366134,0.31,1,814490,813992,498
40843501,39.6764,55.655,472,43985,0.385227,0.35,1,814526,814054,472
40846421,19.9353,37.531,454,44033,0.437045,0.37,1,814541,814087,454
40849341,26.3871,18.7062,468,44081,0.479409,0.39,1,814569,814101,468
40852261,26.0774,26.1412,466,44129,0.487882,0.37,1,814595,814129,466
40855181,33.2155,26.8282,474,44177,0.473576,0.35,1,814630,814156,474
40858101,35.4431,33.3656,475,44225,0.470715,0.35,1,814666,814191,475
40861021,26.2886,36.2731,462,44273,0.486143,0.35,1,814690,814228,462
40863941,27.6577,26.4546,466,44321,0.489229,0.37,1,814718,814252,466
40866861,26.3315,26.8909,465,44369,0.489846,0.37,1,814744,814279,465
40869781,37.2663,27.7782,477,44417,0.489969,0.35,1,814784,814307,477
40872701,25.0533,36.7556,460,44464,0.505994,0.37,1,814806,814346,460
40875621,6.61065,25.7511,439,44511,0.525199,0.35,1,814808,814369,439
40878541,23.7221,27.5502,439,44558,0.52904,0.35,1,814836,814397,439
40881461,31.1444,31.91,439,44605,0.561808,0.37,1,814869,814430,439
40884381,55.0289,54.382,440,44652,0.600362,0.39,1,814930,814490,440
40887301,42.2058,39.6764,443,44699,0.640072,0.45,1,814969,814526,443
40890221,21.2412,19.9353,444,44746,0.616014,0.49,1,814985,814541,444
40893141,28.2482,26.3871,446,44793,0.643203,0.49,1,815015,814569,446
40896061,26.4496,26.0774,446,44840,0.632641,0.47,1,815041,814595,446
40898981,32.4899,33.2155,445,44887,0.662528,0.47,1,815075,814630,445
40901901,36.098,35.4431,446,44934,0.652506,0.49,1,815112,814666,446
40904821,27.2196,26.2886,447,44981,0.682501,0.49,1,815137,814690,447
40907741,27.0439,27.6577,446,45028,0.7525,0.49,2,815164,814718,446
40910661,26.2088,26.3315,446,45075,0.7345,0.49,1,815190,814744,446
40913581,37.2418,37.2663,446,45122,0.7629,0.51,2,815230,814784,446
40916501,26.6484,25.0533,448,45169,0.76858,0.53,2,815254,814806,448
40919421,6.92967,6.61065,448,45216,0.769716,0.53,2,815256,814808,448
40922341,23.7859,23.7221,448,45263,0.833943,0.57,2,815284,814836,448
40925261,31.9572,31.1444,449,45310,0.846789,0.61,2,815318,814869,449
40928181,55.9914,55.0289,450,45357,0.881358,0.65,2,815380,814930,450
40931101,43.9983,42.2058,452,45403,0.904272,0.61,2,815421,814969,452
40934021,21.5997,21.2412,452,45449,0.876854,0.65,2,815437,814985,452
40936941,28.3199,28.2482,452,45495,0.887371,0.63,2,815467,815015,452
40939861,27.264,26.4496,453,45541,0.905474,0.67,2,815494,815041,453
41150101,29,32,512,48761,0.63,1,1,817724,817212,512
41153021,29.8,32.8,509,48804,0.614,1,1,817754,817245,509
41155941,32.36,32.96,509,48847,0.5308,1,1,817787,817278,509
41158861,31.272,6.592,540,48890,0.51416,1,1,817818,817278,540
41161781,27.0544,38.1184,520,48933,0.446832,1,1,817844,817324,520
41164701,26.2109,38.0237,508,48976,0.449366,1,1,817870,817362,508
41167621,28.4422,33.2047,505,49019,0.305873,1,1,817899,817394,505
41170541,23.2884,15.4409,516,49062,0.277175,0.99,1,817921,817405,516
41173461,28.6577,38.2882,502,49105,0.127435,1,1,817951,817449,502
41176381,31.3315,32.4576,503,49148,0.081487,1,1,817983,817480,503
41179301,27.0663,28.8915,501,49191,0.0242974,1,1,818009,817508,501
41182221,29.4133,28.9783,502,49234,0.0288595,1,1,818039,817537,502
41185141,28.2827,31.3957,498,49277,0.0297719,0.96,1,818067,817569,498
41188061,29.6565,34.2791,493,49320,0.0299544,0.93,1,818097,817604,493
41190981,31.5313,30.8558,495,49363,0.0299909,0.81,1,818129,817634,495
41193901,25.5063,31.7712,487,49406,0.0459982,0.71,1,818153,817666,487
41196821,24.3013,29.5542,482,49449,0.0331996,0.63,1,818177,817695,482
41199741,26.4603,29.1108,480,49492,0.0626399,0.61,1,818204,817724,480
41202661,30.8921,29.8222,482,49535,0.052528,0.51,1,818236,817754,482
41205581,28.5784,32.3644,477,49578,0.0505056,0.51,1,818264,817787,477
41208501,20.1157,31.2729,464,49620,0.0501011,0.43,1,818282,817818,464
41211421,24.8231,27.0546,464,49662,0.0500202,0.45,1,818308,817844,464
41214341,26.5646,26.2109,465,49704,0.018004,0.27,1,818335,817870,465
41217261,16.5129,28.4422,450,49746,0.00360081,0.27,1,818349,817899,450
41220181,21.7026,23.2884,451,49788,0.0567202,0.09,1,818372,817921,451
41223101,31.5405,28.6577,455,49830,0.035344,0.07,1,818406,817951,455
41226021,27.9081,31.3315,450,49872,0.0150688,0.01,1,818433,817983,450
41228941,27.9816,27.0663,452,49914,0.0270138,0.03,1,818461,818009,452
41231861,27.1963,29.4133,449,49956,0.00540275,0.03,1,818488,818039,449
41234781,30.2393,28.2827,452,49998,0.0250806,0.03,1,818519,818067,452
41237701,31.6479,29.6565,454,50040,0.0290161,0.03,1,818551,818097,454
41240621,25.5296,31.5313,446,50082,0.0618032,0.05,1,818575,818129,446
41243541,25.1059,25.5063,447,50124,0.116361,0.03,1,818600,818153,447
41246461,26.6212,24.3013,450,50166,0.0472721,0.07,1,818627,818177,450
41249381,30.1242,26.4603,454,50208,0.113454,0.05,1,818658,818204,454
41252301,28.4248,30.8921,450,50250,0.0946909,0.05,1,818686,818236,450
41255221,20.085,28.5784,440,50292,0.0909382,0.05,1,818704,818264,440
41258141,5.61699,20.1157,424,50334,0.0901876,0.05,1,818706,818282,424
41261061,20.3234,24.8231,422,50376,0.0260375,0.01,1,818730,818308,422
41263981,26.4647,26.5646,423,50418,0.0452075,0,1,818758,818335,423
41266901,17.2929,16.5129,424,50460,0.0490415,0.07,1,818773,818349,424
41269821,23.4586,21.7026,426,50502,0.0498083,0.03,1,818798,818372,426
41272741,29.4917,31.5405,423,50544,0.0339617,0.01,1,818829,818406,423
41275661,28.2983,27.9081,424,50586,0.00679233,0.03,1,818857,818433,424
41278581,27.2597,27.9816,423,50628,0.0733585,0,1,818884,818461,423
41281501,26.2519,27.1963,422,50670,0.0386717,0.03,1,818910,818488,422
41284421,30.8504,30.2393,423,50712,0.0317343,0.03,1,818942,818519,423
41287341,31.7701,31.6479,423,50754,0.0303469,0.07,1,818974,818551,423
41290261,28.754,25.5296,427,50795,0.0780694,0.13,1,819002,818575,427
41293181,21.7508,25.1059,422,50836,0.0556139,0.03,1,819022,818600,422
41296101,29.1502,26.6212,426,50877,0.0351228,0.13,1,819053,818627,426
41299021,30.63,30.1242,426,50918,0.0790246,0.09,1,819084,818658,426
41301941,28.526,28.4248,426,50959,0.151805,0.09,1,819112,818686,426
41304861,16.9052,20.085,422,51000,0.134361,0.09,1,819126,818704,422
41307781,4.98104,5.61699,422,51041,0.130872,0.01,1,819128,818706,422
41310701,20.1962,20.3234,422,51082,0.146174,0.05,1,819152,818730,422
41313621,26.4392,26.4647,422,51123,0.181235,0.05,1,819180,818758,422
41316541,17.2878,17.2929,422,51164,0.188247,0.05,1,819195,818773,422
41319461,23.4576,23.4586,422,51205,0.221649,0.03,1,819220,818798,422
41322381,29.4915,29.4917,422,51246,0.18033,0,1,819251,818829,422
41325301,28.2983,28.2983,422,51287,0.140066,0.09,1,819279,818857,422
41328221,27.2597,27.2597,422,51328,0.116013,0.03,1,819306,818884,422
41331141,26.2519,26.2519,422,51369,0.127203,0.03,1,819332,818910,422
41334061,30.8504,30.8504,422,51410,0.0974405,0.03,1,819364,818942,422
41336981,32.5701,31.7701,423,51451,0.0194881,0.09,1,819397,818974,423
41339901,29.714,28.754,424,51492,0.0758976,0.05,1,819426,819002,424
41342821,20.3428,21.7508,422,51533,0.0551795,0.03,1,819444,819022,422
41345741,30.4686,29.1502,424,51574,0.0670359,0.09,1,819477,819053,424
41348661,33.2937,30.63,427,51615,0.0534072,0.17,1,819511,819084,427
41351581,29.8587,28.526,428,51656,0.0826814,0.13,1,819540,819112,428
41354501,17.1717,16.9052,428,51697,0.0565363,0.13,1,819554,819126,428
41357421,5.03435,4.98104,428,51738,0.0513073,0.15,1,819556,819128,428
41360341,21.0069,20.1962,429,51779,0.0982615,0.15,1,819581,819152,429
41363261,28.2014,4.03924,459,51820,0.0756523,0.19,1,819611,819152,459
41366181,17.6403,23.2078,446,51861,0.0871305,0.19,1,819626,819180,446
41369101,24.3281,16.6416,457,51902,0.121426,0.23,1,819652,819195,457
41372021,26.4656,23.3283,459,51943,0.128285,0.17,1,819679,819220,459
41374941,26.8931,29.4657,455,51984,0.177657,0.13,1,819706,819251,455
41377861,26.1786,28.2931,453,52025,0.187531,0.11,1,819732,819279,453
41380781,23.6357,27.2586,449,52065,0.173506,0.13,1,819755,819306,449
41383701,30.3271,26.2517,455,52105,0.170701,0.09,1,819787,819332,455
41386621,30.8654,30.8503,454,52145,0.12214,0,1,819818,819364,454
41389541,30.9731,32.5701,452,52185,0.080428,0.09,1,819849,819397,452
41392461,20.5946,29.714,441,52225,0.0880856,0.05,1,819867,819426,441
41395381,30.5189,20.3428,456,52265,0.0736171,0.07,1,819900,819444,456
41398301,33.3038,30.4686,457,52305,0.0867234,0.05,1,819934,819477,457
41401221,29.8608,33.2937,452,52345,0.0893447,0.09,1,819963,819511,452
41404141,17.1722,29.8587,437,52385,0.121869,0.05,1,819977,819540,437
41407061,5.03443,17.1717,425,52425,0.128374,0.05,1,819979,819554,425
41409981,21.8069,5.03435,449,52465,0.129675,0.11,1,820005,819556,449
41412901,29.9614,21.0069,456,52505,0.161935,0.07,1,820037,819581,456
41415821,18.7923,28.2014,442,52545,0.184387,0.09,1,820053,819611,442
41418741,24.5585,17.6403,453,52585,0.204877,0.13,1,820079,819626,453
41421661,28.1117,24.3281,456,52625,0.224975,0.13,1,820108,819652,456
41424581,28.0223,26.4656,457,52665,0.244995,0.19,1,820136,819679,457
41427501,26.4045,26.8931,456,52705,0.264999,0.19,1,820162,819706,456
41430421,22.8809,26.1786,452,52745,0.269,0.17,1,820184,819732,452
41433341,30.1762,23.6357,461,52785,0.2858,0.17,1,820216,819755,461
41436261,27.6352,30.3271,456,52825,0.28916,0.11,1,820243,819787,456
41439181,29.527,30.8654,455,52865,0.289832,0.07,1,820273,819818,455
41442101,21.1054,30.9731,443,52905,0.305966,0.09,1,820292,819849,443
41445021,29.8211,20.5946,457,52945,0.325193,0.07,1,820324,819867,457
41447941,33.9642,30.5189,459,52985,0.345039,0.09,1,820359,819900,459
41450861,31.5928,33.3038,456,53025,0.333008,0.09,1,820390,819934,456
41453781,17.5186,29.8608,441,53065,0.330602,0.13,1,820404,819963,441
41456701,5.10371,17.1722,429,53105,0.33012,0.13,1,820406,819977,429
41459621,22.6207,5.03443,454,53145,0.378024,0.13,1,820433,819979,454
41462541,31.7241,21.8069,462,53185,0.387605,0.17,1,820467,820005,462
41465461,19.1448,29.9614,446,53225,0.389521,0.19,1,820483,820037,446
41468381,5.42897,18.7923,432,53265,0.389904,0.21,1,820485,820053,432
41471301,22.6858,24.5585,433,53305,0.405981,0.23,1,820512,820079,433
41474221,27.7372,28.1117,433,53344,0.361196,0.25,1,820541,820108,433
41477141,29.5474,28.0223,435,53383,0.368239,0.27,1,820571,820136,435
41480061,26.7095,26.4045,435,53422,0.337648,0.27,1,820597,820162,435
41482981,22.9419,22.8809,435,53461,0.36353,0.29,1,820619,820184,435
41485901,31.7884,30.1762,437,53500,0.368706,0.29,1,820653,820216,437
41488821,27.1577,27.6352,436,53539,0.369741,0.29,1,820679,820243,436
41491741,29.4315,29.527,436,53578,0.369948,0.31,1,820709,820273,436
41494661,22.6863,21.1054,438,53617,0.36999,0.33,1,820730,820292,438
41497581,30.1373,29.8211,438,53656,0.417998,0.35,1,820762,820324,438
41500501,34.8275,33.9642,439,53695,0.4116,0.33,1,820798,820359,439
41503421,30.9655,31.5928,438,53734,0.41032,0.33,1,820828,820390,438
41506341,18.1931,17.5186,439,53773,0.426064,0.33,1,820843,820404,439
41509261,5.23862,5.10371,439,53812,0.429213,0.39,1,820845,820406,439
41512181,24.2477,22.6207,441,53851,0.461843,0.39,1,820874,820433,441
41515101,32.0495,31.7241,441,53890,0.548369,0.39,1,820908,820467,441
41518021,19.2099,19.1448,441,53929,0.533674,0.39,1,820924,820483,441
41520941,5.44198,5.42897,441,53968,0.562735,0.41,1,820926,820485,441
41523861,21.8884,22.6858,440,54007,0.584547,0.35,1,820952,820512,440
41526781,26.7777,27.7372,439,54046,0.588909,0.37,1,820980,820541,439
41529701,28.5555,29.5474,438,54085,0.605782,0.33,1,821009,820571,438
41532621,26.5111,26.7095,438,54124,0.625156,0.37,1,821035,820597,438
41535541,22.9022,22.9419,438,54163,0.645031,0.37,1,821057,820619,438
41538461,31.7804,31.7884,438,54202,0.713006,0.37,1,821091,820653,438
41541381,27.1561,27.1577,438,54241,0.726601,0.37,1,821117,820679,438
41544301,30.2312,29.4315,439,54280,0.72932,0.37,1,821148,820709,439
41547221,23.6462,22.6863,440,54319,0.745864,0.43,1,821170,820730,440
41550141,31.1292,30.1373,441,54358,0.765173,0.41,2,821203,820762,441
41553061,35.8258,34.8275,442,54397,0.721035,0.41,1,821240,820798,442
41555981,31.1652,30.9655,442,54436,0.728207,0.43,1,821270,820828,442
41558901,19.833,18.1931,444,54475,0.745641,0.43,1,821287,820843,444
41561821,5.56661,5.23862,444,54514,0.749128,0.47,1,821289,820845,444
41564741,25.9133,24.2477,446,54553,0.733826,0.57,1,821320,820874,446
41567661,33.9827,32.0495,448,54592,0.762765,0.53,2,821356,820908,448
41570581,19.5965,19.2099,448,54631,0.768553,0.57,2,821372,820924,448
41573501,5.51931,5.44198,448,54670,0.769711,0.59,2,821374,820926,448
41576421,22.7039,21.8884,449,54708,0.753942,0.59,2,821401,820952,449
41579341,27.7408,4.37768,478,54746,0.766788,0.59,2,821430,820952,478
41582261,30.3482,23.2755,481,54784,0.785358,0.61,2,821461,820980,481
41585181,27.6696,27.8551,479,54822,0.805072,0.63,2,821488,821009,479
41588101,23.9339,26.371,476,54860,0.809014,0.65,2,821511,821035,476
41591021,32.7868,22.8742,489,54898,0.857803,0.73,2,821546,821057,489
41593941,27.3574,31.7748,481,54936,0.867561,0.73,2,821572,821091,481
41596861,31.8715,27.155,488,54974,0.885512,0.73,2,821605,821117,488
41599781,24.7743,30.231,480,55012,0.873102,0.75,2,821628,821148,480
41602701,30.5549,23.6462,490,55050,0.87062,0.77,2,821660,821170,490
41605621,35.711,31.1292,494,55088,0.886124,0.71,2,821697,821203,494
41608541,31.1422,35.8258,487,55126,0.889225,0.73,2,821727,821240,487
41611461,19.0284,31.1652,473,55164,0.889845,0.75,2,821743,821270,473
41614381,5.40569,19.833,458,55202,0.889969,0.75,2,821745,821287,458
41617301,25.8811,5.56661,487,55240,0.905994,0.73,2,821776,821289,487
41620221,34.7762,25.9133,493,55278,0.861199,0.77,2,821813,821320,493
41623141,19.7552,33.9827,473,55316,0.85224,0.77,2,821829,821356,473
41626061,5.55105,19.5965,459,55354,0.866448,0.77,2,821831,821372,459
41628981,23.5102,5.51931,485,55392,0.88529,0.75,2,821859,821374,485
41631901,28.702,22.7039,488,55430,0.921058,0.77,2,821889,821401,488
41836301,31,44,466,27010,0.59,0.94,1,824181,823715,466
41842141,62.2,58.4,474,26280,0.526,0.98,1,824251,823777,474
41868421,27.64,31.68,468,27010,0.5292,0.57,1,824270,823802,468
41891781,242.328,262.336,444,26280,0.49784,0.55,1,824566,824122,444
41894701,74.0656,74.8672,448,27088,0.523568,0.59,1,824598,824150,448
41897621,74.8131,39.7734,492,27166,0.480714,0.51,1,824673,824181,492
41900541,48.5626,63.9547,464,27244,0.536143,0.55,1,824715,824251,464
41903461,64.1125,51.9909,483,27322,0.563229,0.51,1,824783,824300,483
41906381,64.8225,54.3982,493,27400,0.616646,0.49,1,824848,824355,493
41909301,40.1645,64.4796,460,27477,0.643329,0.51,1,824882,824422,460
41912221,33.6329,39.2959,459,27554,0.680666,0.55,1,824914,824455,459
41915141,30.7266,27.0592,465,27631,0.704133,0.53,1,824944,824479,465
41918061,59.7453,51.0118,475,27708,0.740827,0.53,1,825011,824536,475
41920981,38.3491,59.8024,446,27784,0.748165,0.47,1,825044,824598,446
41923901,69.2698,71.9605,448,27860,0.829633,0.55,2,825121,824673,448
41926821,48.254,47.9921,449,27936,0.861927,0.57,2,825164,824715,449
41929741,64.8508,63.9984,450,28012,0.884385,0.63,2,825233,824783,450
41932661,67.3702,64.7997,453,28088,0.936877,0.65,2,825301,824848,453
42049461,38,39,495,30960,0.85,1,2,827288,826793,495
42052381,38,32.6,502,31028,0.786,1,2,827326,826824,502
42055301,64.4,62.52,503,31096,0.6612,1,1,827397,826894,503
42058221,42.48,38.904,507,31164,0.66824,0.89,1,827434,826927,507
42061141,50.096,71.7808,479,31232,0.685648,1,1,827486,827007,479
42064061,36.4192,36.7562,484,31300,0.64113,1,1,827519,827035,484
42066981,29.6838,7.35123,512,31368,0.664226,1,1,827547,827035,512
42069901,52.3368,28.6702,536,31435,0.716845,1,1,827605,827069,536
42072821,60.8674,56.1341,536,31502,0.711369,0.95,1,827668,827132,536
42075741,51.3735,64.0268,519,31569,0.774274,0.87,2,827717,827198,519
42078661,39.8747,54.4054,504,31636,0.738855,0.85,1,827754,827250,504
42081581,34.3749,41.2811,499,31703,0.795771,0.77,2,827787,827288,499
42084501,58.075,38.6562,525,31770,0.855154,0.63,2,827851,827326,525
42087421,39.615,64.5312,489,31837,0.883031,0.67,2,827886,827397,489
42090341,51.923,42.5062,507,31903,0.904606,0.69,2,827941,827434,507
42093261,39.1846,50.1013,491,31969,0.924921,0.63,2,827977,827486,491
42096181,31.0369,36.4202,487,32035,0.912984,0.67,2,828006,827519,487
42230501,30,30,510,34942,0.63,1,1,830036,829526,510
42233421,34.8,34,511,35003,0.582,1,1,830072,829561,511
42236341,45.36,34,525,35063,0.4604,0.97,1,830120,829595,525
42239261,33.072,39.6,514,35123,0.37208,1,1,830150,829636,514
42242181,75.4144,39.12,561,35183,0.146416,1,1,830236,829675,561
42245101,37.4829,68.624,513,35243,0.0372832,1,1,830264,829751,513
42248021,37.8966,48.9248,507,35303,0.0474566,1,1,830302,829795,507
42250941,55.5793,38.585,531,35363,0.0174913,1,1,830362,829831,531
42253861,35.9159,55.717,502,35423,0.0434983,0.98,1,830393,829891,502
42256781,35.9832,36.7434,506,35483,0.0486997,0.89,1,830429,829923,506
42259701,32.7966,40.1487,497,35543,0.0337399,0.79,1,830461,829964,497
42262621,27.3593,41.6297,481,35602,0.030748,0.63,1,830487,830006,481
42265541,30.2719,32.3259,482,35661,0.0301496,0.57,1,830518,830036,482
42268461,7.65437,35.2652,448,35720,0.0300299,0.43,1,830520,830072,448
42271381,32.7309,45.453,439,35779,0.046006,0.35,1,830559,830120,439
42274301,27.3462,33.0906,435,35838,0.0652012,0.09,1,830585,830150,435
42277221,65.4692,75.4181,424,35897,0.0850402,0.01,1,830660,830236,424
42280141,34.6938,37.4836,423,35956,0.041008,0.05,1,830687,830264,423
42283061,40.5388,37.8967,427,36015,0.0642016,0.01,1,830729,830302,427
42285981,52.1078,55.5793,422,36074,0.0848403,0.05,1,830784,830362,422
42288901,36.8215,35.9159,424,36133,0.0569681,0.05,1,830817,830393,424
42291821,35.3643,35.9832,423,36191,0.0993936,0.03,1,830852,830429,423
42294741,32.6729,32.7966,423,36249,0.0758787,0.03,1,830884,830461,423
42297661,26.5346,27.3593,422,36307,0.0551757,0.03,1,830909,830487,422
42300581,30.9069,30.2719,423,36365,0.0510351,0.03,1,830941,830518,423
42303501,7.78138,7.65437,423,36423,0.018207,0.05,1,830943,830520,423
42306421,32.7563,32.7309,423,36481,0.0436414,0.07,1,830982,830559,423
42309341,27.3513,27.3462,423,36539,0.128728,0.09,1,831008,830585,423
42312261,67.0703,65.4692,425,36597,0.161746,0.03,1,831085,830660,425
42315181,33.414,34.6938,423,36655,0.152349,0.07,1,831110,830687,423
42318101,40.2828,40.5388,423,36713,0.0864698,0.09,1,831152,830729,423
42321021,51.2566,52.1078,422,36771,0.089294,0.05,1,831206,830784,422
42323941,36.6513,36.8215,422,36828,0.0578588,0.11,1,831239,830817,422
42326861,38.5303,35.3643,426,36885,0.0355718,0.07,1,831278,830852,426
42329781,30.9061,32.6729,423,36942,0.0631144,0.05,1,831307,830884,423
42332701,27.7812,26.5346,425,36999,0.0526229,0.05,1,831334,830909,425
42335621,28.7562,30.9069,422,37056,0.114525,0.01,1,831363,830941,422
42338541,7.35125,7.78138,422,37113,0.126905,0.05,1,831365,830943,422
42341461,34.2702,32.7563,424,37170,0.113381,0.05,1,831406,830982,424
42344381,29.254,6.55126,452,37227,0.142676,0.15,1,831434,830982,452
42347301,69.8508,22.1103,506,37284,0.164535,0.17,1,831514,831008,506
42350221,33.1702,66.0221,453,37341,0.168907,0.15,1,831538,831085,453
42353141,35.434,33.2044,464,37398,0.185781,0.07,1,831574,831110,464
