#Ack,ack_ewma(ms),send_ewma(ms),rtt_ratio,cwnd (Bytes),Last Router Ocupation Ack Arriaval(Packets),Last Router Ocupation Packet Sent(Packets),Network Situation,AckArrival(ms),TSInsideAck(ms),RTTAck(ms)
40881,1126.74,1102.86,1128,1460,0.417728,0,1,50336,49208,1128
46721,1174.74,1150.86,1176,1460,0.457718,0,1,54944,53768,1176
52561,1222.74,1198.86,1224,1460,0.497718,0,1,59744,58520,1224
89061,1510.74,1486.86,1512,1460,0.737718,0,2,93800,92288,1512
96361,1558.74,1534.8,1560,1460,0.777599,0,2,101456,99896,1560
119721,1750.74,1726.86,1752,1460,0.937718,0,2,127952,126200,1752
134321,981.29,1594.8,949,1460,0.201328,0,1,144813,143864,949
135781,660.865,981.29,644,1460,0.0805311,0,1,145457,144813,644
137241,644.843,660.865,644,1460,0.0322124,0,1,146101,145457,644
138701,644.042,644.843,644,1460,0.012885,0,1,146745,146101,644
140161,644.002,644.042,644,1460,0.00515399,0,1,147389,146745,644
141621,644,644.002,644,1460,0.0020616,0,1,148033,147389,644
143081,644,644,644,1460,0.000824638,0,1,148677,148033,644
144541,644,644,644,1460,0.000329855,0,1,149321,148677,644
146001,644,644,644,1460,0.000131942,0,1,149965,149321,644
147461,644,644,644,1460,5.27769e-05,0,1,150609,149965,644
148921,644,644,644,1460,2.11107e-05,0,1,151253,150609,644
150381,644,644,644,1460,8.4443e-06,0,1,151897,151253,644
151841,644,644,644,1460,3.37772e-06,0,1,152541,151897,644
153301,644,644,644,1460,1.35109e-06,0,1,153185,152541,644
154761,644,644,644,1460,5.40435e-07,0,1,153829,153185,644
156221,644,644,644,1460,2.16174e-07,0,1,154473,153829,644
157681,644,644,644,1460,8.64696e-08,0,1,155117,154473,644
159141,644,644,644,1460,3.45878e-08,0,1,155761,155117,644
160601,644,644,644,1460,0.00600001,0,1,156405,155761,644
162061,647.8,644,648,1460,0.0204,0,1,157053,156405,648
169361,694.74,670.803,696,1460,0.0576265,0,1,160389,159693,696
175201,742.743,718.857,744,1460,0.0977152,0,1,163269,162525,744
192721,886.743,862.857,888,1460,0.217718,0,1,173061,172173,888
200021,934.74,910.803,936,1460,0.257599,0,1,177597,176661,936
205861,982.743,958.857,984,1460,0.297715,0,1,181437,180453,984
223381,1126.74,1102.86,1128,1460,0.417718,0,1,194109,192981,1128
230681,1174.74,1150.8,1176,1460,0.457599,0,1,199845,198669,1176
236521,1222.74,1198.86,1224,1460,0.497715,0,1,204645,203421,1224
273021,1510.74,1486.86,1512,1460,0.737715,0,2,238893,237381,1512
278861,1558.74,1534.86,1560,1460,0.777718,0,2,245037,243477,1560
303681,1750.74,1726.8,1752,1460,0.937599,0,2,273237,271485,1752
315361,1594.8,1800.06,1584,1460,0.492213,0,1,287349,285765,1584
318281,660.58,975.59,644,1460,0.0787542,0,1,288936,288292,644
319741,644.829,660.58,644,1460,0.0315017,0,1,289580,288936,644
321201,644.041,644.829,644,1460,0.0126007,0,1,290224,289580,644
322661,644.002,644.041,644,1460,0.00504027,0,1,290868,290224,644
324121,644,644.002,644,1460,0.00201611,0,1,291512,290868,644
325581,644,644,644,1460,0.000806443,0,1,292156,291512,644
327041,644,644,644,1460,0.000322577,0,1,292800,292156,644
328501,644,644,644,1460,0.000129031,0,1,293444,292800,644
329961,644,644,644,1460,5.16123e-05,0,1,294088,293444,644
331421,644,644,644,1460,2.06449e-05,0,1,294732,294088,644
332881,644,644,644,1460,8.25797e-06,0,1,295376,294732,644
334341,644,644,644,1460,3.30319e-06,0,1,296020,295376,644
335801,644,644,644,1460,1.32128e-06,0,1,296664,296020,644
337261,644,644,644,1460,5.2851e-07,0,1,297308,296664,644
338721,644,644,644,1460,2.11404e-07,0,1,297952,297308,644
340181,644,644,644,1460,8.45616e-08,0,1,298596,297952,644
341641,644,644,644,1460,3.38247e-08,0,1,299240,298596,644
343101,644,644,644,1460,1.35299e-08,0,1,299884,299240,644
344561,644,644,644,1460,0.00600001,0,1,300528,299884,644
346021,647.8,644,648,1460,0.0204,0,1,301176,300528,648
351861,694.743,670.857,696,1460,0.0577862,0,1,303864,303168,696
357701,742.743,718.857,744,1460,0.0977193,0,1,306744,306000,744
376681,886.743,862.857,888,1460,0.217783,0,1,317376,316488,888
382521,934.743,910.857,936,1460,0.257719,0,1,321024,320088,936
388361,982.743,958.857,984,1460,0.297718,0,1,324864,323880,984
407341,1126.74,1102.8,1128,1460,0.417599,0,1,338616,337488,1128
413181,1174.74,1150.86,1176,1460,0.457715,0,1,343224,342048,1176
419021,1222.74,1198.86,1224,1460,0.497717,0,1,348024,346800,1224
455521,1510.74,1486.86,1512,1460,0.737718,0,2,382224,380712,1512
461361,1558.74,1534.86,1560,1460,0.777718,0,2,388368,386808,1560
486181,1750.74,1726.86,1752,1460,0.937719,0,2,416520,414768,1752
497861,1594.8,1800.06,1584,1460,0.492214,0,1,430632,429048,1584
500781,660.627,976.54,644,1460,0.0787542,0,1,432220,431576,644
502241,644.831,660.627,644,1460,0.0315017,0,1,432864,432220,644
503701,644.042,644.831,644,1460,0.0126007,0,1,433508,432864,644
505161,644.002,644.042,644,1460,0.00504027,0,1,434152,433508,644
506621,644,644.002,644,1460,0.00201611,0,1,434796,434152,644
508081,644,644,644,1460,0.000806443,0,1,435440,434796,644
509541,644,644,644,1460,0.000322577,0,1,436084,435440,644
511001,644,644,644,1460,0.000129031,0,1,436728,436084,644
512461,644,644,644,1460,5.16123e-05,0,1,437372,436728,644
513921,644,644,644,1460,2.06449e-05,0,1,438016,437372,644
515381,644,644,644,1460,8.25797e-06,0,1,438660,438016,644
516841,644,644,644,1460,3.30319e-06,0,1,439304,438660,644
518301,644,644,644,1460,1.32128e-06,0,1,439948,439304,644
519761,644,644,644,1460,5.2851e-07,0,1,440592,439948,644
521221,644,644,644,1460,2.11404e-07,0,1,441236,440592,644
522681,644,644,644,1460,8.45616e-08,0,1,441880,441236,644
524141,644,644,644,1460,3.38247e-08,0,1,442524,441880,644
525601,644,644,644,1460,1.35299e-08,0,1,443168,442524,644
527061,644,644,644,1460,0.00600001,0,1,443812,443168,644
528521,647.8,644,648,1460,0.0204,0,1,444460,443812,648
534361,694.743,670.857,696,1460,0.0577862,0,1,447148,446452,696
540201,742.743,718.857,744,1460,0.0977193,0,1,450028,449284,744
559181,886.743,862.857,888,1460,0.217783,0,1,460660,459772,888
565021,934.743,910.857,936,1460,0.257719,0,1,464308,463372,936
570861,982.743,958.857,984,1460,0.297718,0,1,468148,467164,984
589841,1126.74,1102.8,1128,1460,0.417599,0,1,481900,480772,1128
595681,1174.74,1150.86,1176,1460,0.457715,0,1,486508,485332,1176
601521,1222.74,1198.86,1224,1460,0.497717,0,1,491308,490084,1224
638021,1510.74,1486.86,1512,1460,0.737718,0,2,525508,523996,1512
643861,1558.74,1534.86,1560,1460,0.777718,0,2,531652,530092,1560
668681,1750.74,1726.86,1752,1460,0.937719,0,2,559804,558052,1752
680361,1594.8,1800.06,1584,1460,0.492214,0,1,573916,572332,1584
683281,660.627,976.54,644,1460,0.0787542,0,1,575504,574860,644
684741,644.831,660.627,644,1460,0.0315017,0,1,576148,575504,644
686201,644.042,644.831,644,1460,0.0126007,0,1,576792,576148,644
687661,644.002,644.042,644,1460,0.00504027,0,1,577436,576792,644
689121,644,644.002,644,1460,0.00201611,0,1,578080,577436,644
690581,644,644,644,1460,0.000806443,0,1,578724,578080,644
692041,644,644,644,1460,0.000322577,0,1,579368,578724,644
693501,644,644,644,1460,0.000129031,0,1,580012,579368,644
694961,644,644,644,1460,5.16123e-05,0,1,580656,580012,644
696421,644,644,644,1460,2.06449e-05,0,1,581300,580656,644
697881,644,644,644,1460,8.25797e-06,0,1,581944,581300,644
699341,644,644,644,1460,3.30319e-06,0,1,582588,581944,644
700801,644,644,644,1460,1.32128e-06,0,1,583232,582588,644
702261,644,644,644,1460,5.2851e-07,0,1,583876,583232,644
703721,644,644,644,1460,2.11404e-07,0,1,584520,583876,644
705181,644,644,644,1460,8.45616e-08,0,1,585164,584520,644
706641,644,644,644,1460,3.38247e-08,0,1,585808,585164,644
708101,644,644,644,1460,1.35299e-08,0,1,586452,585808,644
709561,644,644,644,1460,0.00600001,0,1,587096,586452,644
711021,647.8,644,648,1460,0.0204,0,1,587744,587096,648
716861,694.743,670.857,696,1460,0.0577862,0,1,590432,589736,696
722701,742.743,718.857,744,1460,0.0977193,0,1,593312,592568,744
741681,886.743,862.857,888,1460,0.217783,0,1,603944,603056,888
747521,934.743,910.857,936,1460,0.257719,0,1,607592,606656,936
753361,982.743,958.857,984,1460,0.297718,0,1,611432,610448,984
772341,1126.74,1102.8,1128,1460,0.417599,0,1,625184,624056,1128
778181,1174.74,1150.86,1176,1460,0.457715,0,1,629792,628616,1176
784021,1222.74,1198.86,1224,1460,0.497717,0,1,634592,633368,1224
820521,1510.74,1486.86,1512,1460,0.737718,0,2,668792,667280,1512
826361,1558.74,1534.86,1560,1460,0.777718,0,2,674936,673376,1560
851181,1750.74,1726.86,1752,1460,0.937719,0,2,703088,701336,1752
862861,1594.8,1800.06,1584,1460,0.492214,0,1,717200,715616,1584
865781,660.627,976.54,644,1460,0.0787542,0,1,718788,718144,644
867241,644.831,660.627,644,1460,0.0315017,0,1,719432,718788,644
868701,644.042,644.831,644,1460,0.0126007,0,1,720076,719432,644
870161,644.002,644.042,644,1460,0.00504027,0,1,720720,720076,644
871621,644,644.002,644,1460,0.00201611,0,1,721364,720720,644
873081,644,644,644,1460,0.000806443,0,1,722008,721364,644
874541,644,644,644,1460,0.000322577,0,1,722652,722008,644
876001,644,644,644,1460,0.000129031,0,1,723296,722652,644
877461,644,644,644,1460,5.16123e-05,0,1,723940,723296,644
878921,644,644,644,1460,2.06449e-05,0,1,724584,723940,644
880381,644,644,644,1460,8.25797e-06,0,1,725228,724584,644
881841,644,644,644,1460,3.30319e-06,0,1,725872,725228,644
883301,644,644,644,1460,1.32128e-06,0,1,726516,725872,644
884761,644,644,644,1460,5.2851e-07,0,1,727160,726516,644
886221,644,644,644,1460,2.11404e-07,0,1,727804,727160,644
887681,644,644,644,1460,8.45616e-08,0,1,728448,727804,644
889141,644,644,644,1460,3.38247e-08,0,1,729092,728448,644
890601,644,644,644,1460,1.35299e-08,0,1,729736,729092,644
892061,644,644,644,1460,0.00600001,0,1,730380,729736,644
893521,647.8,644,648,1460,0.0204,0,1,731028,730380,648
899361,694.743,670.857,696,1460,0.0577862,0,1,733716,733020,696
905201,742.743,718.857,744,1460,0.0977193,0,1,736596,735852,744
924181,886.743,862.857,888,1460,0.217783,0,1,747228,746340,888
930021,934.743,910.857,936,1460,0.257719,0,1,750876,749940,936
935861,982.743,958.857,984,1460,0.297718,0,1,754716,753732,984
954841,1126.74,1102.8,1128,1460,0.417599,0,1,768468,767340,1128
960681,1174.74,1150.86,1176,1460,0.457715,0,1,773076,771900,1176
966521,1222.74,1198.86,1224,1460,0.497717,0,1,777876,776652,1224
1003021,1510.74,1486.86,1512,1460,0.737718,0,2,812076,810564,1512
1008861,1558.74,1534.86,1560,1460,0.777718,0,2,818220,816660,1560
1033681,1750.74,1726.86,1752,1460,0.937719,0,2,846372,844620,1752
1045361,1594.8,1800.06,1584,1460,0.492214,0,1,860484,858900,1584
1048281,660.627,976.54,644,1460,0.0787542,0,1,862072,861428,644
1049741,644.831,660.627,644,1460,0.0315017,0,1,862716,862072,644
1051201,644.042,644.831,644,1460,0.0126007,0,1,863360,862716,644
1052661,644.002,644.042,644,1460,0.00504027,0,1,864004,863360,644
1054121,644,644.002,644,1460,0.00201611,0,1,864648,864004,644
1055581,644,644,644,1460,0.000806443,0,1,865292,864648,644
1057041,644,644,644,1460,0.000322577,0,1,865936,865292,644
1058501,644,644,644,1460,0.000129031,0,1,866580,865936,644
1059961,644,644,644,1460,5.16123e-05,0,1,867224,866580,644
1061421,644,644,644,1460,2.06449e-05,0,1,867868,867224,644
1062881,644,644,644,1460,8.25797e-06,0,1,868512,867868,644
1064341,644,644,644,1460,3.30319e-06,0,1,869156,868512,644
1065801,644,644,644,1460,1.32128e-06,0,1,869800,869156,644
1067261,644,644,644,1460,5.2851e-07,0,1,870444,869800,644
1068721,644,644,644,1460,2.11404e-07,0,1,871088,870444,644
1070181,644,644,644,1460,8.45616e-08,0,1,871732,871088,644
1071641,644,644,644,1460,3.38247e-08,0,1,872376,871732,644
1073101,644,644,644,1460,1.35299e-08,0,1,873020,872376,644
1074561,644,644,644,1460,0.00600001,0,1,873664,873020,644
1076021,647.8,644,648,1460,0.0204,0,1,874312,873664,648
1081861,694.743,670.857,696,1460,0.0577862,0,1,877000,876304,696
1087701,742.743,718.857,744,1460,0.0977193,0,1,879880,879136,744
1106681,886.743,862.857,888,1460,0.217783,0,1,890512,889624,888
1112521,934.743,910.857,936,1460,0.257719,0,1,894160,893224,936
1118361,982.743,958.857,984,1460,0.297718,0,1,898000,897016,984
1137341,1126.74,1102.8,1128,1460,0.417599,0,1,911752,910624,1128
1143181,1174.74,1150.86,1176,1460,0.457715,0,1,916360,915184,1176
1149021,1222.74,1198.86,1224,1460,0.497717,0,1,921160,919936,1224
1185521,1510.74,1486.86,1512,1460,0.737718,0,2,955360,953848,1512
1191361,1558.74,1534.86,1560,1460,0.777718,0,2,961504,959944,1560
1216181,1750.74,1726.86,1752,1460,0.937719,0,2,989656,987904,1752
1227861,1594.8,1800.06,1584,1460,0.492214,0,1,1003768,1002184,1584
1230781,660.627,976.54,644,1460,0.0787542,0,1,1005356,1004712,644
1232241,644.831,660.627,644,1460,0.0315017,0,1,1006000,1005356,644
1233701,644.042,644.831,644,1460,0.0126007,0,1,1006644,1006000,644
1235161,644.002,644.042,644,1460,0.00504027,0,1,1007288,1006644,644
1236621,644,644.002,644,1460,0.00201611,0,1,1007932,1007288,644
1238081,644,644,644,1460,0.000806443,0,1,1008576,1007932,644
1239541,644,644,644,1460,0.000322577,0,1,1009220,1008576,644
1241001,644,644,644,1460,0.000129031,0,1,1009864,1009220,644
1242461,644,644,644,1460,5.16123e-05,0,1,1010508,1009864,644
1243921,644,644,644,1460,2.06449e-05,0,1,1011152,1010508,644
1245381,644,644,644,1460,8.25797e-06,0,1,1011796,1011152,644
1246841,644,644,644,1460,3.30319e-06,0,1,1012440,1011796,644
1248301,644,644,644,1460,1.32128e-06,0,1,1013084,1012440,644
1249761,644,644,644,1460,5.2851e-07,0,1,1013728,1013084,644
1251221,644,644,644,1460,2.11404e-07,0,1,1014372,1013728,644
1252681,644,644,644,1460,8.45616e-08,0,1,1015016,1014372,644
1254141,644,644,644,1460,3.38247e-08,0,1,1015660,1015016,644
1255601,644,644,644,1460,1.35299e-08,0,1,1016304,1015660,644
1257061,644,644,644,1460,0.00600001,0,1,1016948,1016304,644
1258521,647.8,644,648,1460,0.0204,0,1,1017596,1016948,648
1264361,694.743,670.857,696,1460,0.0577862,0,1,1020284,1019588,696
1270201,742.743,718.857,744,1460,0.0977193,0,1,1023164,1022420,744
1289181,886.743,862.857,888,1460,0.217783,0,1,1033796,1032908,888
1295021,934.743,910.857,936,1460,0.257719,0,1,1037444,1036508,936
1300861,982.743,958.857,984,1460,0.297718,0,1,1041284,1040300,984
1319841,1126.74,1102.8,1128,1460,0.417599,0,1,1055036,1053908,1128
1325681,1174.74,1150.86,1176,1460,0.457715,0,1,1059644,1058468,1176
1331521,1222.74,1198.86,1224,1460,0.497717,0,1,1064444,1063220,1224
1368021,1510.74,1486.86,1512,1460,0.737718,0,2,1098644,1097132,1512
1373861,1558.74,1534.86,1560,1460,0.777718,0,2,1104788,1103228,1560
1398681,1750.74,1726.86,1752,1460,0.937719,0,2,1132940,1131188,1752
1410361,1594.8,1800.06,1584,1460,0.492214,0,1,1147052,1145468,1584
1413281,660.627,976.54,644,1460,0.0787542,0,1,1148640,1147996,644
1414741,644.831,660.627,644,1460,0.0315017,0,1,1149284,1148640,644
1416201,644.042,644.831,644,1460,0.0126007,0,1,1149928,1149284,644
1417661,644.002,644.042,644,1460,0.00504027,0,1,1150572,1149928,644
1419121,644,644.002,644,1460,0.00201611,0,1,1151216,1150572,644
1420581,644,644,644,1460,0.000806443,0,1,1151860,1151216,644
1422041,644,644,644,1460,0.000322577,0,1,1152504,1151860,644
1423501,644,644,644,1460,0.000129031,0,1,1153148,1152504,644
1424961,644,644,644,1460,5.16123e-05,0,1,1153792,1153148,644
1426421,644,644,644,1460,2.06449e-05,0,1,1154436,1153792,644
1427881,644,644,644,1460,8.25797e-06,0,1,1155080,1154436,644
1429341,644,644,644,1460,3.30319e-06,0,1,1155724,1155080,644
1430801,644,644,644,1460,1.32128e-06,0,1,1156368,1155724,644
1432261,644,644,644,1460,5.2851e-07,0,1,1157012,1156368,644
1433721,644,644,644,1460,2.11404e-07,0,1,1157656,1157012,644
1435181,644,644,644,1460,8.45616e-08,0,1,1158300,1157656,644
1436641,644,644,644,1460,3.38247e-08,0,1,1158944,1158300,644
1438101,644,644,644,1460,1.35299e-08,0,1,1159588,1158944,644
1439561,644,644,644,1460,0.00600001,0,1,1160232,1159588,644
1441021,647.8,644,648,1460,0.0204,0,1,1160880,1160232,648
1446861,694.743,670.857,696,1460,0.0577862,0,1,1163568,1162872,696
1452701,742.743,718.857,744,1460,0.0977193,0,1,1166448,1165704,744
1471681,886.743,862.857,888,1460,0.217783,0,1,1177080,1176192,888
1477521,934.743,910.857,936,1460,0.257719,0,1,1180728,1179792,936
1483361,982.743,958.857,984,1460,0.297718,0,1,1184568,1183584,984
1502341,1126.74,1102.8,1128,1460,0.417599,0,1,1198320,1197192,1128
1508181,1174.74,1150.86,1176,1460,0.457715,0,1,1202928,1201752,1176
1514021,1222.74,1198.86,1224,1460,0.497717,0,1,1207728,1206504,1224
1550521,1510.74,1486.86,1512,1460,0.737718,0,2,1241928,1240416,1512
1556361,1558.74,1534.86,1560,1460,0.777718,0,2,1248072,1246512,1560
1581181,1750.74,1726.86,1752,1460,0.937719,0,2,1276224,1274472,1752
1592861,1594.8,1800.06,1584,1460,0.492214,0,1,1290336,1288752,1584
1595781,660.627,976.54,644,1460,0.0787542,0,1,1291924,1291280,644
1597241,644.831,660.627,644,1460,0.0315017,0,1,1292568,1291924,644
1598701,644.042,644.831,644,1460,0.0126007,0,1,1293212,1292568,644
1600161,644.002,644.042,644,1460,0.00504027,0,1,1293856,1293212,644
1601621,644,644.002,644,1460,0.00201611,0,1,1294500,1293856,644
1603081,644,644,644,1460,0.000806443,0,1,1295144,1294500,644
1604541,644,644,644,1460,0.000322577,0,1,1295788,1295144,644
1606001,644,644,644,1460,0.000129031,0,1,1296432,1295788,644
1607461,644,644,644,1460,5.16123e-05,0,1,1297076,1296432,644
1608921,644,644,644,1460,2.06449e-05,0,1,1297720,1297076,644
1610381,644,644,644,1460,8.25797e-06,0,1,1298364,1297720,644
1611841,644,644,644,1460,3.30319e-06,0,1,1299008,1298364,644
1613301,644,644,644,1460,1.32128e-06,0,1,1299652,1299008,644
1614761,644,644,644,1460,5.2851e-07,0,1,1300296,1299652,644
1616221,644,644,644,1460,2.11404e-07,0,1,1300940,1300296,644
1617681,644,644,644,1460,8.45616e-08,0,1,1301584,1300940,644
1619141,644,644,644,1460,3.38247e-08,0,1,1302228,1301584,644
1620601,644,644,644,1460,1.35299e-08,0,1,1302872,1302228,644
1622061,644,644,644,1460,0.00600001,0,1,1303516,1302872,644
1623521,647.8,644,648,1460,0.0204,0,1,1304164,1303516,648
1629361,694.743,670.857,696,1460,0.0577862,0,1,1306852,1306156,696
1635201,742.743,718.857,744,1460,0.0977193,0,1,1309732,1308988,744
1654181,886.743,862.857,888,1460,0.217783,0,1,1320364,1319476,888
1660021,934.743,910.857,936,1460,0.257719,0,1,1324012,1323076,936
1665861,982.743,958.857,984,1460,0.297718,0,1,1327852,1326868,984
1684841,1126.74,1102.8,1128,1460,0.417599,0,1,1341604,1340476,1128
1690681,1174.74,1150.86,1176,1460,0.457715,0,1,1346212,1345036,1176
1696521,1222.74,1198.86,1224,1460,0.497717,0,1,1351012,1349788,1224
1733021,1510.74,1486.86,1512,1460,0.737718,0,2,1385212,1383700,1512
1738861,1558.74,1534.86,1560,1460,0.777718,0,2,1391356,1389796,1560
1763681,1750.74,1726.86,1752,1460,0.937719,0,2,1419508,1417756,1752
1775361,1594.8,1800.06,1584,1460,0.492214,0,1,1433620,1432036,1584
1778281,660.627,976.54,644,1460,0.0787542,0,1,1435208,1434564,644
1779741,644.831,660.627,644,1460,0.0315017,0,1,1435852,1435208,644
1781201,644.042,644.831,644,1460,0.0126007,0,1,1436496,1435852,644
1782661,644.002,644.042,644,1460,0.00504027,0,1,1437140,1436496,644
1784121,644,644.002,644,1460,0.00201611,0,1,1437784,1437140,644
1785581,644,644,644,1460,0.000806443,0,1,1438428,1437784,644
1787041,644,644,644,1460,0.000322577,0,1,1439072,1438428,644
1788501,644,644,644,1460,0.000129031,0,1,1439716,1439072,644
1789961,644,644,644,1460,5.16123e-05,0,1,1440360,1439716,644
1791421,644,644,644,1460,2.06449e-05,0,1,1441004,1440360,644
1792881,644,644,644,1460,8.25797e-06,0,1,1441648,1441004,644
1794341,644,644,644,1460,3.30319e-06,0,1,1442292,1441648,644
1795801,644,644,644,1460,1.32128e-06,0,1,1442936,1442292,644
1797261,644,644,644,1460,5.2851e-07,0,1,1443580,1442936,644
1798721,644,644,644,1460,2.11404e-07,0,1,1444224,1443580,644
1800181,644,644,644,1460,8.45616e-08,0,1,1444868,1444224,644
1801641,644,644,644,1460,3.38247e-08,0,1,1445512,1444868,644
1803101,644,644,644,1460,1.35299e-08,0,1,1446156,1445512,644
1804561,644,644,644,1460,0.00600001,0,1,1446800,1446156,644
1806021,647.8,644,648,1460,0.0204,0,1,1447448,1446800,648
1811861,694.743,670.857,696,1460,0.0577862,0,1,1450136,1449440,696
1817701,742.743,718.857,744,1460,0.0977193,0,1,1453016,1452272,744
1836681,886.743,862.857,888,1460,0.217783,0,1,1463648,1462760,888
1842521,934.743,910.857,936,1460,0.257719,0,1,1467296,1466360,936
1848361,982.743,958.857,984,1460,0.297718,0,1,1471136,1470152,984
1867341,1126.74,1102.8,1128,1460,0.417599,0,1,1484888,1483760,1128
1873181,1174.74,1150.86,1176,1460,0.457715,0,1,1489496,1488320,1176
1879021,1222.74,1198.86,1224,1460,0.497717,0,1,1494296,1493072,1224
1915521,1510.74,1486.86,1512,1460,0.737718,0,2,1528496,1526984,1512
1921361,1558.74,1534.86,1560,1460,0.777718,0,2,1534640,1533080,1560
1946181,1750.74,1726.86,1752,1460,0.937719,0,2,1562792,1561040,1752
1957861,1594.8,1800.06,1584,1460,0.492214,0,1,1576904,1575320,1584
1960781,660.627,976.54,644,1460,0.0787542,0,1,1578492,1577848,644
1962241,644.831,660.627,644,1460,0.0315017,0,1,1579136,1578492,644
1963701,644.042,644.831,644,1460,0.0126007,0,1,1579780,1579136,644
1965161,644.002,644.042,644,1460,0.00504027,0,1,1580424,1579780,644
1966621,644,644.002,644,1460,0.00201611,0,1,1581068,1580424,644
1968081,644,644,644,1460,0.000806443,0,1,1581712,1581068,644
1969541,644,644,644,1460,0.000322577,0,1,1582356,1581712,644
1971001,644,644,644,1460,0.000129031,0,1,1583000,1582356,644
1972461,644,644,644,1460,5.16123e-05,0,1,1583644,1583000,644
1973921,644,644,644,1460,2.06449e-05,0,1,1584288,1583644,644
1975381,644,644,644,1460,8.25797e-06,0,1,1584932,1584288,644
1976841,644,644,644,1460,3.30319e-06,0,1,1585576,1584932,644
1978301,644,644,644,1460,1.32128e-06,0,1,1586220,1585576,644
1979761,644,644,644,1460,5.2851e-07,0,1,1586864,1586220,644
1981221,644,644,644,1460,2.11404e-07,0,1,1587508,1586864,644
1982681,644,644,644,1460,8.45616e-08,0,1,1588152,1587508,644
1984141,644,644,644,1460,3.38247e-08,0,1,1588796,1588152,644
1985601,644,644,644,1460,1.35299e-08,0,1,1589440,1588796,644
1987061,644,644,644,1460,0.00600001,0,1,1590084,1589440,644
1988521,647.8,644,648,1460,0.0204,0,1,1590732,1590084,648
1994361,694.743,670.857,696,1460,0.0577862,0,1,1593420,1592724,696
2000201,742.743,718.857,744,1460,0.0977193,0,1,1596300,1595556,744
2019181,886.743,862.857,888,1460,0.217783,0,1,1606932,1606044,888
2025021,934.743,910.857,936,1460,0.257719,0,1,1610580,1609644,936
2030861,982.743,958.857,984,1460,0.297718,0,1,1614420,1613436,984
2049841,1126.74,1102.8,1128,1460,0.417599,0,1,1628172,1627044,1128
2055681,1174.74,1150.86,1176,1460,0.457715,0,1,1632780,1631604,1176
2061521,1222.74,1198.86,1224,1460,0.497717,0,1,1637580,1636356,1224
2098021,1510.74,1486.86,1512,1460,0.737718,0,2,1671780,1670268,1512
2103861,1558.74,1534.86,1560,1460,0.777718,0,2,1677924,1676364,1560
2128681,1750.74,1726.86,1752,1460,0.937719,0,2,1706076,1704324,1752
2140361,1594.8,1800.06,1584,1460,0.492214,0,1,1720188,1718604,1584
2143281,660.627,976.54,644,1460,0.0787542,0,1,1721776,1721132,644
2144741,644.831,660.627,644,1460,0.0315017,0,1,1722420,1721776,644
2146201,644.042,644.831,644,1460,0.0126007,0,1,1723064,1722420,644
2147661,644.002,644.042,644,1460,0.00504027,0,1,1723708,1723064,644
2149121,644,644.002,644,1460,0.00201611,0,1,1724352,1723708,644
2150581,644,644,644,1460,0.000806443,0,1,1724996,1724352,644
2152041,644,644,644,1460,0.000322577,0,1,1725640,1724996,644
2153501,644,644,644,1460,0.000129031,0,1,1726284,1725640,644
2154961,644,644,644,1460,5.16123e-05,0,1,1726928,1726284,644
2156421,644,644,644,1460,2.06449e-05,0,1,1727572,1726928,644
2157881,644,644,644,1460,8.25797e-06,0,1,1728216,1727572,644
2159341,644,644,644,1460,3.30319e-06,0,1,1728860,1728216,644
2160801,644,644,644,1460,1.32128e-06,0,1,1729504,1728860,644
2162261,644,644,644,1460,5.2851e-07,0,1,1730148,1729504,644
2163721,644,644,644,1460,2.11404e-07,0,1,1730792,1730148,644
2165181,644,644,644,1460,8.45616e-08,0,1,1731436,1730792,644
2166641,644,644,644,1460,3.38247e-08,0,1,1732080,1731436,644
2168101,644,644,644,1460,1.35299e-08,0,1,1732724,1732080,644
2169561,644,644,644,1460,0.00600001,0,1,1733368,1732724,644
2171021,647.8,644,648,1460,0.0204,0,1,1734016,1733368,648
2176861,694.743,670.857,696,1460,0.0577862,0,1,1736704,1736008,696
2182701,742.743,718.857,744,1460,0.0977193,0,1,1739584,1738840,744
2201681,886.743,862.857,888,1460,0.217783,0,1,1750216,1749328,888
2207521,934.743,910.857,936,1460,0.257719,0,1,1753864,1752928,936
2213361,982.743,958.857,984,1460,0.297718,0,1,1757704,1756720,984
2232341,1126.74,1102.8,1128,1460,0.417599,0,1,1771456,1770328,1128
2238181,1174.74,1150.86,1176,1460,0.457715,0,1,1776064,1774888,1176
2244021,1222.74,1198.86,1224,1460,0.497717,0,1,1780864,1779640,1224
2280521,1510.74,1486.86,1512,1460,0.737718,0,2,1815064,1813552,1512
2286361,1558.74,1534.86,1560,1460,0.777718,0,2,1821208,1819648,1560
2311181,1750.74,1726.86,1752,1460,0.937719,0,2,1849360,1847608,1752
2322861,1594.8,1800.06,1584,1460,0.492214,0,1,1863472,1861888,1584
2325781,660.627,976.54,644,1460,0.0787542,0,1,1865060,1864416,644
2327241,644.831,660.627,644,1460,0.0315017,0,1,1865704,1865060,644
2328701,644.042,644.831,644,1460,0.0126007,0,1,1866348,1865704,644
2330161,644.002,644.042,644,1460,0.00504027,0,1,1866992,1866348,644
2331621,644,644.002,644,1460,0.00201611,0,1,1867636,1866992,644
2333081,644,644,644,1460,0.000806443,0,1,1868280,1867636,644
2334541,644,644,644,1460,0.000322577,0,1,1868924,1868280,644
2336001,644,644,644,1460,0.000129031,0,1,1869568,1868924,644
2337461,644,644,644,1460,5.16123e-05,0,1,1870212,1869568,644
2338921,644,644,644,1460,2.06449e-05,0,1,1870856,1870212,644
2340381,644,644,644,1460,8.25797e-06,0,1,1871500,1870856,644
2341841,644,644,644,1460,3.30319e-06,0,1,1872144,1871500,644
2343301,644,644,644,1460,1.32128e-06,0,1,1872788,1872144,644
2344761,644,644,644,1460,5.2851e-07,0,1,1873432,1872788,644
2346221,644,644,644,1460,2.11404e-07,0,1,1874076,1873432,644
2347681,644,644,644,1460,8.45616e-08,0,1,1874720,1874076,644
2349141,644,644,644,1460,3.38247e-08,0,1,1875364,1874720,644
2350601,644,644,644,1460,1.35299e-08,0,1,1876008,1875364,644
2352061,644,644,644,1460,0.00600001,0,1,1876652,1876008,644
2353521,647.8,644,648,1460,0.0204,0,1,1877300,1876652,648
2359361,694.743,670.857,696,1460,0.0577862,0,1,1879988,1879292,696
2365201,742.743,718.857,744,1460,0.0977193,0,1,1882868,1882124,744
2384181,886.743,862.857,888,1460,0.217783,0,1,1893500,1892612,888
2390021,934.743,910.857,936,1460,0.257719,0,1,1897148,1896212,936
2395861,982.743,958.857,984,1460,0.297718,0,1,1900988,1900004,984
2414841,1126.74,1102.8,1128,1460,0.417599,0,1,1914740,1913612,1128
2420681,1174.74,1150.86,1176,1460,0.457715,0,1,1919348,1918172,1176
2426521,1222.74,1198.86,1224,1460,0.497717,0,1,1924148,1922924,1224
2463021,1510.74,1486.86,1512,1460,0.737718,0,2,1958348,1956836,1512
2468861,1558.74,1534.86,1560,1460,0.777718,0,2,1964492,1962932,1560
2493681,1750.74,1726.86,1752,1460,0.937719,0,2,1992644,1990892,1752
2505361,1594.8,1800.06,1584,1460,0.492214,0,1,2006756,2005172,1584
2508281,660.627,976.54,644,1460,0.0787542,0,1,2008344,2007700,644
2509741,644.831,660.627,644,1460,0.0315017,0,1,2008988,2008344,644
2511201,644.042,644.831,644,1460,0.0126007,0,1,2009632,2008988,644
2512661,644.002,644.042,644,1460,0.00504027,0,1,2010276,2009632,644
2514121,644,644.002,644,1460,0.00201611,0,1,2010920,2010276,644
2515581,644,644,644,1460,0.000806443,0,1,2011564,2010920,644
2517041,644,644,644,1460,0.000322577,0,1,2012208,2011564,644
2518501,644,644,644,1460,0.000129031,0,1,2012852,2012208,644
2519961,644,644,644,1460,5.16123e-05,0,1,2013496,2012852,644
2521421,644,644,644,1460,2.06449e-05,0,1,2014140,2013496,644
2522881,644,644,644,1460,8.25797e-06,0,1,2014784,2014140,644
2524341,644,644,644,1460,3.30319e-06,0,1,2015428,2014784,644
2525801,644,644,644,1460,1.32128e-06,0,1,2016072,2015428,644
2527261,644,644,644,1460,5.2851e-07,0,1,2016716,2016072,644
2528721,644,644,644,1460,2.11404e-07,0,1,2017360,2016716,644
2530181,644,644,644,1460,8.45616e-08,0,1,2018004,2017360,644
2531641,644,644,644,1460,3.38247e-08,0,1,2018648,2018004,644
2533101,644,644,644,1460,1.35299e-08,0,1,2019292,2018648,644
2534561,644,644,644,1460,0.00600001,0,1,2019936,2019292,644
2536021,647.8,644,648,1460,0.0204,0,1,2020584,2019936,648
2541861,694.743,670.857,696,1460,0.0577862,0,1,2023272,2022576,696
2547701,742.743,718.857,744,1460,0.0977193,0,1,2026152,2025408,744
2566681,886.743,862.857,888,1460,0.217783,0,1,2036784,2035896,888
2572521,934.743,910.857,936,1460,0.257719,0,1,2040432,2039496,936
2578361,982.743,958.857,984,1460,0.297718,0,1,2044272,2043288,984
2597341,1126.74,1102.8,1128,1460,0.417599,0,1,2058024,2056896,1128
2603181,1174.74,1150.86,1176,1460,0.457715,0,1,2062632,2061456,1176
2609021,1222.74,1198.86,1224,1460,0.497717,0,1,2067432,2066208,1224
2645521,1510.74,1486.86,1512,1460,0.737718,0,2,2101632,2100120,1512
2651361,1558.74,1534.86,1560,1460,0.777718,0,2,2107776,2106216,1560
2676181,1750.74,1726.86,1752,1460,0.937719,0,2,2135928,2134176,1752
2687861,1594.8,1800.06,1584,1460,0.492214,0,1,2150040,2148456,1584
2690781,660.627,976.54,644,1460,0.0787542,0,1,2151628,2150984,644
2692241,644.831,660.627,644,1460,0.0315017,0,1,2152272,2151628,644
2693701,644.042,644.831,644,1460,0.0126007,0,1,2152916,2152272,644
2695161,644.002,644.042,644,1460,0.00504027,0,1,2153560,2152916,644
2696621,644,644.002,644,1460,0.00201611,0,1,2154204,2153560,644
2698081,644,644,644,1460,0.000806443,0,1,2154848,2154204,644
2699541,644,644,644,1460,0.000322577,0,1,2155492,2154848,644
2701001,644,644,644,1460,0.000129031,0,1,2156136,2155492,644
2702461,644,644,644,1460,5.16123e-05,0,1,2156780,2156136,644
2703921,644,644,644,1460,2.06449e-05,0,1,2157424,2156780,644
2705381,644,644,644,1460,8.25797e-06,0,1,2158068,2157424,644
2706841,644,644,644,1460,3.30319e-06,0,1,2158712,2158068,644
2708301,644,644,644,1460,1.32128e-06,0,1,2159356,2158712,644
2709761,644,644,644,1460,5.2851e-07,0,1,2160000,2159356,644
2711221,644,644,644,1460,2.11404e-07,0,1,2160644,2160000,644
2712681,644,644,644,1460,8.45616e-08,0,1,2161288,2160644,644
2714141,644,644,644,1460,3.38247e-08,0,1,2161932,2161288,644
2715601,644,644,644,1460,1.35299e-08,0,1,2162576,2161932,644
2717061,644,644,644,1460,0.00600001,0,1,2163220,2162576,644
2718521,647.8,644,648,1460,0.0204,0,1,2163868,2163220,648
2724361,694.743,670.857,696,1460,0.0577862,0,1,2166556,2165860,696
2730201,742.743,718.857,744,1460,0.0977193,0,1,2169436,2168692,744
2749181,886.743,862.857,888,1460,0.217783,0,1,2180068,2179180,888
2755021,934.743,910.857,936,1460,0.257719,0,1,2183716,2182780,936
2760861,982.743,958.857,984,1460,0.297718,0,1,2187556,2186572,984
2779841,1126.74,1102.8,1128,1460,0.417599,0,1,2201308,2200180,1128
2785681,1174.74,1150.86,1176,1460,0.457715,0,1,2205916,2204740,1176
2791521,1222.74,1198.86,1224,1460,0.497717,0,1,2210716,2209492,1224
2828021,1510.74,1486.86,1512,1460,0.737718,0,2,2244916,2243404,1512
2833861,1558.74,1534.86,1560,1460,0.777718,0,2,2251060,2249500,1560
2858681,1750.74,1726.86,1752,1460,0.937719,0,2,2279212,2277460,1752
2870361,1594.8,1800.06,1584,1460,0.492214,0,1,2293324,2291740,1584
2873281,660.627,976.54,644,1460,0.0787542,0,1,2294912,2294268,644
2874741,644.831,660.627,644,1460,0.0315017,0,1,2295556,2294912,644
2876201,644.042,644.831,644,1460,0.0126007,0,1,2296200,2295556,644
2877661,644.002,644.042,644,1460,0.00504027,0,1,2296844,2296200,644
2879121,644,644.002,644,1460,0.00201611,0,1,2297488,2296844,644
2880581,644,644,644,1460,0.000806443,0,1,2298132,2297488,644
2882041,644,644,644,1460,0.000322577,0,1,2298776,2298132,644
2883501,644,644,644,1460,0.000129031,0,1,2299420,2298776,644
2884961,644,644,644,1460,5.16123e-05,0,1,2300064,2299420,644
2886421,644,644,644,1460,2.06449e-05,0,1,2300708,2300064,644
2887881,644,644,644,1460,8.25797e-06,0,1,2301352,2300708,644
2889341,644,644,644,1460,3.30319e-06,0,1,2301996,2301352,644
2890801,644,644,644,1460,1.32128e-06,0,1,2302640,2301996,644
2892261,644,644,644,1460,5.2851e-07,0,1,2303284,2302640,644
2893721,644,644,644,1460,2.11404e-07,0,1,2303928,2303284,644
2895181,644,644,644,1460,8.45616e-08,0,1,2304572,2303928,644
2896641,644,644,644,1460,3.38247e-08,0,1,2305216,2304572,644
2898101,644,644,644,1460,1.35299e-08,0,1,2305860,2305216,644
2899561,644,644,644,1460,0.00600001,0,1,2306504,2305860,644
2901021,647.8,644,648,1460,0.0204,0,1,2307152,2306504,648
2906861,694.743,670.857,696,1460,0.0577862,0,1,2309840,2309144,696
2912701,742.743,718.857,744,1460,0.0977193,0,1,2312720,2311976,744
2931681,886.743,862.857,888,1460,0.217783,0,1,2323352,2322464,888
2937521,934.743,910.857,936,1460,0.257719,0,1,2327000,2326064,936
2943361,982.743,958.857,984,1460,0.297718,0,1,2330840,2329856,984
2962341,1126.74,1102.8,1128,1460,0.417599,0,1,2344592,2343464,1128
2968181,1174.74,1150.86,1176,1460,0.457715,0,1,2349200,2348024,1176
2974021,1222.74,1198.86,1224,1460,0.497717,0,1,2354000,2352776,1224
3010521,1510.74,1486.86,1512,1460,0.737718,0,2,2388200,2386688,1512
3016361,1558.74,1534.86,1560,1460,0.777718,0,2,2394344,2392784,1560
3041181,1750.74,1726.86,1752,1460,0.937719,0,2,2422496,2420744,1752
3052861,1594.8,1800.06,1584,1460,0.492214,0,1,2436608,2435024,1584
3055781,660.627,976.54,644,1460,0.0787542,0,1,2438196,2437552,644
3057241,644.831,660.627,644,1460,0.0315017,0,1,2438840,2438196,644
3058701,644.042,644.831,644,1460,0.0126007,0,1,2439484,2438840,644
3060161,644.002,644.042,644,1460,0.00504027,0,1,2440128,2439484,644
3061621,644,644.002,644,1460,0.00201611,0,1,2440772,2440128,644
3063081,644,644,644,1460,0.000806443,0,1,2441416,2440772,644
3064541,644,644,644,1460,0.000322577,0,1,2442060,2441416,644
3066001,644,644,644,1460,0.000129031,0,1,2442704,2442060,644
3067461,644,644,644,1460,5.16123e-05,0,1,2443348,2442704,644
3068921,644,644,644,1460,2.06449e-05,0,1,2443992,2443348,644
3070381,644,644,644,1460,8.25797e-06,0,1,2444636,2443992,644
3071841,644,644,644,1460,3.30319e-06,0,1,2445280,2444636,644
3073301,644,644,644,1460,1.32128e-06,0,1,2445924,2445280,644
3074761,644,644,644,1460,5.2851e-07,0,1,2446568,2445924,644
3076221,644,644,644,1460,2.11404e-07,0,1,2447212,2446568,644
3077681,644,644,644,1460,8.45616e-08,0,1,2447856,2447212,644
3079141,644,644,644,1460,3.38247e-08,0,1,2448500,2447856,644
3080601,644,644,644,1460,1.35299e-08,0,1,2449144,2448500,644
3082061,644,644,644,1460,0.00600001,0,1,2449788,2449144,644
3083521,647.8,644,648,1460,0.0204,0,1,2450436,2449788,648
3089361,694.743,670.857,696,1460,0.0577862,0,1,2453124,2452428,696
3095201,742.743,718.857,744,1460,0.0977193,0,1,2456004,2455260,744
3114181,886.743,862.857,888,1460,0.217783,0,1,2466636,2465748,888
3120021,934.743,910.857,936,1460,0.257719,0,1,2470284,2469348,936
3125861,982.743,958.857,984,1460,0.297718,0,1,2474124,2473140,984
3144841,1126.74,1102.8,1128,1460,0.417599,0,1,2487876,2486748,1128
3150681,1174.74,1150.86,1176,1460,0.457715,0,1,2492484,2491308,1176
3156521,1222.74,1198.86,1224,1460,0.497717,0,1,2497284,2496060,1224
3193021,1510.74,1486.86,1512,1460,0.737718,0,2,2531484,2529972,1512
3198861,1558.74,1534.86,1560,1460,0.777718,0,2,2537628,2536068,1560
3223681,1750.74,1726.86,1752,1460,0.937719,0,2,2565780,2564028,1752
3235361,1594.8,1800.06,1584,1460,0.492214,0,1,2579892,2578308,1584
3238281,660.627,976.54,644,1460,0.0787542,0,1,2581480,2580836,644
3239741,644.831,660.627,644,1460,0.0315017,0,1,2582124,2581480,644
3241201,644.042,644.831,644,1460,0.0126007,0,1,2582768,2582124,644
3242661,644.002,644.042,644,1460,0.00504027,0,1,2583412,2582768,644
3244121,644,644.002,644,1460,0.00201611,0,1,2584056,2583412,644
3245581,644,644,644,1460,0.000806443,0,1,2584700,2584056,644
3247041,644,644,644,1460,0.000322577,0,1,2585344,2584700,644
3248501,644,644,644,1460,0.000129031,0,1,2585988,2585344,644
3249961,644,644,644,1460,5.16123e-05,0,1,2586632,2585988,644
3251421,644,644,644,1460,2.06449e-05,0,1,2587276,2586632,644
3252881,644,644,644,1460,8.25797e-06,0,1,2587920,2587276,644
3254341,644,644,644,1460,3.30319e-06,0,1,2588564,2587920,644
3255801,644,644,644,1460,1.32128e-06,0,1,2589208,2588564,644
3257261,644,644,644,1460,5.2851e-07,0,1,2589852,2589208,644
3258721,644,644,644,1460,2.11404e-07,0,1,2590496,2589852,644
3260181,644,644,644,1460,8.45616e-08,0,1,2591140,2590496,644
3261641,644,644,644,1460,3.38247e-08,0,1,2591784,2591140,644
3263101,644,644,644,1460,1.35299e-08,0,1,2592428,2591784,644
3264561,644,644,644,1460,0.00600001,0,1,2593072,2592428,644
3266021,647.8,644,648,1460,0.0204,0,1,2593720,2593072,648
3271861,694.743,670.857,696,1460,0.0577862,0,1,2596408,2595712,696
3277701,742.743,718.857,744,1460,0.0977193,0,1,2599288,2598544,744
3296681,886.743,862.857,888,1460,0.217783,0,1,2609920,2609032,888
3302521,934.743,910.857,936,1460,0.257719,0,1,2613568,2612632,936
3308361,982.743,958.857,984,1460,0.297718,0,1,2617408,2616424,984
3327341,1126.74,1102.8,1128,1460,0.417599,0,1,2631160,2630032,1128
3333181,1174.74,1150.86,1176,1460,0.457715,0,1,2635768,2634592,1176
3339021,1222.74,1198.86,1224,1460,0.497717,0,1,2640568,2639344,1224
3375521,1510.74,1486.86,1512,1460,0.737718,0,2,2674768,2673256,1512
3381361,1558.74,1534.86,1560,1460,0.777718,0,2,2680912,2679352,1560
3406181,1750.74,1726.86,1752,1460,0.937719,0,2,2709064,2707312,1752
3417861,1594.8,1800.06,1584,1460,0.492214,0,1,2723176,2721592,1584
3420781,660.627,976.54,644,1460,0.0787542,0,1,2724764,2724120,644
3422241,644.831,660.627,644,1460,0.0315017,0,1,2725408,2724764,644
3423701,644.042,644.831,644,1460,0.0126007,0,1,2726052,2725408,644
3425161,644.002,644.042,644,1460,0.00504027,0,1,2726696,2726052,644
3426621,644,644.002,644,1460,0.00201611,0,1,2727340,2726696,644
3428081,644,644,644,1460,0.000806443,0,1,2727984,2727340,644
3429541,644,644,644,1460,0.000322577,0,1,2728628,2727984,644
3431001,644,644,644,1460,0.000129031,0,1,2729272,2728628,644
3432461,644,644,644,1460,5.16123e-05,0,1,2729916,2729272,644
3433921,644,644,644,1460,2.06449e-05,0,1,2730560,2729916,644
3435381,644,644,644,1460,8.25797e-06,0,1,2731204,2730560,644
3436841,644,644,644,1460,3.30319e-06,0,1,2731848,2731204,644
3438301,644,644,644,1460,1.32128e-06,0,1,2732492,2731848,644
3439761,644,644,644,1460,5.2851e-07,0,1,2733136,2732492,644
3441221,644,644,644,1460,2.11404e-07,0,1,2733780,2733136,644
3442681,644,644,644,1460,8.45616e-08,0,1,2734424,2733780,644
3444141,644,644,644,1460,3.38247e-08,0,1,2735068,2734424,644
3445601,644,644,644,1460,1.35299e-08,0,1,2735712,2735068,644
3447061,644,644,644,1460,0.00600001,0,1,2736356,2735712,644
3448521,647.8,644,648,1460,0.0204,0,1,2737004,2736356,648
3454361,694.743,670.857,696,1460,0.0577862,0,1,2739692,2738996,696
3460201,742.743,718.857,744,1460,0.0977193,0,1,2742572,2741828,744
3479181,886.743,862.857,888,1460,0.217783,0,1,2753204,2752316,888
3485021,934.743,910.857,936,1460,0.257719,0,1,2756852,2755916,936
3490861,982.743,958.857,984,1460,0.297718,0,1,2760692,2759708,984
3509841,1126.74,1102.8,1128,1460,0.417599,0,1,2774444,2773316,1128
3515681,1174.74,1150.86,1176,1460,0.457715,0,1,2779052,2777876,1176
3521521,1222.74,1198.86,1224,1460,0.497717,0,1,2783852,2782628,1224
3558021,1510.74,1486.86,1512,1460,0.737718,0,2,2818052,2816540,1512
3563861,1558.74,1534.86,1560,1460,0.777718,0,2,2824196,2822636,1560
3588681,1750.74,1726.86,1752,1460,0.937719,0,2,2852348,2850596,1752
3600361,1594.8,1800.06,1584,1460,0.492214,0,1,2866460,2864876,1584
3603281,660.627,976.54,644,1460,0.0787542,0,1,2868048,2867404,644
3604741,644.831,660.627,644,1460,0.0315017,0,1,2868692,2868048,644
3606201,644.042,644.831,644,1460,0.0126007,0,1,2869336,2868692,644
3607661,644.002,644.042,644,1460,0.00504027,0,1,2869980,2869336,644
3609121,644,644.002,644,1460,0.00201611,0,1,2870624,2869980,644
3610581,644,644,644,1460,0.000806443,0,1,2871268,2870624,644
3612041,644,644,644,1460,0.000322577,0,1,2871912,2871268,644
3613501,644,644,644,1460,0.000129031,0,1,2872556,2871912,644
3614961,644,644,644,1460,5.16123e-05,0,1,2873200,2872556,644
3616421,644,644,644,1460,2.06449e-05,0,1,2873844,2873200,644
3617881,644,644,644,1460,8.25797e-06,0,1,2874488,2873844,644
3619341,644,644,644,1460,3.30319e-06,0,1,2875132,2874488,644
3620801,644,644,644,1460,1.32128e-06,0,1,2875776,2875132,644
3622261,644,644,644,1460,5.2851e-07,0,1,2876420,2875776,644
3623721,644,644,644,1460,2.11404e-07,0,1,2877064,2876420,644
3625181,644,644,644,1460,8.45616e-08,0,1,2877708,2877064,644
3626641,644,644,644,1460,3.38247e-08,0,1,2878352,2877708,644
3628101,644,644,644,1460,1.35299e-08,0,1,2878996,2878352,644
3629561,644,644,644,1460,0.00600001,0,1,2879640,2878996,644
3631021,647.8,644,648,1460,0.0204,0,1,2880288,2879640,648
3636861,694.743,670.857,696,1460,0.0577862,0,1,2882976,2882280,696
3642701,742.743,718.857,744,1460,0.0977193,0,1,2885856,2885112,744
3661681,886.743,862.857,888,1460,0.217783,0,1,2896488,2895600,888
3667521,934.743,910.857,936,1460,0.257719,0,1,2900136,2899200,936
3673361,982.743,958.857,984,1460,0.297718,0,1,2903976,2902992,984
3692341,1126.74,1102.8,1128,1460,0.417599,0,1,2917728,2916600,1128
3698181,1174.74,1150.86,1176,1460,0.457715,0,1,2922336,2921160,1176
3704021,1222.74,1198.86,1224,1460,0.497717,0,1,2927136,2925912,1224
3740521,1510.74,1486.86,1512,1460,0.737718,0,2,2961336,2959824,1512
3746361,1558.74,1534.86,1560,1460,0.777718,0,2,2967480,2965920,1560
3771181,1750.74,1726.86,1752,1460,0.937719,0,2,2995632,2993880,1752
3782861,1594.8,1800.06,1584,1460,0.492214,0,1,3009744,3008160,1584
3785781,660.627,976.54,644,1460,0.0787542,0,1,3011332,3010688,644
3787241,644.831,660.627,644,1460,0.0315017,0,1,3011976,3011332,644
3788701,644.042,644.831,644,1460,0.0126007,0,1,3012620,3011976,644
3790161,644.002,644.042,644,1460,0.00504027,0,1,3013264,3012620,644
3791621,644,644.002,644,1460,0.00201611,0,1,3013908,3013264,644
3793081,644,644,644,1460,0.000806443,0,1,3014552,3013908,644
3794541,644,644,644,1460,0.000322577,0,1,3015196,3014552,644
3796001,644,644,644,1460,0.000129031,0,1,3015840,3015196,644
3797461,644,644,644,1460,5.16123e-05,0,1,3016484,3015840,644
3798921,644,644,644,1460,2.06449e-05,0,1,3017128,3016484,644
3800381,644,644,644,1460,8.25797e-06,0,1,3017772,3017128,644
3801841,644,644,644,1460,3.30319e-06,0,1,3018416,3017772,644
3803301,644,644,644,1460,1.32128e-06,0,1,3019060,3018416,644
3804761,644,644,644,1460,5.2851e-07,0,1,3019704,3019060,644
3806221,644,644,644,1460,2.11404e-07,0,1,3020348,3019704,644
3807681,644,644,644,1460,8.45616e-08,0,1,3020992,3020348,644
3809141,644,644,644,1460,3.38247e-08,0,1,3021636,3020992,644
3810601,644,644,644,1460,1.35299e-08,0,1,3022280,3021636,644
3812061,644,644,644,1460,0.00600001,0,1,3022924,3022280,644
3813521,647.8,644,648,1460,0.0204,0,1,3023572,3022924,648
3819361,694.743,670.857,696,1460,0.0577862,0,1,3026260,3025564,696
3825201,742.743,718.857,744,1460,0.0977193,0,1,3029140,3028396,744
3844181,886.743,862.857,888,1460,0.217783,0,1,3039772,3038884,888
3850021,934.743,910.857,936,1460,0.257719,0,1,3043420,3042484,936
3855861,982.743,958.857,984,1460,0.297718,0,1,3047260,3046276,984
3874841,1126.74,1102.8,1128,1460,0.417599,0,1,3061012,3059884,1128
3880681,1174.74,1150.86,1176,1460,0.457715,0,1,3065620,3064444,1176
3886521,1222.74,1198.86,1224,1460,0.497717,0,1,3070420,3069196,1224
3923021,1510.74,1486.86,1512,1460,0.737718,0,2,3104620,3103108,1512
3928861,1558.74,1534.86,1560,1460,0.777718,0,2,3110764,3109204,1560
3953681,1750.74,1726.86,1752,1460,0.937719,0,2,3138916,3137164,1752
3965361,1594.8,1800.06,1584,1460,0.492214,0,1,3153028,3151444,1584
3968281,660.627,976.54,644,1460,0.0787542,0,1,3154616,3153972,644
3969741,644.831,660.627,644,1460,0.0315017,0,1,3155260,3154616,644
3971201,644.042,644.831,644,1460,0.0126007,0,1,3155904,3155260,644
3972661,644.002,644.042,644,1460,0.00504027,0,1,3156548,3155904,644
3974121,644,644.002,644,1460,0.00201611,0,1,3157192,3156548,644
3975581,644,644,644,1460,0.000806443,0,1,3157836,3157192,644
3977041,644,644,644,1460,0.000322577,0,1,3158480,3157836,644
3978501,644,644,644,1460,0.000129031,0,1,3159124,3158480,644
3979961,644,644,644,1460,5.16123e-05,0,1,3159768,3159124,644
3981421,644,644,644,1460,2.06449e-05,0,1,3160412,3159768,644
3982881,644,644,644,1460,8.25797e-06,0,1,3161056,3160412,644
3984341,644,644,644,1460,3.30319e-06,0,1,3161700,3161056,644
3985801,644,644,644,1460,1.32128e-06,0,1,3162344,3161700,644
3987261,644,644,644,1460,5.2851e-07,0,1,3162988,3162344,644
3988721,644,644,644,1460,2.11404e-07,0,1,3163632,3162988,644
3990181,644,644,644,1460,8.45616e-08,0,1,3164276,3163632,644
3991641,644,644,644,1460,3.38247e-08,0,1,3164920,3164276,644
3993101,644,644,644,1460,1.35299e-08,0,1,3165564,3164920,644
3994561,644,644,644,1460,0.00600001,0,1,3166208,3165564,644
3996021,647.8,644,648,1460,0.0204,0,1,3166856,3166208,648
4001861,694.743,670.857,696,1460,0.0577862,0,1,3169544,3168848,696
4007701,742.743,718.857,744,1460,0.0977193,0,1,3172424,3171680,744
4026681,886.743,862.857,888,1460,0.217783,0,1,3183056,3182168,888
4032521,934.743,910.857,936,1460,0.257719,0,1,3186704,3185768,936
4038361,982.743,958.857,984,1460,0.297718,0,1,3190544,3189560,984
4057341,1126.74,1102.8,1128,1460,0.417599,0,1,3204296,3203168,1128
4063181,1174.74,1150.86,1176,1460,0.457715,0,1,3208904,3207728,1176
4069021,1222.74,1198.86,1224,1460,0.497717,0,1,3213704,3212480,1224
4105521,1510.74,1486.86,1512,1460,0.737718,0,2,3247904,3246392,1512
4111361,1558.74,1534.86,1560,1460,0.777718,0,2,3254048,3252488,1560
4136181,1750.74,1726.86,1752,1460,0.937719,0,2,3282200,3280448,1752
4147861,1594.8,1800.06,1584,1460,0.492214,0,1,3296312,3294728,1584
4150781,660.627,976.54,644,1460,0.0787542,0,1,3297900,3297256,644
4152241,644.831,660.627,644,1460,0.0315017,0,1,3298544,3297900,644
4153701,644.042,644.831,644,1460,0.0126007,0,1,3299188,3298544,644
4155161,644.002,644.042,644,1460,0.00504027,0,1,3299832,3299188,644
4156621,644,644.002,644,1460,0.00201611,0,1,3300476,3299832,644
4158081,644,644,644,1460,0.000806443,0,1,3301120,3300476,644
4159541,644,644,644,1460,0.000322577,0,1,3301764,3301120,644
4161001,644,644,644,1460,0.000129031,0,1,3302408,3301764,644
4162461,644,644,644,1460,5.16123e-05,0,1,3303052,3302408,644
4163921,644,644,644,1460,2.06449e-05,0,1,3303696,3303052,644
4165381,644,644,644,1460,8.25797e-06,0,1,3304340,3303696,644
4166841,644,644,644,1460,3.30319e-06,0,1,3304984,3304340,644
4168301,644,644,644,1460,1.32128e-06,0,1,3305628,3304984,644
4169761,644,644,644,1460,5.2851e-07,0,1,3306272,3305628,644
4171221,644,644,644,1460,2.11404e-07,0,1,3306916,3306272,644
4172681,644,644,644,1460,8.45616e-08,0,1,3307560,3306916,644
4174141,644,644,644,1460,3.38247e-08,0,1,3308204,3307560,644
4175601,644,644,644,1460,1.35299e-08,0,1,3308848,3308204,644
4177061,644,644,644,1460,0.00600001,0,1,3309492,3308848,644
4178521,647.8,644,648,1460,0.0204,0,1,3310140,3309492,648
4184361,694.743,670.857,696,1460,0.0577862,0,1,3312828,3312132,696
4190201,742.743,718.857,744,1460,0.0977193,0,1,3315708,3314964,744
4209181,886.743,862.857,888,1460,0.217783,0,1,3326340,3325452,888
4215021,934.743,910.857,936,1460,0.257719,0,1,3329988,3329052,936
4220861,982.743,958.857,984,1460,0.297718,0,1,3333828,3332844,984
4239841,1126.74,1102.8,1128,1460,0.417599,0,1,3347580,3346452,1128
4245681,1174.74,1150.86,1176,1460,0.457715,0,1,3352188,3351012,1176
4251521,1222.74,1198.86,1224,1460,0.497717,0,1,3356988,3355764,1224
4288021,1510.74,1486.86,1512,1460,0.737718,0,2,3391188,3389676,1512
4293861,1558.74,1534.86,1560,1460,0.777718,0,2,3397332,3395772,1560
4318681,1750.74,1726.86,1752,1460,0.937719,0,2,3425484,3423732,1752
4330361,1594.8,1800.06,1584,1460,0.492214,0,1,3439596,3438012,1584
4333281,660.627,976.54,644,1460,0.0787542,0,1,3441184,3440540,644
4334741,644.831,660.627,644,1460,0.0315017,0,1,3441828,3441184,644
4336201,644.042,644.831,644,1460,0.0126007,0,1,3442472,3441828,644
4337661,644.002,644.042,644,1460,0.00504027,0,1,3443116,3442472,644
4339121,644,644.002,644,1460,0.00201611,0,1,3443760,3443116,644
4340581,644,644,644,1460,0.000806443,0,1,3444404,3443760,644
4342041,644,644,644,1460,0.000322577,0,1,3445048,3444404,644
4343501,644,644,644,1460,0.000129031,0,1,3445692,3445048,644
4344961,644,644,644,1460,5.16123e-05,0,1,3446336,3445692,644
4346421,644,644,644,1460,2.06449e-05,0,1,3446980,3446336,644
4347881,644,644,644,1460,8.25797e-06,0,1,3447624,3446980,644
4349341,644,644,644,1460,3.30319e-06,0,1,3448268,3447624,644
4350801,644,644,644,1460,1.32128e-06,0,1,3448912,3448268,644
4352261,644,644,644,1460,5.2851e-07,0,1,3449556,3448912,644
4353721,644,644,644,1460,2.11404e-07,0,1,3450200,3449556,644
4355181,644,644,644,1460,8.45616e-08,0,1,3450844,3450200,644
4356641,644,644,644,1460,3.38247e-08,0,1,3451488,3450844,644
4358101,644,644,644,1460,1.35299e-08,0,1,3452132,3451488,644
4359561,644,644,644,1460,0.00600001,0,1,3452776,3452132,644
4361021,647.8,644,648,1460,0.0204,0,1,3453424,3452776,648
4366861,694.743,670.857,696,1460,0.0577862,0,1,3456112,3455416,696
4372701,742.743,718.857,744,1460,0.0977193,0,1,3458992,3458248,744
4391681,886.743,862.857,888,1460,0.217783,0,1,3469624,3468736,888
4397521,934.743,910.857,936,1460,0.257719,0,1,3473272,3472336,936
4403361,982.743,958.857,984,1460,0.297718,0,1,3477112,3476128,984
4422341,1126.74,1102.8,1128,1460,0.417599,0,1,3490864,3489736,1128
4428181,1174.74,1150.86,1176,1460,0.457715,0,1,3495472,3494296,1176
4434021,1222.74,1198.86,1224,1460,0.497717,0,1,3500272,3499048,1224
4470521,1510.74,1486.86,1512,1460,0.737718,0,2,3534472,3532960,1512
4476361,1558.74,1534.86,1560,1460,0.777718,0,2,3540616,3539056,1560
4501181,1750.74,1726.86,1752,1460,0.937719,0,2,3568768,3567016,1752
4512861,1594.8,1800.06,1584,1460,0.492214,0,1,3582880,3581296,1584
4515781,660.627,976.54,644,1460,0.0787542,0,1,3584468,3583824,644
4517241,644.831,660.627,644,1460,0.0315017,0,1,3585112,3584468,644
4518701,644.042,644.831,644,1460,0.0126007,0,1,3585756,3585112,644
4520161,644.002,644.042,644,1460,0.00504027,0,1,3586400,3585756,644
4521621,644,644.002,644,1460,0.00201611,0,1,3587044,3586400,644
4523081,644,644,644,1460,0.000806443,0,1,3587688,3587044,644
4524541,644,644,644,1460,0.000322577,0,1,3588332,3587688,644
4526001,644,644,644,1460,0.000129031,0,1,3588976,3588332,644
4527461,644,644,644,1460,5.16123e-05,0,1,3589620,3588976,644
4528921,644,644,644,1460,2.06449e-05,0,1,3590264,3589620,644
4530381,644,644,644,1460,8.25797e-06,0,1,3590908,3590264,644
4531841,644,644,644,1460,3.30319e-06,0,1,3591552,3590908,644
4533301,644,644,644,1460,1.32128e-06,0,1,3592196,3591552,644
4534761,644,644,644,1460,5.2851e-07,0,1,3592840,3592196,644
4536221,644,644,644,1460,2.11404e-07,0,1,3593484,3592840,644
4537681,644,644,644,1460,8.45616e-08,0,1,3594128,3593484,644
4539141,644,644,644,1460,3.38247e-08,0,1,3594772,3594128,644
4540601,644,644,644,1460,1.35299e-08,0,1,3595416,3594772,644
4542061,644,644,644,1460,0.00600001,0,1,3596060,3595416,644
4543521,647.8,644,648,1460,0.0204,0,1,3596708,3596060,648
4549361,694.743,670.857,696,1460,0.0577862,0,1,3599396,3598700,696
4555201,742.743,718.857,744,1460,0.0977193,0,1,3602276,3601532,744
4574181,886.743,862.857,888,1460,0.217783,0,1,3612908,3612020,888
4580021,934.743,910.857,936,1460,0.257719,0,1,3616556,3615620,936
4585861,982.743,958.857,984,1460,0.297718,0,1,3620396,3619412,984
4604841,1126.74,1102.8,1128,1460,0.417599,0,1,3634148,3633020,1128
4610681,1174.74,1150.86,1176,1460,0.457715,0,1,3638756,3637580,1176
4616521,1222.74,1198.86,1224,1460,0.497717,0,1,3643556,3642332,1224
4653021,1510.74,1486.86,1512,1460,0.737718,0,2,3677756,3676244,1512
4658861,1558.74,1534.86,1560,1460,0.777718,0,2,3683900,3682340,1560
4683681,1750.74,1726.86,1752,1460,0.937719,0,2,3712052,3710300,1752
4695361,1594.8,1800.06,1584,1460,0.492214,0,1,3726164,3724580,1584
4698281,660.627,976.54,644,1460,0.0787542,0,1,3727752,3727108,644
4699741,644.831,660.627,644,1460,0.0315017,0,1,3728396,3727752,644
4701201,644.042,644.831,644,1460,0.0126007,0,1,3729040,3728396,644
4702661,644.002,644.042,644,1460,0.00504027,0,1,3729684,3729040,644
4704121,644,644.002,644,1460,0.00201611,0,1,3730328,3729684,644
4705581,644,644,644,1460,0.000806443,0,1,3730972,3730328,644
4707041,644,644,644,1460,0.000322577,0,1,3731616,3730972,644
4708501,644,644,644,1460,0.000129031,0,1,3732260,3731616,644
4709961,644,644,644,1460,5.16123e-05,0,1,3732904,3732260,644
4711421,644,644,644,1460,2.06449e-05,0,1,3733548,3732904,644
4712881,644,644,644,1460,8.25797e-06,0,1,3734192,3733548,644
4714341,644,644,644,1460,3.30319e-06,0,1,3734836,3734192,644
4715801,644,644,644,1460,1.32128e-06,0,1,3735480,3734836,644
4717261,644,644,644,1460,5.2851e-07,0,1,3736124,3735480,644
4718721,644,644,644,1460,2.11404e-07,0,1,3736768,3736124,644
4720181,644,644,644,1460,8.45616e-08,0,1,3737412,3736768,644
4721641,644,644,644,1460,3.38247e-08,0,1,3738056,3737412,644
4723101,644,644,644,1460,1.35299e-08,0,1,3738700,3738056,644
4724561,644,644,644,1460,0.00600001,0,1,3739344,3738700,644
4726021,647.8,644,648,1460,0.0204,0,1,3739992,3739344,648
4731861,694.743,670.857,696,1460,0.0577862,0,1,3742680,3741984,696
4737701,742.743,718.857,744,1460,0.0977193,0,1,3745560,3744816,744
4756681,886.743,862.857,888,1460,0.217783,0,1,3756192,3755304,888
4762521,934.743,910.857,936,1460,0.257719,0,1,3759840,3758904,936
4768361,982.743,958.857,984,1460,0.297718,0,1,3763680,3762696,984
4787341,1126.74,1102.8,1128,1460,0.417599,0,1,3777432,3776304,1128
4793181,1174.74,1150.86,1176,1460,0.457715,0,1,3782040,3780864,1176
4799021,1222.74,1198.86,1224,1460,0.497717,0,1,3786840,3785616,1224
4835521,1510.74,1486.86,1512,1460,0.737718,0,2,3821040,3819528,1512
4841361,1558.74,1534.86,1560,1460,0.777718,0,2,3827184,3825624,1560
4866181,1750.74,1726.86,1752,1460,0.937719,0,2,3855336,3853584,1752
4877861,1594.8,1800.06,1584,1460,0.492214,0,1,3869448,3867864,1584
4880781,660.627,976.54,644,1460,0.0787542,0,1,3871036,3870392,644
4882241,644.831,660.627,644,1460,0.0315017,0,1,3871680,3871036,644
4883701,644.042,644.831,644,1460,0.0126007,0,1,3872324,3871680,644
4885161,644.002,644.042,644,1460,0.00504027,0,1,3872968,3872324,644
4886621,644,644.002,644,1460,0.00201611,0,1,3873612,3872968,644
4888081,644,644,644,1460,0.000806443,0,1,3874256,3873612,644
4889541,644,644,644,1460,0.000322577,0,1,3874900,3874256,644
4891001,644,644,644,1460,0.000129031,0,1,3875544,3874900,644
4892461,644,644,644,1460,5.16123e-05,0,1,3876188,3875544,644
4893921,644,644,644,1460,2.06449e-05,0,1,3876832,3876188,644
4895381,644,644,644,1460,8.25797e-06,0,1,3877476,3876832,644
4896841,644,644,644,1460,3.30319e-06,0,1,3878120,3877476,644
4898301,644,644,644,1460,1.32128e-06,0,1,3878764,3878120,644
4899761,644,644,644,1460,5.2851e-07,0,1,3879408,3878764,644
4901221,644,644,644,1460,2.11404e-07,0,1,3880052,3879408,644
4902681,644,644,644,1460,8.45616e-08,0,1,3880696,3880052,644
4904141,644,644,644,1460,3.38247e-08,0,1,3881340,3880696,644
4905601,644,644,644,1460,1.35299e-08,0,1,3881984,3881340,644
4907061,644,644,644,1460,0.00600001,0,1,3882628,3881984,644
4908521,647.8,644,648,1460,0.0204,0,1,3883276,3882628,648
4914361,694.743,670.857,696,1460,0.0577862,0,1,3885964,3885268,696
4920201,742.743,718.857,744,1460,0.0977193,0,1,3888844,3888100,744
4939181,886.743,862.857,888,1460,0.217783,0,1,3899476,3898588,888
4945021,934.743,910.857,936,1460,0.257719,0,1,3903124,3902188,936
4950861,982.743,958.857,984,1460,0.297718,0,1,3906964,3905980,984
4969841,1126.74,1102.8,1128,1460,0.417599,0,1,3920716,3919588,1128
4975681,1174.74,1150.86,1176,1460,0.457715,0,1,3925324,3924148,1176
4981521,1222.74,1198.86,1224,1460,0.497717,0,1,3930124,3928900,1224
5018021,1510.74,1486.86,1512,1460,0.737718,0,2,3964324,3962812,1512
5023861,1558.74,1534.86,1560,1460,0.777718,0,2,3970468,3968908,1560
5048681,1750.74,1726.86,1752,1460,0.937719,0,2,3998620,3996868,1752
5060361,1594.8,1800.06,1584,1460,0.492214,0,1,4012732,4011148,1584
5063281,660.627,976.54,644,1460,0.0787542,0,1,4014320,4013676,644
5064741,644.831,660.627,644,1460,0.0315017,0,1,4014964,4014320,644
5066201,644.042,644.831,644,1460,0.0126007,0,1,4015608,4014964,644
5067661,644.002,644.042,644,1460,0.00504027,0,1,4016252,4015608,644
5069121,644,644.002,644,1460,0.00201611,0,1,4016896,4016252,644
5070581,644,644,644,1460,0.000806443,0,1,4017540,4016896,644
5072041,644,644,644,1460,0.000322577,0,1,4018184,4017540,644
5073501,644,644,644,1460,0.000129031,0,1,4018828,4018184,644
5074961,644,644,644,1460,5.16123e-05,0,1,4019472,4018828,644
5076421,644,644,644,1460,2.06449e-05,0,1,4020116,4019472,644
5077881,644,644,644,1460,8.25797e-06,0,1,4020760,4020116,644
5079341,644,644,644,1460,3.30319e-06,0,1,4021404,4020760,644
5080801,644,644,644,1460,1.32128e-06,0,1,4022048,4021404,644
5082261,644,644,644,1460,5.2851e-07,0,1,4022692,4022048,644
5083721,644,644,644,1460,2.11404e-07,0,1,4023336,4022692,644
5085181,644,644,644,1460,8.45616e-08,0,1,4023980,4023336,644
5086641,644,644,644,1460,3.38247e-08,0,1,4024624,4023980,644
5088101,644,644,644,1460,1.35299e-08,0,1,4025268,4024624,644
5089561,644,644,644,1460,0.00600001,0,1,4025912,4025268,644
5091021,647.8,644,648,1460,0.0204,0,1,4026560,4025912,648
5096861,694.743,670.857,696,1460,0.0577862,0,1,4029248,4028552,696
5102701,742.743,718.857,744,1460,0.0977193,0,1,4032128,4031384,744
5121681,886.743,862.857,888,1460,0.217783,0,1,4042760,4041872,888
5127521,934.743,910.857,936,1460,0.257719,0,1,4046408,4045472,936
5133361,982.743,958.857,984,1460,0.297718,0,1,4050248,4049264,984
5152341,1126.74,1102.8,1128,1460,0.417599,0,1,4064000,4062872,1128
5158181,1174.74,1150.86,1176,1460,0.457715,0,1,4068608,4067432,1176
5164021,1222.74,1198.86,1224,1460,0.497717,0,1,4073408,4072184,1224
5200521,1510.74,1486.86,1512,1460,0.737718,0,2,4107608,4106096,1512
5206361,1558.74,1534.86,1560,1460,0.777718,0,2,4113752,4112192,1560
5231181,1750.74,1726.86,1752,1460,0.937719,0,2,4141904,4140152,1752
5242861,1594.8,1800.06,1584,1460,0.492214,0,1,4156016,4154432,1584
5245781,660.627,976.54,644,1460,0.0787542,0,1,4157604,4156960,644
5247241,644.831,660.627,644,1460,0.0315017,0,1,4158248,4157604,644
5248701,644.042,644.831,644,1460,0.0126007,0,1,4158892,4158248,644
5250161,644.002,644.042,644,1460,0.00504027,0,1,4159536,4158892,644
5251621,644,644.002,644,1460,0.00201611,0,1,4160180,4159536,644
5253081,644,644,644,1460,0.000806443,0,1,4160824,4160180,644
5254541,644,644,644,1460,0.000322577,0,1,4161468,4160824,644
5256001,644,644,644,1460,0.000129031,0,1,4162112,4161468,644
5257461,644,644,644,1460,5.16123e-05,0,1,4162756,4162112,644
5258921,644,644,644,1460,2.06449e-05,0,1,4163400,4162756,644
5260381,644,644,644,1460,8.25797e-06,0,1,4164044,4163400,644
5261841,644,644,644,1460,3.30319e-06,0,1,4164688,4164044,644
5263301,644,644,644,1460,1.32128e-06,0,1,4165332,4164688,644
5264761,644,644,644,1460,5.2851e-07,0,1,4165976,4165332,644
5266221,644,644,644,1460,2.11404e-07,0,1,4166620,4165976,644
5267681,644,644,644,1460,8.45616e-08,0,1,4167264,4166620,644
5269141,644,644,644,1460,3.38247e-08,0,1,4167908,4167264,644
5270601,644,644,644,1460,1.35299e-08,0,1,4168552,4167908,644
5272061,644,644,644,1460,0.00600001,0,1,4169196,4168552,644
5273521,647.8,644,648,1460,0.0204,0,1,4169844,4169196,648
5279361,694.743,670.857,696,1460,0.0577862,0,1,4172532,4171836,696
5285201,742.743,718.857,744,1460,0.0977193,0,1,4175412,4174668,744
5304181,886.743,862.857,888,1460,0.217783,0,1,4186044,4185156,888
5310021,934.743,910.857,936,1460,0.257719,0,1,4189692,4188756,936
5315861,982.743,958.857,984,1460,0.297718,0,1,4193532,4192548,984
5334841,1126.74,1102.8,1128,1460,0.417599,0,1,4207284,4206156,1128
5340681,1174.74,1150.86,1176,1460,0.457715,0,1,4211892,4210716,1176
5346521,1222.74,1198.86,1224,1460,0.497717,0,1,4216692,4215468,1224
5383021,1510.74,1486.86,1512,1460,0.737718,0,2,4250892,4249380,1512
5388861,1558.74,1534.86,1560,1460,0.777718,0,2,4257036,4255476,1560
5413681,1750.74,1726.86,1752,1460,0.937719,0,2,4285188,4283436,1752
5425361,1594.8,1800.06,1584,1460,0.492214,0,1,4299300,4297716,1584
5428281,660.627,976.54,644,1460,0.0787542,0,1,4300888,4300244,644
5429741,644.831,660.627,644,1460,0.0315017,0,1,4301532,4300888,644
5431201,644.042,644.831,644,1460,0.0126007,0,1,4302176,4301532,644
5432661,644.002,644.042,644,1460,0.00504027,0,1,4302820,4302176,644
5434121,644,644.002,644,1460,0.00201611,0,1,4303464,4302820,644
5435581,644,644,644,1460,0.000806443,0,1,4304108,4303464,644
5437041,644,644,644,1460,0.000322577,0,1,4304752,4304108,644
5438501,644,644,644,1460,0.000129031,0,1,4305396,4304752,644
5439961,644,644,644,1460,5.16123e-05,0,1,4306040,4305396,644
5441421,644,644,644,1460,2.06449e-05,0,1,4306684,4306040,644
5442881,644,644,644,1460,8.25797e-06,0,1,4307328,4306684,644
5444341,644,644,644,1460,3.30319e-06,0,1,4307972,4307328,644
5445801,644,644,644,1460,1.32128e-06,0,1,4308616,4307972,644
5447261,644,644,644,1460,5.2851e-07,0,1,4309260,4308616,644
5448721,644,644,644,1460,2.11404e-07,0,1,4309904,4309260,644
5450181,644,644,644,1460,8.45616e-08,0,1,4310548,4309904,644
5451641,644,644,644,1460,3.38247e-08,0,1,4311192,4310548,644
5453101,644,644,644,1460,1.35299e-08,0,1,4311836,4311192,644
5454561,644,644,644,1460,0.00600001,0,1,4312480,4311836,644
5456021,647.8,644,648,1460,0.0204,0,1,4313128,4312480,648
5461861,694.743,670.857,696,1460,0.0577862,0,1,4315816,4315120,696
5467701,742.743,718.857,744,1460,0.0977193,0,1,4318696,4317952,744
5486681,886.743,862.857,888,1460,0.217783,0,1,4329328,4328440,888
5492521,934.743,910.857,936,1460,0.257719,0,1,4332976,4332040,936
5498361,982.743,958.857,984,1460,0.297718,0,1,4336816,4335832,984
5517341,1126.74,1102.8,1128,1460,0.417599,0,1,4350568,4349440,1128
5523181,1174.74,1150.86,1176,1460,0.457715,0,1,4355176,4354000,1176
5529021,1222.74,1198.86,1224,1460,0.497717,0,1,4359976,4358752,1224
5565521,1510.74,1486.86,1512,1460,0.737718,0,2,4394176,4392664,1512
5571361,1558.74,1534.86,1560,1460,0.777718,0,2,4400320,4398760,1560
5596181,1750.74,1726.86,1752,1460,0.937719,0,2,4428472,4426720,1752
5607861,1594.8,1800.06,1584,1460,0.492214,0,1,4442584,4441000,1584
5610781,660.627,976.54,644,1460,0.0787542,0,1,4444172,4443528,644
5612241,644.831,660.627,644,1460,0.0315017,0,1,4444816,4444172,644
5613701,644.042,644.831,644,1460,0.0126007,0,1,4445460,4444816,644
5615161,644.002,644.042,644,1460,0.00504027,0,1,4446104,4445460,644
5616621,644,644.002,644,1460,0.00201611,0,1,4446748,4446104,644
5618081,644,644,644,1460,0.000806443,0,1,4447392,4446748,644
5619541,644,644,644,1460,0.000322577,0,1,4448036,4447392,644
5621001,644,644,644,1460,0.000129031,0,1,4448680,4448036,644
5622461,644,644,644,1460,5.16123e-05,0,1,4449324,4448680,644
5623921,644,644,644,1460,2.06449e-05,0,1,4449968,4449324,644
5625381,644,644,644,1460,8.25797e-06,0,1,4450612,4449968,644
5626841,644,644,644,1460,3.30319e-06,0,1,4451256,4450612,644
5628301,644,644,644,1460,1.32128e-06,0,1,4451900,4451256,644
5629761,644,644,644,1460,5.2851e-07,0,1,4452544,4451900,644
5631221,644,644,644,1460,2.11404e-07,0,1,4453188,4452544,644
5632681,644,644,644,1460,8.45616e-08,0,1,4453832,4453188,644
5634141,644,644,644,1460,3.38247e-08,0,1,4454476,4453832,644
5635601,644,644,644,1460,1.35299e-08,0,1,4455120,4454476,644
5637061,644,644,644,1460,0.00600001,0,1,4455764,4455120,644
5638521,647.8,644,648,1460,0.0204,0,1,4456412,4455764,648
5644361,694.743,670.857,696,1460,0.0577862,0,1,4459100,4458404,696
5650201,742.743,718.857,744,1460,0.0977193,0,1,4461980,4461236,744
5669181,886.743,862.857,888,1460,0.217783,0,1,4472612,4471724,888
5675021,934.743,910.857,936,1460,0.257719,0,1,4476260,4475324,936
5680861,982.743,958.857,984,1460,0.297718,0,1,4480100,4479116,984
5699841,1126.74,1102.8,1128,1460,0.417599,0,1,4493852,4492724,1128
5705681,1174.74,1150.86,1176,1460,0.457715,0,1,4498460,4497284,1176
5711521,1222.74,1198.86,1224,1460,0.497717,0,1,4503260,4502036,1224
5748021,1510.74,1486.86,1512,1460,0.737718,0,2,4537460,4535948,1512
5753861,1558.74,1534.86,1560,1460,0.777718,0,2,4543604,4542044,1560
5778681,1750.74,1726.86,1752,1460,0.937719,0,2,4571756,4570004,1752
5790361,1594.8,1800.06,1584,1460,0.492214,0,1,4585868,4584284,1584
5793281,660.627,976.54,644,1460,0.0787542,0,1,4587456,4586812,644
5794741,644.831,660.627,644,1460,0.0315017,0,1,4588100,4587456,644
5796201,644.042,644.831,644,1460,0.0126007,0,1,4588744,4588100,644
5797661,644.002,644.042,644,1460,0.00504027,0,1,4589388,4588744,644
5799121,644,644.002,644,1460,0.00201611,0,1,4590032,4589388,644
5800581,644,644,644,1460,0.000806443,0,1,4590676,4590032,644
5802041,644,644,644,1460,0.000322577,0,1,4591320,4590676,644
5803501,644,644,644,1460,0.000129031,0,1,4591964,4591320,644
5804961,644,644,644,1460,5.16123e-05,0,1,4592608,4591964,644
5806421,644,644,644,1460,2.06449e-05,0,1,4593252,4592608,644
5807881,644,644,644,1460,8.25797e-06,0,1,4593896,4593252,644
5809341,644,644,644,1460,3.30319e-06,0,1,4594540,4593896,644
5810801,644,644,644,1460,1.32128e-06,0,1,4595184,4594540,644
5812261,644,644,644,1460,5.2851e-07,0,1,4595828,4595184,644
5813721,644,644,644,1460,2.11404e-07,0,1,4596472,4595828,644
5815181,644,644,644,1460,8.45616e-08,0,1,4597116,4596472,644
5816641,644,644,644,1460,3.38247e-08,0,1,4597760,4597116,644
5818101,644,644,644,1460,1.35299e-08,0,1,4598404,4597760,644
5819561,644,644,644,1460,0.00600001,0,1,4599048,4598404,644
5821021,647.8,644,648,1460,0.0204,0,1,4599696,4599048,648
5826861,694.743,670.857,696,1460,0.0577862,0,1,4602384,4601688,696
5832701,742.743,718.857,744,1460,0.0977193,0,1,4605264,4604520,744
5851681,886.743,862.857,888,1460,0.217783,0,1,4615896,4615008,888
5857521,934.743,910.857,936,1460,0.257719,0,1,4619544,4618608,936
5863361,982.743,958.857,984,1460,0.297718,0,1,4623384,4622400,984
5882341,1126.74,1102.8,1128,1460,0.417599,0,1,4637136,4636008,1128
5888181,1174.74,1150.86,1176,1460,0.457715,0,1,4641744,4640568,1176
5894021,1222.74,1198.86,1224,1460,0.497717,0,1,4646544,4645320,1224
5930521,1510.74,1486.86,1512,1460,0.737718,0,2,4680744,4679232,1512
5936361,1558.74,1534.86,1560,1460,0.777718,0,2,4686888,4685328,1560
5961181,1750.74,1726.86,1752,1460,0.937719,0,2,4715040,4713288,1752
5972861,1594.8,1800.06,1584,1460,0.492214,0,1,4729152,4727568,1584
5975781,660.627,976.54,644,1460,0.0787542,0,1,4730740,4730096,644
5977241,644.831,660.627,644,1460,0.0315017,0,1,4731384,4730740,644
5978701,644.042,644.831,644,1460,0.0126007,0,1,4732028,4731384,644
5980161,644.002,644.042,644,1460,0.00504027,0,1,4732672,4732028,644
5981621,644,644.002,644,1460,0.00201611,0,1,4733316,4732672,644
5983081,644,644,644,1460,0.000806443,0,1,4733960,4733316,644
5984541,644,644,644,1460,0.000322577,0,1,4734604,4733960,644
5986001,644,644,644,1460,0.000129031,0,1,4735248,4734604,644
5987461,644,644,644,1460,5.16123e-05,0,1,4735892,4735248,644
5988921,644,644,644,1460,2.06449e-05,0,1,4736536,4735892,644
5990381,644,644,644,1460,8.25797e-06,0,1,4737180,4736536,644
5991841,644,644,644,1460,3.30319e-06,0,1,4737824,4737180,644
5993301,644,644,644,1460,1.32128e-06,0,1,4738468,4737824,644
5994761,644,644,644,1460,5.2851e-07,0,1,4739112,4738468,644
5996221,644,644,644,1460,2.11404e-07,0,1,4739756,4739112,644
5997681,644,644,644,1460,8.45616e-08,0,1,4740400,4739756,644
5999141,644,644,644,1460,3.38247e-08,0,1,4741044,4740400,644
6000601,644,644,644,1460,1.35299e-08,0,1,4741688,4741044,644
6002061,644,644,644,1460,0.00600001,0,1,4742332,4741688,644
6003521,647.8,644,648,1460,0.0204,0,1,4742980,4742332,648
6009361,694.743,670.857,696,1460,0.0577862,0,1,4745668,4744972,696
6015201,742.743,718.857,744,1460,0.0977193,0,1,4748548,4747804,744
6034181,886.743,862.857,888,1460,0.217783,0,1,4759180,4758292,888
6040021,934.743,910.857,936,1460,0.257719,0,1,4762828,4761892,936
6045861,982.743,958.857,984,1460,0.297718,0,1,4766668,4765684,984
6064841,1126.74,1102.8,1128,1460,0.417599,0,1,4780420,4779292,1128
6070681,1174.74,1150.86,1176,1460,0.457715,0,1,4785028,4783852,1176
6076521,1222.74,1198.86,1224,1460,0.497717,0,1,4789828,4788604,1224
6113021,1510.74,1486.86,1512,1460,0.737718,0,2,4824028,4822516,1512
6118861,1558.74,1534.86,1560,1460,0.777718,0,2,4830172,4828612,1560
6143681,1750.74,1726.86,1752,1460,0.937719,0,2,4858324,4856572,1752
6155361,1594.8,1800.06,1584,1460,0.492214,0,1,4872436,4870852,1584
6158281,660.627,976.54,644,1460,0.0787542,0,1,4874024,4873380,644
6159741,644.831,660.627,644,1460,0.0315017,0,1,4874668,4874024,644
6161201,644.042,644.831,644,1460,0.0126007,0,1,4875312,4874668,644
6162661,644.002,644.042,644,1460,0.00504027,0,1,4875956,4875312,644
6164121,644,644.002,644,1460,0.00201611,0,1,4876600,4875956,644
6165581,644,644,644,1460,0.000806443,0,1,4877244,4876600,644
6167041,644,644,644,1460,0.000322577,0,1,4877888,4877244,644
6168501,644,644,644,1460,0.000129031,0,1,4878532,4877888,644
6169961,644,644,644,1460,5.16123e-05,0,1,4879176,4878532,644
6171421,644,644,644,1460,2.06449e-05,0,1,4879820,4879176,644
6172881,644,644,644,1460,8.25797e-06,0,1,4880464,4879820,644
6174341,644,644,644,1460,3.30319e-06,0,1,4881108,4880464,644
6175801,644,644,644,1460,1.32128e-06,0,1,4881752,4881108,644
6177261,644,644,644,1460,5.2851e-07,0,1,4882396,4881752,644
6178721,644,644,644,1460,2.11404e-07,0,1,4883040,4882396,644
6180181,644,644,644,1460,8.45616e-08,0,1,4883684,4883040,644
6181641,644,644,644,1460,3.38247e-08,0,1,4884328,4883684,644
6183101,644,644,644,1460,1.35299e-08,0,1,4884972,4884328,644
6184561,644,644,644,1460,0.00600001,0,1,4885616,4884972,644
6186021,647.8,644,648,1460,0.0204,0,1,4886264,4885616,648
6191861,694.743,670.857,696,1460,0.0577862,0,1,4888952,4888256,696
6197701,742.743,718.857,744,1460,0.0977193,0,1,4891832,4891088,744
6216681,886.743,862.857,888,1460,0.217783,0,1,4902464,4901576,888
6222521,934.743,910.857,936,1460,0.257719,0,1,4906112,4905176,936
6228361,982.743,958.857,984,1460,0.297718,0,1,4909952,4908968,984
6247341,1126.74,1102.8,1128,1460,0.417599,0,1,4923704,4922576,1128
6253181,1174.74,1150.86,1176,1460,0.457715,0,1,4928312,4927136,1176
6259021,1222.74,1198.86,1224,1460,0.497717,0,1,4933112,4931888,1224
6295521,1510.74,1486.86,1512,1460,0.737718,0,2,4967312,4965800,1512
6301361,1558.74,1534.86,1560,1460,0.777718,0,2,4973456,4971896,1560
6326181,1750.74,1726.86,1752,1460,0.937719,0,2,5001608,4999856,1752
6337861,1594.8,1800.06,1584,1460,0.492214,0,1,5015720,5014136,1584
6340781,660.627,976.54,644,1460,0.0787542,0,1,5017308,5016664,644
6342241,644.831,660.627,644,1460,0.0315017,0,1,5017952,5017308,644
6343701,644.042,644.831,644,1460,0.0126007,0,1,5018596,5017952,644
6345161,644.002,644.042,644,1460,0.00504027,0,1,5019240,5018596,644
6346621,644,644.002,644,1460,0.00201611,0,1,5019884,5019240,644
6348081,644,644,644,1460,0.000806443,0,1,5020528,5019884,644
6349541,644,644,644,1460,0.000322577,0,1,5021172,5020528,644
6351001,644,644,644,1460,0.000129031,0,1,5021816,5021172,644
6352461,644,644,644,1460,5.16123e-05,0,1,5022460,5021816,644
6353921,644,644,644,1460,2.06449e-05,0,1,5023104,5022460,644
6355381,644,644,644,1460,8.25797e-06,0,1,5023748,5023104,644
6356841,644,644,644,1460,3.30319e-06,0,1,5024392,5023748,644
6358301,644,644,644,1460,1.32128e-06,0,1,5025036,5024392,644
6359761,644,644,644,1460,5.2851e-07,0,1,5025680,5025036,644
6361221,644,644,644,1460,2.11404e-07,0,1,5026324,5025680,644
6362681,644,644,644,1460,8.45616e-08,0,1,5026968,5026324,644
6364141,644,644,644,1460,3.38247e-08,0,1,5027612,5026968,644
6365601,644,644,644,1460,1.35299e-08,0,1,5028256,5027612,644
6367061,644,644,644,1460,0.00600001,0,1,5028900,5028256,644
6368521,647.8,644,648,1460,0.0204,0,1,5029548,5028900,648
6374361,694.743,670.857,696,1460,0.0577862,0,1,5032236,5031540,696
6380201,742.743,718.857,744,1460,0.0977193,0,1,5035116,5034372,744
6399181,886.743,862.857,888,1460,0.217783,0,1,5045748,5044860,888
6405021,934.743,910.857,936,1460,0.257719,0,1,5049396,5048460,936
6410861,982.743,958.857,984,1460,0.297718,0,1,5053236,5052252,984
6429841,1126.74,1102.8,1128,1460,0.417599,0,1,5066988,5065860,1128
6435681,1174.74,1150.86,1176,1460,0.457715,0,1,5071596,5070420,1176
6441521,1222.74,1198.86,1224,1460,0.497717,0,1,5076396,5075172,1224
6478021,1510.74,1486.86,1512,1460,0.737718,0,2,5110596,5109084,1512
6483861,1558.74,1534.86,1560,1460,0.777718,0,2,5116740,5115180,1560
6508681,1750.74,1726.86,1752,1460,0.937719,0,2,5144892,5143140,1752
6520361,1594.8,1800.06,1584,1460,0.492214,0,1,5159004,5157420,1584
6523281,660.627,976.54,644,1460,0.0787542,0,1,5160592,5159948,644
6524741,644.831,660.627,644,1460,0.0315017,0,1,5161236,5160592,644
6526201,644.042,644.831,644,1460,0.0126007,0,1,5161880,5161236,644
6527661,644.002,644.042,644,1460,0.00504027,0,1,5162524,5161880,644
6529121,644,644.002,644,1460,0.00201611,0,1,5163168,5162524,644
6530581,644,644,644,1460,0.000806443,0,1,5163812,5163168,644
6532041,644,644,644,1460,0.000322577,0,1,5164456,5163812,644
6533501,644,644,644,1460,0.000129031,0,1,5165100,5164456,644
6534961,644,644,644,1460,5.16123e-05,0,1,5165744,5165100,644
6536421,644,644,644,1460,2.06449e-05,0,1,5166388,5165744,644
6537881,644,644,644,1460,8.25797e-06,0,1,5167032,5166388,644
6539341,644,644,644,1460,3.30319e-06,0,1,5167676,5167032,644
6540801,644,644,644,1460,1.32128e-06,0,1,5168320,5167676,644
6542261,644,644,644,1460,5.2851e-07,0,1,5168964,5168320,644
6543721,644,644,644,1460,2.11404e-07,0,1,5169608,5168964,644
6545181,644,644,644,1460,8.45616e-08,0,1,5170252,5169608,644
6546641,644,644,644,1460,3.38247e-08,0,1,5170896,5170252,644
6548101,644,644,644,1460,1.35299e-08,0,1,5171540,5170896,644
6549561,644,644,644,1460,0.00600001,0,1,5172184,5171540,644
6551021,647.8,644,648,1460,0.0204,0,1,5172832,5172184,648
6556861,694.743,670.857,696,1460,0.0577862,0,1,5175520,5174824,696
6562701,742.743,718.857,744,1460,0.0977193,0,1,5178400,5177656,744
6581681,886.743,862.857,888,1460,0.217783,0,1,5189032,5188144,888
6587521,934.743,910.857,936,1460,0.257719,0,1,5192680,5191744,936
6593361,982.743,958.857,984,1460,0.297718,0,1,5196520,5195536,984
6612341,1126.74,1102.8,1128,1460,0.417599,0,1,5210272,5209144,1128
6618181,1174.74,1150.86,1176,1460,0.457715,0,1,5214880,5213704,1176
6624021,1222.74,1198.86,1224,1460,0.497717,0,1,5219680,5218456,1224
6660521,1510.74,1486.86,1512,1460,0.737718,0,2,5253880,5252368,1512
6666361,1558.74,1534.86,1560,1460,0.777718,0,2,5260024,5258464,1560
6691181,1750.74,1726.86,1752,1460,0.937719,0,2,5288176,5286424,1752
6702861,1594.8,1800.06,1584,1460,0.492214,0,1,5302288,5300704,1584
6705781,660.627,976.54,644,1460,0.0787542,0,1,5303876,5303232,644
6707241,644.831,660.627,644,1460,0.0315017,0,1,5304520,5303876,644
6708701,644.042,644.831,644,1460,0.0126007,0,1,5305164,5304520,644
6710161,644.002,644.042,644,1460,0.00504027,0,1,5305808,5305164,644
6711621,644,644.002,644,1460,0.00201611,0,1,5306452,5305808,644
6713081,644,644,644,1460,0.000806443,0,1,5307096,5306452,644
6714541,644,644,644,1460,0.000322577,0,1,5307740,5307096,644
6716001,644,644,644,1460,0.000129031,0,1,5308384,5307740,644
6717461,644,644,644,1460,5.16123e-05,0,1,5309028,5308384,644
6718921,644,644,644,1460,2.06449e-05,0,1,5309672,5309028,644
6720381,644,644,644,1460,8.25797e-06,0,1,5310316,5309672,644
6721841,644,644,644,1460,3.30319e-06,0,1,5310960,5310316,644
6723301,644,644,644,1460,1.32128e-06,0,1,5311604,5310960,644
6724761,644,644,644,1460,5.2851e-07,0,1,5312248,5311604,644
6726221,644,644,644,1460,2.11404e-07,0,1,5312892,5312248,644
6727681,644,644,644,1460,8.45616e-08,0,1,5313536,5312892,644
6729141,644,644,644,1460,3.38247e-08,0,1,5314180,5313536,644
6730601,644,644,644,1460,1.35299e-08,0,1,5314824,5314180,644
6732061,644,644,644,1460,0.00600001,0,1,5315468,5314824,644
6733521,647.8,644,648,1460,0.0204,0,1,5316116,5315468,648
6739361,694.743,670.857,696,1460,0.0577862,0,1,5318804,5318108,696
6745201,742.743,718.857,744,1460,0.0977193,0,1,5321684,5320940,744
6764181,886.743,862.857,888,1460,0.217783,0,1,5332316,5331428,888
6770021,934.743,910.857,936,1460,0.257719,0,1,5335964,5335028,936
6775861,982.743,958.857,984,1460,0.297718,0,1,5339804,5338820,984
6794841,1126.74,1102.8,1128,1460,0.417599,0,1,5353556,5352428,1128
6800681,1174.74,1150.86,1176,1460,0.457715,0,1,5358164,5356988,1176
6806521,1222.74,1198.86,1224,1460,0.497717,0,1,5362964,5361740,1224
6843021,1510.74,1486.86,1512,1460,0.737718,0,2,5397164,5395652,1512
6848861,1558.74,1534.86,1560,1460,0.777718,0,2,5403308,5401748,1560
6873681,1750.74,1726.86,1752,1460,0.937719,0,2,5431460,5429708,1752
6885361,1594.8,1800.06,1584,1460,0.492214,0,1,5445572,5443988,1584
6888281,660.627,976.54,644,1460,0.0787542,0,1,5447160,5446516,644
6889741,644.831,660.627,644,1460,0.0315017,0,1,5447804,5447160,644
6891201,644.042,644.831,644,1460,0.0126007,0,1,5448448,5447804,644
6892661,644.002,644.042,644,1460,0.00504027,0,1,5449092,5448448,644
6894121,644,644.002,644,1460,0.00201611,0,1,5449736,5449092,644
6895581,644,644,644,1460,0.000806443,0,1,5450380,5449736,644
6897041,644,644,644,1460,0.000322577,0,1,5451024,5450380,644
6898501,644,644,644,1460,0.000129031,0,1,5451668,5451024,644
6899961,644,644,644,1460,5.16123e-05,0,1,5452312,5451668,644
6901421,644,644,644,1460,2.06449e-05,0,1,5452956,5452312,644
6902881,644,644,644,1460,8.25797e-06,0,1,5453600,5452956,644
6904341,644,644,644,1460,3.30319e-06,0,1,5454244,5453600,644
6905801,644,644,644,1460,1.32128e-06,0,1,5454888,5454244,644
6907261,644,644,644,1460,5.2851e-07,0,1,5455532,5454888,644
6908721,644,644,644,1460,2.11404e-07,0,1,5456176,5455532,644
6910181,644,644,644,1460,8.45616e-08,0,1,5456820,5456176,644
6911641,644,644,644,1460,3.38247e-08,0,1,5457464,5456820,644
6913101,644,644,644,1460,1.35299e-08,0,1,5458108,5457464,644
6914561,644,644,644,1460,0.00600001,0,1,5458752,5458108,644
6916021,647.8,644,648,1460,0.0204,0,1,5459400,5458752,648
6921861,694.743,670.857,696,1460,0.0577862,0,1,5462088,5461392,696
6927701,742.743,718.857,744,1460,0.0977193,0,1,5464968,5464224,744
6946681,886.743,862.857,888,1460,0.217783,0,1,5475600,5474712,888
6952521,934.743,910.857,936,1460,0.257719,0,1,5479248,5478312,936
6958361,982.743,958.857,984,1460,0.297718,0,1,5483088,5482104,984
6977341,1126.74,1102.8,1128,1460,0.417599,0,1,5496840,5495712,1128
6983181,1174.74,1150.86,1176,1460,0.457715,0,1,5501448,5500272,1176
6989021,1222.74,1198.86,1224,1460,0.497717,0,1,5506248,5505024,1224
7025521,1510.74,1486.86,1512,1460,0.737718,0,2,5540448,5538936,1512
7031361,1558.74,1534.86,1560,1460,0.777718,0,2,5546592,5545032,1560
7056181,1750.74,1726.86,1752,1460,0.937719,0,2,5574744,5572992,1752
7067861,1594.8,1800.06,1584,1460,0.492214,0,1,5588856,5587272,1584
7070781,660.627,976.54,644,1460,0.0787542,0,1,5590444,5589800,644
7072241,644.831,660.627,644,1460,0.0315017,0,1,5591088,5590444,644
7073701,644.042,644.831,644,1460,0.0126007,0,1,5591732,5591088,644
7075161,644.002,644.042,644,1460,0.00504027,0,1,5592376,5591732,644
7076621,644,644.002,644,1460,0.00201611,0,1,5593020,5592376,644
7078081,644,644,644,1460,0.000806443,0,1,5593664,5593020,644
7079541,644,644,644,1460,0.000322577,0,1,5594308,5593664,644
7081001,644,644,644,1460,0.000129031,0,1,5594952,5594308,644
7082461,644,644,644,1460,5.16123e-05,0,1,5595596,5594952,644
7083921,644,644,644,1460,2.06449e-05,0,1,5596240,5595596,644
7085381,644,644,644,1460,8.25797e-06,0,1,5596884,5596240,644
7086841,644,644,644,1460,3.30319e-06,0,1,5597528,5596884,644
7088301,644,644,644,1460,1.32128e-06,0,1,5598172,5597528,644
7089761,644,644,644,1460,5.2851e-07,0,1,5598816,5598172,644
7091221,644,644,644,1460,2.11404e-07,0,1,5599460,5598816,644
7092681,644,644,644,1460,8.45616e-08,0,1,5600104,5599460,644
7094141,644,644,644,1460,3.38247e-08,0,1,5600748,5600104,644
7095601,644,644,644,1460,1.35299e-08,0,1,5601392,5600748,644
7097061,644,644,644,1460,0.00600001,0,1,5602036,5601392,644
7098521,647.8,644,648,1460,0.0204,0,1,5602684,5602036,648
7104361,694.743,670.857,696,1460,0.0577862,0,1,5605372,5604676,696
7110201,742.743,718.857,744,1460,0.0977193,0,1,5608252,5607508,744
7129181,886.743,862.857,888,1460,0.217783,0,1,5618884,5617996,888
7135021,934.743,910.857,936,1460,0.257719,0,1,5622532,5621596,936
7140861,982.743,958.857,984,1460,0.297718,0,1,5626372,5625388,984
7159841,1126.74,1102.8,1128,1460,0.417599,0,1,5640124,5638996,1128
7165681,1174.74,1150.86,1176,1460,0.457715,0,1,5644732,5643556,1176
7171521,1222.74,1198.86,1224,1460,0.497717,0,1,5649532,5648308,1224
7208021,1510.74,1486.86,1512,1460,0.737718,0,2,5683732,5682220,1512
7213861,1558.74,1534.86,1560,1460,0.777718,0,2,5689876,5688316,1560
7238681,1750.74,1726.86,1752,1460,0.937719,0,2,5718028,5716276,1752
7250361,1594.8,1800.06,1584,1460,0.492214,0,1,5732140,5730556,1584
7253281,660.627,976.54,644,1460,0.0787542,0,1,5733728,5733084,644
7254741,644.831,660.627,644,1460,0.0315017,0,1,5734372,5733728,644
7256201,644.042,644.831,644,1460,0.0126007,0,1,5735016,5734372,644
7257661,644.002,644.042,644,1460,0.00504027,0,1,5735660,5735016,644
7259121,644,644.002,644,1460,0.00201611,0,1,5736304,5735660,644
7260581,644,644,644,1460,0.000806443,0,1,5736948,5736304,644
7262041,644,644,644,1460,0.000322577,0,1,5737592,5736948,644
7263501,644,644,644,1460,0.000129031,0,1,5738236,5737592,644
7264961,644,644,644,1460,5.16123e-05,0,1,5738880,5738236,644
7266421,644,644,644,1460,2.06449e-05,0,1,5739524,5738880,644
7267881,644,644,644,1460,8.25797e-06,0,1,5740168,5739524,644
7269341,644,644,644,1460,3.30319e-06,0,1,5740812,5740168,644
7270801,644,644,644,1460,1.32128e-06,0,1,5741456,5740812,644
7272261,644,644,644,1460,5.2851e-07,0,1,5742100,5741456,644
7273721,644,644,644,1460,2.11404e-07,0,1,5742744,5742100,644
7275181,644,644,644,1460,8.45616e-08,0,1,5743388,5742744,644
7276641,644,644,644,1460,3.38247e-08,0,1,5744032,5743388,644
7278101,644,644,644,1460,1.35299e-08,0,1,5744676,5744032,644
7279561,644,644,644,1460,0.00600001,0,1,5745320,5744676,644
7281021,647.8,644,648,1460,0.0204,0,1,5745968,5745320,648
7286861,694.743,670.857,696,1460,0.0577862,0,1,5748656,5747960,696
7292701,742.743,718.857,744,1460,0.0977193,0,1,5751536,5750792,744
7311681,886.743,862.857,888,1460,0.217783,0,1,5762168,5761280,888
7317521,934.743,910.857,936,1460,0.257719,0,1,5765816,5764880,936
7323361,982.743,958.857,984,1460,0.297718,0,1,5769656,5768672,984
7342341,1126.74,1102.8,1128,1460,0.417599,0,1,5783408,5782280,1128
7348181,1174.74,1150.86,1176,1460,0.457715,0,1,5788016,5786840,1176
7354021,1222.74,1198.86,1224,1460,0.497717,0,1,5792816,5791592,1224
7390521,1510.74,1486.86,1512,1460,0.737718,0,2,5827016,5825504,1512
7396361,1558.74,1534.86,1560,1460,0.777718,0,2,5833160,5831600,1560
7421181,1750.74,1726.86,1752,1460,0.937719,0,2,5861312,5859560,1752
7432861,1594.8,1800.06,1584,1460,0.492214,0,1,5875424,5873840,1584
7435781,660.627,976.54,644,1460,0.0787542,0,1,5877012,5876368,644
7437241,644.831,660.627,644,1460,0.0315017,0,1,5877656,5877012,644
7438701,644.042,644.831,644,1460,0.0126007,0,1,5878300,5877656,644
7440161,644.002,644.042,644,1460,0.00504027,0,1,5878944,5878300,644
7441621,644,644.002,644,1460,0.00201611,0,1,5879588,5878944,644
7443081,644,644,644,1460,0.000806443,0,1,5880232,5879588,644
7444541,644,644,644,1460,0.000322577,0,1,5880876,5880232,644
7446001,644,644,644,1460,0.000129031,0,1,5881520,5880876,644
7447461,644,644,644,1460,5.16123e-05,0,1,5882164,5881520,644
7448921,644,644,644,1460,2.06449e-05,0,1,5882808,5882164,644
7450381,644,644,644,1460,8.25797e-06,0,1,5883452,5882808,644
7451841,644,644,644,1460,3.30319e-06,0,1,5884096,5883452,644
7453301,644,644,644,1460,1.32128e-06,0,1,5884740,5884096,644
7454761,644,644,644,1460,5.2851e-07,0,1,5885384,5884740,644
7456221,644,644,644,1460,2.11404e-07,0,1,5886028,5885384,644
7457681,644,644,644,1460,8.45616e-08,0,1,5886672,5886028,644
7459141,644,644,644,1460,3.38247e-08,0,1,5887316,5886672,644
7460601,644,644,644,1460,1.35299e-08,0,1,5887960,5887316,644
7462061,644,644,644,1460,0.00600001,0,1,5888604,5887960,644
7463521,647.8,644,648,1460,0.0204,0,1,5889252,5888604,648
7469361,694.743,670.857,696,1460,0.0577862,0,1,5891940,5891244,696
7475201,742.743,718.857,744,1460,0.0977193,0,1,5894820,5894076,744
7494181,886.743,862.857,888,1460,0.217783,0,1,5905452,5904564,888
7500021,934.743,910.857,936,1460,0.257719,0,1,5909100,5908164,936
7505861,982.743,958.857,984,1460,0.297718,0,1,5912940,5911956,984
7524841,1126.74,1102.8,1128,1460,0.417599,0,1,5926692,5925564,1128
7530681,1174.74,1150.86,1176,1460,0.457715,0,1,5931300,5930124,1176
7536521,1222.74,1198.86,1224,1460,0.497717,0,1,5936100,5934876,1224
7573021,1510.74,1486.86,1512,1460,0.737718,0,2,5970300,5968788,1512
7578861,1558.74,1534.86,1560,1460,0.777718,0,2,5976444,5974884,1560
7603681,1750.74,1726.86,1752,1460,0.937719,0,2,6004596,6002844,1752
7615361,1594.8,1800.06,1584,1460,0.492214,0,1,6018708,6017124,1584
7618281,660.627,976.54,644,1460,0.0787542,0,1,6020296,6019652,644
7619741,644.831,660.627,644,1460,0.0315017,0,1,6020940,6020296,644
7621201,644.042,644.831,644,1460,0.0126007,0,1,6021584,6020940,644
7622661,644.002,644.042,644,1460,0.00504027,0,1,6022228,6021584,644
7624121,644,644.002,644,1460,0.00201611,0,1,6022872,6022228,644
7625581,644,644,644,1460,0.000806443,0,1,6023516,6022872,644
7627041,644,644,644,1460,0.000322577,0,1,6024160,6023516,644
7628501,644,644,644,1460,0.000129031,0,1,6024804,6024160,644
7629961,644,644,644,1460,5.16123e-05,0,1,6025448,6024804,644
7631421,644,644,644,1460,2.06449e-05,0,1,6026092,6025448,644
7632881,644,644,644,1460,8.25797e-06,0,1,6026736,6026092,644
7634341,644,644,644,1460,3.30319e-06,0,1,6027380,6026736,644
7635801,644,644,644,1460,1.32128e-06,0,1,6028024,6027380,644
7637261,644,644,644,1460,5.2851e-07,0,1,6028668,6028024,644
7638721,644,644,644,1460,2.11404e-07,0,1,6029312,6028668,644
7640181,644,644,644,1460,8.45616e-08,0,1,6029956,6029312,644
7641641,644,644,644,1460,3.38247e-08,0,1,6030600,6029956,644
7643101,644,644,644,1460,1.35299e-08,0,1,6031244,6030600,644
7644561,644,644,644,1460,0.00600001,0,1,6031888,6031244,644
7646021,647.8,644,648,1460,0.0204,0,1,6032536,6031888,648
7651861,694.743,670.857,696,1460,0.0577862,0,1,6035224,6034528,696
7657701,742.743,718.857,744,1460,0.0977193,0,1,6038104,6037360,744
7676681,886.743,862.857,888,1460,0.217783,0,1,6048736,6047848,888
7682521,934.743,910.857,936,1460,0.257719,0,1,6052384,6051448,936
7688361,982.743,958.857,984,1460,0.297718,0,1,6056224,6055240,984
7707341,1126.74,1102.8,1128,1460,0.417599,0,1,6069976,6068848,1128
7713181,1174.74,1150.86,1176,1460,0.457715,0,1,6074584,6073408,1176
7719021,1222.74,1198.86,1224,1460,0.497717,0,1,6079384,6078160,1224
7755521,1510.74,1486.86,1512,1460,0.737718,0,2,6113584,6112072,1512
7761361,1558.74,1534.86,1560,1460,0.777718,0,2,6119728,6118168,1560
7786181,1750.74,1726.86,1752,1460,0.937719,0,2,6147880,6146128,1752
7797861,1594.8,1800.06,1584,1460,0.492214,0,1,6161992,6160408,1584
7800781,660.627,976.54,644,1460,0.0787542,0,1,6163580,6162936,644
7802241,644.831,660.627,644,1460,0.0315017,0,1,6164224,6163580,644
7803701,644.042,644.831,644,1460,0.0126007,0,1,6164868,6164224,644
7805161,644.002,644.042,644,1460,0.00504027,0,1,6165512,6164868,644
7806621,644,644.002,644,1460,0.00201611,0,1,6166156,6165512,644
7808081,644,644,644,1460,0.000806443,0,1,6166800,6166156,644
7809541,644,644,644,1460,0.000322577,0,1,6167444,6166800,644
7811001,644,644,644,1460,0.000129031,0,1,6168088,6167444,644
7812461,644,644,644,1460,5.16123e-05,0,1,6168732,6168088,644
7813921,644,644,644,1460,2.06449e-05,0,1,6169376,6168732,644
7815381,644,644,644,1460,8.25797e-06,0,1,6170020,6169376,644
7816841,644,644,644,1460,3.30319e-06,0,1,6170664,6170020,644
7818301,644,644,644,1460,1.32128e-06,0,1,6171308,6170664,644
7819761,644,644,644,1460,5.2851e-07,0,1,6171952,6171308,644
7821221,644,644,644,1460,2.11404e-07,0,1,6172596,6171952,644
7822681,644,644,644,1460,8.45616e-08,0,1,6173240,6172596,644
7824141,644,644,644,1460,3.38247e-08,0,1,6173884,6173240,644
7825601,644,644,644,1460,1.35299e-08,0,1,6174528,6173884,644
7827061,644,644,644,1460,0.00600001,0,1,6175172,6174528,644
7828521,647.8,644,648,1460,0.0204,0,1,6175820,6175172,648
7834361,694.743,670.857,696,1460,0.0577862,0,1,6178508,6177812,696
7840201,742.743,718.857,744,1460,0.0977193,0,1,6181388,6180644,744
7859181,886.743,862.857,888,1460,0.217783,0,1,6192020,6191132,888
7865021,934.743,910.857,936,1460,0.257719,0,1,6195668,6194732,936
7870861,982.743,958.857,984,1460,0.297718,0,1,6199508,6198524,984
7889841,1126.74,1102.8,1128,1460,0.417599,0,1,6213260,6212132,1128
7895681,1174.74,1150.86,1176,1460,0.457715,0,1,6217868,6216692,1176
7901521,1222.74,1198.86,1224,1460,0.497717,0,1,6222668,6221444,1224
7938021,1510.74,1486.86,1512,1460,0.737718,0,2,6256868,6255356,1512
7943861,1558.74,1534.86,1560,1460,0.777718,0,2,6263012,6261452,1560
7968681,1750.74,1726.86,1752,1460,0.937719,0,2,6291164,6289412,1752
7980361,1594.8,1800.06,1584,1460,0.492214,0,1,6305276,6303692,1584
7983281,660.627,976.54,644,1460,0.0787542,0,1,6306864,6306220,644
7984741,644.831,660.627,644,1460,0.0315017,0,1,6307508,6306864,644
7986201,644.042,644.831,644,1460,0.0126007,0,1,6308152,6307508,644
7987661,644.002,644.042,644,1460,0.00504027,0,1,6308796,6308152,644
7989121,644,644.002,644,1460,0.00201611,0,1,6309440,6308796,644
7990581,644,644,644,1460,0.000806443,0,1,6310084,6309440,644
7992041,644,644,644,1460,0.000322577,0,1,6310728,6310084,644
7993501,644,644,644,1460,0.000129031,0,1,6311372,6310728,644
7994961,644,644,644,1460,5.16123e-05,0,1,6312016,6311372,644
7996421,644,644,644,1460,2.06449e-05,0,1,6312660,6312016,644
7997881,644,644,644,1460,8.25797e-06,0,1,6313304,6312660,644
7999341,644,644,644,1460,3.30319e-06,0,1,6313948,6313304,644
8000801,644,644,644,1460,1.32128e-06,0,1,6314592,6313948,644
8002261,644,644,644,1460,5.2851e-07,0,1,6315236,6314592,644
8003721,644,644,644,1460,2.11404e-07,0,1,6315880,6315236,644
8005181,644,644,644,1460,8.45616e-08,0,1,6316524,6315880,644
8006641,644,644,644,1460,3.38247e-08,0,1,6317168,6316524,644
8008101,644,644,644,1460,1.35299e-08,0,1,6317812,6317168,644
8009561,644,644,644,1460,0.00600001,0,1,6318456,6317812,644
8011021,647.8,644,648,1460,0.0204,0,1,6319104,6318456,648
8016861,694.743,670.857,696,1460,0.0577862,0,1,6321792,6321096,696
8022701,742.743,718.857,744,1460,0.0977193,0,1,6324672,6323928,744
8041681,886.743,862.857,888,1460,0.217783,0,1,6335304,6334416,888
8047521,934.743,910.857,936,1460,0.257719,0,1,6338952,6338016,936
8053361,982.743,958.857,984,1460,0.297718,0,1,6342792,6341808,984
8072341,1126.74,1102.8,1128,1460,0.417599,0,1,6356544,6355416,1128
8078181,1174.74,1150.86,1176,1460,0.457715,0,1,6361152,6359976,1176
8084021,1222.74,1198.86,1224,1460,0.497717,0,1,6365952,6364728,1224
8120521,1510.74,1486.86,1512,1460,0.737718,0,2,6400152,6398640,1512
8126361,1558.74,1534.86,1560,1460,0.777718,0,2,6406296,6404736,1560
8151181,1750.74,1726.86,1752,1460,0.937719,0,2,6434448,6432696,1752
8162861,1594.8,1800.06,1584,1460,0.492214,0,1,6448560,6446976,1584
8165781,660.627,976.54,644,1460,0.0787542,0,1,6450148,6449504,644
8167241,644.831,660.627,644,1460,0.0315017,0,1,6450792,6450148,644
8168701,644.042,644.831,644,1460,0.0126007,0,1,6451436,6450792,644
8170161,644.002,644.042,644,1460,0.00504027,0,1,6452080,6451436,644
8171621,644,644.002,644,1460,0.00201611,0,1,6452724,6452080,644
8173081,644,644,644,1460,0.000806443,0,1,6453368,6452724,644
8174541,644,644,644,1460,0.000322577,0,1,6454012,6453368,644
8176001,644,644,644,1460,0.000129031,0,1,6454656,6454012,644
8177461,644,644,644,1460,5.16123e-05,0,1,6455300,6454656,644
8178921,644,644,644,1460,2.06449e-05,0,1,6455944,6455300,644
8180381,644,644,644,1460,8.25797e-06,0,1,6456588,6455944,644
8181841,644,644,644,1460,3.30319e-06,0,1,6457232,6456588,644
8183301,644,644,644,1460,1.32128e-06,0,1,6457876,6457232,644
8184761,644,644,644,1460,5.2851e-07,0,1,6458520,6457876,644
8186221,644,644,644,1460,2.11404e-07,0,1,6459164,6458520,644
8187681,644,644,644,1460,8.45616e-08,0,1,6459808,6459164,644
8189141,644,644,644,1460,3.38247e-08,0,1,6460452,6459808,644
8190601,644,644,644,1460,1.35299e-08,0,1,6461096,6460452,644
8192061,644,644,644,1460,0.00600001,0,1,6461740,6461096,644
8193521,647.8,644,648,1460,0.0204,0,1,6462388,6461740,648
8199361,694.743,670.857,696,1460,0.0577862,0,1,6465076,6464380,696
8205201,742.743,718.857,744,1460,0.0977193,0,1,6467956,6467212,744
8224181,886.743,862.857,888,1460,0.217783,0,1,6478588,6477700,888
8230021,934.743,910.857,936,1460,0.257719,0,1,6482236,6481300,936
8235861,982.743,958.857,984,1460,0.297718,0,1,6486076,6485092,984
8254841,1126.74,1102.8,1128,1460,0.417599,0,1,6499828,6498700,1128
8260681,1174.74,1150.86,1176,1460,0.457715,0,1,6504436,6503260,1176
8266521,1222.74,1198.86,1224,1460,0.497717,0,1,6509236,6508012,1224
8303021,1510.74,1486.86,1512,1460,0.737718,0,2,6543436,6541924,1512
8308861,1558.74,1534.86,1560,1460,0.777718,0,2,6549580,6548020,1560
8333681,1750.74,1726.86,1752,1460,0.937719,0,2,6577732,6575980,1752
8345361,1594.8,1800.06,1584,1460,0.492214,0,1,6591844,6590260,1584
8348281,660.627,976.54,644,1460,0.0787542,0,1,6593432,6592788,644
8349741,644.831,660.627,644,1460,0.0315017,0,1,6594076,6593432,644
8351201,644.042,644.831,644,1460,0.0126007,0,1,6594720,6594076,644
8352661,644.002,644.042,644,1460,0.00504027,0,1,6595364,6594720,644
8354121,644,644.002,644,1460,0.00201611,0,1,6596008,6595364,644
8355581,644,644,644,1460,0.000806443,0,1,6596652,6596008,644
8357041,644,644,644,1460,0.000322577,0,1,6597296,6596652,644
8358501,644,644,644,1460,0.000129031,0,1,6597940,6597296,644
8359961,644,644,644,1460,5.16123e-05,0,1,6598584,6597940,644
8361421,644,644,644,1460,2.06449e-05,0,1,6599228,6598584,644
8362881,644,644,644,1460,8.25797e-06,0,1,6599872,6599228,644
8364341,644,644,644,1460,3.30319e-06,0,1,6600516,6599872,644
8365801,644,644,644,1460,1.32128e-06,0,1,6601160,6600516,644
8367261,644,644,644,1460,5.2851e-07,0,1,6601804,6601160,644
8368721,644,644,644,1460,2.11404e-07,0,1,6602448,6601804,644
8370181,644,644,644,1460,8.45616e-08,0,1,6603092,6602448,644
8371641,644,644,644,1460,3.38247e-08,0,1,6603736,6603092,644
8373101,644,644,644,1460,1.35299e-08,0,1,6604380,6603736,644
8374561,644,644,644,1460,0.00600001,0,1,6605024,6604380,644
8376021,647.8,644,648,1460,0.0204,0,1,6605672,6605024,648
8381861,694.743,670.857,696,1460,0.0577862,0,1,6608360,6607664,696
8387701,742.743,718.857,744,1460,0.0977193,0,1,6611240,6610496,744
8406681,886.743,862.857,888,1460,0.217783,0,1,6621872,6620984,888
8412521,934.743,910.857,936,1460,0.257719,0,1,6625520,6624584,936
8418361,982.743,958.857,984,1460,0.297718,0,1,6629360,6628376,984
8437341,1126.74,1102.8,1128,1460,0.417599,0,1,6643112,6641984,1128
8443181,1174.74,1150.86,1176,1460,0.457715,0,1,6647720,6646544,1176
8449021,1222.74,1198.86,1224,1460,0.497717,0,1,6652520,6651296,1224
8485521,1510.74,1486.86,1512,1460,0.737718,0,2,6686720,6685208,1512
8491361,1558.74,1534.86,1560,1460,0.777718,0,2,6692864,6691304,1560
8516181,1750.74,1726.86,1752,1460,0.937719,0,2,6721016,6719264,1752
8527861,1594.8,1800.06,1584,1460,0.492214,0,1,6735128,6733544,1584
8530781,660.627,976.54,644,1460,0.0787542,0,1,6736716,6736072,644
8532241,644.831,660.627,644,1460,0.0315017,0,1,6737360,6736716,644
8533701,644.042,644.831,644,1460,0.0126007,0,1,6738004,6737360,644
8535161,644.002,644.042,644,1460,0.00504027,0,1,6738648,6738004,644
8536621,644,644.002,644,1460,0.00201611,0,1,6739292,6738648,644
8538081,644,644,644,1460,0.000806443,0,1,6739936,6739292,644
8539541,644,644,644,1460,0.000322577,0,1,6740580,6739936,644
8541001,644,644,644,1460,0.000129031,0,1,6741224,6740580,644
8542461,644,644,644,1460,5.16123e-05,0,1,6741868,6741224,644
8543921,644,644,644,1460,2.06449e-05,0,1,6742512,6741868,644
8545381,644,644,644,1460,8.25797e-06,0,1,6743156,6742512,644
8546841,644,644,644,1460,3.30319e-06,0,1,6743800,6743156,644
8548301,644,644,644,1460,1.32128e-06,0,1,6744444,6743800,644
8549761,644,644,644,1460,5.2851e-07,0,1,6745088,6744444,644
8551221,644,644,644,1460,2.11404e-07,0,1,6745732,6745088,644
8552681,644,644,644,1460,8.45616e-08,0,1,6746376,6745732,644
8554141,644,644,644,1460,3.38247e-08,0,1,6747020,6746376,644
8555601,644,644,644,1460,1.35299e-08,0,1,6747664,6747020,644
8557061,644,644,644,1460,0.00600001,0,1,6748308,6747664,644
8558521,647.8,644,648,1460,0.0204,0,1,6748956,6748308,648
8564361,694.743,670.857,696,1460,0.0577862,0,1,6751644,6750948,696
8570201,742.743,718.857,744,1460,0.0977193,0,1,6754524,6753780,744
8589181,886.743,862.857,888,1460,0.217783,0,1,6765156,6764268,888
8595021,934.743,910.857,936,1460,0.257719,0,1,6768804,6767868,936
8600861,982.743,958.857,984,1460,0.297718,0,1,6772644,6771660,984
8619841,1126.74,1102.8,1128,1460,0.417599,0,1,6786396,6785268,1128
8625681,1174.74,1150.86,1176,1460,0.457715,0,1,6791004,6789828,1176
8631521,1222.74,1198.86,1224,1460,0.497717,0,1,6795804,6794580,1224
8668021,1510.74,1486.86,1512,1460,0.737718,0,2,6830004,6828492,1512
8673861,1558.74,1534.86,1560,1460,0.777718,0,2,6836148,6834588,1560
8698681,1750.74,1726.86,1752,1460,0.937719,0,2,6864300,6862548,1752
8710361,1594.8,1800.06,1584,1460,0.492214,0,1,6878412,6876828,1584
8713281,660.627,976.54,644,1460,0.0787542,0,1,6880000,6879356,644
8714741,644.831,660.627,644,1460,0.0315017,0,1,6880644,6880000,644
8716201,644.042,644.831,644,1460,0.0126007,0,1,6881288,6880644,644
8717661,644.002,644.042,644,1460,0.00504027,0,1,6881932,6881288,644
8719121,644,644.002,644,1460,0.00201611,0,1,6882576,6881932,644
8720581,644,644,644,1460,0.000806443,0,1,6883220,6882576,644
8722041,644,644,644,1460,0.000322577,0,1,6883864,6883220,644
8723501,644,644,644,1460,0.000129031,0,1,6884508,6883864,644
8724961,644,644,644,1460,5.16123e-05,0,1,6885152,6884508,644
8726421,644,644,644,1460,2.06449e-05,0,1,6885796,6885152,644
8727881,644,644,644,1460,8.25797e-06,0,1,6886440,6885796,644
8729341,644,644,644,1460,3.30319e-06,0,1,6887084,6886440,644
8730801,644,644,644,1460,1.32128e-06,0,1,6887728,6887084,644
8732261,644,644,644,1460,5.2851e-07,0,1,6888372,6887728,644
8733721,644,644,644,1460,2.11404e-07,0,1,6889016,6888372,644
8735181,644,644,644,1460,8.45616e-08,0,1,6889660,6889016,644
8736641,644,644,644,1460,3.38247e-08,0,1,6890304,6889660,644
8738101,644,644,644,1460,1.35299e-08,0,1,6890948,6890304,644
8739561,644,644,644,1460,0.00600001,0,1,6891592,6890948,644
8741021,647.8,644,648,1460,0.0204,0,1,6892240,6891592,648
8746861,694.743,670.857,696,1460,0.0577862,0,1,6894928,6894232,696
8752701,742.743,718.857,744,1460,0.0977193,0,1,6897808,6897064,744
8771681,886.743,862.857,888,1460,0.217783,0,1,6908440,6907552,888
8777521,934.743,910.857,936,1460,0.257719,0,1,6912088,6911152,936
8783361,982.743,958.857,984,1460,0.297718,0,1,6915928,6914944,984
8802341,1126.74,1102.8,1128,1460,0.417599,0,1,6929680,6928552,1128
8808181,1174.74,1150.86,1176,1460,0.457715,0,1,6934288,6933112,1176
8814021,1222.74,1198.86,1224,1460,0.497717,0,1,6939088,6937864,1224
8850521,1510.74,1486.86,1512,1460,0.737718,0,2,6973288,6971776,1512
8856361,1558.74,1534.86,1560,1460,0.777718,0,2,6979432,6977872,1560
8881181,1750.74,1726.86,1752,1460,0.937719,0,2,7007584,7005832,1752
8892861,1594.8,1800.06,1584,1460,0.492214,0,1,7021696,7020112,1584
8895781,660.627,976.54,644,1460,0.0787542,0,1,7023284,7022640,644
8897241,644.831,660.627,644,1460,0.0315017,0,1,7023928,7023284,644
8898701,644.042,644.831,644,1460,0.0126007,0,1,7024572,7023928,644
8900161,644.002,644.042,644,1460,0.00504027,0,1,7025216,7024572,644
8901621,644,644.002,644,1460,0.00201611,0,1,7025860,7025216,644
8903081,644,644,644,1460,0.000806443,0,1,7026504,7025860,644
8904541,644,644,644,1460,0.000322577,0,1,7027148,7026504,644
8906001,644,644,644,1460,0.000129031,0,1,7027792,7027148,644
8907461,644,644,644,1460,5.16123e-05,0,1,7028436,7027792,644
8908921,644,644,644,1460,2.06449e-05,0,1,7029080,7028436,644
8910381,644,644,644,1460,8.25797e-06,0,1,7029724,7029080,644
8911841,644,644,644,1460,3.30319e-06,0,1,7030368,7029724,644
8913301,644,644,644,1460,1.32128e-06,0,1,7031012,7030368,644
8914761,644,644,644,1460,5.2851e-07,0,1,7031656,7031012,644
8916221,644,644,644,1460,2.11404e-07,0,1,7032300,7031656,644
8917681,644,644,644,1460,8.45616e-08,0,1,7032944,7032300,644
8919141,644,644,644,1460,3.38247e-08,0,1,7033588,7032944,644
8920601,644,644,644,1460,1.35299e-08,0,1,7034232,7033588,644
8922061,644,644,644,1460,0.00600001,0,1,7034876,7034232,644
8923521,647.8,644,648,1460,0.0204,0,1,7035524,7034876,648
8929361,694.743,670.857,696,1460,0.0577862,0,1,7038212,7037516,696
8935201,742.743,718.857,744,1460,0.0977193,0,1,7041092,7040348,744
8954181,886.743,862.857,888,1460,0.217783,0,1,7051724,7050836,888
8960021,934.743,910.857,936,1460,0.257719,0,1,7055372,7054436,936
8965861,982.743,958.857,984,1460,0.297718,0,1,7059212,7058228,984
8984841,1126.74,1102.8,1128,1460,0.417599,0,1,7072964,7071836,1128
8990681,1174.74,1150.86,1176,1460,0.457715,0,1,7077572,7076396,1176
8996521,1222.74,1198.86,1224,1460,0.497717,0,1,7082372,7081148,1224
9033021,1510.74,1486.86,1512,1460,0.737718,0,2,7116572,7115060,1512
9038861,1558.74,1534.86,1560,1460,0.777718,0,2,7122716,7121156,1560
9063681,1750.74,1726.86,1752,1460,0.937719,0,2,7150868,7149116,1752
9075361,1594.8,1800.06,1584,1460,0.492214,0,1,7164980,7163396,1584
9078281,660.627,976.54,644,1460,0.0787542,0,1,7166568,7165924,644
9079741,644.831,660.627,644,1460,0.0315017,0,1,7167212,7166568,644
9081201,644.042,644.831,644,1460,0.0126007,0,1,7167856,7167212,644
9082661,644.002,644.042,644,1460,0.00504027,0,1,7168500,7167856,644
9084121,644,644.002,644,1460,0.00201611,0,1,7169144,7168500,644
9085581,644,644,644,1460,0.000806443,0,1,7169788,7169144,644
9087041,644,644,644,1460,0.000322577,0,1,7170432,7169788,644
9088501,644,644,644,1460,0.000129031,0,1,7171076,7170432,644
9089961,644,644,644,1460,5.16123e-05,0,1,7171720,7171076,644
9091421,644,644,644,1460,2.06449e-05,0,1,7172364,7171720,644
9092881,644,644,644,1460,8.25797e-06,0,1,7173008,7172364,644
9094341,644,644,644,1460,3.30319e-06,0,1,7173652,7173008,644
9095801,644,644,644,1460,1.32128e-06,0,1,7174296,7173652,644
9097261,644,644,644,1460,5.2851e-07,0,1,7174940,7174296,644
9098721,644,644,644,1460,2.11404e-07,0,1,7175584,7174940,644
9100181,644,644,644,1460,8.45616e-08,0,1,7176228,7175584,644
9101641,644,644,644,1460,3.38247e-08,0,1,7176872,7176228,644
9103101,644,644,644,1460,1.35299e-08,0,1,7177516,7176872,644
9104561,644,644,644,1460,0.00600001,0,1,7178160,7177516,644
9106021,647.8,644,648,1460,0.0204,0,1,7178808,7178160,648
9111861,694.743,670.857,696,1460,0.0577862,0,1,7181496,7180800,696
9117701,742.743,718.857,744,1460,0.0977193,0,1,7184376,7183632,744
9136681,886.743,862.857,888,1460,0.217783,0,1,7195008,7194120,888
9142521,934.743,910.857,936,1460,0.257719,0,1,7198656,7197720,936
9148361,982.743,958.857,984,1460,0.297718,0,1,7202496,7201512,984
9167341,1126.74,1102.8,1128,1460,0.417599,0,1,7216248,7215120,1128
9173181,1174.74,1150.86,1176,1460,0.457715,0,1,7220856,7219680,1176
9179021,1222.74,1198.86,1224,1460,0.497717,0,1,7225656,7224432,1224
9187781,1501.14,1294.74,1512,1460,0.798595,0,2,7233456,7231944,1512
9189241,1693.86,1501.14,1704,1460,0.919438,0,2,7235160,7233456,1704
9202381,1079.88,1077.6,1080,1460,0.40346,0,1,7245600,7244520,1080
9203841,1148.39,1079.88,1152,1460,0.407384,0,1,7246752,7245600,1152
9208221,1174.74,1150.85,1176,1460,0.469353,0,1,7250208,7249032,1176
9209681,1221.54,1174.74,1224,1460,0.493741,0,1,7251432,7250208,1224
9228661,1510.68,1485.65,1512,1460,0.736203,0,2,7269408,7267896,1512
9230121,1534.73,1510.68,1536,1460,0.768481,0,2,7270944,7269408,1536
9231581,1581.54,1534.73,1584,1460,0.793393,0,2,7272528,7270944,1584
9240341,1703.94,1702.79,1704,1460,0.912161,0,2,7282536,7280832,1704
9241801,1749.6,1703.94,1752,1460,0.922864,0,2,7284288,7282536,1752
9262241,1463.88,1461.59,1464,1460,0.711069,0,2,7305648,7304184,1464
9263701,1509.59,1463.88,1512,1460,0.722428,0,2,7307160,7305648,1512
9265161,1511.88,1509.59,1512,1460,0.762971,0,2,7308672,7307160,1512
9266621,1580.39,1511.88,1584,1460,0.779188,0,2,7310256,7308672,1584
9268081,1583.82,1580.39,1584,1460,0.797675,0,2,7311840,7310256,1584
9276841,1679.88,1677.65,1680,1460,0.903492,0,2,7321704,7320024,1680
9278301,1748.39,1679.88,1752,1460,0.919397,0,2,7323456,7321704,1752
9279761,1751.82,1748.39,1752,1460,0.949759,0,2,7325208,7323456,1752
9287061,1478.58,1755.6,1464,1460,0.731252,0,2,7333872,7332408,1464
9288521,1464.73,1478.58,1464,1460,0.730501,0,2,7335336,7333872,1464
9291441,1534.68,1509.64,1536,1460,0.74688,0,2,7338384,7336848,1536
9292901,1535.93,1534.68,1536,1460,0.772752,0,2,7339920,7338384,1536
9294361,1581.6,1535.93,1584,1460,0.783101,0,2,7341504,7339920,1584
9303121,1727.87,1725.42,1728,1460,0.905917,0,2,7351464,7349736,1728
9304581,1727.99,1727.87,1728,1460,0.932367,0,2,7353192,7351464,1728
9335241,1534.68,1509.65,1536,1460,0.756265,0,2,7383768,7382232,1536
9336701,1558.73,1534.68,1560,1460,0.776506,0,2,7385328,7383768,1560
9338161,1582.74,1558.73,1584,1460,0.796602,0,2,7386912,7385328,1584
9346921,1726.8,1703.94,1728,1460,0.917864,0,2,7396992,7395264,1728
9348381,1750.74,1726.8,1752,1460,0.925146,0,2,7398744,7396992,1752
9349841,1751.94,1750.74,1752,1460,0.928058,0,2,7400496,7398744,1752
9364441,1533.48,1485.66,1536,1460,0.74139,0,2,7415904,7414368,1536
9365901,1535.87,1533.48,1536,1460,0.758556,0,2,7417440,7415904,1536
9367361,1558.79,1535.87,1560,1460,0.777422,0,2,7419000,7417440,1560
9368821,1582.74,1558.79,1584,1460,0.796969,0,2,7420584,7419000,1584
9377581,1726.68,1701.6,1728,1460,0.9159,0,2,7430568,7428840,1728
9403861,1487.82,1484.34,1488,1460,0.705517,0,2,7457952,7456464,1488
9405321,1487.99,1487.82,1488,1460,0.720207,0,2,7459440,7457952,1488
9406781,1510.8,1487.99,1512,1460,0.762083,0,2,7460952,7459440,1512
9408241,1580.34,1510.8,1584,1460,0.766833,0,2,7462536,7460952,1584
9418461,1703.88,1701.65,1704,1460,0.923267,0,2,7474056,7472352,1704
9419921,1772.39,1703.88,1776,1460,0.927307,0,2,7475832,7474056,1776
9438901,1511.82,1508.45,1512,1460,0.75016,0,2,7496088,7494576,1512
9452041,1679.94,1678.73,1680,1460,0.903723,0,2,7510560,7508880,1680
9453501,1748.4,1679.94,1752,1460,0.919489,0,2,7512312,7510560,1752
9454961,1751.82,1748.4,1752,1460,0.949796,0,2,7514064,7512312,1752
9471021,1103.93,1102.68,1104,1460,0.425212,0,1,7529376,7528272,1104
9472481,1172.4,1103.93,1176,1460,0.440085,0,1,7530552,7529376,1176
9473941,1175.82,1172.4,1176,1460,0.470034,0,1,7531728,7530552,1176
9492921,1485.54,1438.74,1488,1460,0.701423,0,2,7549008,7547520,1488
9494381,1487.88,1485.54,1488,1460,0.730569,0,2,7550496,7549008,1488
9495841,1533.59,1487.88,1536,1460,0.742228,0,2,7552032,7550496,1536
9497301,1535.88,1533.59,1536,1460,0.758891,0,2,7553568,7552032,1536
9498761,1558.79,1535.88,1560,1460,0.777556,0,2,7555128,7553568,1560
9500221,1582.74,1558.79,1584,1460,0.797023,0,2,7556712,7555128,1584
9507521,1725.54,1678.74,1728,1460,0.90147,0,2,7565016,7563288,1728
9508981,1727.88,1725.54,1728,1460,0.906588,0,2,7566744,7565016,1728
9510441,1727.99,1727.88,1728,1460,0.932635,0,2,7568472,7566744,1728
9533801,1510.68,1485.66,1512,1460,0.724402,0,2,7592232,7590720,1512
9535261,1511.93,1510.68,1512,1460,0.739761,0,2,7593744,7592232,1512
9536721,1534.8,1511.93,1536,1460,0.757904,0,2,7595280,7593744,1536
9538181,1558.74,1534.8,1560,1460,0.789162,0,2,7596840,7595280,1560
9546941,1703.94,1702.79,1704,1460,0.90002,0,2,7606824,7605120,1704
9548401,1726.8,1703.94,1728,1460,0.930008,0,2,7608552,7606824,1728
9561541,720.375,727.508,720,1460,0.0852782,0,1,7620480,7619760,720
9571761,862.686,837.711,864,1460,0.208609,0,1,7626072,7625208,864
9573221,909.534,862.686,912,1460,0.221444,0,1,7626984,7626072,912
9574681,911.877,909.534,912,1460,0.250577,0,1,7627896,7626984,912
9576141,957.594,911.877,960,1460,0.274231,0,1,7628856,7627896,960
9586361,1103.94,1102.79,1104,1460,0.412096,0,1,7636248,7635144,1104
9587821,1149.6,1103.94,1152,1460,0.434838,0,1,7637400,7636248,1152
9589281,1174.68,1149.6,1176,1460,0.467935,0,1,7638576,7637400,1176
9590741,1221.53,1174.68,1224,1460,0.469174,0,1,7639800,7638576,1224
9608261,1462.79,1439.88,1464,1460,0.709421,0,2,7655832,7654368,1464
9609721,1509.54,1462.79,1512,1460,0.709768,0,2,7657344,7655832,1512
9617021,1582.74,1558.85,1584,1460,0.797415,0,2,7665072,7663488,1584
9624321,1703.88,1701.59,1704,1460,0.910902,0,2,7673400,7671696,1704
9625781,1749.59,1703.88,1752,1460,0.922361,0,2,7675152,7673400,1752
9643301,1439.88,1437.6,1440,1460,0.703334,0,2,7693176,7691736,1440
9644761,1508.39,1439.88,1512,1460,0.707333,0,2,7694688,7693176,1512
9649141,1558.68,1533.65,1560,1460,0.776069,0,2,7699272,7697712,1560
9650601,1582.73,1558.68,1584,1460,0.796428,0,2,7700856,7699272,1584
9659361,1703.88,1701.65,1704,1460,0.911282,0,2,7710816,7709112,1704
9660821,1749.59,1703.88,1752,1460,0.946513,0,2,7712568,7710816,1752
9669581,1037.39,1139.88,1032,1460,0.209238,0,1,7721904,7720872,1032
9672501,674.053,713.07,672,1460,0.0826781,0,1,7723272,7722600,672
9690021,934.683,909.657,936,1460,0.256393,0,1,7733112,7732176,936
9691481,958.734,934.683,960,1460,0.288557,0,1,7734072,7733112,960
9701701,1127.82,1124.45,1128,1460,0.418195,0,1,7741536,7740408,1128
9703161,1150.79,1127.82,1152,1460,0.437278,0,1,7742688,7741536,1152
9704621,1174.74,1150.79,1176,1460,0.444911,0,1,7743864,7742688,1176
9706081,1175.94,1174.74,1176,1460,0.483964,0,1,7745040,7743864,1176
9707541,1244.4,1175.94,1248,1460,0.487586,0,1,7746288,7745040,1248
9723601,1462.8,1439.99,1464,1460,0.710241,0,2,7761216,7759752,1464
9725061,1509.54,1462.8,1512,1460,0.734096,0,2,7762728,7761216,1512
9726521,1534.68,1509.54,1536,1460,0.743639,0,2,7764264,7762728,1536
9727981,1535.93,1534.68,1536,1460,0.783455,0,2,7765800,7764264,1536
9729441,1604.4,1535.93,1608,1460,0.799382,0,2,7767408,7765800,1608
9738201,1726.68,1701.54,1728,1460,0.915603,0,2,7777368,7775640,1728
9739661,1750.73,1726.68,1752,1460,0.948241,0,2,7779120,7777368,1752
9751341,1485.54,1438.75,1488,1460,0.703432,0,2,7791696,7790208,1488
9752801,1487.88,1485.54,1488,1460,0.731373,0,2,7793184,7791696,1488
9754261,1533.59,1487.88,1536,1460,0.754549,0,2,7794720,7793184,1536
9755721,1558.68,1533.59,1560,1460,0.77582,0,2,7796280,7794720,1560
9757181,1582.73,1558.68,1584,1460,0.784328,0,2,7797864,7796280,1584
9758641,1583.94,1582.73,1584,1460,0.787731,0,2,7799448,7797864,1584
9768861,1727.88,1725.65,1728,1460,0.931268,0,2,7811136,7809408,1728
9795141,1511.88,1509.65,1512,1460,0.751382,0,2,7837344,7835832,1512
9796601,1557.59,1511.88,1560,1460,0.762553,0,2,7838904,7837344,1560
9798061,1559.88,1557.59,1560,1460,0.791021,0,2,7840464,7838904,1560
9806821,1702.8,1679.99,1704,1460,0.910231,0,2,7850448,7848744,1704
9808281,1749.54,1702.8,1752,1460,0.922092,0,2,7852200,7850448,1752
9815581,1526.46,1801.19,1512,1460,0.710905,0,2,7860912,7859400,1512
9822881,1487.82,1484.45,1488,1460,0.719091,0,2,7868136,7866648,1488
9824341,1510.79,1487.82,1512,1460,0.725636,0,2,7869648,7868136,1512
9825801,1511.94,1510.79,1512,1460,0.752255,0,2,7871160,7869648,1512
9827261,1557.6,1511.94,1560,1460,0.762902,0,2,7872720,7871160,1560
9828721,1559.88,1557.6,1560,1460,0.791161,0,2,7874280,7872720,1560
9852081,934.798,911.966,936,1460,0.264436,0,1,7898256,7897320,936
9853541,958.74,934.798,960,1460,0.267774,0,1,7899216,7898256,960
9865221,1126.79,1103.88,1128,1460,0.417555,0,1,7907640,7906512,1128
9866681,1150.74,1126.79,1152,1460,0.437022,0,1,7908792,7907640,1152
9868141,1174.74,1150.74,1176,1460,0.468809,0,1,7909968,7908792,1176
9869601,1221.54,1174.74,1224,1460,0.481524,0,1,7911192,7909968,1224
9871061,1223.88,1221.54,1224,1460,0.498609,0,1,7912416,7911192,1224
9885661,1485.54,1438.8,1488,1460,0.701949,0,2,7926096,7924608,1488
9887121,1487.88,1485.54,1488,1460,0.71878,0,2,7927584,7926096,1488
9888581,1510.79,1487.88,1512,1460,0.749512,0,2,7929096,7927584,1512
9890041,1557.54,1510.79,1560,1460,0.761805,0,2,7930656,7929096,1560
9891501,1559.88,1557.54,1560,1460,0.766722,0,2,7932216,7930656,1560
9892961,1559.99,1559.88,1560,1460,0.792689,0,2,7933776,7932216,1560
9900261,1725.59,1679.82,1728,1460,0.901887,0,2,7942080,7940352,1728
9901721,1727.88,1725.59,1728,1460,0.918755,0,2,7943808,7942080,1728
9903181,1750.79,1727.88,1752,1460,0.937502,0,2,7945560,7943808,1752
9926541,1486.74,1462.79,1488,1460,0.717015,0,2,7969752,7968264,1488
9928001,1510.74,1486.74,1512,1460,0.760806,0,2,7971264,7969752,1512
9939681,1725.54,1678.85,1728,1460,0.926077,0,2,7984320,7982592,1728
9954281,865.3,889.998,864,1460,0.255386,0,1,7999416,7998552,864
9968881,1127.82,1124.39,1128,1460,0.429746,0,1,8009616,8008488,1128
9970341,1173.59,1127.82,1176,1460,0.429898,0,1,8010792,8009616,1176
9995161,1535.88,1533.65,1536,1460,0.783197,0,2,8033904,8032368,1536
10006841,1703.88,1701.65,1704,1460,0.923379,0,2,8047080,8045376,1704
10008301,1772.39,1703.88,1776,1460,0.927352,0,2,8048856,8047080,1776
10015601,1394.16,1435.25,1392,1460,0.293742,0,1,8057040,8055648,1392
10021441,719.999,719.97,720,1460,0.0997278,0,1,8059872,8059152,720
10030201,886.626,860.511,888,1460,0.227328,0,1,8064792,8063904,888
10031661,933.531,886.626,936,1460,0.228931,0,1,8065728,8064792,936
10036041,981.543,934.854,984,1460,0.294252,0,1,8068560,8067576,984
10047721,1151.88,1149.65,1152,1460,0.451385,0,1,8077248,8076096,1152
10049181,1197.59,1151.88,1200,1460,0.462554,0,1,8078448,8077248,1200
10050641,1199.88,1197.59,1200,1460,0.467022,0,1,8079648,8078448,1200
10068161,1486.68,1461.65,1488,1460,0.728225,0,2,8095920,8094432,1488
10069621,1533.53,1486.68,1536,1460,0.74129,0,2,8097456,8095920,1536
10071081,1535.88,1533.53,1536,1460,0.758516,0,2,8098992,8097456,1536
10072541,1558.79,1535.88,1560,1460,0.789406,0,2,8100552,8098992,1560
10084221,1726.74,1702.79,1728,1460,0.929113,0,2,8113848,8112120,1728
10090061,1730.46,1777.13,1728,1460,0.785593,0,2,8120928,8119200,1728
10091521,1477.32,1730.46,1464,1460,0.716237,0,2,8122392,8120928,1464
10092981,1441.87,1477.32,1440,1460,0.712495,0,2,8123832,8122392,1440
10095901,1487.88,1485.69,1488,1460,0.746399,0,2,8126808,8125320,1488
10097361,1556.39,1487.88,1560,1460,0.76056,0,2,8128368,8126808,1560
10098821,1559.82,1556.39,1560,1460,0.778224,0,2,8129928,8128368,1560
10100281,1582.79,1559.82,1584,1460,0.79729,0,2,8131512,8129928,1584
10111961,1726.79,1703.88,1728,1460,0.929815,0,2,8144880,8143152,1728
10126561,859.016,764.319,864,1460,0.224976,0,1,8157432,8156568,864
10128021,954.951,859.016,960,1460,0.27599,0,1,8158392,8157432,960
10136781,1103.82,1100.46,1104,1460,0.410246,0,1,8164728,8163624,1104
10142621,1198.68,1173.65,1200,1460,0.464246,0,1,8169384,8168184,1200
10144081,1199.93,1198.68,1200,1460,0.491699,0,1,8170584,8169384,1200
10160141,1462.79,1439.88,1464,1460,0.709464,0,2,8185488,8184024,1464
10161601,1509.54,1462.79,1512,1460,0.733786,0,2,8187000,8185488,1512
10163061,1534.68,1509.54,1536,1460,0.743514,0,2,8188536,8187000,1536
10164521,1535.93,1534.68,1536,1460,0.783406,0,2,8190072,8188536,1536
10165981,1604.4,1535.93,1608,1460,0.787362,0,2,8191680,8190072,1608
10174741,1726.79,1703.76,1728,1460,0.916782,0,2,8201640,8199912,1728
10176201,1750.74,1726.79,1752,1460,0.936713,0,2,8203392,8201640,1752
10177661,1774.74,1750.74,1776,1460,0.944685,0,2,8205168,8203392,1776
10198101,1486.79,1463.88,1488,1460,0.729401,0,2,8225784,8224296,1488
10199561,1533.54,1486.79,1536,1460,0.75376,0,2,8227320,8225784,1536
10211241,1701.6,1655.99,1704,1460,0.906873,0,2,8240232,8238528,1704
10212701,1749.48,1701.6,1752,1460,0.908749,0,2,8241984,8240232,1752
10231681,1486.73,1462.62,1488,1460,0.704075,0,2,8262024,8260536,1488
10233141,1487.94,1486.73,1488,1460,0.73163,0,2,8263512,8262024,1488
10234601,1533.6,1487.94,1536,1460,0.766652,0,2,8265048,8263512,1536
10236061,1581.48,1533.6,1584,1460,0.768661,0,2,8266632,8265048,1584
10246281,1725.54,1678.85,1728,1460,0.914174,0,2,8278128,8276400,1728
10247741,1750.68,1725.54,1752,1460,0.92367,0,2,8279880,8278128,1752
10249201,1751.93,1750.68,1752,1460,0.927468,0,2,8281632,8279880,1752
10269641,1486.74,1462.79,1488,1460,0.728993,0,2,8302824,8301336,1488
10271101,1533.54,1486.74,1536,1460,0.741597,0,2,8304360,8302824,1536
10272561,1535.88,1533.54,1536,1460,0.758639,0,2,8305896,8304360,1536
10274021,1558.79,1535.88,1560,1460,0.777456,0,2,8307456,8305896,1560
10284241,1727.82,1724.34,1728,1460,0.917562,0,2,8319048,8317320,1728
10285701,1750.79,1727.82,1752,1460,0.937025,0,2,8320800,8319048,1752
10293001,1615.38,1755.59,1608,1460,0.462418,0,1,8329584,8327976,1608
10307601,863.88,861.594,864,1460,0.211034,0,1,8337720,8336856,864
10309061,909.594,863.88,912,1460,0.222414,0,1,8338632,8337720,912
10310521,911.88,909.594,912,1460,0.250966,0,1,8339544,8338632,912
10311981,957.594,911.88,960,1460,0.262386,0,1,8340504,8339544,960
10313441,959.88,957.594,960,1460,0.290954,0,1,8341464,8340504,960
10322201,1127.82,1124.39,1128,1460,0.429672,0,1,8347848,8346720,1128
10323661,1173.59,1127.82,1176,1460,0.429869,0,1,8349024,8347848,1176
10344101,1485.59,1439.82,1488,1460,0.714123,0,2,8367528,8366040,1488
10345561,1510.68,1485.59,1512,1460,0.723649,0,2,8369040,8367528,1512
10347021,1511.93,1510.68,1512,1460,0.75146,0,2,8370552,8369040,1512
10348481,1557.6,1511.93,1560,1460,0.762584,0,2,8372112,8370552,1560
10349941,1559.88,1557.6,1560,1460,0.779034,0,2,8373672,8372112,1560
10358701,1726.68,1701.54,1728,1460,0.903519,0,2,8383608,8381880,1728
10360161,1727.93,1726.68,1728,1460,0.931408,0,2,8385336,8383608,1728
10361621,1773.6,1727.93,1776,1460,0.942563,0,2,8387112,8385336,1776
10382061,1462.74,1438.85,1464,1460,0.721448,0,2,8408160,8406696,1464
10383521,1532.34,1462.74,1536,1460,0.738579,0,2,8409696,8408160,1536
10384981,1535.82,1532.34,1536,1460,0.745432,0,2,8411232,8409696,1536
10386441,1535.99,1535.82,1536,1460,0.772173,0,2,8412768,8411232,1536
10406881,1452.3,1686,1440,1460,0.720621,0,2,8436336,8434896,1440
10414181,1557.54,1510.85,1560,1460,0.762736,0,2,8443872,8442312,1560
10415641,1559.88,1557.54,1560,1460,0.791094,0,2,8445432,8443872,1560
10434621,1329.12,1502.46,1320,1460,0.498876,0,1,8467032,8465712,1320
10449221,1126.8,1103.93,1128,1460,0.417656,0,1,8477472,8476344,1128
10450681,1150.74,1126.8,1152,1460,0.449063,0,1,8478624,8477472,1152
10452141,1197.54,1150.74,1200,1460,0.449625,0,1,8479824,8478624,1200
10471121,1486.62,1460.4,1488,1460,0.702915,0,2,8497200,8495712,1488
10472581,1487.93,1486.62,1488,1460,0.719166,0,2,8498688,8497200,1488
10474041,1510.8,1487.93,1512,1460,0.749666,0,2,8500200,8498688,1512
10475501,1557.54,1510.8,1560,1460,0.761867,0,2,8501760,8500200,1560
10476961,1559.88,1557.54,1560,1460,0.778747,0,2,8503320,8501760,1560
10478421,1582.79,1559.88,1584,1460,0.785499,0,2,8504904,8503320,1584
10485721,1725.6,1679.93,1728,1460,0.914428,0,2,8513232,8511504,1728
10487181,1750.68,1725.6,1752,1460,0.935771,0,2,8514984,8513232,1752
10494481,1480.85,1801.02,1464,1460,0.745163,0,2,8523600,8522136,1464
10498861,1084.44,1168.78,1080,1460,0.42377,0,1,8527320,8526240,1080
10501781,1127.89,1125.82,1128,1460,0.424203,0,1,8529576,8528448,1128
10503241,1150.79,1127.89,1152,1460,0.439681,0,1,8530728,8529576,1152
10504701,1174.74,1150.79,1176,1460,0.457873,0,1,8531904,8530728,1176
10506161,1198.74,1174.74,1200,1460,0.489149,0,1,8533104,8531904,1200
10507621,1245.54,1198.74,1248,1460,0.48966,0,1,8534352,8533104,1248
10525141,1486.74,1462.8,1488,1460,0.729326,0,2,8550936,8549448,1488
10526601,1533.54,1486.74,1536,1460,0.74173,0,2,8552472,8550936,1536
10528061,1535.88,1533.54,1536,1460,0.758692,0,2,8554008,8552472,1536
10529521,1558.79,1535.88,1560,1460,0.777477,0,2,8555568,8554008,1560
10536821,1679.88,1677.59,1680,1460,0.902902,0,2,8563776,8562096,1680
10538281,1748.39,1679.88,1752,1460,0.907161,0,2,8565528,8563776,1752
10548501,1592.58,1755.59,1584,1460,0.481749,0,1,8577768,8576184,1584
10551421,890.901,946.029,888,1460,0.27748,0,1,8579568,8578680,888
10555801,959.934,958.687,960,1460,0.294479,0,1,8582424,8581464,960
10566021,1126.79,1103.82,1128,1460,0.417107,0,1,8589816,8588688,1128
10567481,1150.74,1126.79,1152,1460,0.436843,0,1,8590968,8589816,1152
10568941,1174.74,1150.74,1176,1460,0.456737,0,1,8592144,8590968,1176
10570401,1198.74,1174.74,1200,1460,0.464695,0,1,8593344,8592144,1200
10571861,1199.94,1198.74,1200,1460,0.467878,0,1,8594544,8593344,1200
10586461,1461.54,1414.86,1464,1460,0.70636,0,2,8608056,8606592,1464
10587921,1509.48,1461.54,1512,1460,0.732544,0,2,8609568,8608056,1512
10589381,1534.67,1509.48,1536,1460,0.743018,0,2,8611104,8609568,1536
10590841,1535.93,1534.67,1536,1460,0.759207,0,2,8612640,8611104,1536
10592301,1558.8,1535.93,1560,1460,0.789683,0,2,8614200,8612640,1560
10593761,1605.54,1558.8,1608,1460,0.789873,0,2,8615808,8614200,1608
10612741,1219.8,1596,1200,1460,0.460954,0,1,8637552,8636352,1200
10618581,1147.03,1052.6,1152,1460,0.405736,0,1,8641800,8640648,1152
10639021,1439.88,1437.54,1440,1460,0.702615,0,2,8659896,8658456,1440
10640481,1508.39,1439.88,1512,1460,0.707046,0,2,8661408,8659896,1512
10644861,1557.54,1510.85,1560,1460,0.774131,0,2,8665968,8664408,1560
10646321,1582.68,1557.54,1584,1460,0.795652,0,2,8667552,8665968,1584
10656541,1726.8,1703.93,1728,1460,0.941822,0,2,8679240,8677512,1728
10663841,1544.58,1707.66,1536,1460,0.763695,0,2,8687856,8686320,1536
10688661,1153.16,1175.22,1152,1460,0.494263,0,1,8715288,8714136,1152
10707641,1485.6,1439.93,1488,1460,0.714533,0,2,8732568,8731080,1488
10709101,1510.68,1485.6,1512,1460,0.723813,0,2,8734080,8732568,1512
10710561,1511.93,1510.68,1512,1460,0.739525,0,2,8735592,8734080,1512
10712021,1534.8,1511.93,1536,1460,0.75781,0,2,8737128,8735592,1536
10713481,1558.74,1534.8,1560,1460,0.789124,0,2,8738688,8737128,1560
10733921,1031.7,1482.05,1008,1460,0.210252,0,1,8761872,8760864,1008
10748521,886.626,860.514,888,1460,0.227419,0,1,8769576,8768688,888
10754361,982.626,956.514,984,1460,0.295406,0,1,8773344,8772360,984
10766041,1126.8,1103.94,1128,1460,0.417959,0,1,8781864,8780736,1128
10767501,1150.74,1126.8,1152,1460,0.461184,0,1,8783016,8781864,1152
10768961,1220.34,1150.74,1224,1460,0.466473,0,1,8784240,8783016,1224
10785021,1439.88,1437.65,1440,1460,0.703217,0,2,8798880,8797440,1440
10786481,1508.39,1439.88,1512,1460,0.707287,0,2,8800392,8798880,1512
10790861,1558.68,1533.65,1560,1460,0.776066,0,2,8804976,8803416,1560
10792321,1582.73,1558.68,1584,1460,0.784427,0,2,8806560,8804976,1584
10802541,1727.83,1724.51,1728,1460,0.930544,0,2,8818248,8816520,1728
10824441,1463.94,1462.79,1464,1460,0.736263,0,2,8840784,8839320,1464
10825901,1555.2,1463.94,1560,1460,0.744505,0,2,8842344,8840784,1560
10837581,1725.54,1678.74,1728,1460,0.901595,0,2,8855352,8853624,1728
10839041,1727.88,1725.54,1728,1460,0.930638,0,2,8857080,8855352,1728
10840501,1773.59,1727.88,1776,1460,0.942255,0,2,8858856,8857080,1776
10850721,895.698,1041.96,888,1460,0.288742,0,1,8869656,8868768,888
10865321,1126.62,1100.45,1128,1460,0.426973,0,1,8879736,8878608,1128
10912041,1800.06,1801.14,1800,1460,0.922129,0,2,8927736,8925936,1800
10916421,917.412,1020.24,912,1460,0.268056,0,1,8931336,8930424,912
10917881,889.471,917.412,888,1460,0.257223,0,1,8932224,8931336,888
10920801,935.884,933.674,936,1460,0.287156,0,1,8934096,8933160,936
10922261,1004.39,935.884,1008,1460,0.288862,0,1,8935104,8934096,1008
10931021,1125.6,1079.94,1128,1460,0.414838,0,1,8941488,8940360,1128
10932481,1150.68,1125.6,1152,1460,0.447935,0,1,8942640,8941488,1152
10933941,1197.53,1150.68,1200,1460,0.449174,0,1,8943840,8942640,1200
10955841,1511.82,1508.46,1512,1460,0.750306,0,2,8964120,8962608,1512
10957301,1557.59,1511.82,1560,1460,0.762122,0,2,8965680,8964120,1560
10958761,1559.88,1557.59,1560,1460,0.790849,0,2,8967240,8965680,1560
10967521,1725.59,1679.88,1728,1460,0.914293,0,2,8977176,8975448,1728
10968981,1750.68,1725.59,1752,1460,0.935717,0,2,8978928,8977176,1752
10970441,1774.73,1750.68,1776,1460,0.944287,0,2,8980704,8978928,1776
10983581,1461.54,1414.75,1464,1460,0.707442,0,2,8994936,8993472,1464
10985041,1509.48,1461.54,1512,1460,0.708977,0,2,8996448,8994936,1512
10989421,1580.34,1510.85,1584,1460,0.779054,0,2,9001032,8999448,1584
10990881,1583.82,1580.34,1584,1460,0.797622,0,2,9002616,9001032,1584
10999641,1726.79,1703.88,1728,1460,0.917439,0,2,9012648,9010920,1728
11018621,1124.39,1055.88,1128,1460,0.400159,0,1,9030696,9029568,1128
11020081,1127.82,1124.39,1128,1460,0.418064,0,1,9031824,9030696,1128
11021541,1150.79,1127.82,1152,1460,0.437225,0,1,9032976,9031824,1152
11023001,1174.74,1150.79,1176,1460,0.46889,0,1,9034152,9032976,1176
11024461,1221.54,1174.74,1224,1460,0.469556,0,1,9035376,9034152,1224
11040521,1439.82,1436.39,1440,1460,0.701747,0,2,9049920,9048480,1440
11046361,1535.83,1532.51,1536,1460,0.758461,0,2,9055968,9054432,1536
11047821,1558.79,1535.83,1560,1460,0.777384,0,2,9057528,9055968,1560
11049281,1582.74,1558.79,1584,1460,0.796954,0,2,9059112,9057528,1584
11055121,1679.93,1678.68,1680,1460,0.903362,0,2,9065736,9064056,1680
11078481,1440,1439.94,1440,1460,0.70515,0,2,9090024,9088584,1440
11079941,1508.4,1440,1512,1460,0.70806,0,2,9091536,9090024,1512
11094541,1726.79,1703.88,1728,1460,0.917572,0,2,9107784,9106056,1728
11096001,1750.74,1726.79,1752,1460,0.937029,0,2,9109536,9107784,1752
11106221,888.046,888.912,888,1460,0.25159,0,1,9119256,9118368,888
11109141,935.88,933.602,936,1460,0.262254,0,1,9121128,9120192,936
11110601,958.794,935.88,960,1460,0.290902,0,1,9122088,9121128,960
11119361,1125.48,1077.6,1128,1460,0.40088,0,1,9128400,9127272,1128
11120821,1127.87,1125.48,1128,1460,0.406352,0,1,9129528,9128400,1128
11122281,1127.99,1127.87,1128,1460,0.420541,0,1,9130656,9129528,1128
11123741,1150.8,1127.99,1152,1460,0.450216,0,1,9131808,9130656,1152
11125201,1197.54,1150.8,1200,1460,0.474087,0,1,9133008,9131808,1200
11126661,1222.68,1197.54,1224,1460,0.495635,0,1,9134232,9133008,1224
11142721,1462.79,1439.88,1464,1460,0.70969,0,2,9149256,9147792,1464
11144181,1509.54,1462.79,1512,1460,0.721876,0,2,9150768,9149256,1512
11145641,1511.88,1509.54,1512,1460,0.76275,0,2,9152280,9150768,1512
11147101,1580.39,1511.88,1584,1460,0.7671,0,2,9153864,9152280,1584
11157321,1726.74,1702.74,1728,1460,0.916651,0,2,9165432,9163704,1728
11158781,1750.74,1726.74,1752,1460,0.93666,0,2,9167184,9165432,1752
11167541,1200.42,1664.34,1176,1460,0.40109,0,1,9177240,9176064,1176
11186521,933.483,885.654,936,1460,0.241086,0,1,9187752,9186816,936
11187981,935.874,933.483,936,1460,0.258435,0,1,9188688,9187752,936
11189441,958.794,935.874,960,1460,0.265374,0,1,9189648,9188688,960
11190901,959.94,958.794,960,1460,0.28015,0,1,9190608,9189648,960
11192361,982.797,959.94,984,1460,0.29806,0,1,9191592,9190608,984
11199661,1125.6,1079.93,1128,1460,0.414556,0,1,9196944,9195816,1128
11201121,1150.68,1125.6,1152,1460,0.435822,0,1,9198096,9196944,1152
11202581,1174.73,1150.68,1176,1460,0.468329,0,1,9199272,9198096,1176
11204041,1221.54,1174.73,1224,1460,0.481332,0,1,9200496,9199272,1224
11205501,1223.88,1221.54,1224,1460,0.498533,0,1,9201720,9200496,1224
11221561,1486.74,1462.74,1488,1460,0.716725,0,2,9216840,9215352,1488
11223021,1510.74,1486.74,1512,1460,0.73669,0,2,9218352,9216840,1512
11224481,1534.74,1510.74,1536,1460,0.768676,0,2,9219888,9218352,1536
11225941,1581.54,1534.74,1584,1460,0.79347,0,2,9221472,9219888,1584
11236161,1703.88,1701.65,1704,1460,0.911483,0,2,9233088,9231384,1704
11237621,1749.59,1703.88,1752,1460,0.946593,0,2,9234840,9233088,1752
11246381,1241.52,1574.34,1224,1460,0.295973,0,1,9244920,9243696,1224
11260981,886.737,862.737,888,1460,0.216768,0,1,9252840,9251952,888
11262441,910.737,886.737,912,1460,0.236707,0,1,9253752,9252840,912
11263901,934.737,910.737,936,1460,0.268683,0,1,9254688,9253752,936
11265361,981.537,934.737,984,1460,0.293473,0,1,9255672,9254688,984
11275581,1103.94,1102.74,1104,1460,0.423894,0,1,9263064,9261960,1104
11277041,1172.4,1103.94,1176,1460,0.427558,0,1,9264240,9263064,1176
11298941,1486.79,1463.87,1488,1460,0.741376,0,2,9284184,9282696,1488
11300401,1556.34,1486.79,1560,1460,0.74655,0,2,9285744,9284184,1560
11310621,1701.6,1655.93,1704,1460,0.906484,0,2,9297072,9295368,1704
11312081,1749.48,1701.6,1752,1460,0.908594,0,2,9298824,9297072,1752
11322301,1346.96,1403.27,1344,1460,0.479725,0,1,9310200,9308856,1344
11323761,1093.35,1346.96,1080,1460,0.42589,0,1,9311280,9310200,1080
11326681,1103.97,1103.47,1104,1460,0.419742,0,1,9313488,9312384,1104
11328141,1149.6,1103.97,1152,1460,0.437897,0,1,9314640,9313488,1152
11329601,1174.68,1149.6,1176,1460,0.445159,0,1,9315816,9314640,1176
11331061,1175.93,1174.68,1176,1460,0.460064,0,1,9316992,9315816,1176
11332521,1198.8,1175.93,1200,1460,0.478025,0,1,9318192,9316992,1200
11347121,1485.48,1437.6,1488,1460,0.71277,0,2,9331728,9330240,1488
11352961,1557.54,1510.86,1560,1460,0.786391,0,2,9337800,9336240,1560
11354421,1605.48,1557.54,1608,1460,0.788556,0,2,9339408,9337800,1608
11364641,1750.68,1725.66,1752,1460,0.936315,0,2,9351168,9349416,1752
11366101,1774.73,1750.68,1776,1460,0.944526,0,2,9352944,9351168,1776
11371941,1525.31,1778.28,1512,1460,0.76602,0,2,9359832,9358320,1512
11373401,1512.67,1525.31,1512,1460,0.756408,0,2,9361344,9359832,1512
11376321,1558.74,1534.83,1560,1460,0.767825,0,2,9364440,9362880,1560
11385081,1725.59,1679.88,1728,1460,0.902321,0,2,9374352,9372624,1728
11386541,1727.88,1725.59,1728,1460,0.918929,0,2,9376080,9374352,1728
11388001,1750.79,1727.88,1752,1460,0.937571,0,2,9377832,9376080,1752
11398221,1176,1175.97,1176,1460,0.496052,0,1,9388368,9387192,1176
11423041,1582.68,1557.6,1584,1460,0.796129,0,2,9412224,9410640,1584
11430341,1703.93,1702.62,1704,1460,0.911042,0,2,9420528,9418824,1704
11431801,1749.6,1703.93,1752,1460,0.922417,0,2,9422280,9420528,1752
11433261,1751.88,1749.6,1752,1460,0.938967,0,2,9424032,9422280,1752
11440561,1413.65,1825.08,1392,1460,0.757081,0,2,9432672,9431280,1392
11446401,1196.39,1127.86,1200,1460,0.468517,0,1,9437640,9436440,1200
11447861,1199.82,1196.39,1200,1460,0.481407,0,1,9438840,9437640,1200
11449321,1222.79,1199.82,1224,1460,0.498563,0,1,9440064,9438840,1224
11466841,1486.74,1462.74,1488,1460,0.728678,0,2,9456360,9454872,1488
11468301,1533.54,1486.74,1536,1460,0.741471,0,2,9457896,9456360,1536
11469761,1535.88,1533.54,1536,1460,0.770588,0,2,9459432,9457896,1536
11479981,1725.6,1679.94,1728,1460,0.914638,0,2,9470952,9469224,1728
11481441,1750.68,1725.6,1752,1460,0.935855,0,2,9472704,9470952,1752
11496041,907.015,812.304,912,1460,0.251966,0,1,9485280,9484368,912
11497501,980.151,907.015,984,1460,0.286786,0,1,9486264,9485280,984
11506261,1126.68,1101.6,1128,1460,0.415981,0,1,9492672,9491544,1128
11507721,1150.73,1126.68,1152,1460,0.448392,0,1,9493824,9492672,1152
11509181,1197.54,1150.73,1200,1460,0.461357,0,1,9495024,9493824,1200
11510641,1199.88,1197.54,1200,1460,0.466543,0,1,9496224,9495024,1200
11512101,1199.99,1199.88,1200,1460,0.480617,0,1,9497424,9496224,1200
11528161,1487.82,1484.4,1488,1460,0.70579,0,2,9512400,9510912,1488
11529621,1487.99,1487.82,1488,1460,0.720316,0,2,9513888,9512400,1488
11531081,1510.8,1487.99,1512,1460,0.750126,0,2,9515400,9513888,1512
11532541,1557.54,1510.8,1560,1460,0.774051,0,2,9516960,9515400,1560
11545681,1727.89,1725.71,1728,1460,0.943832,0,2,9531984,9530256,1728
11566121,1463.88,1461.6,1464,1460,0.711107,0,2,9552912,9551448,1464
11567581,1509.59,1463.88,1512,1460,0.734443,0,2,9554424,9552912,1512
11569041,1534.68,1509.59,1536,1460,0.755777,0,2,9555960,9554424,1536
11570501,1558.73,1534.68,1560,1460,0.776311,0,2,9557520,9555960,1560
11571961,1582.74,1558.73,1584,1460,0.796524,0,2,9559104,9557520,1584
11580721,1703.82,1700.4,1704,1460,0.9099,0,2,9568992,9567288,1704
11582181,1749.59,1703.82,1752,1460,0.92196,0,2,9570744,9568992,1752
11589481,1640.46,1801.19,1632,1460,0.757559,0,2,9579576,9577944,1632
11590941,1450.02,1640.46,1440,1460,0.753024,0,2,9581016,9579576,1440
11607001,1486.68,1461.54,1488,1460,0.715596,0,2,9596304,9594816,1488
11608461,1510.73,1486.68,1512,1460,0.736238,0,2,9597816,9596304,1512
11609921,1534.74,1510.73,1536,1460,0.756495,0,2,9599352,9597816,1536
11611381,1558.74,1534.74,1560,1460,0.788598,0,2,9600912,9599352,1560
11612841,1605.54,1558.74,1608,1460,0.789439,0,2,9602520,9600912,1608
11621601,1725.6,1679.94,1728,1460,0.91484,0,2,9612504,9610776,1728
11623061,1750.68,1725.6,1752,1460,0.935936,0,2,9614256,9612504,1752
11637661,911.94,910.805,912,1460,0.268768,0,1,9627600,9626688,912
11639121,980.397,911.94,984,1460,0.293507,0,1,9628584,9627600,984
11652261,1151.88,1149.65,1152,1460,0.451391,0,1,9638280,9637128,1152
11653721,1197.59,1151.88,1200,1460,0.462556,0,1,9639480,9638280,1200
11655181,1199.88,1197.59,1200,1460,0.491022,0,1,9640680,9639480,1200
11675621,1534.68,1509.65,1536,1460,0.756165,0,2,9660192,9658656,1536
11677081,1558.73,1534.68,1560,1460,0.788466,0,2,9661752,9660192,1560
11690221,1774.68,1749.66,1776,1460,0.944332,0,2,9676920,9675144,1776
11696061,1777.25,1801.08,1776,1460,0.788671,0,2,9684096,9682320,1776
11697521,1456.86,1777.25,1440,1460,0.717468,0,2,9685536,9684096,1440
11698981,1440.84,1456.86,1440,1460,0.712987,0,2,9686976,9685536,1440
11703361,1487.99,1487.88,1488,1460,0.734191,0,2,9691440,9689952,1488
11704821,1533.6,1487.99,1536,1460,0.767676,0,2,9692976,9691440,1536
11706281,1581.48,1533.6,1584,1460,0.781071,0,2,9694560,9692976,1584
11707741,1583.87,1581.48,1584,1460,0.798428,0,2,9696144,9694560,1584
11716501,1702.8,1679.99,1704,1460,0.910261,0,2,9706128,9704424,1704
11717961,1749.54,1702.8,1752,1460,0.934104,0,2,9707880,9706128,1752
11739861,1127.77,1123.31,1128,1460,0.429592,0,1,9728568,9727440,1128
11741321,1173.59,1127.77,1176,1460,0.429837,0,1,9729744,9728568,1176
11763221,1486.74,1462.85,1488,1460,0.717534,0,2,9749784,9748296,1488
11764681,1510.74,1486.74,1512,1460,0.737014,0,2,9751296,9749784,1512
11766141,1534.74,1510.74,1536,1460,0.756805,0,2,9752832,9751296,1536
11767601,1558.74,1534.74,1560,1460,0.788722,0,2,9754392,9752832,1560
11779281,1751.82,1748.45,1752,1460,0.938183,0,2,9767808,9766056,1752
11780741,1774.79,1751.82,1776,1460,0.945273,0,2,9769584,9767808,1776
11789501,899.226,1112.53,888,1460,0.282627,0,1,9778680,9777792,888
11793881,935.938,934.768,936,1460,0.288088,0,1,9781464,9780528,936
11795341,1004.4,935.938,1008,1460,0.289235,0,1,9782472,9781464,1008
11805561,1150.62,1124.45,1152,1460,0.434996,0,1,9789936,9788784,1152
11807021,1174.73,1150.62,1176,1460,0.443998,0,1,9791112,9789936,1176
11808481,1175.94,1174.73,1176,1460,0.459599,0,1,9792288,9791112,1176
11809941,1198.8,1175.94,1200,1460,0.48984,0,1,9793488,9792288,1200
11826001,1463.94,1462.79,1464,1460,0.711893,0,2,9808368,9806904,1464
11827461,1509.6,1463.94,1512,1460,0.734757,0,2,9809880,9808368,1512
11828921,1534.68,1509.6,1536,1460,0.743903,0,2,9811416,9809880,1536
11830381,1535.93,1534.68,1536,1460,0.759561,0,2,9812952,9811416,1536
11840601,1726.62,1700.46,1728,1460,0.903152,0,2,9824496,9822768,1728
11842061,1727.93,1726.62,1728,1460,0.919261,0,2,9826224,9824496,1728
11843521,1750.8,1727.93,1752,1460,0.949704,0,2,9827976,9826224,1752
11849361,1800.06,1801.13,1800,1460,0.713448,0,2,9835200,9833400,1800
11852281,886.86,1321.2,864,1460,0.297752,0,1,9837360,9836496,864
11856661,911.997,911.937,912,1460,0.258336,0,1,9840096,9839184,912
11858121,957.6,911.997,960,1460,0.277334,0,1,9841056,9840096,960
11871261,1174.68,1149.65,1176,1460,0.468145,0,1,9850752,9849576,1176
11872721,1221.53,1174.68,1224,1460,0.469258,0,1,9851976,9850752,1224
11891701,1463.94,1462.74,1464,1460,0.700051,0,2,9869472,9868008,1464
11893161,1486.8,1463.94,1488,1460,0.71802,0,2,9870960,9869472,1488
11894621,1510.74,1486.8,1512,1460,0.749208,0,2,9872472,9870960,1512
11896081,1557.54,1510.74,1560,1460,0.773683,0,2,9874032,9872472,1560
11897541,1582.68,1557.54,1584,1460,0.795473,0,2,9875616,9874032,1584
11907761,1750.68,1725.66,1752,1460,0.924376,0,2,9887424,9885672,1752
11909221,1751.93,1750.68,1752,1460,0.93975,0,2,9889176,9887424,1752
11916521,1145.76,1483.13,1128,1460,0.400909,0,1,9897216,9896088,1128
11922361,1124.34,1054.7,1128,1460,0.436935,0,1,9901416,9900288,1128
11923821,1196.22,1124.34,1200,1460,0.468774,0,1,9902616,9901416,1200
11925281,1222.61,1196.22,1224,1460,0.49351,0,1,9903840,9902616,1224
11942801,1532.29,1461.71,1536,1460,0.750301,0,2,9920304,9918768,1536
11944261,1558.61,1532.29,1560,1460,0.76212,0,2,9921864,9920304,1560
11945721,1559.93,1558.61,1560,1460,0.766848,0,2,9923424,9921864,1560
11955941,1727.82,1724.4,1728,1460,0.929975,0,2,9935040,9933312,1728
11983681,1485.54,1438.8,1488,1460,0.713975,0,2,9963216,9961728,1488
11985141,1510.68,1485.54,1512,1460,0.72359,0,2,9964728,9963216,1512
11986601,1511.93,1510.68,1512,1460,0.739436,0,2,9966240,9964728,1512
11988061,1534.8,1511.93,1536,1460,0.769774,0,2,9967776,9966240,1536
11989521,1581.54,1534.8,1584,1460,0.79391,0,2,9969360,9967776,1584
11999741,1704,1703.93,1704,1460,0.91297,0,2,9981000,9979296,1704
12001201,1749.6,1704,1752,1460,0.947188,0,2,9982752,9981000,1752
12008501,1432.98,1755.6,1416,1460,0.745242,0,2,9991368,9989952,1416
12030401,1486.74,1462.74,1488,1460,0.716721,0,2,10011504,10010016,1488
12031861,1510.74,1486.74,1512,1460,0.724688,0,2,10013016,10011504,1512
12033321,1511.94,1510.74,1512,1460,0.751875,0,2,10014528,10013016,1512
12034781,1557.6,1511.94,1560,1460,0.78675,0,2,10016088,10014528,1560
12043541,1702.68,1677.54,1704,1460,0.907756,0,2,10025952,10024248,1704
12045001,1749.53,1702.68,1752,1460,0.921102,0,2,10027704,10025952,1752
12046461,1751.88,1749.53,1752,1460,0.926441,0,2,10029456,10027704,1752
12072741,1486.8,1463.93,1488,1460,0.717832,0,2,10055184,10053696,1488
12074201,1510.74,1486.8,1512,1460,0.737133,0,2,10056696,10055184,1512
12075661,1534.74,1510.74,1536,1460,0.756853,0,2,10058232,10056696,1536
12077121,1558.74,1534.74,1560,1460,0.764741,0,2,10059792,10058232,1560
12078581,1559.94,1558.74,1560,1460,0.791897,0,2,10061352,10059792,1560
12104861,1509.49,1461.71,1512,1460,0.746032,0,2,10090632,10089120,1512
12106321,1557.47,1509.49,1560,1460,0.748413,0,2,10092192,10090632,1560
12118001,1726.68,1701.6,1728,1460,0.903893,0,2,10105296,10103568,1728
12119461,1727.93,1726.68,1728,1460,0.919557,0,2,10107024,10105296,1728
12120921,1750.8,1727.93,1752,1460,0.949823,0,2,10108776,10107024,1752
12144281,1463.94,1462.73,1464,1460,0.711759,0,2,10132872,10131408,1464
12145741,1509.6,1463.94,1512,1460,0.734704,0,2,10134384,10132872,1512
12147201,1534.68,1509.6,1536,1460,0.755881,0,2,10135920,10134384,1536
12148661,1558.73,1534.68,1560,1460,0.764353,0,2,10137480,10135920,1560
12150121,1559.94,1558.73,1560,1460,0.791741,0,2,10139040,10137480,1560
12158881,1725.48,1677.65,1728,1460,0.913068,0,2,10148952,10147224,1728
12160341,1750.67,1725.48,1752,1460,0.923227,0,2,10150704,10148952,1752
12161801,1751.93,1750.67,1752,1460,0.927291,0,2,10152456,10150704,1752
12169101,1525.32,1778.39,1512,1460,0.707118,0,2,10161144,10159632,1512
12177861,1511.82,1508.45,1512,1460,0.762496,0,2,10169880,10168368,1512
12199761,1545.84,1732.74,1536,1460,0.790488,0,2,10195104,10193568,1536
12211441,1725.59,1679.82,1728,1460,0.901982,0,2,10208136,10206408,1728
12212901,1727.88,1725.59,1728,1460,0.930793,0,2,10209864,10208136,1728
12221661,1193.52,1526.46,1176,1460,0.498307,0,1,10219752,10218576,1176
12223121,1154.08,1193.52,1152,1460,0.469323,0,1,10220904,10219752,1152
12226041,1198.75,1174.9,1200,1460,0.481892,0,1,10223280,10222080,1200
12246481,1511.88,1509.65,1512,1460,0.751482,0,2,10242672,10241160,1512
12247941,1557.59,1511.88,1560,1460,0.786593,0,2,10244232,10242672,1560
12256701,1703.88,1701.59,1704,1460,0.910935,0,2,10254168,10252464,1704
12280061,1510.69,1485.71,1512,1460,0.748592,0,2,10278912,10277400,1512
12281521,1557.53,1510.69,1560,1460,0.761437,0,2,10280472,10278912,1560
12282981,1559.88,1557.53,1560,1460,0.766575,0,2,10282032,10280472,1560
12284441,1559.99,1559.88,1560,1460,0.79263,0,2,10283592,10282032,1560
12300501,1663.25,1801.07,1656,1460,0.702999,0,2,10302456,10300800,1656
12315101,1486.74,1462.74,1488,1460,0.704869,0,2,10316400,10314912,1488
12316561,1487.94,1486.74,1488,1460,0.731948,0,2,10317888,10316400,1488
12318021,1533.6,1487.94,1536,1460,0.754779,0,2,10319424,10317888,1536
12319481,1558.68,1533.6,1560,1460,0.763912,0,2,10320984,10319424,1560
12320941,1559.93,1558.68,1560,1460,0.791565,0,2,10322544,10320984,1560
12331161,1727.83,1724.51,1728,1460,0.930679,0,2,10334280,10332552,1728
12339921,1435.26,1801.19,1416,1460,0.49902,0,1,10344672,10343256,1416
12354521,886.734,862.68,888,1460,0.204424,0,1,10352928,10352040,888
12355981,887.937,886.734,888,1460,0.23177,0,1,10353816,10352928,888
12357441,933.597,887.937,936,1460,0.254708,0,1,10354752,10353816,936
12358901,958.68,933.597,960,1460,0.275883,0,1,10355712,10354752,960
12369121,1125.54,1078.74,1128,1460,0.413572,0,1,10362984,10361856,1128
12370581,1150.68,1125.54,1152,1460,0.423429,0,1,10364136,10362984,1152
12372041,1151.93,1150.68,1152,1460,0.451371,0,1,10365288,10364136,1152
12398321,1583.82,1580.45,1584,1460,0.797918,0,2,10390056,10388472,1584
12407081,1726.74,1702.74,1728,1460,0.916672,0,2,10400064,10398336,1728
12408541,1750.74,1726.74,1752,1460,0.924669,0,2,10401816,10400064,1752
12430441,1462.8,1439.94,1464,1460,0.71015,0,2,10425072,10423608,1464
12431901,1509.54,1462.8,1512,1460,0.73406,0,2,10426584,10425072,1512
12433361,1534.68,1509.54,1536,1460,0.755624,0,2,10428120,10426584,1536
12434821,1558.73,1534.68,1560,1460,0.76425,0,2,10429680,10428120,1560
12443581,1725.48,1677.6,1728,1460,0.912771,0,2,10439544,10437816,1728
12445041,1750.67,1725.48,1752,1460,0.923108,0,2,10441296,10439544,1752
12474241,1462.73,1438.68,1464,1460,0.708374,0,2,10469736,10468272,1464
12475701,1509.54,1462.73,1512,1460,0.73335,0,2,10471248,10469736,1512
12477161,1534.68,1509.54,1536,1460,0.75534,0,2,10472784,10471248,1536
12478621,1558.73,1534.68,1560,1460,0.764136,0,2,10474344,10472784,1560
12480081,1559.94,1558.73,1560,1460,0.779654,0,2,10475904,10474344,1560
12481541,1582.8,1559.94,1584,1460,0.797862,0,2,10477488,10475904,1584
12490301,1725.54,1678.79,1728,1460,0.913738,0,2,10487400,10485672,1728
12491761,1750.68,1725.54,1752,1460,0.935495,0,2,10489152,10487400,1752
12497601,1800.05,1801.08,1800,1460,0.769725,0,2,10496352,10494552,1800
12499061,1412.4,1800.05,1392,1460,0.44589,0,1,10497744,10496352,1392
12500521,937.02,1412.4,912,1460,0.244356,0,1,10498656,10497744,912
12503441,654.423,776.451,648,1460,0.047497,0,1,10500072,10499424,648
12507821,718.681,693.616,720,1460,0.0786398,0,1,10502136,10501416,720
12509281,742.734,718.681,744,1460,0.0974559,0,1,10502880,10502136,744
12519501,886.797,863.937,888,1460,0.229948,0,1,10508712,10507824,888
12520961,933.54,886.797,936,1460,0.229979,0,1,10509648,10508712,936
12531181,1079.83,1076.51,1080,1460,0.402471,0,1,10516752,10515672,1080
12537021,1198.63,1172.51,1200,1460,0.487279,0,1,10521384,10520184,1200
12538481,1245.53,1198.63,1248,1460,0.488912,0,1,10522632,10521384,1248
12570601,1726.74,1702.73,1728,1460,0.92845,0,2,10555128,10553400,1728
12572061,1773.54,1726.74,1776,1460,0.92938,0,2,10556904,10555128,1776
12583741,1439.95,1439.08,1440,1460,0.709138,0,2,10569864,10568424,1440
12585201,1508.4,1439.95,1512,1460,0.733655,0,2,10571376,10569864,1512
12586661,1534.62,1508.4,1536,1460,0.743462,0,2,10572912,10571376,1536
12588121,1535.93,1534.62,1536,1460,0.747385,0,2,10574448,10572912,1536
12589581,1536,1535.93,1536,1460,0.772954,0,2,10575984,10574448,1536
12627541,1510.68,1485.65,1512,1460,0.748194,0,2,10615464,10613952,1512
12629001,1557.53,1510.68,1560,1460,0.749278,0,2,10617024,10615464,1560
12639221,1679.88,1677.65,1680,1460,0.903394,0,2,10628400,10626720,1680
12640681,1748.39,1679.88,1752,1460,0.919358,0,2,10630152,10628400,1752
12642141,1751.82,1748.39,1752,1460,0.937743,0,2,10631904,10630152,1752
12658201,1486.73,1462.69,1488,1460,0.716954,0,2,10649136,10647648,1488
12659661,1510.74,1486.73,1512,1460,0.724782,0,2,10650648,10649136,1512
12661121,1511.94,1510.74,1512,1460,0.751913,0,2,10652160,10650648,1512
12662581,1557.6,1511.94,1560,1460,0.774765,0,2,10653720,10652160,1560
12664041,1582.68,1557.6,1584,1460,0.783906,0,2,10655304,10653720,1584
12672801,1725.6,1679.94,1728,1460,0.902817,0,2,10665288,10663560,1728
12674261,1727.88,1725.6,1728,1460,0.931127,0,2,10667016,10665288,1728
12693241,1510.68,1485.65,1512,1460,0.736612,0,2,10687704,10686192,1512
12694701,1534.73,1510.68,1536,1460,0.768645,0,2,10689240,10687704,1536
12696161,1581.54,1534.73,1584,1460,0.769458,0,2,10690824,10689240,1584
12706381,1726.68,1701.65,1728,1460,0.916194,0,2,10702392,10700664,1728
12707841,1750.73,1726.68,1752,1460,0.924478,0,2,10704144,10702392,1752
12709301,1751.94,1750.73,1752,1460,0.939791,0,2,10705896,10704144,1752
12716601,1118.99,1593.71,1094,1460,0.475502,0,1,10713950,10712856,1094
12719521,1150.78,1127.55,1152,1460,0.44928,0,1,10716230,10715078,1152
12720981,1174.74,1150.78,1176,1460,0.461712,0,1,10717406,10716230,1176
12722441,1198.74,1174.74,1200,1460,0.466685,0,1,10718606,10717406,1200
12723901,1199.94,1198.74,1200,1460,0.480674,0,1,10719806,10718606,1200
12725361,1222.8,1199.94,1224,1460,0.49827,0,1,10721030,10719806,1224
12741421,1463.89,1461.71,1464,1460,0.72363,0,2,10736126,10734662,1464
12742881,1532.39,1463.89,1536,1460,0.739452,0,2,10737662,10736126,1536
12744341,1535.82,1532.39,1536,1460,0.769781,0,2,10739198,10737662,1536
12745801,1581.59,1535.82,1584,1460,0.781912,0,2,10740782,10739198,1584
12754561,1725.59,1679.88,1728,1460,0.914502,0,2,10750742,10749014,1728
12756021,1750.68,1725.59,1752,1460,0.923801,0,2,10752494,10750742,1752
12757481,1751.93,1750.68,1752,1460,0.93952,0,2,10754246,10752494,1752
12777921,1486.74,1462.8,1488,1460,0.729231,0,2,10775030,10773542,1488
12779381,1533.54,1486.74,1536,1460,0.741692,0,2,10776566,10775030,1536
12780841,1535.88,1533.54,1536,1460,0.782677,0,2,10778102,10776566,1536
12782301,1604.39,1535.88,1608,1460,0.787071,0,2,10779710,10778102,1608
12791061,1703.88,1701.54,1704,1460,0.910752,0,2,10789622,10787918,1704
12792521,1749.59,1703.88,1752,1460,0.934301,0,2,10791374,10789622,1752
12793981,1774.68,1749.59,1776,1460,0.94372,0,2,10793150,10791374,1776
12801281,1411.32,1778.39,1392,1460,0.436086,0,1,10801742,10800350,1392
12804201,889.308,914.166,888,1460,0.246174,0,1,10803518,10802630,888
12805661,888.065,889.308,888,1460,0.22447,0,1,10804406,10803518,888
12842161,1511.77,1507.31,1512,1460,0.737376,0,2,10834838,10833326,1512
12843621,1534.79,1511.77,1536,1460,0.74495,0,2,10836374,10834838,1536
12845081,1535.94,1534.79,1536,1460,0.77198,0,2,10837910,10836374,1536
12846541,1581.6,1535.94,1584,1460,0.782792,0,2,10839494,10837910,1584
12848001,1583.88,1581.6,1584,1460,0.799117,0,2,10841078,10839494,1584
12855301,1701.54,1654.8,1704,1460,0.906004,0,2,10849310,10847606,1704
12856761,1749.48,1701.54,1752,1460,0.920402,0,2,10851062,10849310,1752
12858221,1751.87,1749.48,1752,1460,0.926161,0,2,10852814,10851062,1752
12868441,1462.71,1438.28,1464,1460,0.70306,0,2,10864142,10862678,1464
12874281,1511.88,1509.66,1512,1460,0.763774,0,2,10870118,10868606,1512
12875741,1580.39,1511.88,1584,1460,0.76751,0,2,10871702,10870118,1584
12885961,1725.54,1678.79,1728,1460,0.913792,0,2,10883174,10881446,1728
12887421,1750.68,1725.54,1752,1460,0.923517,0,2,10884926,10883174,1752
12907861,1126.62,1100.4,1128,1460,0.414877,0,1,10903502,10902374,1128
12909321,1150.73,1126.62,1152,1460,0.423951,0,1,10904654,10903502,1152
12910781,1151.94,1150.73,1152,1460,0.45158,0,1,10905806,10904654,1152
12912241,1197.6,1151.94,1200,1460,0.462632,0,1,10907006,10905806,1200
12913701,1199.88,1197.6,1200,1460,0.491053,0,1,10908206,10907006,1200
12929761,1486.68,1461.54,1488,1460,0.70334,0,2,10923038,10921550,1488
12931221,1487.93,1486.68,1488,1460,0.719336,0,2,10924526,10923038,1488
12932681,1510.8,1487.93,1512,1460,0.737734,0,2,10926038,10924526,1512
12934141,1534.74,1510.8,1536,1460,0.745094,0,2,10927574,10926038,1536
12935601,1535.94,1534.74,1536,1460,0.772038,0,2,10929110,10927574,1536
12947281,1726.79,1703.82,1728,1460,0.905349,0,2,10942382,10940654,1728
12948741,1727.94,1726.79,1728,1460,0.94414,0,2,10944110,10942382,1728
12954581,1638.12,1754.39,1632,1460,0.775418,0,2,10951094,10949462,1632
12956041,1495.51,1638.12,1488,1460,0.748167,0,2,10952582,10951094,1488
12961881,1582.62,1556.46,1584,1460,0.795937,0,2,10958726,10957142,1584
12970641,1702.74,1678.73,1704,1460,0.908623,0,2,10968590,10966886,1704
12972101,1749.54,1702.74,1752,1460,0.933449,0,2,10970342,10968590,1752
12985241,913.186,935.715,912,1460,0.269425,0,1,10983878,10982966,912
12988161,935.943,934.859,936,1460,0.277108,0,1,10985750,10984814,936
12989621,981.597,935.943,984,1460,0.284843,0,1,10986734,10985750,984
12996921,1101.54,1054.85,1104,1460,0.406165,0,1,10991966,10990862,1104
12998381,1149.48,1101.54,1152,1460,0.408466,0,1,10993118,10991966,1152
13005681,1222.68,1197.65,1224,1460,0.484327,0,1,10998998,10997774,1224
13020281,1484.34,1414.8,1488,1460,0.710731,0,2,11012510,11011022,1488
13021741,1510.62,1484.34,1512,1460,0.722293,0,2,11014022,11012510,1512
13023201,1511.93,1510.62,1512,1460,0.726917,0,2,11015534,11014022,1512
13024661,1512,1511.93,1512,1460,0.752767,0,2,11017046,11015534,1512
13026121,1557.6,1512,1560,1460,0.787107,0,2,11018606,11017046,1560
13027581,1605.48,1557.6,1608,1460,0.788843,0,2,11020214,11018606,1608
13036341,1703.94,1702.79,1704,1460,0.912142,0,2,11030198,11028494,1704
13037801,1749.6,1703.94,1752,1460,0.934857,0,2,11031950,11030198,1752
13048021,894.843,1024.86,888,1460,0.265955,0,1,11042822,11041934,888
13049481,888.342,894.843,888,1460,0.244382,0,1,11043710,11042822,888
13052401,934.741,910.817,936,1460,0.273101,0,1,11045558,11044622,936
13061161,1078.74,1054.85,1080,1460,0.401226,0,1,11051726,11050646,1080
13062621,1148.34,1078.74,1152,1460,0.41849,0,1,11052878,11051726,1152
13064081,1151.82,1148.34,1152,1460,0.437396,0,1,11054030,11052878,1152
13065541,1174.79,1151.82,1176,1460,0.444958,0,1,11055206,11054030,1176
13067001,1175.94,1174.79,1176,1460,0.483983,0,1,11056382,11055206,1176
13068461,1244.4,1175.94,1248,1460,0.499593,0,1,11057630,11056382,1248
13085981,1464,1463.94,1464,1460,0.70105,0,2,11074070,11072606,1464
13087441,1486.8,1464,1488,1460,0.71842,0,2,11075558,11074070,1488
13088901,1510.74,1486.8,1512,1460,0.737368,0,2,11077070,11075558,1512
13090361,1534.74,1510.74,1536,1460,0.756947,0,2,11078606,11077070,1536
13091821,1558.74,1534.74,1560,1460,0.788779,0,2,11080166,11078606,1560
13093281,1605.54,1558.74,1608,1460,0.789512,0,2,11081774,11080166,1608
13109341,1777.2,1800.05,1776,1460,0.770193,0,2,11100758,11098982,1776
13110801,1434.06,1777.2,1416,1460,0.770077,0,2,11102174,11100758,1416
13128321,1486.74,1462.73,1488,1460,0.716519,0,2,11118758,11117270,1488
13129781,1510.74,1486.74,1512,1460,0.748608,0,2,11120270,11118758,1512
13131241,1557.54,1510.74,1560,1460,0.773443,0,2,11121830,11120270,1560
13132701,1582.68,1557.54,1584,1460,0.783377,0,2,11123414,11121830,1584
13134161,1583.93,1582.68,1584,1460,0.799351,0,2,11124998,11123414,1584
13141461,1702.74,1678.79,1704,1460,0.909001,0,2,11133302,11131598,1704
13142921,1749.54,1702.74,1752,1460,0.921601,0,2,11135054,11133302,1752
13172121,1462.8,1439.94,1464,1460,0.722076,0,2,11164382,11162918,1464
13173581,1532.34,1462.8,1536,1460,0.72683,0,2,11165918,11164382,1536
13189641,1774.62,1748.45,1776,1460,0.936922,0,2,11184038,11182262,1776
13201321,935.881,933.623,936,1460,0.265444,0,1,11194550,11193614,936
13202781,958.794,935.881,960,1460,0.268177,0,1,11195510,11194550,960
13204241,959.94,958.794,960,1460,0.281271,0,1,11196470,11195510,960
13205701,982.797,959.94,984,1460,0.298508,0,1,11197454,11196470,984
13213001,1102.74,1078.79,1104,1460,0.408993,0,1,11202758,11201654,1104
13214461,1149.54,1102.74,1152,1460,0.421597,0,1,11203910,11202758,1152
13215921,1151.88,1149.54,1152,1460,0.438639,0,1,11205062,11203910,1152
13217381,1174.79,1151.88,1176,1460,0.457456,0,1,11206238,11205062,1176
13218841,1198.74,1174.79,1200,1460,0.488982,0,1,11207438,11206238,1200
13236361,1486.79,1463.87,1488,1460,0.705321,0,2,11223782,11222294,1488
13237821,1487.94,1486.79,1488,1460,0.744128,0,2,11225270,11223782,1488
13250961,1703.93,1702.68,1704,1460,0.911497,0,2,11239862,11238158,1704
13252421,1749.6,1703.93,1752,1460,0.922599,0,2,11241614,11239862,1752
13253881,1751.88,1749.6,1752,1460,0.939039,0,2,11243366,11241614,1752
13259721,1754.45,1801.08,1752,1460,0.745815,0,2,11250518,11248766,1752
13268481,1486.62,1460.4,1488,1460,0.703311,0,2,11258990,11257502,1488
13269941,1487.93,1486.62,1488,1460,0.731325,0,2,11260478,11258990,1488
13271401,1533.6,1487.93,1536,1460,0.74253,0,2,11262014,11260478,1536
13272861,1535.88,1533.6,1536,1460,0.771012,0,2,11263550,11262014,1536
13284541,1726.68,1701.6,1728,1460,0.916011,0,2,11276702,11274974,1728
13286001,1750.73,1726.68,1752,1460,0.936404,0,2,11278454,11276702,1752
13287461,1774.74,1750.73,1776,1460,0.944562,0,2,11280230,11278454,1776
13296221,884.526,1274.52,864,1460,0.295196,0,1,11289542,11288678,864
13300601,934.797,911.931,936,1460,0.274973,0,1,11292302,11291366,936
13302061,981.54,934.797,984,1460,0.283989,0,1,11293286,11292302,984
13303521,983.877,981.54,984,1460,0.299596,0,1,11294270,11293286,984
13312281,1126.74,1102.8,1128,1460,0.429109,0,1,11300726,11299598,1128
13313741,1173.54,1126.74,1176,1460,0.441643,0,1,11301902,11300726,1176
13315201,1175.88,1173.54,1176,1460,0.458657,0,1,11303078,11301902,1176
13316661,1198.79,1175.88,1200,1460,0.477463,0,1,11304278,11303078,1200
13334181,1485.59,1439.88,1488,1460,0.70254,0,2,11320502,11319014,1488
13335641,1487.88,1485.59,1488,1460,0.719016,0,2,11321990,11320502,1488
13337101,1510.79,1487.88,1512,1460,0.737606,0,2,11323502,11321990,1512
13338561,1534.74,1510.79,1536,1460,0.757043,0,2,11325038,11323502,1536
13340021,1558.74,1534.74,1560,1460,0.776817,0,2,11326598,11325038,1560
13341481,1582.74,1558.74,1584,1460,0.796727,0,2,11328182,11326598,1584
13357541,1404.47,1641.48,1392,1460,0.707485,0,2,11346590,11345198,1392
13360461,1486.65,1461.02,1488,1460,0.709598,0,2,11349542,11348054,1488
13361921,1487.93,1486.65,1488,1460,0.721839,0,2,11351030,11349542,1488
13363381,1510.8,1487.93,1512,1460,0.738736,0,2,11352542,11351030,1512
13364841,1534.74,1510.8,1536,1460,0.769494,0,2,11354078,11352542,1536
13366301,1581.54,1534.74,1584,1460,0.769798,0,2,11355662,11354078,1584
13376521,1726.74,1702.79,1728,1460,0.916963,0,2,11367254,11365526,1728
13377981,1750.74,1726.74,1752,1460,0.948785,0,2,11369006,11367254,1752
13402801,1485.54,1438.74,1488,1460,0.701465,0,2,11393486,11391998,1488
13404261,1487.88,1485.54,1488,1460,0.706586,0,2,11394974,11393486,1488
13405721,1487.99,1487.88,1488,1460,0.744634,0,2,11396462,11394974,1488
13407181,1556.4,1487.99,1560,1460,0.759854,0,2,11398022,11396462,1560
13408641,1559.82,1556.4,1560,1460,0.789941,0,2,11399582,11398022,1560
13417401,1679.99,1679.88,1680,1460,0.904689,0,2,11409470,11407790,1680
13418861,1748.4,1679.99,1752,1460,0.919876,0,2,11411222,11409470,1752
13420321,1751.82,1748.4,1752,1460,0.94995,0,2,11412974,11411222,1752
13434921,1485.54,1438.74,1488,1460,0.714123,0,2,11428406,11426918,1488
13436381,1510.68,1485.54,1512,1460,0.723649,0,2,11429918,11428406,1512
13437841,1511.93,1510.68,1512,1460,0.75146,0,2,11431430,11429918,1512
13439301,1557.6,1511.93,1560,1460,0.774584,0,2,11432990,11431430,1560
13440761,1582.68,1557.6,1584,1460,0.795834,0,2,11434574,11432990,1584
13459741,1515.06,1573.2,1512,1460,0.762121,0,2,11456510,11454998,1512
13472881,1726.68,1701.6,1728,1460,0.903894,0,2,11471174,11469446,1728
13474341,1727.93,1726.68,1728,1460,0.931557,0,2,11472902,11471174,1728
13475801,1773.6,1727.93,1776,1460,0.942623,0,2,11474678,11472902,1776
13483101,964.44,1504.79,936,1460,0.245611,0,1,11482526,11481590,936
13490401,887.805,884.107,888,1460,0.241603,0,1,11486558,11485670,888
13502081,1079.88,1077.65,1080,1460,0.403124,0,1,11494622,11493542,1080
13503541,1148.39,1079.88,1152,1460,0.40725,0,1,11495774,11494622,1152
13529821,1534.68,1509.65,1536,1460,0.744114,0,2,11519894,11518358,1536
13531281,1535.93,1534.68,1536,1460,0.759646,0,2,11521430,11519894,1536
13532741,1558.8,1535.93,1560,1460,0.789858,0,2,11522990,11521430,1560
13541501,1703.88,1701.59,1704,1460,0.910948,0,2,11532926,11531222,1704
13542961,1749.59,1703.88,1752,1460,0.922379,0,2,11534678,11532926,1752
13561941,1486.79,1463.88,1488,1460,0.717517,0,2,11554718,11553230,1488
13563401,1510.74,1486.79,1512,1460,0.749007,0,2,11556230,11554718,1512
13564861,1557.54,1510.74,1560,1460,0.749603,0,2,11557790,11556230,1560
13576541,1726.74,1702.74,1728,1460,0.928736,0,2,11570918,11569190,1728
13578001,1773.54,1726.74,1776,1460,0.929494,0,2,11572694,11570918,1776
13586761,1491.18,1551.54,1488,1460,0.729853,0,2,11582942,11581454,1488
13588221,1488.16,1491.18,1488,1460,0.717941,0,2,11584430,11582942,1488
13592601,1557.54,1510.8,1560,1460,0.786828,0,2,11588990,11587430,1560
13594061,1605.48,1557.54,1608,1460,0.788731,0,2,11590598,11588990,1608
13602821,1725.59,1679.88,1728,1460,0.914407,0,2,11600534,11598806,1728
13604281,1750.68,1725.59,1752,1460,0.947763,0,2,11602286,11600534,1752
13605741,1797.53,1750.68,1800,1460,0.949105,0,2,11604086,11602286,1800
13617421,935.891,933.813,936,1460,0.282248,0,1,11614766,11613830,936
13618881,981.595,935.891,984,1460,0.286899,0,1,11615750,11614766,984
13629101,1126.74,1102.8,1128,1460,0.417163,0,1,11623214,11622086,1128
13630561,1150.74,1126.74,1152,1460,0.436865,0,1,11624366,11623214,1152
13632021,1174.74,1150.74,1176,1460,0.456746,0,1,11625542,11624366,1176
13633481,1198.74,1174.74,1200,1460,0.476698,0,1,11626742,11625542,1200
13651001,1485.54,1438.79,1488,1460,0.713878,0,2,11642990,11641502,1488
13652461,1510.68,1485.54,1512,1460,0.735551,0,2,11644502,11642990,1512
13653921,1534.73,1510.68,1536,1460,0.75622,0,2,11646038,11644502,1536
13655381,1558.74,1534.73,1560,1460,0.788488,0,2,11647598,11646038,1560
13665601,1704,1703.94,1704,1460,0.913084,0,2,11659262,11657558,1704
13667061,1749.6,1704,1752,1460,0.935234,0,2,11661014,11659262,1752
13677281,1237.53,1494.54,1224,1460,0.475378,0,1,11672558,11671334,1224
13678741,1110.68,1237.53,1104,1460,0.448151,0,1,11673662,11672558,1104
13681661,1174.7,1149.93,1176,1460,0.449704,0,1,11675990,11674814,1176
13683121,1175.93,1174.7,1176,1460,0.473882,0,1,11677166,11675990,1176
13700641,1462.69,1437.71,1464,1460,0.720644,0,2,11693222,11691758,1464
13702101,1532.33,1462.69,1536,1460,0.726257,0,2,11694758,11693222,1536
13740061,1439.99,1439.82,1440,1460,0.704354,0,2,11735006,11733566,1440
13741521,1508.4,1439.99,1512,1460,0.719742,0,2,11736518,11735006,1512
13742981,1511.82,1508.4,1512,1460,0.725897,0,2,11738030,11736518,1512
13744441,1511.99,1511.82,1512,1460,0.740359,0,2,11739542,11738030,1512
13745901,1534.8,1511.99,1536,1460,0.758143,0,2,11741078,11739542,1536
13747361,1558.74,1534.8,1560,1460,0.777257,0,2,11742638,11741078,1560
13748821,1582.74,1558.74,1584,1460,0.784903,0,2,11744222,11742638,1584
13757581,1726.74,1702.8,1728,1460,0.917049,0,2,11754254,11752526,1728
13759041,1750.74,1726.74,1752,1460,0.936819,0,2,11756006,11754254,1752
13776561,1487.82,1484.45,1488,1460,0.742339,0,2,11774678,11773190,1488
13789701,1726.68,1701.54,1728,1460,0.915508,0,2,11789246,11787518,1728
13791161,1750.73,1726.68,1752,1460,0.936203,0,2,11790998,11789246,1752
13792621,1774.74,1750.73,1776,1460,0.944481,0,2,11792774,11790998,1776
13815981,1463.93,1462.68,1464,1460,0.711614,0,2,11816726,11815262,1464
13817441,1509.6,1463.93,1512,1460,0.734646,0,2,11818238,11816726,1512
13818901,1534.68,1509.6,1536,1460,0.755858,0,2,11819774,11818238,1536
13820361,1558.73,1534.68,1560,1460,0.764343,0,2,11821334,11819774,1560
13821821,1559.94,1558.73,1560,1460,0.791737,0,2,11822894,11821334,1560
13830581,1726.74,1702.74,1728,1460,0.916646,0,2,11832902,11831174,1728
13832041,1750.74,1726.74,1752,1460,0.936659,0,2,11834654,11832902,1752
13843721,1278.45,1401.06,1272,1460,0.499957,0,1,11847902,11846630,1272
13845181,1158.32,1278.45,1152,1460,0.457983,0,1,11849054,11847902,1152
13849561,1222.68,1197.62,1224,1460,0.486031,0,1,11852630,11851406,1224
13865621,1485.48,1437.54,1488,1460,0.700261,0,2,11867342,11865854,1488
13867081,1487.87,1485.48,1488,1460,0.718104,0,2,11868830,11867342,1488
13868541,1510.79,1487.87,1512,1460,0.749242,0,2,11870342,11868830,1512
13870001,1557.54,1510.79,1560,1460,0.761697,0,2,11871902,11870342,1560
13871461,1559.88,1557.54,1560,1460,0.778679,0,2,11873462,11871902,1560
13881681,1726.74,1702.74,1728,1460,0.916842,0,2,11885102,11883374,1728
13883141,1750.74,1726.74,1752,1460,0.948737,0,2,11886854,11885102,1752
13891901,1074.96,1435.26,1056,1460,0.405709,0,1,11896574,11895518,1056
13894821,963.707,1034.15,960,1460,0.291714,0,1,11898566,11897606,960
13906501,1102.8,1079.94,1104,1460,0.422161,0,1,11906942,11905838,1104
13907961,1172.34,1102.8,1176,1460,0.438865,0,1,11908118,11906942,1176
13909421,1175.82,1172.34,1176,1460,0.457546,0,1,11909294,11908118,1176
13928401,1486.68,1461.59,1488,1460,0.715725,0,2,11926646,11925158,1488
13929861,1510.73,1486.68,1512,1460,0.74829,0,2,11928158,11926646,1512
13931321,1557.54,1510.73,1560,1460,0.749316,0,2,11929718,11928158,1560
13943001,1726.74,1702.74,1728,1460,0.916814,0,2,11942870,11941142,1728
13944461,1750.74,1726.74,1752,1460,0.924726,0,2,11944622,11942870,1752
13966361,1486.79,1463.82,1488,1460,0.705238,0,2,11967590,11966102,1488
13967821,1487.94,1486.79,1488,1460,0.744095,0,2,11969078,11967590,1488
13969281,1556.4,1487.94,1560,1460,0.771638,0,2,11970638,11969078,1560
13970741,1582.62,1556.4,1584,1460,0.782655,0,2,11972222,11970638,1584
13980961,1750.63,1724.51,1752,1460,0.947415,0,2,11983934,11982182,1752
13994101,864.011,864.211,864,1460,0.21298,0,1,11996246,11995382,864
13997021,910.74,886.801,912,1460,0.239277,0,1,11998046,11997134,912
13998481,934.737,910.74,936,1460,0.269711,0,1,11998982,11998046,936
13999941,981.537,934.737,984,1460,0.269884,0,1,11999966,11998982,984
14011621,1126.68,1101.59,1128,1460,0.415755,0,1,12008270,12007142,1128
14013081,1150.73,1126.68,1152,1460,0.424302,0,1,12009422,12008270,1152
14014541,1151.94,1150.73,1152,1460,0.451721,0,1,12010574,12009422,1152
14016001,1197.6,1151.94,1200,1460,0.474688,0,1,12011774,12010574,1200
14017461,1222.68,1197.6,1224,1460,0.495875,0,1,12012998,12011774,1224
14032061,1485.59,1439.82,1488,1460,0.701924,0,2,12026558,12025070,1488
14033521,1487.88,1485.59,1488,1460,0.70677,0,2,12028046,12026558,1488
14034981,1487.99,1487.88,1488,1460,0.732708,0,2,12029534,12028046,1488
14036441,1533.6,1487.99,1536,1460,0.743083,0,2,12031070,12029534,1536
14037901,1535.88,1533.6,1536,1460,0.783233,0,2,12032606,12031070,1536
14039361,1604.39,1535.88,1608,1460,0.787293,0,2,12034214,12032606,1608
14048121,1725.54,1678.8,1728,1460,0.90194,0,2,12044150,12042422,1728
14049581,1727.88,1725.54,1728,1460,0.942776,0,2,12045878,12044150,1728
14051041,1796.39,1727.88,1800,1460,0.94711,0,2,12047678,12045878,1800
14067101,1486.74,1462.74,1488,1460,0.717085,0,2,12064838,12063350,1488
14068561,1510.74,1486.74,1512,1460,0.724834,0,2,12066350,12064838,1512
14070021,1511.94,1510.74,1512,1460,0.751934,0,2,12067862,12066350,1512
14071481,1557.6,1511.94,1560,1460,0.774773,0,2,12069422,12067862,1560
14072941,1582.68,1557.6,1584,1460,0.795909,0,2,12071006,12069422,1584
14084621,1750.68,1725.65,1752,1460,0.948248,0,2,12084374,12082622,1752
14093381,889.599,919.977,888,1460,0.261642,0,1,12093086,12092198,888
14096301,934.744,910.88,936,1460,0.275863,0,1,12094934,12093998,936
14097761,981.537,934.744,984,1460,0.284345,0,1,12095918,12094934,984
14099221,983.877,981.537,984,1460,0.287738,0,1,12096902,12095918,984
14113821,1199.88,1197.65,1200,1460,0.479161,0,1,12107918,12106718,1200
14115281,1222.79,1199.88,1224,1460,0.485664,0,1,12109142,12107918,1224
14129881,1485.6,1439.94,1488,1460,0.702812,0,2,12122870,12121382,1488
14131341,1487.88,1485.6,1488,1460,0.743125,0,2,12124358,12122870,1488
14132801,1556.39,1487.88,1560,1460,0.77125,0,2,12125918,12124358,1560
14134261,1582.62,1556.39,1584,1460,0.7825,0,2,12127502,12125918,1584
14135721,1583.93,1582.62,1584,1460,0.799,0,2,12129086,12127502,1584
14143021,1703.88,1701.59,1704,1460,0.910918,0,2,12137414,12135710,1704
14144481,1749.59,1703.88,1752,1460,0.934367,0,2,12139166,12137414,1752
14145941,1774.68,1749.59,1776,1460,0.943747,0,2,12140942,12139166,1776
14154701,1435.26,1801.2,1416,1460,0.773592,0,2,12151382,12149966,1416
14170761,1462.74,1438.74,1464,1460,0.708802,0,2,12166526,12165062,1464
14172221,1509.54,1462.74,1512,1460,0.721521,0,2,12168038,12166526,1512
14173681,1511.88,1509.54,1512,1460,0.738608,0,2,12169550,12168038,1512
14175141,1534.79,1511.88,1536,1460,0.757443,0,2,12171086,12169550,1536
14176601,1558.74,1534.79,1560,1460,0.776977,0,2,12172646,12171086,1560
14178061,1582.74,1558.74,1584,1460,0.784791,0,2,12174230,12172646,1584
14197041,1201.39,1227.78,1200,1460,0.488433,0,1,12195566,12194366,1200
14214561,1485.48,1437.6,1488,1460,0.700741,0,2,12211598,12210110,1488
14216021,1487.87,1485.48,1488,1460,0.718296,0,2,12213086,12211598,1488
14217481,1510.79,1487.87,1512,1460,0.749319,0,2,12214598,12213086,1512
14218941,1557.54,1510.79,1560,1460,0.773727,0,2,12216158,12214598,1560
14220401,1582.68,1557.54,1584,1460,0.795491,0,2,12217742,12216158,1584
14232081,1726.74,1702.74,1728,1460,0.904864,0,2,12230990,12229262,1728
14233541,1727.94,1726.74,1728,1460,0.919946,0,2,12232718,12230990,1728
14245221,1197.6,1151.92,1200,1460,0.495887,0,1,12244574,12243374,1200
14262741,1486.68,1461.65,1488,1460,0.728193,0,2,12260822,12259334,1488
14264201,1533.53,1486.68,1536,1460,0.729277,0,2,12262358,12260822,1536
14277341,1703.94,1702.73,1704,1460,0.911791,0,2,12276998,12275294,1704
14278801,1749.6,1703.94,1752,1460,0.922716,0,2,12278750,12276998,1752
14289021,881.163,1207.26,864,1460,0.265263,0,1,12289766,12288902,864
14308001,1197.49,1149.71,1200,1460,0.461206,0,1,12303254,12302054,1200
14309461,1199.87,1197.49,1200,1460,0.490483,0,1,12304454,12303254,1200
14326981,1462.8,1439.94,1464,1460,0.709925,0,2,12320630,12319166,1464
14328441,1509.54,1462.8,1512,1460,0.72197,0,2,12322142,12320630,1512
14329901,1511.88,1509.54,1512,1460,0.750788,0,2,12323654,12322142,1512
14331361,1557.59,1511.88,1560,1460,0.774315,0,2,12325214,12323654,1560
14332821,1582.68,1557.59,1584,1460,0.795726,0,2,12326798,12325214,1584
14341581,1726.74,1702.74,1728,1460,0.928786,0,2,12336830,12335102,1728
14343041,1773.54,1726.74,1776,1460,0.929514,0,2,12338606,12336830,1776
14363481,1485.6,1439.94,1488,1460,0.714834,0,2,12359846,12358358,1488
14364941,1510.68,1485.6,1512,1460,0.735934,0,2,12361358,12359846,1512
14366401,1534.73,1510.68,1536,1460,0.756373,0,2,12362894,12361358,1536
14367861,1558.74,1534.73,1560,1460,0.764549,0,2,12364454,12362894,1560
14369321,1559.94,1558.74,1560,1460,0.79182,0,2,12366014,12364454,1560
14376621,1725.54,1678.74,1728,1460,0.913417,0,2,12374318,12372590,1728
14388301,1208.86,1377.12,1200,1460,0.44646,0,1,12387302,12386102,1200
14389761,1086.44,1208.86,1080,1460,0.436584,0,1,12388382,12387302,1080
14395601,1196.35,1126.91,1200,1460,0.472313,0,1,12392966,12391766,1200
14397061,1222.62,1196.35,1224,1460,0.482925,0,1,12394190,12392966,1224
14398521,1223.93,1222.62,1224,1460,0.49917,0,1,12395414,12394190,1224
14413121,1486.68,1461.65,1488,1460,0.728089,0,2,12409190,12407702,1488
14414581,1533.53,1486.68,1536,1460,0.729236,0,2,12410726,12409190,1536
14427721,1725.48,1677.66,1728,1460,0.91312,0,2,12425246,12423518,1728
14429181,1750.67,1725.48,1752,1460,0.923248,0,2,12426998,12425246,1752
14430641,1751.93,1750.67,1752,1460,0.927299,0,2,12428750,12426998,1752
14459841,1581.48,1533.65,1584,1460,0.781115,0,2,12458606,12457022,1584
14461301,1583.87,1581.48,1584,1460,0.786446,0,2,12460190,12458606,1584
14470061,1726.79,1703.88,1728,1460,0.929516,0,2,12470222,12468494,1728
14471521,1773.54,1726.79,1776,1460,0.929806,0,2,12471998,12470222,1776
14487581,1485.59,1439.88,1488,1460,0.714577,0,2,12488870,12487382,1488
14489041,1510.68,1485.59,1512,1460,0.735831,0,2,12490382,12488870,1512
14490501,1534.73,1510.68,1536,1460,0.756332,0,2,12491918,12490382,1536
14491961,1558.74,1534.73,1560,1460,0.776533,0,2,12493478,12491918,1560
14493421,1582.74,1558.74,1584,1460,0.784613,0,2,12495062,12493478,1584
14503641,1725.6,1679.99,1728,1460,0.927116,0,2,12506678,12504950,1728
14505101,1773.48,1725.6,1776,1460,0.928846,0,2,12508454,12506678,1776
14525541,1461.54,1414.75,1464,1460,0.705957,0,2,12528950,12527486,1464
14527001,1509.48,1461.54,1512,1460,0.720383,0,2,12530462,12528950,1512
14528461,1511.87,1509.48,1512,1460,0.738153,0,2,12531974,12530462,1512
14529921,1534.79,1511.87,1536,1460,0.757261,0,2,12533510,12531974,1536
14531381,1558.74,1534.79,1560,1460,0.776905,0,2,12535070,12533510,1560
14543061,1726.79,1703.88,1728,1460,0.92961,0,2,12548342,12546614,1728
14560581,1462.74,1438.85,1464,1460,0.721591,0,2,12566654,12565190,1464
14562041,1532.34,1462.74,1536,1460,0.738636,0,2,12568190,12566654,1536
14563501,1535.82,1532.34,1536,1460,0.745455,0,2,12569726,12568190,1536
14564961,1535.99,1535.82,1536,1460,0.760182,0,2,12571262,12569726,1536
14566421,1558.8,1535.99,1560,1460,0.790073,0,2,12572822,12571262,1560
14575181,1726.74,1702.73,1728,1460,0.916517,0,2,12582806,12581078,1728
14586861,870.675,997.497,864,1460,0.268944,0,1,12595262,12594398,864
14589781,957.497,909.934,960,1460,0.269831,0,1,12597134,12596174,960
14591241,959.875,957.497,960,1460,0.281932,0,1,12598094,12597134,960
14592701,982.794,959.875,984,1460,0.286773,0,1,12599078,12598094,984
14601461,1149.42,1100.46,1152,1460,0.41989,0,1,12605438,12604286,1152
14602921,1151.87,1149.42,1152,1460,0.425956,0,1,12606590,12605438,1152
14604381,1151.99,1151.87,1152,1460,0.452382,0,1,12607742,12606590,1152
14605841,1197.6,1151.99,1200,1460,0.486953,0,1,12608942,12607742,1200
14649641,924.195,1155.9,912,1460,0.277963,0,1,12653702,12652790,912
14651101,889.81,924.195,888,1460,0.273185,0,1,12654590,12653702,888
14664241,1125.6,1079.94,1128,1460,0.402802,0,1,12663830,12662702,1128
14665701,1127.88,1125.6,1128,1460,0.407121,0,1,12664958,12663830,1128
14667161,1127.99,1127.88,1128,1460,0.444848,0,1,12666086,12664958,1128
14668621,1196.4,1127.99,1200,1460,0.447939,0,1,12667286,12666086,1200
14690521,1487.88,1485.65,1488,1460,0.74333,0,2,12687494,12686006,1488
14691981,1556.39,1487.88,1560,1460,0.759332,0,2,12689054,12687494,1560
14693441,1559.82,1556.39,1560,1460,0.789733,0,2,12690614,12689054,1560
14694901,1605.59,1559.82,1608,1460,0.789893,0,2,12692222,12690614,1608
14702201,1725.48,1677.59,1728,1460,0.900629,0,2,12700478,12698750,1728
14703661,1727.87,1725.48,1728,1460,0.930252,0,2,12702206,12700478,1728
14713881,892.107,970.14,888,1460,0.256458,0,1,12712886,12711998,888
14732861,1174.68,1149.65,1176,1460,0.468087,0,1,12726278,12725102,1176
14734321,1221.53,1174.68,1224,1460,0.481235,0,1,12727502,12726278,1224
14735781,1223.88,1221.53,1224,1460,0.486494,0,1,12728726,12727502,1224
14751841,1487.82,1484.46,1488,1460,0.718172,0,2,12743726,12742238,1488
14757681,1559.82,1556.46,1560,1460,0.790369,0,2,12749846,12748286,1560
14766441,1702.8,1679.93,1704,1460,0.909675,0,2,12759758,12758054,1704
14767901,1749.54,1702.8,1752,1460,0.93387,0,2,12761510,12759758,1752
14782501,1485.48,1437.6,1488,1460,0.702155,0,2,12777470,12775982,1488
14783961,1487.87,1485.48,1488,1460,0.706862,0,2,12778958,12777470,1488
14785421,1487.99,1487.87,1488,1460,0.744745,0,2,12780446,12778958,1488
14786881,1556.4,1487.99,1560,1460,0.759898,0,2,12782006,12780446,1560
14788341,1559.82,1556.4,1560,1460,0.777959,0,2,12783566,12782006,1560
14789801,1582.79,1559.82,1584,1460,0.785184,0,2,12785150,12783566,1584
14800021,1749.54,1702.85,1752,1460,0.934267,0,2,12796862,12795110,1752
14801481,1774.68,1749.54,1776,1460,0.943707,0,2,12798638,12796862,1776
14810241,1186.11,1378.2,1176,1460,0.406852,0,1,12808118,12806942,1176
14817541,1125.54,1078.85,1128,1460,0.415209,0,1,12813470,12812342,1128
14819001,1150.68,1125.54,1152,1460,0.424084,0,1,12814622,12813470,1152
14820461,1151.93,1150.68,1152,1460,0.439633,0,1,12815774,12814622,1152
14821921,1174.8,1151.93,1176,1460,0.457853,0,1,12816950,12815774,1176
14823381,1198.74,1174.8,1200,1460,0.465141,0,1,12818150,12816950,1200
14824841,1199.94,1198.74,1200,1460,0.492057,0,1,12819350,12818150,1200
14840901,1463.99,1463.88,1464,1460,0.712627,0,2,12834374,12832910,1464
14842361,1509.6,1463.99,1512,1460,0.735051,0,2,12835886,12834374,1512
14843821,1534.68,1509.6,1536,1460,0.75602,0,2,12837422,12835886,1536
14845281,1558.73,1534.68,1560,1460,0.776408,0,2,12838982,12837422,1560
14846741,1582.74,1558.73,1584,1460,0.796563,0,2,12840566,12838982,1584
14867181,1544.64,1708.8,1536,1460,0.754141,0,2,12864494,12862958,1536
14868641,1490.83,1544.64,1488,1460,0.751657,0,2,12865982,12864494,1488
14871561,1558.69,1533.74,1560,1460,0.779065,0,2,12869078,12867518,1560
14873021,1582.73,1558.69,1584,1460,0.797626,0,2,12870662,12869078,1584
14881781,1726.79,1703.88,1728,1460,0.905439,0,2,12880694,12878966,1728
14883241,1727.94,1726.79,1728,1460,0.944175,0,2,12882422,12880694,1728
14892001,1177.22,1200.3,1176,1460,0.490797,0,1,12891806,12890630,1176
14915361,1534.74,1510.85,1536,1460,0.757395,0,2,12913790,12912254,1536
14916821,1558.74,1534.74,1560,1460,0.776958,0,2,12915350,12913790,1560
14918281,1582.74,1558.74,1584,1460,0.796783,0,2,12916934,12915350,1584
14944561,1486.74,1462.85,1488,1460,0.729622,0,2,12945566,12944078,1488
14946021,1533.54,1486.74,1536,1460,0.741849,0,2,12947102,12945566,1536
14947481,1535.88,1533.54,1536,1460,0.75874,0,2,12948638,12947102,1536
14948941,1558.79,1535.88,1560,1460,0.789496,0,2,12950198,12948638,1560
14957701,1703.82,1700.34,1704,1460,0.909687,0,2,12960086,12958382,1704
14959161,1749.59,1703.82,1752,1460,0.921875,0,2,12961838,12960086,1752
14960621,1751.88,1749.59,1752,1460,0.93875,0,2,12963590,12961838,1752
14982521,1486.79,1463.88,1488,1460,0.705601,0,2,12986270,12984782,1488
14983981,1487.94,1486.79,1488,1460,0.72024,0,2,12987758,12986270,1488
14985441,1510.8,1487.94,1512,1460,0.750096,0,2,12989270,12987758,1512
14986901,1557.54,1510.8,1560,1460,0.774038,0,2,12990830,12989270,1560
14988361,1582.68,1557.54,1584,1460,0.795615,0,2,12992414,12990830,1584
14997121,1726.74,1702.79,1728,1460,0.91697,0,2,13002446,13000718,1728
14998581,1750.74,1726.74,1752,1460,0.936788,0,2,13004198,13002446,1752
15000041,1774.74,1750.74,1776,1460,0.944715,0,2,13005974,13004198,1776
15010261,1463.83,1460.55,1464,1460,0.713834,0,2,13017038,13015574,1464
15023401,1700.39,1631.89,1704,1460,0.903502,0,2,13031342,13029638,1704
15024861,1749.42,1700.39,1752,1460,0.907401,0,2,13033094,13031342,1752
15036541,905.781,1243.63,888,1460,0.280033,0,1,13045694,13044806,888
15038001,888.889,905.781,888,1460,0.262013,0,1,13046582,13045694,888
15040921,958.682,933.644,960,1460,0.268722,0,1,13048478,13047518,960
15042381,959.934,958.682,960,1460,0.281489,0,1,13049438,13048478,960
15043841,982.797,959.934,984,1460,0.286596,0,1,13050422,13049438,984
15054061,1126.74,1102.8,1128,1460,0.429162,0,1,13057886,13056758,1128
15055521,1173.54,1126.74,1176,1460,0.441665,0,1,13059062,13057886,1176
15056981,1175.88,1173.54,1176,1460,0.470666,0,1,13060238,13059062,1176
15058441,1221.59,1175.88,1224,1460,0.494266,0,1,13061462,13060238,1224
15075961,1464,1463.94,1464,1460,0.725036,0,2,13077830,13076366,1464
15077421,1532.4,1464,1536,1460,0.740014,0,2,13079366,13077830,1536
15078881,1535.82,1532.4,1536,1460,0.758006,0,2,13080902,13079366,1536
15080341,1558.79,1535.82,1560,1460,0.777202,0,2,13082462,13080902,1560
15090561,1727.82,1724.39,1728,1460,0.917746,0,2,13094054,13092326,1728
15092021,1750.79,1727.82,1752,1460,0.949098,0,2,13095806,13094054,1752
15113921,1463.83,1460.51,1464,1460,0.710638,0,2,13118246,13116782,1464
15115381,1509.59,1463.83,1512,1460,0.722255,0,2,13119758,13118246,1512
15116841,1511.88,1509.59,1512,1460,0.738902,0,2,13121270,13119758,1512
15118301,1534.79,1511.88,1536,1460,0.757561,0,2,13122806,13121270,1536
15119761,1558.74,1534.79,1560,1460,0.789024,0,2,13124366,13122806,1560
15128521,1726.67,1701.48,1728,1460,0.90313,0,2,13134278,13132550,1728
15129981,1727.93,1726.67,1728,1460,0.919252,0,2,13136006,13134278,1728
15131441,1750.8,1727.93,1752,1460,0.949701,0,2,13137758,13136006,1752
15138741,1147.87,1525.32,1128,1460,0.487507,0,1,13145798,13144670,1128
15143121,1174.8,1151.99,1176,1460,0.48648,0,1,13149278,13148102,1176
15144581,1244.34,1174.8,1248,1460,0.488592,0,1,13150526,13149278,1248
15160641,1463.88,1461.65,1464,1460,0.723217,0,2,13165430,13163966,1464
15162101,1532.39,1463.88,1536,1460,0.727287,0,2,13166966,13165430,1536
15185461,1522.98,1731.6,1512,1460,0.751099,0,2,13193630,13192118,1512
15201521,1485.54,1438.74,1488,1460,0.713612,0,2,13208774,13207286,1488
15202981,1510.68,1485.54,1512,1460,0.723445,0,2,13210286,13208774,1512
15204441,1511.93,1510.68,1512,1460,0.751378,0,2,13211798,13210286,1512
15205901,1557.6,1511.93,1560,1460,0.774551,0,2,13213358,13211798,1560
15207361,1582.68,1557.6,1584,1460,0.79582,0,2,13214942,13213358,1584
15216121,1703.88,1701.53,1704,1460,0.910542,0,2,13224830,13223126,1704
15217581,1749.59,1703.88,1752,1460,0.922217,0,2,13226582,13224830,1752
15227801,959.82,1412.4,936,1460,0.248251,0,1,13237862,13236926,936
15235101,863.934,862.678,864,1460,0.200907,0,1,13241990,13241126,864
15236561,886.797,863.934,888,1460,0.218363,0,1,13242878,13241990,888
15238021,910.74,886.797,912,1460,0.249345,0,1,13243790,13242878,912
15239481,957.537,910.74,960,1460,0.273738,0,1,13244750,13243790,960
15240941,982.677,957.537,984,1460,0.283495,0,1,13245734,13244750,984
15242401,983.934,982.677,984,1460,0.299398,0,1,13246718,13245734,984
15251161,1125.6,1079.99,1128,1460,0.415065,0,1,13253126,13251998,1128
15252621,1150.68,1125.6,1152,1460,0.436026,0,1,13254278,13253126,1152
15254081,1174.73,1150.68,1176,1460,0.45641,0,1,13255454,13254278,1176
15255541,1198.74,1174.73,1200,1460,0.488564,0,1,13256654,13255454,1200
15273061,1485.6,1439.94,1488,1460,0.726721,0,2,13272902,13271414,1488
15274521,1533.48,1485.6,1536,1460,0.728688,0,2,13274438,13272902,1536
15297881,866.283,1365.66,840,1460,0.283673,0,1,13300190,13299350,840
15300801,910.746,886.914,912,1460,0.262588,0,1,13301990,13301078,912
15312481,1125.54,1078.8,1128,1460,0.401943,0,1,13310246,13309118,1128
15318321,1175.82,1172.46,1176,1460,0.470466,0,1,13314830,13313654,1176
15319781,1221.59,1175.82,1224,1460,0.494186,0,1,13316054,13314830,1224
15337301,1486.79,1463.82,1488,1460,0.729129,0,2,13332446,13330958,1488
15338761,1533.54,1486.79,1536,1460,0.753651,0,2,13333982,13332446,1536
15340221,1558.68,1533.54,1560,1460,0.775461,0,2,13335542,13333982,1560
15341681,1582.73,1558.68,1584,1460,0.784184,0,2,13337126,13335542,1584
15343141,1583.94,1582.73,1584,1460,0.799674,0,2,13338710,13337126,1584
15350441,1678.79,1655.88,1680,1460,0.90167,0,2,13346918,13345238,1680
15351901,1748.34,1678.79,1752,1460,0.918668,0,2,13348670,13346918,1752
15353361,1751.82,1748.34,1752,1460,0.949467,0,2,13350422,13348670,1752
15363581,1463.99,1463.76,1464,1460,0.720661,0,2,13362038,13360574,1464
15365041,1509.6,1463.99,1512,1460,0.738265,0,2,13363550,13362038,1512
15366501,1534.68,1509.6,1536,1460,0.769306,0,2,13365086,13363550,1536
15367961,1581.53,1534.68,1584,1460,0.781722,0,2,13366670,13365086,1584
15369421,1583.88,1581.53,1584,1460,0.798689,0,2,13368254,13366670,1584
15404461,1462.73,1438.68,1464,1460,0.708146,0,2,13404806,13403342,1464
15405921,1509.54,1462.73,1512,1460,0.709258,0,2,13406318,13404806,1512
15419061,1702.74,1678.73,1704,1460,0.908481,0,2,13420718,13419014,1704
15420521,1749.54,1702.74,1752,1460,0.909392,0,2,13422470,13420718,1752
15452641,1510.63,1484.51,1512,1460,0.735395,0,2,13454438,13452926,1512
15454101,1534.73,1510.63,1536,1460,0.744158,0,2,13455974,13454438,1536
15455561,1535.94,1534.73,1536,1460,0.771663,0,2,13457510,13455974,1536
15457021,1581.6,1535.94,1584,1460,0.794665,0,2,13459094,13457510,1584
15464321,1701.48,1653.66,1704,1460,0.90519,0,2,13467302,13465598,1704
15465781,1749.47,1701.48,1752,1460,0.908076,0,2,13469054,13467302,1752
15478921,914.377,959.538,912,1460,0.283465,0,1,13482446,13481534,912
15513961,1487.82,1484.4,1488,1460,0.705926,0,2,13511918,13510430,1488
15515421,1487.99,1487.82,1488,1460,0.744371,0,2,13513406,13511918,1488
15516881,1556.4,1487.99,1560,1460,0.771748,0,2,13514966,13513406,1560
15528561,1725.6,1680,1728,1460,0.927118,0,2,13528118,13526390,1728
15530021,1773.48,1725.6,1776,1460,0.928847,0,2,13529894,13528118,1776
15537321,1521.89,1709.88,1512,1460,0.747415,0,2,13538462,13536950,1512
15551921,1486.74,1462.79,1488,1460,0.716886,0,2,13552526,13551038,1488
15553381,1510.74,1486.74,1512,1460,0.736754,0,2,13554038,13552526,1512
15554841,1534.74,1510.74,1536,1460,0.756702,0,2,13555574,13554038,1536
15556301,1558.74,1534.74,1560,1460,0.776681,0,2,13557134,13555574,1560
15566521,1727.82,1724.34,1728,1460,0.929684,0,2,13568750,13567022,1728
15576741,1191.24,1480.86,1176,1460,0.495182,0,1,13580318,13579142,1176
15578201,1153.96,1191.24,1152,1460,0.492073,0,1,13581470,13580318,1152
15598641,1510.68,1485.65,1512,1460,0.748195,0,2,13600526,13599014,1512
15600101,1557.53,1510.68,1560,1460,0.749278,0,2,13602086,13600526,1560
15611781,1725.59,1679.83,1728,1460,0.902221,0,2,13615166,13613438,1728
15613241,1727.88,1725.59,1728,1460,0.918888,0,2,13616894,13615166,1728
15614701,1750.79,1727.88,1752,1460,0.949555,0,2,13618646,13616894,1752
15635141,839.877,837.534,840,1460,0.2028,0,1,13635086,13634246,840
15636601,908.394,839.877,912,1460,0.20712,0,1,13635998,13635086,912
15652661,1126.74,1102.74,1128,1460,0.41683,0,1,13647182,13646054,1128
15654121,1150.74,1126.74,1152,1460,0.436732,0,1,13648334,13647182,1152
15655581,1174.74,1150.74,1176,1460,0.444693,0,1,13649510,13648334,1176
15657041,1175.94,1174.74,1176,1460,0.483877,0,1,13650686,13649510,1176
15658501,1244.4,1175.94,1248,1460,0.487551,0,1,13651934,13650686,1248
15692081,1726.79,1703.88,1728,1460,0.929686,0,2,13686350,13684622,1728
15693541,1773.54,1726.79,1776,1460,0.941874,0,2,13688126,13686350,1776
15700841,878.826,1160.51,864,1460,0.260061,0,1,13695494,13694630,864
15702301,864.741,878.826,864,1460,0.242024,0,1,13696358,13695494,864
15705221,934.682,909.637,936,1460,0.272724,0,1,13698206,13697270,936
15716901,1126.74,1102.79,1128,1460,0.404965,0,1,13706582,13705454,1128
15718361,1127.94,1126.74,1128,1460,0.443986,0,1,13707710,13706582,1128
15719821,1196.4,1127.94,1200,1460,0.447594,0,1,13708910,13707710,1200
15740261,1487.82,1484.4,1488,1460,0.729962,0,2,13727750,13726262,1488
15741721,1533.59,1487.82,1536,1460,0.753985,0,2,13729286,13727750,1536
15743181,1558.68,1533.59,1560,1460,0.775594,0,2,13730846,13729286,1560
15744641,1582.73,1558.68,1584,1460,0.784238,0,2,13732430,13730846,1584
15746101,1583.94,1582.73,1584,1460,0.787695,0,2,13734014,13732430,1584
15754861,1702.79,1679.88,1704,1460,0.909726,0,2,13743950,13742246,1704
15756321,1749.54,1702.79,1752,1460,0.93389,0,2,13745702,13743950,1752
15762161,1708.85,1801.08,1704,1460,0.782644,0,2,13752806,13751102,1704
15763621,1476.24,1708.85,1464,1460,0.751057,0,2,13754270,13752806,1464
15779681,1485.54,1438.74,1488,1460,0.701484,0,2,13769390,13767902,1488
15781141,1487.88,1485.54,1488,1460,0.718594,0,2,13770878,13769390,1488
15782601,1510.79,1487.88,1512,1460,0.737437,0,2,13772390,13770878,1512
15784061,1534.74,1510.79,1536,1460,0.756975,0,2,13773926,13772390,1536
15785521,1558.74,1534.74,1560,1460,0.77679,0,2,13775486,13773926,1560
15786981,1582.74,1558.74,1584,1460,0.784716,0,2,13777070,13775486,1584
15795741,1702.8,1679.94,1704,1460,0.909898,0,2,13787006,13785302,1704
15797201,1749.54,1702.8,1752,1460,0.933959,0,2,13788758,13787006,1752
15804501,1252.86,1801.14,1224,1460,0.273583,0,1,13797182,13795958,1224
15813261,905.871,789.418,912,1460,0.222779,0,1,13801598,13800686,912
15814721,934.494,905.871,936,1460,0.251112,0,1,13802534,13801598,936
15816181,958.725,934.494,960,1460,0.286445,0,1,13803494,13802534,960
15817641,1005.54,958.725,1008,1460,0.288578,0,1,13804502,13803494,1008
15826401,1104,1103.93,1104,1460,0.424909,0,1,13810910,13809806,1104
15827861,1172.4,1104,1176,1460,0.439963,0,1,13812086,13810910,1176
15829321,1175.82,1172.4,1176,1460,0.457985,0,1,13813262,13812086,1176
15830781,1198.79,1175.82,1200,1460,0.489194,0,1,13814462,13813262,1200
15846841,1486.73,1462.67,1488,1460,0.704032,0,2,13829318,13827830,1488
15848301,1487.94,1486.73,1488,1460,0.719613,0,2,13830806,13829318,1488
15849761,1510.8,1487.94,1512,1460,0.749845,0,2,13832318,13830806,1512
15851221,1557.54,1510.8,1560,1460,0.749938,0,2,13833878,13832318,1560
15862901,1703.94,1702.74,1704,1460,0.911882,0,2,13847006,13845302,1704
15864361,1749.6,1703.94,1752,1460,0.922753,0,2,13848758,13847006,1752
15883341,1485.54,1438.79,1488,1460,0.701831,0,2,13868654,13867166,1488
15884801,1487.88,1485.54,1488,1460,0.718732,0,2,13870142,13868654,1488
15886261,1510.79,1487.88,1512,1460,0.725493,0,2,13871654,13870142,1512
15887721,1511.94,1510.79,1512,1460,0.752197,0,2,13873166,13871654,1512
15889181,1557.6,1511.94,1560,1460,0.774879,0,2,13874726,13873166,1560
15890641,1582.68,1557.6,1584,1460,0.795952,0,2,13876310,13874726,1584
15899401,1703.94,1702.79,1704,1460,0.900171,0,2,13886318,13884614,1704
15900861,1726.8,1703.94,1728,1460,0.930068,0,2,13888046,13886318,1728
15919841,1485.48,1437.54,1488,1460,0.712588,0,2,13907918,13906430,1488
15925681,1582.62,1556.46,1584,1460,0.783026,0,2,13914062,13912478,1584
15927141,1583.93,1582.62,1584,1460,0.787211,0,2,13915646,13914062,1584
15935901,1725.6,1679.99,1728,1460,0.915015,0,2,13925630,13923902,1728
15937361,1750.68,1725.6,1752,1460,0.948006,0,2,13927382,13925630,1752
15938821,1797.53,1750.68,1800,1460,0.949202,0,2,13929182,13927382,1800
15957801,1486.68,1461.59,1488,1460,0.715846,0,2,13948358,13946870,1488
15959261,1510.73,1486.68,1512,1460,0.724339,0,2,13949870,13948358,1512
15960721,1511.94,1510.73,1512,1460,0.751735,0,2,13951382,13949870,1512
15962181,1557.6,1511.94,1560,1460,0.774694,0,2,13952942,13951382,1560
15963641,1582.68,1557.6,1584,1460,0.783878,0,2,13954526,13952942,1584
15973861,1774.62,1748.46,1776,1460,0.943028,0,2,13966334,13964558,1776
15975321,1775.93,1774.62,1776,1460,0.947211,0,2,13968110,13966334,1776
15982621,1386.3,1733.93,1368,1460,0.708186,0,2,13976654,13975286,1368
15991381,1199.82,1196.46,1200,1460,0.479566,0,1,13983902,13982702,1200
15992841,1222.79,1199.82,1224,1460,0.485826,0,1,13985126,13983902,1224
16008901,1486.79,1463.88,1488,1460,0.729503,0,2,14000222,13998734,1488
16010361,1533.54,1486.79,1536,1460,0.741801,0,2,14001758,14000222,1536
16011821,1535.88,1533.54,1536,1460,0.74672,0,2,14003294,14001758,1536
16013281,1535.99,1535.88,1536,1460,0.760688,0,2,14004830,14003294,1536
16014741,1558.8,1535.99,1560,1460,0.790275,0,2,14006390,14004830,1560
16043941,1103.94,1102.73,1104,1460,0.412125,0,1,14035694,14034590,1104
16049781,1199.82,1196.45,1200,1460,0.490214,0,1,14040374,14039174,1200
16067301,1463.94,1462.79,1464,1460,0.724102,0,2,14056718,14055254,1464
16068761,1532.4,1463.94,1536,1460,0.751641,0,2,14058254,14056718,1536
16089201,1730.46,1777.13,1728,1460,0.773698,0,2,14081750,14080022,1728
16090661,1454.52,1730.46,1440,1460,0.723479,0,2,14083190,14081750,1440
16093581,1486.78,1463.53,1488,1460,0.736157,0,2,14086142,14084654,1488
16095041,1533.54,1486.78,1536,1460,0.768463,0,2,14087678,14086142,1536
16096501,1581.48,1533.54,1584,1460,0.781385,0,2,14089262,14087678,1584
16097961,1583.87,1581.48,1584,1460,0.786554,0,2,14090846,14089262,1584
16106721,1725.6,1679.99,1728,1460,0.927013,0,2,14100830,14099102,1728
16108181,1773.48,1725.6,1776,1460,0.940805,0,2,14102606,14100830,1776
16109641,1775.87,1773.48,1776,1460,0.946322,0,2,14104382,14102606,1776
16135921,1487.82,1484.45,1488,1460,0.705829,0,2,14130038,14128550,1488
16137381,1487.99,1487.82,1488,1460,0.720332,0,2,14131526,14130038,1488
16138841,1510.8,1487.99,1512,1460,0.750133,0,2,14133038,14131526,1512
16160741,1385.04,1708.74,1368,1460,0.732574,0,2,14158070,14156702,1368
16182641,1485.53,1438.68,1488,1460,0.713336,0,2,14178110,14176622,1488
16184101,1510.68,1485.53,1512,1460,0.735334,0,2,14179622,14178110,1512
16185561,1534.73,1510.68,1536,1460,0.756134,0,2,14181158,14179622,1536
16187021,1558.74,1534.73,1560,1460,0.788454,0,2,14182718,14181158,1560
16197241,1704,1703.93,1704,1460,0.912838,0,2,14194334,14192630,1704
16198701,1749.6,1704,1752,1460,0.935135,0,2,14196086,14194334,1752
16220601,1150.62,1124.46,1152,1460,0.435111,0,1,14215502,14214350,1152
16222061,1174.73,1150.62,1176,1460,0.444045,0,1,14216678,14215502,1176
16223521,1175.94,1174.73,1176,1460,0.459618,0,1,14217854,14216678,1176
16224981,1198.8,1175.94,1200,1460,0.489847,0,1,14219054,14217854,1200
16226441,1245.54,1198.8,1248,1460,0.489939,0,1,14220302,14219054,1248
16245421,1535.77,1531.31,1536,1460,0.769272,0,2,14238398,14236862,1536
16246881,1581.59,1535.77,1584,1460,0.769709,0,2,14239982,14238398,1584
16257101,1703.88,1701.59,1704,1460,0.911014,0,2,14251502,14249798,1704
16267321,1502.52,1778.4,1488,1460,0.737935,0,2,14263694,14262206,1488
16268781,1465.93,1502.52,1464,1460,0.733174,0,2,14265158,14263694,1464
16274621,1580.34,1510.85,1584,1460,0.767713,0,2,14271254,14269670,1584
16292141,1800.05,1801.02,1800,1460,0.752686,0,2,14291726,14289926,1800
16312581,1485.59,1439.88,1488,1460,0.702381,0,2,14310446,14308958,1488
16314041,1487.88,1485.59,1488,1460,0.730952,0,2,14311934,14310446,1488
16315501,1533.59,1487.88,1536,1460,0.754381,0,2,14313470,14311934,1536
16316961,1558.68,1533.59,1560,1460,0.775752,0,2,14315030,14313470,1560
16318421,1582.73,1558.68,1584,1460,0.784301,0,2,14316614,14315030,1584
16327181,1725.59,1679.88,1728,1460,0.902389,0,2,14326550,14324822,1728
16328641,1727.88,1725.59,1728,1460,0.918956,0,2,14328278,14326550,1728
16330101,1750.79,1727.88,1752,1460,0.925582,0,2,14330030,14328278,1752
16347621,1534.68,1509.65,1536,1460,0.75629,0,2,14348558,14347022,1536
16349081,1558.73,1534.68,1560,1460,0.788516,0,2,14350118,14348558,1560
16350541,1605.54,1558.73,1608,1460,0.789406,0,2,14351726,14350118,1608
16357841,1726.68,1701.53,1728,1460,0.903312,0,2,14360030,14358302,1728
16359301,1727.93,1726.68,1728,1460,0.943325,0,2,14361758,14360030,1728
16360761,1796.4,1727.93,1800,1460,0.94733,0,2,14363558,14361758,1800
16382661,1485.59,1439.82,1488,1460,0.70214,0,2,14386166,14384678,1488
16384121,1487.88,1485.59,1488,1460,0.730856,0,2,14387654,14386166,1488
16385581,1533.59,1487.88,1536,1460,0.742342,0,2,14389190,14387654,1536
16387041,1535.88,1533.59,1536,1460,0.758937,0,2,14390726,14389190,1536
16388501,1558.79,1535.88,1560,1460,0.765575,0,2,14392286,14390726,1560
16389961,1559.94,1558.79,1560,1460,0.79223,0,2,14393846,14392286,1560
16398721,1726.68,1701.6,1728,1460,0.915881,0,2,14403830,14402102,1728
16400181,1750.73,1726.68,1752,1460,0.924352,0,2,14405582,14403830,1752
16408941,1497.96,1687.14,1488,1460,0.75048,0,2,14415950,14414462,1488
16427921,1761.54,1486.74,1776,1460,0.939402,0,2,14434238,14432462,1776
16430841,1569.62,1752.48,1560,1460,0.477904,0,1,14437550,14435990,1560
16442521,1127.77,1123.31,1128,1460,0.453198,0,1,14445734,14444606,1128
16467341,1726.73,1702.68,1728,1460,0.928317,0,2,14470622,14468894,1728
16474641,1480.91,1802.28,1464,1460,0.421125,0,1,14479310,14477846,1464
16476101,872.046,1480.91,840,1460,0.29445,0,1,14480150,14479310,840
16479021,933.56,887.202,936,1460,0.281112,0,1,14481974,14481038,936
16486321,1148.39,1079.7,1152,1460,0.417954,0,1,14487230,14486078,1152
16487781,1151.82,1148.39,1152,1460,0.437182,0,1,14488382,14487230,1152
16489241,1174.79,1151.82,1176,1460,0.468873,0,1,14489558,14488382,1176
16490701,1221.54,1174.79,1224,1460,0.493549,0,1,14490782,14489558,1224
16500921,1463.81,1460.28,1464,1460,0.70888,0,2,14500334,14498870,1464
16502381,1509.59,1463.81,1512,1460,0.733552,0,2,14501846,14500334,1512
16503841,1534.68,1509.59,1536,1460,0.743421,0,2,14503382,14501846,1536
16505301,1535.93,1534.68,1536,1460,0.783368,0,2,14504918,14503382,1536
16533041,1487.82,1484.34,1488,1460,0.717187,0,2,14533526,14532038,1488
16534501,1510.79,1487.82,1512,1460,0.748875,0,2,14535038,14533526,1512
16535961,1557.54,1510.79,1560,1460,0.78555,0,2,14536598,14535038,1560
16541801,1726.62,1700.33,1728,1460,0.901822,0,2,14543270,14541542,1728
16543261,1727.93,1726.62,1728,1460,0.906729,0,2,14544998,14543270,1728
16549101,1456.85,1777.02,1440,1460,0.738844,0,2,14551742,14550302,1440
16552021,1510.72,1486.44,1512,1460,0.755415,0,2,14554742,14553230,1512
16553481,1557.54,1510.72,1560,1460,0.788166,0,2,14556302,14554742,1560
16560781,1703.87,1701.48,1704,1460,0.922192,0,2,14564582,14562878,1704
16585601,1487.82,1484.33,1488,1460,0.741045,0,2,14588966,14587478,1488
16587061,1556.39,1487.82,1560,1460,0.770418,0,2,14590526,14588966,1560
16594361,1702.68,1677.65,1704,1460,0.919937,0,2,14598782,14597078,1704
16595821,1772.33,1702.68,1776,1460,0.937975,0,2,14600558,14598782,1776
16601661,1383.9,1685.94,1368,1460,0.705372,0,2,14607182,14605814,1368
16617721,1510.62,1484.45,1512,1460,0.746661,0,2,14622182,14620670,1512
16619181,1557.53,1510.62,1560,1460,0.784664,0,2,14623742,14622182,1560
16626481,1725.54,1678.74,1728,1460,0.901344,0,2,14632046,14630318,1728
16627941,1727.88,1725.54,1728,1460,0.930537,0,2,14633774,14632046,1728
16635241,1155.9,1686.05,1128,1460,0.489327,0,1,14641982,14640854,1128
16636701,1129.4,1155.9,1128,1460,0.465731,0,1,14643110,14641982,1128
16649841,1507.2,1415.93,1512,1460,0.715877,0,2,14655110,14653598,1512
16651301,1511.76,1507.2,1512,1460,0.724351,0,2,14656622,14655110,1512
16652761,1511.99,1511.76,1512,1460,0.76374,0,2,14658134,14656622,1512
16654221,1580.4,1511.99,1584,1460,0.779496,0,2,14659718,14658134,1584
16660061,1725.53,1678.62,1728,1460,0.924515,0,2,14666366,14664638,1728
16681961,1487.82,1484.45,1488,1460,0.741629,0,2,14688038,14686550,1488
16692181,1702.79,1679.82,1704,1460,0.920833,0,2,14699366,14697662,1704
16702401,1559.78,1555.64,1560,1460,0.781663,0,2,14710958,14709398,1560
16715541,1616.51,1778.22,1608,1460,0.77251,0,2,14726174,14724566,1608
16724301,1725.59,1679.82,1728,1460,0.91391,0,2,14735966,14734238,1728
16725761,1750.68,1725.59,1752,1460,0.923564,0,2,14737718,14735966,1752
16743281,1486.62,1460.45,1488,1460,0.72694,0,2,14755862,14754374,1488
16744741,1533.53,1486.62,1536,1460,0.764776,0,2,14757398,14755862,1536
16746201,1581.48,1533.53,1584,1460,0.79191,0,2,14758982,14757398,1584
16752041,1703.82,1700.34,1704,1460,0.909185,0,2,14765630,14763926,1704
16753501,1749.59,1703.82,1752,1460,0.909674,0,2,14767382,14765630,1752
16760801,1423.86,1573.19,1416,1460,0.706457,0,2,14775734,14774318,1416
16763721,1486.7,1461.99,1488,1460,0.733433,0,2,14778686,14777198,1488
16765181,1533.53,1486.7,1536,1460,0.767373,0,2,14780222,14778686,1536
16766641,1581.48,1533.53,1584,1460,0.792949,0,2,14781806,14780222,1584
16772481,1748.33,1678.68,1752,1460,0.905659,0,2,14788502,14786750,1752
16791461,1703.93,1702.61,1704,1460,0.922865,0,2,14810318,14808614,1704
16803141,1485.48,1437.65,1488,1460,0.716523,0,2,14823278,14821790,1488
16804601,1510.67,1485.48,1512,1460,0.736609,0,2,14824790,14823278,1512
16806061,1534.73,1510.67,1536,1460,0.780644,0,2,14826326,14824790,1536
16807521,1604.34,1534.73,1608,1460,0.798257,0,2,14827934,14826326,1608
16813361,1725.59,1679.82,1728,1460,0.913763,0,2,14834630,14832902,1728
16833801,1486.79,1463.81,1488,1460,0.716588,0,2,14855414,14853926,1488
16835261,1510.74,1486.79,1512,1460,0.748635,0,2,14856926,14855414,1512
16836721,1557.54,1510.74,1560,1460,0.761454,0,2,14858486,14856926,1560
16842561,1701.59,1655.76,1704,1460,0.905333,0,2,14865062,14863358,1704
16844021,1749.48,1701.59,1752,1460,0.944133,0,2,14866814,14865062,1752
16851321,1596.05,1825.08,1584,1460,0.779943,0,2,14875670,14874086,1584
16852781,1516.2,1596.05,1512,1460,0.737977,0,2,14877182,14875670,1512
16861541,1700.4,1631.93,1704,1460,0.903347,0,2,14886806,14885102,1704
16863001,1749.42,1700.4,1752,1460,0.931339,0,2,14888558,14886806,1752
16864461,1774.67,1749.42,1776,1460,0.948536,0,2,14890334,14888558,1776
16876141,1725.53,1678.62,1728,1460,0.913257,0,2,14903870,14902142,1728
16877601,1750.68,1725.53,1752,1460,0.947303,0,2,14905622,14903870,1752
16890741,1725.59,1679.88,1728,1460,0.914657,0,2,14921078,14919350,1728
16892201,1750.68,1725.59,1752,1460,0.947863,0,2,14922830,14921078,1752
16914101,1485.54,1438.74,1488,1460,0.725418,0,2,14944334,14942846,1488
16915561,1533.48,1485.54,1536,1460,0.764167,0,2,14945870,14944334,1536
16917021,1581.47,1533.48,1584,1460,0.779667,0,2,14947454,14945870,1584
16922861,1724.33,1654.68,1728,1460,0.921831,0,2,14954054,14952326,1728
16931621,1159.32,1298.46,1152,1460,0.485502,0,1,14963678,14962526,1152
16946221,1485.6,1439.93,1488,1460,0.726157,0,2,14976998,14975510,1488
16947681,1533.48,1485.6,1536,1460,0.776463,0,2,14978534,14976998,1536
16956441,1727.82,1724.44,1728,1460,0.941552,0,2,14988470,14986742,1728
16957901,1796.39,1727.82,1800,1460,0.946621,0,2,14990270,14988470,1800
16968121,1702.62,1676.41,1704,1460,0.908142,0,2,15002174,15000470,1704
16969581,1749.53,1702.62,1752,1460,0.933257,0,2,15003926,15002174,1752
16987101,1257.42,1436.4,1248,1460,0.470534,0,1,15024446,15023198,1248
16988561,1088.87,1257.42,1080,1460,0.470213,0,1,15025526,15024446,1080
16998781,1462.67,1437.48,1464,1460,0.718995,0,2,15035006,15033542,1464
17000241,1532.33,1462.67,1536,1460,0.725598,0,2,15036542,15035006,1536
17009001,1703.88,1701.53,1704,1460,0.910132,0,2,15046310,15044606,1704
17010461,1749.59,1703.88,1752,1460,0.946053,0,2,15048062,15046310,1752
17020681,1439.83,1436.51,1440,1460,0.706372,0,2,15059126,15057686,1440
17022141,1508.39,1439.83,1512,1460,0.720549,0,2,15060638,15059126,1512
17023601,1511.82,1508.39,1512,1460,0.75022,0,2,15062150,15060638,1512
17025061,1557.59,1511.82,1560,1460,0.774088,0,2,15063710,15062150,1560
17030901,1748.27,1677.48,1752,1460,0.904409,0,2,15070358,15068606,1752
17052801,1678.79,1655.81,1680,1460,0.900723,0,2,15094910,15093230,1680
17054261,1748.34,1678.79,1752,1460,0.918289,0,2,15096662,15094910,1752
17055721,1751.82,1748.34,1752,1460,0.937316,0,2,15098414,15096662,1752
17063021,968.37,1127.4,960,1460,0.282459,0,1,15105614,15104654,960
17064481,892.018,968.37,888,1460,0.262984,0,1,15106502,15105614,888
17098061,1702.68,1677.65,1704,1460,0.919965,0,2,15136886,15135182,1704
17099521,1772.33,1702.68,1776,1460,0.937986,0,2,15138662,15136886,1776
17111201,1079.91,1078.14,1080,1460,0.409523,0,1,15149606,15148526,1080
17112661,1148.4,1079.91,1152,1460,0.421809,0,1,15150758,15149606,1152
17114121,1151.82,1148.4,1152,1460,0.450724,0,1,15151910,15150758,1152
17115581,1197.59,1151.82,1200,1460,0.462289,0,1,15153110,15151910,1200
17117041,1199.88,1197.59,1200,1460,0.490916,0,1,15154310,15153110,1200
17127261,1463.88,1461.53,1464,1460,0.722307,0,2,15163958,15162494,1464
17128721,1532.39,1463.88,1536,1460,0.738923,0,2,15165494,15163958,1536
17130181,1535.82,1532.39,1536,1460,0.757569,0,2,15167030,15165494,1536
17137481,1703.88,1701.59,1704,1460,0.922494,0,2,15175310,15173606,1704
17144781,1431.78,1731.6,1416,1460,0.742954,0,2,15183830,15182414,1416
17147701,1511.8,1507.99,1512,1460,0.768073,0,2,15186854,15185342,1512
17149161,1580.39,1511.8,1584,1460,0.769229,0,2,15188438,15186854,1584
17157921,1726.79,1703.88,1728,1460,0.941445,0,2,15198446,15196718,1728
17172521,1126.55,1098.93,1128,1460,0.414692,0,1,15212414,15211286,1128
17173981,1150.73,1126.55,1152,1460,0.447877,0,1,15213566,15212414,1152
17175441,1197.54,1150.73,1200,1460,0.461151,0,1,15214766,15213566,1200
17176901,1199.88,1197.54,1200,1460,0.49046,0,1,15215966,15214766,1200
17188581,1486.73,1462.67,1488,1460,0.739839,0,2,15226934,15225446,1488
17190041,1556.34,1486.73,1560,1460,0.769936,0,2,15228494,15226934,1560
17191501,1582.62,1556.34,1584,1460,0.781974,0,2,15230078,15228494,1584
17197341,1727.81,1724.22,1728,1460,0.928419,0,2,15236774,15235046,1728
17209021,937.12,958.395,936,1460,0.299206,0,1,15248414,15247478,936
17216321,1126.56,1099.25,1128,1460,0.425877,0,1,15253670,15252542,1128
17217781,1173.53,1126.56,1176,1460,0.452351,0,1,15254846,15253670,1176
17219241,1198.68,1173.53,1200,1460,0.47494,0,1,15256046,15254846,1200
17220701,1222.73,1198.68,1224,1460,0.495976,0,1,15257270,15256046,1224
17233841,1535.82,1532.45,1536,1460,0.793735,0,2,15269966,15268430,1536
17248441,1458.06,1801.19,1440,1460,0.479616,0,1,15286958,15285518,1440
17249901,984.903,1458.06,960,1460,0.221847,0,1,15287918,15286958,960
17260121,861.48,813.597,864,1460,0.204953,0,1,15293270,15292406,864
17261581,909.474,861.48,912,1460,0.231981,0,1,15294182,15293270,912
17263041,934.674,909.474,936,1460,0.254792,0,1,15295118,15294182,936
17264501,958.734,934.674,960,1460,0.275917,0,1,15296078,15295118,960
17270341,1101.53,1054.68,1104,1460,0.404935,0,1,15300254,15299150,1104
17271801,1149.48,1101.53,1152,1460,0.431974,0,1,15301406,15300254,1152
17273261,1174.67,1149.48,1176,1460,0.45479,0,1,15302582,15301406,1176
17274721,1198.73,1174.67,1200,1460,0.475916,0,1,15303782,15302582,1200
17286401,1462.62,1436.39,1464,1460,0.7064,0,2,15314534,15313070,1464
17287861,1509.53,1462.62,1512,1460,0.74456,0,2,15316046,15314534,1512
17289321,1557.48,1509.53,1560,1460,0.771824,0,2,15317606,15316046,1560
17296621,1726.62,1700.39,1728,1460,0.926364,0,2,15325886,15324158,1728
17311221,1556.22,1484.49,1560,1460,0.783083,0,2,15342374,15340814,1560
17312681,1605.41,1556.22,1608,1460,0.787233,0,2,15343982,15342374,1608
17318521,1748.27,1677.48,1752,1460,0.916745,0,2,15350630,15348878,1752
17319981,1751.81,1748.27,1752,1460,0.924698,0,2,15352382,15350630,1752
17327281,1475.16,1687.19,1464,1460,0.735891,0,2,15360926,15359462,1464
17334581,1439.94,1438.75,1440,1460,0.705292,0,2,15368102,15366662,1440
17336041,1508.4,1439.94,1512,1460,0.720117,0,2,15369614,15368102,1512
17337501,1511.82,1508.4,1512,1460,0.750047,0,2,15371126,15369614,1512
17338961,1557.59,1511.82,1560,1460,0.798019,0,2,15372686,15371126,1560
17346261,1726.74,1702.74,1728,1460,0.928476,0,2,15381086,15379358,1728
17368161,1486.73,1462.67,1488,1460,0.71592,0,2,15402566,15401078,1488
17369621,1510.74,1486.73,1512,1460,0.748368,0,2,15404078,15402566,1512
17371081,1557.54,1510.74,1560,1460,0.785347,0,2,15405638,15404078,1560
17378381,1702.68,1677.6,1704,1460,0.919783,0,2,15413894,15412190,1704
17385681,1489.98,1527.59,1488,1460,0.740353,0,2,15422318,15420830,1488
17388601,1534.74,1510.9,1536,1460,0.760456,0,2,15425366,15423830,1536
17394441,1701.59,1655.76,1704,1460,0.905308,0,2,15431942,15430238,1704
17395901,1749.48,1701.59,1752,1460,0.932123,0,2,15433694,15431942,1752
17397361,1774.67,1749.48,1776,1460,0.942849,0,2,15435470,15433694,1776
17416341,1487.88,1485.65,1488,1460,0.755201,0,2,15454238,15452750,1488
17417801,1579.19,1487.88,1584,1460,0.764081,0,2,15455822,15454238,1584
17448461,1727.76,1723.25,1728,1460,0.916361,0,2,15489470,15487742,1728
17461601,1463.71,1458.13,1464,1460,0.710335,0,2,15503798,15502334,1464
17463061,1509.59,1463.71,1512,1460,0.722134,0,2,15505310,15503798,1512
17464521,1511.88,1509.59,1512,1460,0.774854,0,2,15506822,15505310,1512
17471821,1700.34,1630.86,1704,1460,0.915067,0,2,15515006,15513302,1704
17473281,1772.22,1700.34,1776,1460,0.936027,0,2,15516782,15515006,1776
17490801,1460.39,1391.88,1464,1460,0.703042,0,2,15534518,15533054,1464
17492261,1509.42,1460.39,1512,1460,0.707217,0,2,15536030,15534518,1512
17502481,1726.74,1702.73,1728,1460,0.928086,0,2,15547406,15545678,1728
17503941,1773.54,1726.74,1776,1460,0.947234,0,2,15549182,15547406,1776
17521461,1703.76,1699.25,1704,1460,0.908656,0,2,15568742,15567038,1704
17522921,1749.59,1703.76,1752,1460,0.945462,0,2,15570494,15568742,1752
17531681,1120.11,1426.25,1104,1460,0.470035,0,1,15580118,15579014,1104
17534601,1197.52,1150.41,1200,1460,0.494006,0,1,15582470,15581270,1200
17546281,1486.67,1461.48,1488,1460,0.714712,0,2,15593342,15591854,1488
17547741,1510.73,1486.67,1512,1460,0.747885,0,2,15594854,15593342,1512
17549201,1557.54,1510.73,1560,1460,0.773154,0,2,15596414,15594854,1560
17550661,1582.68,1557.54,1584,1460,0.795262,0,2,15597998,15596414,1584
17566721,878.934,1162.69,864,1460,0.284675,0,1,15615230,15614366,864
17593001,1485.59,1439.82,1488,1460,0.737964,0,2,15636806,15635318,1488
17594461,1556.28,1485.59,1560,1460,0.757186,0,2,15638366,15636806,1560
17595921,1559.81,1556.28,1560,1460,0.788874,0,2,15639926,15638366,1560
17603221,1726.79,1703.87,1728,1460,0.91715,0,2,15648326,15646598,1728
17609061,1593.71,1778.22,1584,1460,0.447175,0,1,15655262,15653678,1584
17617821,885.589,839.786,888,1460,0.216121,0,1,15660374,15659486,888
17619281,910.679,885.589,912,1460,0.224448,0,1,15661286,15660374,912
17620741,911.934,910.679,912,1460,0.275779,0,1,15662198,15661286,912
17628041,1125.54,1078.74,1128,1460,0.413253,0,1,15667502,15666374,1128
17629501,1150.68,1125.54,1152,1460,0.435301,0,1,15668654,15667502,1152
17630961,1174.73,1150.68,1176,1460,0.46812,0,1,15669830,15668654,1176
17632421,1221.54,1174.73,1224,1460,0.493248,0,1,15671054,15669830,1224
17642641,1486.67,1461.47,1488,1460,0.726582,0,2,15680630,15679142,1488
17644101,1533.53,1486.67,1536,1460,0.740633,0,2,15682166,15680630,1536
17645561,1535.88,1533.53,1536,1460,0.770253,0,2,15683702,15682166,1536
17652861,1726.74,1702.73,1728,1460,0.928191,0,2,15692054,15690326,1728
17654321,1773.54,1726.74,1776,1460,0.935277,0,2,15693830,15692054,1776
17666001,1702.62,1676.36,1704,1460,0.919821,0,2,15707558,15705854,1704
17667461,1772.33,1702.62,1776,1460,0.949928,0,2,15709334,15707558,1776
17673301,1752.23,1756.68,1752,1460,0.933198,0,2,15716486,15714734,1752
17680601,1549.26,1801.13,1536,1460,0.761207,0,2,15725198,15723662,1536
17682061,1491.06,1549.26,1488,1460,0.730483,0,2,15726686,15725198,1488
17692281,1727.87,1725.47,1728,1460,0.941688,0,2,15738038,15736310,1728
17693741,1796.39,1727.87,1800,1460,0.946675,0,2,15739838,15738038,1800
17699581,1431.83,1732.68,1416,1460,0.707995,0,2,15746582,15745166,1416
17715641,1507.14,1414.74,1512,1460,0.702987,0,2,15761246,15759734,1512
17725861,1725.48,1677.53,1728,1460,0.911714,0,2,15772430,15770702,1728
17727321,1750.67,1725.48,1752,1460,0.946685,0,2,15774182,15772430,1752
17743381,1485.59,1439.87,1488,1460,0.726116,0,2,15791030,15789542,1488
17744841,1533.48,1485.59,1536,1460,0.752447,0,2,15792566,15791030,1536
17746301,1558.67,1533.48,1560,1460,0.786979,0,2,15794126,15792566,1560
17762361,1113.49,1293.9,1104,1460,0.44923,0,1,15812030,15810926,1104
17776961,1439.87,1437.42,1440,1460,0.701729,0,2,15824966,15823526,1440
17778421,1508.39,1439.87,1512,1460,0.730692,0,2,15826478,15824966,1512
17779881,1534.62,1508.39,1536,1460,0.742277,0,2,15828014,15826478,1536
17781341,1535.93,1534.62,1536,1460,0.782911,0,2,15829550,15828014,1536
17782801,1604.4,1535.93,1608,1460,0.799164,0,2,15831158,15829550,1608
17787181,1702.62,1676.39,1704,1460,0.906266,0,2,15836150,15834446,1704
17788641,1749.53,1702.62,1752,1460,0.944507,0,2,15837902,15836150,1752
17795941,1686.12,1802.34,1680,1460,0.716894,0,2,15846854,15845174,1680
17798861,1230.86,1361.11,1224,1460,0.406303,0,1,15849422,15848198,1224
17804701,1100.4,1031.91,1104,1460,0.406353,0,1,15853574,15852470,1104
17806161,1149.42,1100.4,1152,1460,0.420541,0,1,15854726,15853574,1152
17807621,1151.87,1149.42,1152,1460,0.450217,0,1,15855878,15854726,1152
17809081,1197.59,1151.87,1200,1460,0.498087,0,1,15857078,15855878,1200
17820761,1463.87,1461.48,1464,1460,0.722033,0,2,15868022,15866558,1464
17822221,1532.39,1463.87,1536,1460,0.762813,0,2,15869558,15868022,1536
17823681,1581.42,1532.39,1584,1460,0.779125,0,2,15871142,15869558,1584
17829521,1700.39,1631.88,1704,1460,0.915098,0,2,15877694,15875990,1704
17830981,1772.22,1700.39,1776,1460,0.948039,0,2,15879470,15877694,1776
17839741,854.937,1138.75,840,1460,0.26643,0,1,15888614,15887774,840
17842661,933.517,886.347,936,1460,0.276629,0,1,15890438,15889502,936
17851421,1149.42,1100.45,1152,1460,0.431357,0,1,15896702,15895550,1152
17852881,1174.67,1149.42,1176,1460,0.454543,0,1,15897878,15896702,1176
17854341,1198.73,1174.67,1200,1460,0.499817,0,1,15899078,15897878,1200
17866021,1486.73,1462.67,1488,1460,0.739845,0,2,15910070,15908582,1488
17867481,1556.34,1486.73,1560,1460,0.769938,0,2,15911630,15910070,1560
17876241,1726.73,1702.68,1728,1460,0.90425,0,2,15921590,15919862,1728
17896681,1462.67,1437.47,1464,1460,0.706798,0,2,15941630,15940166,1464
17898141,1509.53,1462.67,1512,1460,0.744719,0,2,15943142,15941630,1512
17899601,1557.48,1509.53,1560,1460,0.771888,0,2,15944702,15943142,1560
17905441,1678.73,1654.68,1680,1460,0.900032,0,2,15951254,15949574,1680
17906901,1748.34,1678.73,1752,1460,0.930013,0,2,15953006,15951254,1752
17915661,1118.11,1386.29,1104,1460,0.481081,0,1,15962630,15961526,1104
17930261,1463.82,1460.45,1464,1460,0.709851,0,2,15975926,15974462,1464
17931721,1509.59,1463.82,1512,1460,0.75794,0,2,15977438,15975926,1512
17933181,1580.28,1509.59,1584,1460,0.777176,0,2,15979022,15977438,1584
17940481,1725.54,1678.79,1728,1460,0.925574,0,2,15987326,15985598,1728
17941941,1773.48,1725.54,1776,1460,0.93423,0,2,15989102,15987326,1776
17956541,1702.74,1678.73,1704,1460,0.90854,0,2,16005806,16004102,1704
17958001,1749.54,1702.74,1752,1460,0.933416,0,2,16007558,16005806,1752
17978441,1485.36,1435.19,1488,1460,0.709999,0,2,16027598,16026110,1488
17979901,1510.67,1485.36,1512,1460,0.722,0,2,16029110,16027598,1512
17981361,1511.93,1510.67,1512,1460,0.7748,0,2,16030622,16029110,1512
17987201,1678.74,1654.73,1680,1460,0.900107,0,2,16037198,16035518,1680
17988661,1748.34,1678.74,1752,1460,0.918043,0,2,16038950,16037198,1752
17990121,1751.82,1748.34,1752,1460,0.925217,0,2,16040702,16038950,1752
18000341,899.121,1110.42,888,1460,0.269341,0,1,16051142,16050254,888
18010561,1126.62,1100.33,1128,1460,0.425964,0,1,16058246,16057118,1128
18012021,1173.53,1126.62,1176,1460,0.452385,0,1,16059422,16058246,1176
18013481,1198.68,1173.53,1200,1460,0.486954,0,1,16060622,16059422,1200
18014941,1245.53,1198.68,1248,1460,0.488782,0,1,16061870,16060622,1248
18025161,1439.88,1437.53,1440,1460,0.702336,0,2,16071350,16069910,1440
18026621,1508.39,1439.88,1512,1460,0.718934,0,2,16072862,16071350,1512
18028081,1511.82,1508.39,1512,1460,0.761574,0,2,16074374,16072862,1512
18029541,1580.39,1511.82,1584,1460,0.79063,0,2,16075958,16074374,1584
18035381,1726.67,1701.48,1728,1460,0.91472,0,2,16082654,16080926,1728
18057281,1508.33,1438.68,1512,1460,0.717847,0,2,16105142,16103630,1512
18058741,1511.82,1508.33,1512,1460,0.761139,0,2,16106654,16105142,1512
18060201,1580.39,1511.82,1584,1460,0.778455,0,2,16108238,16106654,1584
18067501,1703.82,1700.39,1704,1460,0.909632,0,2,16116494,16114790,1704
18074801,1525.32,1778.39,1512,1460,0.754361,0,2,16125182,16123670,1512
18076261,1489.87,1525.32,1488,1460,0.751744,0,2,16126670,16125182,1488
18086481,1679.94,1678.73,1680,1460,0.903613,0,2,16137998,16136318,1680
18087941,1748.4,1679.94,1752,1460,0.919445,0,2,16139750,16137998,1752
18099621,1485.57,1439.44,1488,1460,0.719645,0,2,16152710,16151222,1488
18101081,1510.68,1485.57,1512,1460,0.737858,0,2,16154222,16152710,1512
18102541,1534.73,1510.68,1536,1460,0.757143,0,2,16155758,16154222,1536
18109841,1702.74,1678.79,1704,1460,0.932569,0,2,16164014,16162310,1704
18125901,1079.82,1076.39,1080,1460,0.414637,0,1,16178774,16177694,1080
18127361,1171.19,1079.82,1176,1460,0.423855,0,1,16179950,16178774,1176
18131741,1223.82,1220.45,1224,1460,0.497767,0,1,16183550,16182326,1224
18140501,1461.42,1412.39,1464,1460,0.703014,0,2,16191638,16190174,1464
18141961,1509.47,1461.42,1512,1460,0.731205,0,2,16193150,16191638,1512
18143421,1534.67,1509.47,1536,1460,0.766482,0,2,16194686,16193150,1536
18144881,1581.53,1534.67,1584,1460,0.780593,0,2,16196270,16194686,1584
18152181,1725.59,1679.87,1728,1460,0.92607,0,2,16204574,16202846,1728
18172621,1535.71,1530.11,1536,1460,0.780036,0,2,16225574,16224038,1536
18174081,1604.39,1535.71,1608,1460,0.798015,0,2,16227182,16225574,1608
18181381,1703.88,1701.65,1704,1460,0.947215,0,2,16235534,16233830,1704
18182841,1817.99,1703.88,1824,1460,0.948886,0,2,16237358,16235534,1824
18185761,1616.5,1778.1,1608,1460,0.724222,0,2,16240742,16239134,1608
18190141,1462.71,1438.16,1464,1460,0.73827,0,2,16245038,16243574,1464
18191601,1555.14,1462.71,1560,1460,0.757308,0,2,16246598,16245038,1560
18193061,1559.76,1555.14,1560,1460,0.788923,0,2,16248158,16246598,1560
18200361,1726.67,1701.48,1728,1460,0.927,0,2,16256462,16254734,1728
18201821,1773.53,1726.67,1776,1460,0.9408,0,2,16258238,16256462,1776
18209121,1216.38,1527.54,1200,1460,0.468274,0,1,16266350,16265150,1200
18210581,1086.82,1216.38,1080,1460,0.42131,0,1,16267430,16266350,1080
18213501,1172.36,1103.14,1176,1460,0.44541,0,1,16269710,16268534,1176
18214961,1175.82,1172.36,1176,1460,0.472164,0,1,16270886,16269710,1176
18226641,1462.62,1436.39,1464,1460,0.706167,0,2,16281518,16280054,1464
18228101,1509.53,1462.62,1512,1460,0.720467,0,2,16283030,16281518,1512
18229561,1511.88,1509.53,1512,1460,0.762187,0,2,16284542,16283030,1512
18231021,1580.39,1511.88,1584,1460,0.766875,0,2,16286126,16284542,1584
18247081,1488.96,1507.13,1488,1460,0.751717,0,2,16304750,16303262,1488
18250001,1535.88,1533.65,1536,1460,0.774275,0,2,16307822,16306286,1536
18251461,1581.59,1535.88,1584,1460,0.79571,0,2,16309406,16307822,1584
18257301,1725.53,1678.68,1728,1460,0.91293,0,2,16316078,16314350,1728
18258761,1750.68,1725.53,1752,1460,0.935172,0,2,16317830,16316078,1752
18266061,1544.7,1709.94,1536,1460,0.790315,0,2,16326470,16324934,1536
18274821,1724.34,1654.73,1728,1460,0.922159,0,2,16336190,16334462,1728
18276281,1773.42,1724.34,1776,1460,0.938864,0,2,16337966,16336190,1776
18286501,1176.99,1195.8,1176,1460,0.487687,0,1,16349078,16347902,1176
18299641,1486.79,1463.87,1488,1460,0.717089,0,2,16361318,16359830,1488
18301101,1510.74,1486.79,1512,1460,0.748835,0,2,16362830,16361318,1512
18302561,1557.54,1510.74,1560,1460,0.785534,0,2,16364390,16362830,1560
18309861,1725.48,1677.6,1728,1460,0.912585,0,2,16372670,16370942,1728
18311321,1750.67,1725.48,1752,1460,0.947034,0,2,16374422,16372670,1752
18323001,1725.48,1677.6,1728,1460,0.913446,0,2,16388126,16386398,1728
18324461,1750.67,1725.48,1752,1460,0.947378,0,2,16389878,16388126,1752
18331761,875.46,1093.2,864,1460,0.290357,0,1,16397198,16396334,864
18334681,935.849,932.973,936,1460,0.268457,0,1,16399070,16398134,936
18336141,958.792,935.849,960,1460,0.281383,0,1,16400030,16399070,960
18341981,1078.79,1055.82,1080,1460,0.401043,0,1,16404206,16403126,1080
18343441,1148.34,1078.79,1152,1460,0.430417,0,1,16405358,16404206,1152
18344901,1174.62,1148.34,1176,1460,0.466167,0,1,16406534,16405358,1176
18346361,1221.53,1174.62,1224,1460,0.492467,0,1,16407758,16406534,1224
18358041,1486.73,1462.67,1488,1460,0.739914,0,2,16418726,16417238,1488
18359501,1556.34,1486.73,1560,1460,0.757966,0,2,16420286,16418726,1560
18360961,1559.82,1556.34,1560,1460,0.789186,0,2,16421846,16420286,1560
18368261,1726.74,1702.73,1728,1460,0.928385,0,2,16430222,16428494,1728
18391621,1508.33,1438.68,1512,1460,0.705704,0,2,16452878,16451366,1512
18412061,1484.36,1415.14,1488,1460,0.727634,0,2,16475342,16473854,1488
18413521,1533.42,1484.36,1536,1460,0.753054,0,2,16476878,16475342,1536
18414981,1558.67,1533.42,1560,1460,0.775221,0,2,16478438,16476878,1560
18422281,1703.88,1701.53,1704,1460,0.922367,0,2,16486718,16485014,1704
18436881,1727.82,1724.4,1728,1460,0.918754,0,2,16504190,16502462,1728
18444181,1243.74,1618.85,1224,1460,0.490224,0,1,16512446,16511222,1224
18445641,1110.99,1243.74,1104,1460,0.43009,0,1,16513550,16512446,1104
18447101,1104.35,1110.99,1104,1460,0.430036,0,1,16514654,16513550,1104
18450021,1174.68,1149.62,1176,1460,0.458806,0,1,16516982,16515806,1176
18451481,1198.73,1174.68,1200,1460,0.489522,0,1,16518182,16516982,1200
18463161,1486.73,1462.62,1488,1460,0.727654,0,2,16529150,16527662,1488
18464621,1533.54,1486.73,1536,1460,0.765062,0,2,16530686,16529150,1536
18466081,1581.48,1533.54,1584,1460,0.792025,0,2,16532270,16530686,1584
18471921,1679.93,1678.68,1680,1460,0.903236,0,2,16538894,16537214,1680
18473381,1748.4,1679.93,1752,1460,0.943294,0,2,16540646,16538894,1752
18487981,1725.48,1677.59,1728,1460,0.924598,0,2,16557374,16555646,1728
18489441,1773.47,1725.48,1776,1460,0.939839,0,2,16559150,16557374,1776
18505501,1506,1391.94,1512,1460,0.713375,0,2,16575686,16574174,1512
18506961,1511.7,1506,1512,1460,0.75935,0,2,16577198,16575686,1512
18508421,1580.38,1511.7,1584,1460,0.77774,0,2,16578782,16577198,1584
18514261,1702.67,1677.48,1704,1460,0.906902,0,2,16585382,16583678,1704
18515721,1749.53,1702.67,1752,1460,0.944761,0,2,16587134,16585382,1752
18523021,1360.01,1664.28,1344,1460,0.495329,0,1,16595534,16594190,1344
18524481,1071.2,1360.01,1056,1460,0.444131,0,1,16596590,16595534,1056
18527401,1127.86,1125.16,1128,1460,0.475461,0,1,16598846,16597718,1128
18537621,1461.59,1415.75,1464,1460,0.717053,0,2,16608254,16606790,1464
18539081,1532.28,1461.59,1536,1460,0.736821,0,2,16609790,16608254,1536
18540541,1535.81,1532.28,1536,1460,0.780728,0,2,16611326,16609790,1536
18547841,1703.94,1702.73,1704,1460,0.923499,0,2,16619678,16617974,1704
18556601,1543.56,1687.2,1536,1460,0.740101,0,2,16630118,16628582,1536
18563901,1507.13,1414.64,1512,1460,0.716126,0,2,16637222,16635710,1512
18565361,1511.76,1507.13,1512,1460,0.73645,0,2,16638734,16637222,1512
18566821,1534.79,1511.76,1536,1460,0.74458,0,2,16640270,16638734,1536
18568281,1535.94,1534.79,1536,1460,0.795832,0,2,16641806,16640270,1536
18574121,1702.62,1676.45,1704,1460,0.918597,0,2,16648430,16646726,1704
18575581,1772.33,1702.62,1776,1460,0.949439,0,2,16650206,16648430,1776
18591641,1102.79,1079.88,1104,1460,0.410444,0,1,16665014,16663910,1104
18593101,1149.54,1102.79,1152,1460,0.446178,0,1,16666166,16665014,1152
18594561,1197.48,1149.54,1200,1460,0.472471,0,1,16667366,16666166,1200
18606241,1486.62,1460.4,1488,1460,0.702488,0,2,16678286,16676798,1488
18607701,1487.93,1486.62,1488,1460,0.754995,0,2,16679774,16678286,1488
18609161,1579.2,1487.93,1584,1460,0.775998,0,2,16681358,16679774,1584
18616461,1749.42,1700.45,1752,1460,0.943514,0,2,16689686,16687934,1752
18628141,1487.82,1484.43,1488,1460,0.73251,0,2,16702526,16701038,1488
18629601,1533.59,1487.82,1536,1460,0.743004,0,2,16704062,16702526,1536
18631061,1535.88,1533.59,1536,1460,0.795202,0,2,16705598,16704062,1536
18638361,1724.39,1655.83,1728,1460,0.934917,0,2,16713854,16712126,1728
18652961,1702.56,1675.2,1704,1460,0.906082,0,2,16730894,16729190,1704
18654421,1749.53,1702.56,1752,1460,0.908433,0,2,16732646,16730894,1752
18673401,886.734,862.674,888,1460,0.216433,0,1,16748246,16747358,888
18674861,910.737,886.734,912,1460,0.260573,0,1,16749158,16748246,912
18676321,980.337,910.737,984,1460,0.290229,0,1,16750142,16749158,984
18683621,1124.39,1055.88,1128,1460,0.423174,0,1,16755398,16754270,1128
18685081,1173.42,1124.39,1176,1460,0.463269,0,1,16756574,16755398,1176
18686541,1221.47,1173.42,1224,1460,0.479308,0,1,16757798,16756574,1224
18688001,1223.87,1221.47,1224,1460,0.497723,0,1,16759022,16757798,1224
18698221,1486.62,1460.39,1488,1460,0.750227,0,2,16768646,16767158,1488
18699681,1579.13,1486.62,1584,1460,0.762091,0,2,16770230,16768646,1584
18715741,1232.28,1389.66,1224,1460,0.448147,0,1,16788182,16786958,1224
18717201,1064.81,1232.28,1056,1460,0.437259,0,1,16789238,16788182,1056
18720121,1174.58,1147.64,1176,1460,0.459961,0,1,16791566,16790390,1176
18721581,1198.73,1174.58,1200,1460,0.477985,0,1,16792766,16791566,1200
18733261,1508.33,1438.67,1512,1460,0.705606,0,2,16803662,16802150,1512
18743481,1725.48,1677.59,1728,1460,0.93632,0,2,16814942,16813214,1728
18750781,1526.51,1802.28,1512,1460,0.731287,0,2,16823702,16822190,1512
18756621,1510.68,1485.61,1512,1460,0.761809,0,2,16829582,16828070,1512
18763921,1725.54,1678.79,1728,1460,0.913417,0,2,16837886,16836158,1728
18778521,1485.59,1439.85,1488,1460,0.716174,0,2,16853942,16852454,1488
18779981,1510.68,1485.59,1512,1460,0.73647,0,2,16855454,16853942,1512
18781441,1534.73,1510.68,1536,1460,0.768588,0,2,16856990,16855454,1536
18782901,1581.54,1534.73,1584,1460,0.793435,0,2,16858574,16856990,1584
18788741,1678.79,1655.88,1680,1460,0.901352,0,2,16865174,16863494,1680
18797501,1516.26,1597.2,1512,1460,0.752421,0,2,16875542,16874030,1512
18804801,1679.88,1677.53,1680,1460,0.902338,0,2,16883654,16881974,1680
18806261,1748.39,1679.88,1752,1460,0.930935,0,2,16885406,16883654,1752
18813561,1754.51,1802.28,1752,1460,0.781632,0,2,16894382,16892630,1752
18815021,1455.73,1754.51,1440,1460,0.738653,0,2,16895822,16894382,1440
18817941,1510.72,1486.39,1512,1460,0.743384,0,2,16898822,16897310,1512
18819401,1534.74,1510.72,1536,1460,0.759354,0,2,16900358,16898822,1536
18820861,1558.74,1534.74,1560,1460,0.777742,0,2,16901918,16900358,1560
18826701,1725.53,1678.62,1728,1460,0.90047,0,2,16908566,16906838,1728
18828161,1727.88,1725.53,1728,1460,0.942188,0,2,16910294,16908566,1728
18847141,1486.74,1462.74,1488,1460,0.728539,0,2,16929782,16928294,1488
18848601,1533.54,1486.74,1536,1460,0.777415,0,2,16931318,16929782,1536
18850061,1604.28,1533.54,1608,1460,0.796966,0,2,16932926,16931318,1608
18879261,1486.73,1462.56,1488,1460,0.703543,0,2,16962470,16960982,1488
18880721,1487.94,1486.73,1488,1460,0.755417,0,2,16963958,16962470,1488
18889481,1773.37,1723.31,1776,1460,0.938789,0,2,16973990,16972214,1776
18898241,1113.38,1291.56,1104,1460,0.423916,0,1,16983398,16982294,1104
18899701,1081.67,1113.38,1080,1460,0.403567,0,1,16984478,16983398,1080
18918681,1486.74,1462.79,1488,1460,0.764825,0,2,17001422,16999934,1488
18920141,1601.94,1486.74,1608,1460,0.79193,0,2,17003030,17001422,1608
18927441,1749.42,1700.45,1752,1460,0.931677,0,2,17011382,17009630,1752
18946421,1462.79,1439.76,1464,1460,0.732565,0,2,17030606,17029142,1464
18956641,1727.87,1725.42,1728,1460,0.929703,0,2,17042054,17040326,1728
18977081,1485.48,1437.6,1488,1460,0.724681,0,2,17063222,17061734,1488
18978541,1533.47,1485.48,1536,1460,0.763872,0,2,17064758,17063222,1536
18980001,1581.47,1533.47,1584,1460,0.791549,0,2,17066342,17064758,1584
18987301,1703.94,1702.73,1704,1460,0.935609,0,2,17074694,17072990,1704
18988761,1795.2,1703.94,1800,1460,0.944244,0,2,17076494,17074694,1800
18994601,1104.6,1571.94,1080,1460,0.457949,0,1,17082710,17081630,1080
18998981,1174.68,1149.6,1176,1460,0.460589,0,1,17086142,17084966,1176
19000441,1198.73,1174.68,1200,1460,0.490235,0,1,17087342,17086142,1200
19012121,1486.67,1461.48,1488,1460,0.714808,0,2,17098262,17096774,1488
19013581,1510.73,1486.67,1512,1460,0.735923,0,2,17099774,17098262,1512
19015041,1534.74,1510.73,1536,1460,0.792369,0,2,17101310,17099774,1536
19022341,1726.73,1702.68,1728,1460,0.940111,0,2,17109686,17107958,1728
19028181,1543.44,1684.85,1536,1460,0.774451,0,2,17116478,17114942,1536
19050081,1702.74,1678.73,1704,1460,0.909035,0,2,17141678,17139974,1704
19051541,1749.54,1702.74,1752,1460,0.933614,0,2,17143430,17141678,1752
19060301,1102.38,1527.6,1080,1460,0.431502,0,1,17153246,17152166,1080
19061761,1058.32,1102.38,1056,1460,0.298601,0,1,17154302,17153246,1056
19063221,896.516,1058.32,888,1460,0.24544,0,1,17155190,17154302,888
19073441,1149.43,1100.5,1152,1460,0.45572,0,1,17162366,17161214,1152
19086581,1507.19,1415.82,1512,1460,0.703244,0,2,17174318,17172806,1512
19090961,1558.68,1533.65,1560,1460,0.799808,0,2,17178902,17177342,1560
19105561,1587.73,1658.69,1584,1460,0.77951,0,2,17195846,17194262,1584
19107021,1538.59,1587.73,1536,1460,0.749804,0,2,17197382,17195846,1536
19117241,1750.56,1723.25,1752,1460,0.945512,0,2,17208830,17207078,1752
19121621,1684.85,1777.08,1680,1460,0.775473,0,2,17214086,17212406,1680
19123081,1475.04,1684.85,1464,1460,0.748189,0,2,17215550,17214086,1464
19134761,1487.71,1482.11,1488,1460,0.715976,0,2,17226758,17225270,1488
19136221,1510.79,1487.71,1512,1460,0.74839,0,2,17228270,17226758,1512
19137681,1557.54,1510.79,1560,1460,0.785356,0,2,17229830,17228270,1560
19144981,1703.88,1701.54,1704,1460,0.934471,0,2,17238134,17236430,1704
19155201,1462.75,1439.02,1464,1460,0.713783,0,2,17249366,17247902,1464
19156661,1509.54,1462.75,1512,1460,0.735513,0,2,17250878,17249366,1512
19158121,1534.68,1509.54,1536,1460,0.756205,0,2,17252414,17250878,1536
19163961,1700.39,1631.82,1704,1460,0.902511,0,2,17258942,17257238,1704
19165421,1749.42,1700.39,1752,1460,0.919004,0,2,17260694,17258942,1752
19166881,1751.87,1749.42,1752,1460,0.949602,0,2,17262446,17260694,1752
19180021,1726.67,1701.48,1728,1460,0.903773,0,2,17277926,17276198,1728
19194621,1463.91,1462.13,1464,1460,0.727991,0,2,17294390,17292926,1464
19196081,1532.4,1463.91,1536,1460,0.741197,0,2,17295926,17294390,1536
19197541,1535.82,1532.4,1536,1460,0.758479,0,2,17297462,17295926,1536
19199001,1558.79,1535.82,1560,1460,0.789391,0,2,17299022,17297462,1560
19204841,1726.73,1702.61,1728,1460,0.915456,0,2,17305742,17304014,1728
19206301,1750.74,1726.73,1752,1460,0.936183,0,2,17307494,17305742,1752
19212141,1382.76,1663.14,1368,1460,0.704366,0,2,17314094,17312726,1368
19226741,1484.39,1415.82,1488,1460,0.710542,0,2,17327534,17326046,1488
19228201,1510.62,1484.39,1512,1460,0.758217,0,2,17329046,17327534,1512
19236961,1679.83,1676.51,1680,1460,0.914194,0,2,17338790,17337110,1680
19253021,1702.79,1679.87,1704,1460,0.921618,0,2,17357510,17355806,1704
19258861,1616.51,1778.27,1608,1460,0.747289,0,2,17364494,17362886,1608
19263241,1558.58,1531.64,1560,1460,0.778627,0,2,17369030,17367470,1560
19269081,1703.81,1700.28,1704,1460,0.908845,0,2,17375654,17373950,1704
19270541,1749.59,1703.81,1752,1460,0.921538,0,2,17377406,17375654,1752
19283681,1486.62,1460.34,1488,1460,0.72762,0,2,17391518,17390030,1488
19285141,1533.53,1486.62,1536,1460,0.753048,0,2,17393054,17391518,1536
19286601,1558.68,1533.53,1560,1460,0.763219,0,2,17394614,17393054,1560
19293901,1749.48,1701.64,1752,1460,0.944459,0,2,17402966,17401214,1752
19295361,1797.47,1749.48,1800,1460,0.947783,0,2,17404766,17402966,1800
19320181,1444.38,1527.59,1440,1460,0.719311,0,2,17433398,17431958,1440
19323101,1533.49,1485.82,1536,1460,0.75709,0,2,17436422,17434886,1536
19324561,1558.67,1533.49,1560,1460,0.788836,0,2,17437982,17436422,1560
19331861,1725.59,1679.88,1728,1460,0.926154,0,2,17446310,17444582,1728
19340621,1462.61,1436.17,1464,1460,0.702338,0,2,17455886,17454422,1464
19342081,1486.73,1462.61,1488,1460,0.706935,0,2,17457374,17455886,1488
19343541,1487.94,1486.73,1488,1460,0.732774,0,2,17458862,17457374,1488
19345001,1533.6,1487.94,1536,1460,0.75511,0,2,17460398,17458862,1536
19352301,1748.28,1677.59,1752,1460,0.917073,0,2,17468654,17466902,1752
19353761,1751.81,1748.28,1752,1460,0.948829,0,2,17470406,17468654,1752
19359601,1639.32,1778.33,1632,1460,0.773042,0,2,17477438,17475806,1632
19368361,1725.53,1678.68,1728,1460,0.925022,0,2,17487182,17485454,1728
19369821,1773.48,1725.53,1776,1460,0.940009,0,2,17488958,17487182,1776
19385881,1103.82,1100.45,1104,1460,0.423083,0,1,17503526,17502422,1104
19387341,1172.39,1103.82,1176,1460,0.451233,0,1,17504702,17503526,1176
19388801,1198.62,1172.39,1200,1460,0.474493,0,1,17505902,17504702,1200
19390261,1222.73,1198.62,1224,1460,0.495797,0,1,17507126,17505902,1224
19400481,1462.68,1437.6,1464,1460,0.707799,0,2,17516774,17515310,1464
19401941,1509.53,1462.68,1512,1460,0.75712,0,2,17518286,17516774,1512
19403401,1580.28,1509.53,1584,1460,0.776848,0,2,17519870,17518286,1584
19404861,1583.81,1580.28,1584,1460,0.796739,0,2,17521454,17519870,1584
19409241,1702.62,1676.34,1704,1460,0.906111,0,2,17526446,17524742,1704
19419461,1159.83,1308.66,1152,1460,0.455761,0,1,17537630,17536478,1152
19420921,1129.59,1159.83,1128,1460,0.440304,0,1,17538758,17537630,1128
19423841,1197.54,1150.88,1200,1460,0.477249,0,1,17541110,17539910,1200
19425301,1222.68,1197.54,1224,1460,0.484899,0,1,17542334,17541110,1224
19435521,1484.28,1413.54,1488,1460,0.708885,0,2,17551766,17550278,1488
19436981,1510.61,1484.28,1512,1460,0.745554,0,2,17553278,17551766,1512
19438441,1557.53,1510.61,1560,1460,0.760222,0,2,17554838,17553278,1560
19439901,1559.88,1557.53,1560,1460,0.778089,0,2,17556398,17554838,1560
19445741,1679.87,1677.48,1680,1460,0.902111,0,2,17562974,17561294,1680
19447201,1748.39,1679.87,1752,1460,0.930844,0,2,17564726,17562974,1752
19463261,1102.68,1077.6,1104,1460,0.432739,0,1,17579222,17578118,1104
19464721,1195.13,1102.68,1200,1460,0.443096,0,1,17580422,17579222,1200
19477861,1462.62,1436.39,1464,1460,0.730393,0,2,17592374,17590910,1464
19486621,1679.76,1675.25,1680,1460,0.900574,0,2,17601998,17600318,1680
19488081,1748.39,1679.76,1752,1460,0.93023,0,2,17603750,17601998,1752
19512901,1534.68,1509.65,1536,1460,0.779844,0,2,17628806,17627270,1536
19514361,1604.33,1534.68,1608,1460,0.785938,0,2,17630414,17628806,1608
19520201,1701.53,1654.68,1704,1460,0.929192,0,2,17636990,17635286,1704
19521661,1795.08,1701.53,1800,1460,0.941677,0,2,17638790,17636990,1800
19528961,1584.6,1595.99,1584,1460,0.714849,0,2,17647382,17645798,1584
19534801,1463.82,1460.48,1464,1460,0.712332,0,2,17653118,17651654,1464
19536261,1509.59,1463.82,1512,1460,0.734933,0,2,17654630,17653118,1512
19537721,1534.68,1509.59,1536,1460,0.779973,0,2,17656166,17654630,1536
19545021,1702.68,1677.6,1704,1460,0.907728,0,2,17664422,17662718,1704
19546481,1749.53,1702.68,1752,1460,0.933091,0,2,17666174,17664422,1752
19553781,1543.56,1687.19,1536,1460,0.77672,0,2,17674814,17673278,1536
19562541,1726.68,1701.59,1728,1460,0.939694,0,2,17684702,17682974,1728
19594661,1487.76,1483.25,1488,1460,0.717175,0,2,17720438,17718950,1488
19596121,1510.79,1487.76,1512,1460,0.73687,0,2,17721950,17720438,1512
19597581,1534.74,1510.79,1536,1460,0.792748,0,2,17723486,17721950,1536
19616561,1175.98,1175.62,1176,1460,0.494394,0,1,17744102,17742926,1176
19631161,1558.62,1532.45,1560,1460,0.798774,0,2,17758286,17756726,1560
19635541,1702.67,1677.42,1704,1460,0.906242,0,2,17763302,17761598,1704
19637001,1749.53,1702.67,1752,1460,0.944497,0,2,17765054,17763302,1752
19650141,1702.68,1677.59,1704,1460,0.920206,0,2,17780318,17778614,1704
19651601,1772.33,1702.68,1776,1460,0.938082,0,2,17782094,17780318,1776
19667661,1485.48,1437.59,1488,1460,0.700907,0,2,17799038,17797550,1488
19669121,1487.87,1485.48,1488,1460,0.730363,0,2,17800526,17799038,1488
19670581,1533.59,1487.87,1536,1460,0.742145,0,2,17802062,17800526,1536
19672041,1535.88,1533.59,1536,1460,0.794858,0,2,17803598,17802062,1536
19677881,1725.48,1677.59,1728,1460,0.92414,0,2,17810270,17808542,1728
19679341,1773.47,1725.48,1776,1460,0.939656,0,2,17812046,17810270,1776
19686641,1139.94,1366.85,1128,1460,0.461388,0,1,17819918,17818790,1128
19688101,1128.6,1139.94,1128,1460,0.454555,0,1,17821046,17819918,1128
19704161,1486.67,1461.48,1488,1460,0.714998,0,2,17835590,17834102,1488
19705621,1510.73,1486.67,1512,1460,0.759999,0,2,17837102,17835590,1512
19731901,1124.33,1054.68,1128,1460,0.410229,0,1,17862758,17861630,1128
19733361,1150.62,1124.33,1152,1460,0.422092,0,1,17863910,17862758,1152
19734821,1151.93,1150.62,1152,1460,0.426837,0,1,17865062,17863910,1152
19736281,1152,1151.93,1152,1460,0.464735,0,1,17866214,17865062,1152
19747961,1439.88,1437.59,1440,1460,0.714811,0,2,17877038,17875598,1440
19749421,1531.19,1439.88,1536,1460,0.723924,0,2,17878574,17877038,1536
19756721,1701.42,1652.39,1704,1460,0.915083,0,2,17886614,17884910,1704
19765481,1662.12,1778.39,1656,1460,0.476178,0,1,17897198,17895542,1656
19778621,1148.33,1078.57,1152,1460,0.41715,0,1,17906006,17904854,1152
19780081,1151.82,1148.33,1152,1460,0.44886,0,1,17907158,17906006,1152
19781541,1197.59,1151.82,1200,1460,0.449544,0,1,17908358,17907158,1200
19794681,1487.87,1485.47,1488,1460,0.753725,0,2,17920502,17919014,1488
19803441,1679.88,1677.59,1680,1460,0.902636,0,2,17930246,17928566,1680
19804901,1748.39,1679.88,1752,1460,0.931054,0,2,17931998,17930246,1752
19812201,1550.46,1825.13,1536,1460,0.7109,0,2,17940806,17939270,1536
19826801,1508.33,1438.68,1512,1460,0.717816,0,2,17954366,17952854,1512
19828261,1511.82,1508.33,1512,1460,0.749126,0,2,17955878,17954366,1512
19829721,1557.59,1511.82,1560,1460,0.785651,0,2,17957438,17955878,1560
19835561,1702.73,1678.67,1704,1460,0.919873,0,2,17964086,17962382,1704
19837021,1772.34,1702.73,1776,1460,0.937949,0,2,17965862,17964086,1776
19845781,1150.2,1572.06,1128,1460,0.480922,0,1,17975750,17974622,1128
19854541,1173.48,1125.65,1176,1460,0.465556,0,1,17982398,17981222,1176
19856001,1221.47,1173.48,1224,1460,0.468222,0,1,17983622,17982398,1224
19866221,1462.67,1437.42,1464,1460,0.706316,0,2,17993006,17991542,1464
19867681,1509.53,1462.67,1512,1460,0.720526,0,2,17994518,17993006,1512
19869141,1511.88,1509.53,1512,1460,0.774211,0,2,17996030,17994518,1512
19870601,1603.19,1511.88,1608,1460,0.795684,0,2,17997638,17996030,1608
19876441,1724.34,1654.74,1728,1460,0.910242,0,2,18004262,18002534,1728
19877901,1750.62,1724.34,1752,1460,0.934097,0,2,18006014,18004262,1752
19885201,1150.26,1573.19,1128,1460,0.49257,0,1,18014126,18012998,1128
19892501,1103.93,1102.58,1104,1460,0.412746,0,1,18019550,18018446,1104
19893961,1149.6,1103.93,1152,1460,0.435099,0,1,18020702,18019550,1152
19895421,1174.68,1149.6,1176,1460,0.468039,0,1,18021878,18020702,1176
19907101,1484.28,1413.59,1488,1460,0.721275,0,2,18032630,18031142,1488
19908561,1533.41,1484.28,1536,1460,0.75051,0,2,18034166,18032630,1536
19910021,1558.67,1533.41,1560,1460,0.786204,0,2,18035726,18034166,1560
19918781,1726.68,1701.65,1728,1460,0.92804,0,2,18045710,18043982,1728
19934841,1148.33,1078.56,1152,1460,0.429541,0,1,18060158,18059006,1152
19936301,1174.62,1148.33,1176,1460,0.477816,0,1,18061334,18060158,1176
19950901,1511.82,1508.45,1512,1460,0.761924,0,2,18075182,18073670,1512
19958201,1748.34,1678.73,1752,1460,0.917911,0,2,18083486,18081734,1752
19959661,1751.82,1748.34,1752,1460,0.949164,0,2,18085238,18083486,1752
19972801,1725.42,1676.39,1728,1460,0.923873,0,2,18100454,18098726,1728
19974261,1773.47,1725.42,1776,1460,0.939549,0,2,18102230,18100454,1776
19981561,1478.58,1755.59,1464,1460,0.768107,0,2,18110870,18109406,1464
19993241,1484.34,1414.74,1488,1460,0.710294,0,2,18121934,18120446,1488
19994701,1510.62,1484.34,1512,1460,0.746118,0,2,18123446,18121934,1512
19996161,1557.53,1510.62,1560,1460,0.784447,0,2,18125006,18123446,1560
19997621,1605.48,1557.53,1608,1460,0.799779,0,2,18126614,18125006,1608
20003461,1726.67,1701.48,1728,1460,0.914954,0,2,18133310,18131582,1728
20004921,1750.73,1726.67,1752,1460,0.947982,0,2,18135062,18133310,1752
20016601,1463.93,1462.67,1464,1460,0.724062,0,2,18147254,18145790,1464
20018061,1532.4,1463.93,1536,1460,0.739625,0,2,18148790,18147254,1536
20019521,1535.82,1532.4,1536,1460,0.79385,0,2,18150326,18148790,1536
20025361,1702.68,1677.59,1704,1460,0.907315,0,2,18156974,18155270,1704
20026821,1749.53,1702.68,1752,1460,0.920926,0,2,18158726,18156974,1752
20045801,1485.53,1438.68,1488,1460,0.725003,0,2,18177638,18176150,1488
20047261,1533.48,1485.53,1536,1460,0.752001,0,2,18179174,18177638,1536
20048721,1558.67,1533.48,1560,1460,0.7628,0,2,18180734,18179174,1560
20060401,1776.11,1778.16,1776,1460,0.938302,0,2,18194462,18192686,1776
20064781,1177.39,1203.72,1176,1460,0.493251,0,1,18198542,18197366,1176
20077921,1463.76,1459.25,1464,1460,0.708817,0,2,18210614,18209150,1464
20079381,1509.59,1463.76,1512,1460,0.733527,0,2,18212126,18210614,1512
20080841,1534.68,1509.59,1536,1460,0.779411,0,2,18213662,18212126,1536
20088141,1727.82,1724.34,1728,1460,0.91713,0,2,18222014,18220286,1728
20096901,855.969,1159.38,840,1460,0.26807,0,1,18231134,18230294,840
20099821,933.52,886.398,936,1460,0.264891,0,1,18232958,18232022,936
20107121,1101.54,1054.79,1104,1460,0.405653,0,1,18238142,18237038,1104
20108581,1149.48,1101.54,1152,1460,0.444261,0,1,18239294,18238142,1152
20110041,1197.47,1149.48,1200,1460,0.447705,0,1,18240494,18239294,1200
20124641,1487.82,1484.45,1488,1460,0.74173,0,2,18253982,18252494,1488
20126101,1556.39,1487.82,1560,1460,0.758692,0,2,18255542,18253982,1560
20133401,1727.82,1724.33,1728,1460,0.916918,0,2,18263846,18262118,1728
20134861,1750.79,1727.82,1752,1460,0.948767,0,2,18265598,18263846,1752
20142161,1474.08,1665.54,1464,1460,0.700522,0,2,18274190,18272726,1464
20146541,1487.83,1484.55,1488,1460,0.733393,0,2,18278582,18277094,1488
20148001,1533.59,1487.83,1536,1460,0.767357,0,2,18280118,18278582,1536
20155301,1702.74,1678.73,1704,1460,0.920367,0,2,18288374,18286670,1704
20156761,1772.34,1702.74,1776,1460,0.938147,0,2,18290150,18288374,1776
20165521,1113.32,1290.43,1104,1460,0.471238,0,1,18299582,18298478,1104
20178661,1558.62,1532.45,1560,1460,0.798493,0,2,18312158,18310598,1560
20185961,1726.67,1701.43,1728,1460,0.938791,0,2,18320462,18318734,1728
20197641,1702.68,1677.55,1704,1460,0.932584,0,2,18334166,18332462,1704
20207861,1141.25,1392.96,1128,1460,0.477081,0,1,18345182,18344054,1128
20210781,1221.51,1174.26,1224,1460,0.487933,0,1,18347582,18346358,1224
20221001,1439.77,1435.31,1440,1460,0.713057,0,2,18357014,18355574,1440
20244361,1703.76,1699.21,1704,1460,0.921945,0,2,18383654,18381950,1704
20254581,1463.99,1463.76,1464,1460,0.732966,0,2,18395246,18393782,1464
20256041,1532.4,1463.99,1536,1460,0.743187,0,2,18396782,18395246,1536
20257501,1535.82,1532.4,1536,1460,0.783275,0,2,18398318,18396782,1536
20263341,1679.88,1677.53,1680,1460,0.902244,0,2,18404918,18403238,1680
20264801,1748.39,1679.88,1752,1460,0.918898,0,2,18406670,18404918,1752
20266261,1751.82,1748.39,1752,1460,0.949559,0,2,18408422,18406670,1752
20283781,886.617,860.334,888,1460,0.214554,0,1,18422126,18421238,888
20285241,910.731,886.617,912,1460,0.247821,0,1,18423038,18422126,912
20286701,957.537,910.731,960,1460,0.285129,0,1,18423998,18423038,960
20292541,1079.82,1076.39,1080,1460,0.413523,0,1,18428174,18427094,1080
20294001,1171.19,1079.82,1176,1460,0.423409,0,1,18429350,18428174,1176
20308601,1484.39,1415.88,1488,1460,0.710904,0,2,18442526,18441038,1488
20310061,1510.62,1484.39,1512,1460,0.722362,0,2,18444038,18442526,1512
20311521,1511.93,1510.62,1512,1460,0.750945,0,2,18445550,18444038,1512
20312981,1557.6,1511.93,1560,1460,0.774378,0,2,18447110,18445550,1560
20318821,1703.81,1700.28,1704,1460,0.908736,0,2,18453734,18452030,1704
20320281,1749.59,1703.81,1752,1460,0.945494,0,2,18455486,18453734,1752
20327581,903.963,1207.26,888,1460,0.23124,0,1,18462974,18462086,888
20333421,838.684,813.674,840,1460,0.203344,0,1,18466190,18465350,840
20334881,908.334,838.684,912,1460,0.207337,0,1,18467102,18466190,912
20361161,1487.82,1484.34,1488,1460,0.729387,0,2,18488750,18487262,1488
20362621,1533.59,1487.82,1536,1460,0.741755,0,2,18490286,18488750,1536
20364081,1535.88,1533.59,1536,1460,0.782702,0,2,18491822,18490286,1536
20369921,1724.34,1654.73,1728,1460,0.909909,0,2,18498446,18496718,1728
20388901,1462.56,1435.25,1464,1460,0.705675,0,2,18518174,18516710,1464
20390361,1509.53,1462.56,1512,1460,0.72027,0,2,18519686,18518174,1512
20391821,1511.88,1509.53,1512,1460,0.762108,0,2,18521198,18519686,1512
20393281,1580.39,1511.88,1584,1460,0.766843,0,2,18522782,18521198,1584
20400581,1725.6,1679.93,1728,1460,0.926237,0,2,18531086,18529358,1728
20407881,1362.3,1709.94,1344,1460,0.49944,0,1,18539534,18538190,1344
20409341,1071.31,1362.3,1056,1460,0.421776,0,1,18540590,18539534,1056
20412261,1125.58,1079.57,1128,1460,0.423884,0,1,18542798,18541670,1128
20413721,1150.68,1125.58,1152,1460,0.427554,0,1,18543950,18542798,1152
20415181,1151.93,1150.68,1152,1460,0.465021,0,1,18545102,18543950,1152
20428321,1486.68,1461.59,1488,1460,0.739309,0,2,18557294,18555806,1488
20429781,1556.33,1486.68,1560,1460,0.745723,0,2,18558854,18557294,1560
20437081,1702.68,1677.53,1704,1460,0.91907,0,2,18567014,18565310,1704
20438541,1772.33,1702.68,1776,1460,0.949628,0,2,18568790,18567014,1776
20447301,1161.66,1345.26,1152,1460,0.490884,0,1,18578558,18577406,1152
20461901,1439.94,1438.73,1440,1460,0.703576,0,2,18591686,18590246,1440
20463361,1508.4,1439.94,1512,1460,0.73143,0,2,18593198,18591686,1512
20464821,1534.62,1508.4,1536,1460,0.766572,0,2,18594734,18593198,1536
20472121,1726.73,1702.67,1728,1460,0.903847,0,2,18603062,18601334,1728
20492561,1487.76,1483.19,1488,1460,0.728334,0,2,18623222,18621734,1488
20494021,1533.59,1487.76,1536,1460,0.729334,0,2,18624758,18623222,1536
20502781,1701.6,1655.93,1704,1460,0.918307,0,2,18634478,18632774,1704
20504241,1772.28,1701.6,1776,1460,0.925323,0,2,18636254,18634478,1776
20526141,1724.34,1654.74,1728,1460,0.909985,0,2,18659510,18657782,1728
20527601,1750.62,1724.34,1752,1460,0.945994,0,2,18661262,18659510,1752
20536361,1118.05,1385.09,1104,1460,0.468901,0,1,18670814,18669710,1104
20539281,1174.72,1150.3,1176,1460,0.477024,0,1,18673142,18671966,1176
20550961,1461.54,1414.73,1464,1460,0.705249,0,2,18683894,18682430,1464
20552421,1509.48,1461.54,1512,1460,0.7201,0,2,18685406,18683894,1512
20553881,1511.87,1509.48,1512,1460,0.77404,0,2,18686918,18685406,1512
20555341,1603.19,1511.87,1608,1460,0.795616,0,2,18688526,18686918,1608
20561181,1703.93,1702.62,1704,1460,0.910816,0,2,18695222,18693518,1704
20562641,1749.6,1703.93,1752,1460,0.934326,0,2,18696974,18695222,1752
20564101,1774.68,1749.6,1776,1460,0.943731,0,2,18698750,18696974,1776
20574321,1508.34,1438.83,1512,1460,0.709346,0,2,18709622,18708110,1512
20583081,1725.47,1677.48,1728,1460,0.911809,0,2,18719342,18717614,1728
20591841,1081.74,1570.86,1056,1460,0.454499,0,1,18729110,18728054,1056
20594761,1103.94,1102.89,1104,1460,0.43632,0,1,18731318,18730214,1104
20596221,1172.4,1103.94,1176,1460,0.456528,0,1,18732494,18731318,1176
20597681,1198.62,1172.4,1200,1460,0.476611,0,1,18733694,18732494,1200
20599141,1222.73,1198.62,1224,1460,0.496644,0,1,18734918,18733694,1224
20607901,1483.2,1391.94,1488,1460,0.708101,0,2,18743150,18741662,1488
20609361,1510.56,1483.2,1512,1460,0.73324,0,2,18744662,18743150,1512
20610821,1534.73,1510.56,1536,1460,0.743296,0,2,18746198,18744662,1536
20612281,1535.94,1534.73,1536,1460,0.771318,0,2,18747734,18746198,1536
20619581,1726.56,1699.25,1728,1460,0.937591,0,2,18755990,18754262,1728
20621041,1796.33,1726.56,1800,1460,0.945036,0,2,18757790,18755990,1800
20637101,1702.62,1676.45,1704,1460,0.906932,0,2,18776126,18774422,1704
20638561,1749.53,1702.62,1752,1460,0.932773,0,2,18777878,18776126,1752
20645861,1500.17,1731.48,1488,1460,0.732268,0,2,18786422,18784934,1488
20656081,1462.62,1436.45,1464,1460,0.707197,0,2,18796190,18794726,1464
20657541,1509.53,1462.62,1512,1460,0.720879,0,2,18797702,18796190,1512
20659001,1511.88,1509.53,1512,1460,0.750352,0,2,18799214,18797702,1512
20660461,1557.59,1511.88,1560,1460,0.798141,0,2,18800774,18799214,1560
20666301,1726.68,1701.53,1728,1460,0.914912,0,2,18807494,18805766,1728
20667761,1750.73,1726.68,1752,1460,0.935965,0,2,18809246,18807494,1752
20679441,1102.7,1078.08,1104,1460,0.402014,0,1,18820238,18819134,1104
20680901,1126.74,1102.7,1128,1460,0.430806,0,1,18821366,18820238,1128
20682361,1173.54,1126.74,1176,1460,0.454322,0,1,18822542,18821366,1176
20683821,1198.68,1173.54,1200,1460,0.487729,0,1,18823742,18822542,1200
20695501,1486.73,1462.62,1488,1460,0.715697,0,2,18834710,18833222,1488
20696961,1510.74,1486.73,1512,1460,0.724279,0,2,18836222,18834710,1512
20698421,1511.94,1510.74,1512,1460,0.775712,0,2,18837734,18836222,1512
20704261,1703.82,1700.33,1704,1460,0.93277,0,2,18844382,18842678,1704
20705721,1795.19,1703.82,1800,1460,0.943108,0,2,18846182,18844382,1800
20713021,1092.01,1320.11,1080,1460,0.460176,0,1,18853934,18852854,1080
20729081,1439.88,1437.6,1440,1460,0.714929,0,2,18868262,18866822,1440
20730541,1531.19,1439.88,1536,1460,0.747972,0,2,18869798,18868262,1536
20732001,1558.56,1531.19,1560,1460,0.785189,0,2,18871358,18869798,1560
20739301,1702.74,1678.79,1704,1460,0.908856,0,2,18879662,18877958,1704
20740761,1749.54,1702.74,1752,1460,0.945543,0,2,18881414,18879662,1752
20762661,1186.68,1389.66,1176,1460,0.452223,0,1,18906446,18905270,1176
20764121,1085.33,1186.68,1080,1460,0.438889,0,1,18907526,18906446,1080
20767041,1197.43,1148.67,1200,1460,0.465022,0,1,18909878,18908678,1200
20768501,1199.87,1197.43,1200,1460,0.468009,0,1,18911078,18909878,1200
20778721,1438.68,1413.54,1440,1460,0.711307,0,2,18920462,18919022,1440
20780181,1531.13,1438.68,1536,1460,0.734523,0,2,18921998,18920462,1536
20781641,1535.76,1531.13,1536,1460,0.767809,0,2,18923534,18921998,1536
20783101,1581.59,1535.76,1584,1460,0.793124,0,2,18925118,18923534,1584
20790401,1726.68,1701.65,1728,1460,0.939965,0,2,18933494,18931766,1728
20809381,1127.7,1121.94,1128,1460,0.415252,0,1,18950222,18949094,1128
20810841,1150.78,1127.7,1152,1460,0.436101,0,1,18951374,18950222,1152
20812301,1174.74,1150.78,1176,1460,0.46844,0,1,18952550,18951374,1176
20822521,1460.4,1391.93,1464,1460,0.703091,0,2,18961958,18960494,1464
20823981,1509.42,1460.4,1512,1460,0.743236,0,2,18963470,18961958,1512
20834201,1725.48,1677.6,1728,1460,0.924603,0,2,18974822,18973094,1728
20842961,1234.62,1436.4,1224,1460,0.416109,0,1,18984710,18983486,1224
20847341,1102.59,1075.83,1104,1460,0.401751,0,1,18987878,18986774,1104
20848801,1126.73,1102.59,1128,1460,0.4067,0,1,18989006,18987878,1128
20850261,1127.94,1126.73,1128,1460,0.44468,0,1,18990134,18989006,1128
20851721,1196.4,1127.94,1200,1460,0.471872,0,1,18991334,18990134,1200
20864861,1534.56,1507.25,1536,1460,0.753382,0,2,19003718,19002182,1536
20866321,1558.73,1534.56,1560,1460,0.763353,0,2,19005278,19003718,1560
20873621,1702.68,1677.59,1704,1460,0.931558,0,2,19013486,19011782,1704
20894061,1483.19,1391.82,1488,1460,0.707267,0,2,19033910,19032422,1488
20895521,1510.56,1483.19,1512,1460,0.744907,0,2,19035422,19033910,1512
20896981,1557.53,1510.56,1560,1460,0.747963,0,2,19036982,19035422,1560
20905741,1726.68,1701.59,1728,1460,0.927453,0,2,19046846,19045118,1728
20920341,1174.62,1148.44,1176,1460,0.457852,0,1,19061174,19059998,1176
20921801,1198.73,1174.62,1200,1460,0.489141,0,1,19062374,19061174,1200
20933481,1486.62,1460.45,1488,1460,0.73859,0,2,19073294,19071806,1488
20934941,1556.33,1486.62,1560,1460,0.757436,0,2,19074854,19073294,1560
20942241,1726.62,1700.39,1728,1460,0.902217,0,2,19083110,19081382,1728
20943701,1727.93,1726.62,1728,1460,0.942887,0,2,19084838,19083110,1728
20956841,1151.84,1148.76,1152,1460,0.45468,0,1,19097678,19096526,1152
20958301,1197.59,1151.84,1200,1460,0.463872,0,1,19098878,19097678,1200
20959761,1199.88,1197.59,1200,1460,0.491549,0,1,19100078,19098878,1200
20969981,1439.99,1439.76,1440,1460,0.703791,0,2,19109678,19108238,1440
20971441,1508.4,1439.99,1512,1460,0.755516,0,2,19111190,19109678,1512
20972901,1580.22,1508.4,1584,1460,0.788206,0,2,19112774,19111190,1584
20980201,1725.54,1678.74,1728,1460,0.91338,0,2,19121078,19119350,1728
20981661,1750.68,1725.54,1752,1460,0.935352,0,2,19122830,19121078,1752
20988961,1150.2,1572,1128,1460,0.467853,0,1,19130894,19129766,1128
21003561,1507.19,1415.82,1512,1460,0.703305,0,2,19143926,19142414,1512
21013781,1703.82,1700.33,1704,1460,0.909006,0,2,19155158,19153454,1704
21015241,1749.59,1703.82,1752,1460,0.921602,0,2,19156910,19155158,1752
21022541,1567.39,1707.71,1560,1460,0.793748,0,2,19165526,19163966,1560
21024001,1560.37,1567.39,1560,1460,0.791499,0,2,19167086,19165526,1560
21041521,1159.72,1306.38,1152,1460,0.478201,0,1,19186478,19185326,1152
21044441,1175.96,1175.19,1176,1460,0.490512,0,1,19188830,19187654,1176
21056121,1486.67,1461.47,1488,1460,0.714627,0,2,19199654,19198166,1488
21057581,1510.73,1486.67,1512,1460,0.735851,0,2,19201166,19199654,1512
21059041,1534.74,1510.73,1536,1460,0.76834,0,2,19202702,19201166,1536
21064881,1679.93,1678.61,1680,1460,0.91463,0,2,19209302,19207622,1680
21066341,1771.2,1679.93,1776,1460,0.947852,0,2,19211078,19209302,1776
21072181,1572.06,1801.14,1560,1460,0.718201,0,2,19218062,19216502,1560
21082401,1558.62,1532.46,1560,1460,0.799166,0,2,19228358,19226798,1560
21088241,1748.34,1678.73,1752,1460,0.917819,0,2,19235078,19233326,1752
21089701,1751.82,1748.34,1752,1460,0.925128,0,2,19236830,19235078,1752
21098461,889.2,1368,864,1460,0.279933,0,1,19246262,19245398,864
21099921,865.26,889.2,864,1460,0.273973,0,1,19247126,19246262,864
21102841,959.763,955.263,960,1460,0.282636,0,1,19249046,19248086,960
21110141,1125.59,1079.87,1128,1460,0.414091,0,1,19254350,19253222,1128
21111601,1150.68,1125.59,1152,1460,0.435636,0,1,19255502,19254350,1152
21113061,1174.73,1150.68,1176,1460,0.468255,0,1,19256678,19255502,1176
21126201,1486.68,1461.65,1488,1460,0.752023,0,2,19268990,19267502,1488
21127661,1579.13,1486.68,1584,1460,0.762809,0,2,19270574,19268990,1584
21134961,1725.59,1679.81,1728,1460,0.925581,0,2,19278830,19277102,1728
21136421,1773.48,1725.59,1776,1460,0.940232,0,2,19280606,19278830,1776
21145181,838.929,1274.58,816,1460,0.296596,0,1,19289894,19289078,816
21148101,935.757,931.146,936,1460,0.269455,0,1,19291766,19290830,936
21149561,958.788,935.757,960,1460,0.293782,0,1,19292726,19291766,960
21156861,1149.48,1101.65,1152,1460,0.408772,0,1,19298126,19296974,1152
21190441,1275.61,1344.11,1272,1460,0.452715,0,1,19332590,19331318,1272
21191901,1066.98,1275.61,1056,1460,0.403086,0,1,19333646,19332590,1056
21194821,1171.17,1079.35,1176,1460,0.466494,0,1,19335902,19334726,1176
21196281,1221.36,1171.17,1224,1460,0.480597,0,1,19337126,19335902,1224
21206501,1460.33,1390.68,1464,1460,0.701728,0,2,19346462,19344998,1464
21207961,1509.42,1460.33,1512,1460,0.706691,0,2,19347974,19346462,1512
21218181,1726.68,1701.54,1728,1460,0.915305,0,2,19359374,19357646,1728
21219641,1750.73,1726.68,1752,1460,0.942122,0,2,19361126,19359374,1752
21225481,1388.46,1777.19,1368,1460,0.71143,0,2,19367870,19366502,1368
21228401,1486.61,1460.22,1488,1460,0.722229,0,2,19370822,19369334,1488
21229861,1510.73,1486.61,1512,1460,0.762892,0,2,19372334,19370822,1512
21231321,1580.34,1510.73,1584,1460,0.791157,0,2,19373918,19372334,1584
21238621,1725.54,1678.79,1728,1460,0.925717,0,2,19382246,19380518,1728
21240081,1773.48,1725.54,1776,1460,0.934287,0,2,19384022,19382246,1776
21256141,1486.62,1460.39,1488,1460,0.702554,0,2,19400294,19398806,1488
21257601,1487.93,1486.62,1488,1460,0.755021,0,2,19401782,19400294,1488
21259061,1579.2,1487.93,1584,1460,0.788009,0,2,19403366,19401782,1584
21264901,1725.48,1677.54,1728,1460,0.923965,0,2,19410014,19408286,1728
21266361,1773.47,1725.48,1776,1460,0.927586,0,2,19411790,19410014,1776
21273661,1406.7,1685.99,1392,1460,0.710366,0,2,19420214,19418822,1392
21279501,1534.62,1508.45,1536,1460,0.779993,0,2,19426166,19424630,1536
21280961,1604.33,1534.62,1608,1460,0.785997,0,2,19427774,19426166,1608
21285341,1679.76,1675.25,1680,1460,0.900624,0,2,19432718,19431038,1680
21286801,1748.39,1679.76,1752,1460,0.918249,0,2,19434470,19432718,1752
21288261,1751.82,1748.39,1752,1460,0.9493,0,2,19436222,19434470,1752
21310161,1557.42,1508.45,1560,1460,0.783518,0,2,19458470,19456910,1560
21311621,1605.47,1557.42,1608,1460,0.799407,0,2,19460078,19458470,1608
21323301,1616.51,1778.16,1608,1460,0.749544,0,2,19473638,19472030,1608
21324761,1448.83,1616.51,1440,1460,0.713818,0,2,19475078,19473638,1440
21327681,1486.76,1463.24,1488,1460,0.722611,0,2,19478030,19476542,1488
21329141,1510.74,1486.76,1512,1460,0.775044,0,2,19479542,19478030,1512
21330601,1603.14,1510.74,1608,1460,0.796018,0,2,19481150,19479542,1608
21349581,1487.79,1483.85,1488,1460,0.74641,0,2,19502630,19501142,1488
21351041,1556.39,1487.79,1560,1460,0.748564,0,2,19504190,19502630,1560
21365641,1754.46,1801.19,1752,1460,0.770869,0,2,19521302,19519550,1752
21375861,1101.53,1054.62,1104,1460,0.418047,0,1,19529006,19527902,1104
21377321,1172.28,1101.53,1176,1460,0.425219,0,1,19530182,19529006,1176
21381701,1223.82,1220.45,1224,1460,0.497854,0,1,19533782,19532558,1224
21390461,1437.54,1390.73,1440,1460,0.709185,0,2,19541870,19540430,1440
21391921,1531.08,1437.54,1536,1460,0.745674,0,2,19543406,19541870,1536
21393381,1558.55,1531.08,1560,1460,0.77227,0,2,19544966,19543406,1560
21441561,1463.82,1460.45,1464,1460,0.725533,0,2,19597046,19595582,1464
21443021,1532.39,1463.82,1536,1460,0.728213,0,2,19598582,19597046,1536
21450321,1678.74,1654.79,1680,1460,0.912478,0,2,19606694,19605014,1680
21451781,1771.14,1678.74,1776,1460,0.922991,0,2,19608470,19606694,1776
21462001,1205.55,1311,1200,1460,0.442399,0,1,19619726,19618526,1200
21463461,1086.28,1205.55,1080,1460,0.43496,0,1,19620806,19619726,1080
21466381,1151.84,1148.71,1152,1460,0.442794,0,1,19623110,19621958,1152
21467841,1174.79,1151.84,1176,1460,0.459117,0,1,19624286,19623110,1176
21469301,1198.74,1174.79,1200,1460,0.477647,0,1,19625486,19624286,1200
21499961,848.616,1012.31,840,1460,0.24846,0,1,19656902,19656062,840
21508721,1150.56,1123.24,1152,1460,0.445162,0,1,19663094,19661942,1152
21510181,1197.53,1150.56,1200,1460,0.472065,0,1,19664294,19663094,1200
21524781,1533.48,1485.65,1536,1460,0.788693,0,2,19678166,19676630,1536
21539381,1570.86,1777.25,1560,1460,0.765941,0,2,19695158,19693598,1560
21551061,1485.59,1439.87,1488,1460,0.726233,0,2,19706414,19704926,1488
21552521,1533.48,1485.59,1536,1460,0.752493,0,2,19707950,19706414,1536
21553981,1558.67,1533.48,1560,1460,0.786997,0,2,19709510,19707950,1560
21559821,1679.88,1677.53,1680,1460,0.902339,0,2,19716110,19714430,1680
21561281,1748.39,1679.88,1752,1460,0.918936,0,2,19717862,19716110,1752
21577341,1485.47,1437.41,1488,1460,0.723538,0,2,19734710,19733222,1488
21578801,1533.47,1485.47,1536,1460,0.763415,0,2,19736246,19734710,1536
21580261,1581.47,1533.47,1584,1460,0.791366,0,2,19737830,19736246,1584
21587561,1725.54,1678.74,1728,1460,0.937412,0,2,19746134,19744406,1728
21594861,1050.96,1411.26,1032,1460,0.424194,0,1,19753934,19752902,1032
21603621,886.674,861.479,888,1460,0.21638,0,1,19759094,19758206,888
21605081,910.734,886.674,912,1460,0.248552,0,1,19760006,19759094,912
21606541,957.537,910.734,960,1460,0.273421,0,1,19760966,19760006,960
21613841,1148.28,1077.59,1152,1460,0.417261,0,1,19766246,19765094,1152
21615301,1151.81,1148.28,1152,1460,0.448904,0,1,19767398,19766246,1152
21616761,1197.59,1151.81,1200,1460,0.485562,0,1,19768598,19767398,1200
21631361,1556.34,1486.85,1560,1460,0.770647,0,2,19782494,19780934,1560
21637201,1703.93,1702.56,1704,1460,0.910177,0,2,19789166,19787462,1704
21638661,1749.6,1703.93,1752,1460,0.946071,0,2,19790918,19789166,1752
21640121,1797.48,1749.6,1800,1460,0.948428,0,2,19792718,19790918,1800
21657641,1485.53,1438.67,1488,1460,0.700663,0,2,19810166,19808678,1488
21659101,1487.88,1485.53,1488,1460,0.730265,0,2,19811654,19810166,1488
21660561,1533.59,1487.88,1536,1460,0.754106,0,2,19813190,19811654,1536
21662021,1558.68,1533.59,1560,1460,0.787642,0,2,19814750,19813190,1560
21667861,1725.48,1677.53,1728,1460,0.911956,0,2,19821398,19819670,1728
21669321,1750.67,1725.48,1752,1460,0.946782,0,2,19823150,19821398,1752
21675161,1616.46,1777.19,1608,1460,0.736126,0,2,19830134,19828526,1608
21676621,1426.02,1616.46,1416,1460,0.73245,0,2,19831550,19830134,1416
21679541,1534.59,1507.7,1536,1460,0.771192,0,2,19834598,19833062,1536
21681001,1581.53,1534.59,1584,1460,0.794477,0,2,19836182,19834598,1584
21688301,1751.71,1746.11,1752,1460,0.947851,0,2,19844606,19842854,1752
21695601,1594.86,1801.2,1584,1460,0.798144,0,2,19853438,19851854,1584
21704361,1701.54,1654.74,1704,1460,0.917759,0,2,19863182,19861478,1704
21705821,1772.28,1701.54,1776,1460,0.925104,0,2,19864958,19863182,1776
21713121,1519.62,1664.39,1512,1460,0.769687,0,2,19873526,19872014,1512
21716041,1558.76,1535.18,1560,1460,0.78195,0,2,19876622,19875062,1560
21732101,1566.07,1681.5,1560,1460,0.753468,0,2,19895294,19893734,1560
21733561,1491.9,1566.07,1488,1460,0.751387,0,2,19896782,19895294,1488
21736481,1604.29,1533.8,1608,1460,0.788622,0,2,19899926,19898318,1608
21743781,1748.29,1677.71,1752,1460,0.936031,0,2,19908254,19906502,1752
21749621,1593.66,1777.19,1584,1460,0.72289,0,2,19915214,19913630,1584
21754001,1507.17,1415.3,1512,1460,0.733865,0,2,19919534,19918022,1512
21755461,1534.56,1507.17,1536,1460,0.743546,0,2,19921070,19919534,1536
21756921,1535.93,1534.56,1536,1460,0.759418,0,2,19922606,19921070,1536
21764221,1703.82,1700.39,1704,1460,0.909437,0,2,19930838,19929134,1704
21771521,1251.66,1777.25,1224,1460,0.493719,0,1,19939214,19937990,1224
21772981,1088.58,1251.66,1080,1460,0.479488,0,1,19940294,19939214,1080
21787581,1486.62,1460.39,1488,1460,0.714288,0,2,19953662,19952174,1488
21789041,1510.73,1486.62,1512,1460,0.735715,0,2,19955174,19953662,1512
21790501,1534.74,1510.73,1536,1460,0.780286,0,2,19956710,19955174,1536
21797801,1725.6,1679.93,1728,1460,0.938374,0,2,19965062,19963334,1728
21805101,1519.62,1664.34,1512,1460,0.744787,0,2,19973654,19972142,1512
21813861,1702.62,1676.45,1704,1460,0.906754,0,2,19983326,19981622,1704
21815321,1749.53,1702.62,1752,1460,0.920702,0,2,19985078,19983326,1752
21824081,1180.75,1271.1,1176,1460,0.497812,0,1,19994606,19993430,1176
21864961,1509.54,1462.85,1512,1460,0.746291,0,2,20031857,20030345,1512
21866421,1557.48,1509.54,1560,1460,0.748516,0,2,20033417,20031857,1560
21879561,1726.68,1701.65,1728,1460,0.940258,0,2,20048129,20046401,1728
21881021,1796.33,1726.68,1800,1460,0.946103,0,2,20049929,20048129,1800
21886861,1663.25,1801.08,1656,1460,0.737356,0,2,20056985,20055329,1656
21891241,1137.81,1324.28,1128,1460,0.482311,0,1,20060825,20059697,1128
21894161,1199.84,1196.89,1200,1460,0.49597,0,1,20063225,20062025,1200
21913141,1463.94,1462.79,1464,1460,0.724179,0,2,20080721,20079257,1464
21914601,1532.4,1463.94,1536,1460,0.727671,0,2,20082257,20080721,1536
21937961,1584.37,1591.32,1584,1460,0.71499,0,2,20109017,20107433,1584
21942341,1486.7,1462.02,1488,1460,0.720399,0,2,20113385,20111897,1488
21943801,1510.74,1486.7,1512,1460,0.73816,0,2,20114897,20113385,1512
21945261,1534.74,1510.74,1536,1460,0.745264,0,2,20116433,20114897,1536
21946721,1535.94,1534.74,1536,1460,0.748106,0,2,20117969,20116433,1536
21948181,1536,1535.94,1536,1460,0.785242,0,2,20119505,20117969,1536
21956941,1726.62,1700.4,1728,1460,0.902654,0,2,20129417,20127689,1728
21958401,1727.93,1726.62,1728,1460,0.931062,0,2,20131145,20129417,1728
21965701,1141.71,1573.14,1119,1460,0.466753,0,1,20139224,20138105,1119
21967161,1105.89,1141.71,1104,1460,0.432701,0,1,20140328,20139224,1104
21970081,1150.74,1126.89,1152,1460,0.454432,0,1,20142608,20141456,1152
21990521,1463.88,1461.65,1464,1460,0.723166,0,2,20161184,20159720,1464
21991981,1532.39,1463.88,1536,1460,0.739266,0,2,20162720,20161184,1536
21993441,1535.82,1532.39,1536,1460,0.757706,0,2,20164256,20162720,1536
21994901,1558.79,1535.82,1560,1460,0.765083,0,2,20165816,20164256,1560
22006581,1726.79,1703.88,1728,1460,0.905479,0,2,20179040,20177312,1728
22008041,1727.94,1726.79,1728,1460,0.944192,0,2,20180768,20179040,1728
22016801,899.289,1113.78,888,1460,0.285326,0,1,20189936,20189048,888
22021181,935.938,934.768,936,1460,0.276261,0,1,20192720,20191784,936
22022641,981.597,935.938,984,1460,0.284504,0,1,20193704,20192720,984
22024101,983.88,981.597,984,1460,0.299802,0,1,20194688,20193704,984
22031401,1102.8,1079.93,1104,1460,0.409774,0,1,20200016,20198912,1104
22032861,1149.54,1102.8,1152,1460,0.42191,0,1,20201168,20200016,1152
22034321,1151.88,1149.54,1152,1460,0.438764,0,1,20202320,20201168,1152
22035781,1174.79,1151.88,1176,1460,0.469506,0,1,20203496,20202320,1176
22037241,1221.54,1174.79,1224,1460,0.493802,0,1,20204720,20203496,1224
22056221,1486.74,1462.74,1488,1460,0.716641,0,2,20222312,20220824,1488
22057681,1510.74,1486.74,1512,1460,0.748656,0,2,20223824,20222312,1512
22059141,1557.54,1510.74,1560,1460,0.773463,0,2,20225384,20223824,1560
22060601,1582.68,1557.54,1584,1460,0.795385,0,2,20226968,20225384,1584
22092721,1557.48,1509.65,1560,1460,0.773069,0,2,20261912,20260352,1560
22094181,1582.67,1557.48,1584,1460,0.783228,0,2,20263496,20261912,1584
22104401,1726.74,1702.8,1728,1460,0.905206,0,2,20275184,20273456,1728
22105861,1727.94,1726.74,1728,1460,0.944082,0,2,20276912,20275184,1728
22107321,1796.4,1727.94,1800,1460,0.947633,0,2,20278712,20276912,1800
22126301,1463.94,1462.73,1464,1460,0.723753,0,2,20297456,20295992,1464
22127761,1532.4,1463.94,1536,1460,0.739501,0,2,20298992,20297456,1536
22129221,1535.82,1532.4,1536,1460,0.757801,0,2,20300528,20298992,1536
22130681,1558.79,1535.82,1560,1460,0.76512,0,2,20302088,20300528,1560
22152581,902.766,1183.32,888,1460,0.290171,0,1,20326352,20325464,888
22156961,911.999,911.977,912,1460,0.269851,0,1,20329088,20328176,912
22158421,980.4,911.999,984,1460,0.29394,0,1,20330072,20329088,984
22170101,1104,1104,1104,1460,0.425539,0,1,20338592,20337488,1104
22171561,1172.4,1104,1176,1460,0.440216,0,1,20339768,20338592,1176
22173021,1175.82,1172.4,1176,1460,0.446086,0,1,20340944,20339768,1176
22174481,1175.99,1175.82,1176,1460,0.460434,0,1,20342120,20340944,1176
22175941,1198.8,1175.99,1200,1460,0.490174,0,1,20343320,20342120,1200
22192001,1486.73,1462.68,1488,1460,0.704301,0,2,20358272,20356784,1488
22193461,1487.94,1486.73,1488,1460,0.73172,0,2,20359760,20358272,1488
22194921,1533.6,1487.94,1536,1460,0.754688,0,2,20361296,20359760,1536
22196381,1558.68,1533.6,1560,1460,0.775875,0,2,20362856,20361296,1560
22197841,1582.73,1558.68,1584,1460,0.78435,0,2,20364440,20362856,1584
22206601,1725.6,1679.99,1728,1460,0.927003,0,2,20374424,20372696,1728
22224121,1200,1199.93,1200,1460,0.49651,0,1,20392928,20391728,1200
22240181,1486.73,1462.68,1488,1460,0.716347,0,2,20407928,20406440,1488
22241641,1510.74,1486.73,1512,1460,0.724539,0,2,20409440,20407928,1512
22243101,1511.94,1510.74,1512,1460,0.763816,0,2,20410952,20409440,1512
22244561,1580.4,1511.94,1584,1460,0.791526,0,2,20412536,20410952,1584
22254781,1704,1703.93,1704,1460,0.924843,0,2,20424152,20422448,1704
22256241,1772.4,1704,1776,1460,0.939937,0,2,20425928,20424152,1776
22262081,1776.11,1778.28,1776,1460,0.749294,0,2,20433080,20431304,1776
22282521,1486.73,1462.69,1488,1460,0.716625,0,2,20452040,20450552,1488
22283981,1510.74,1486.73,1512,1460,0.73665,0,2,20453552,20452040,1512
22285441,1534.74,1510.74,1536,1460,0.76866,0,2,20455088,20453552,1536
22286901,1581.54,1534.74,1584,1460,0.769464,0,2,20456672,20455088,1584
22297121,1725.54,1678.85,1728,1460,0.926225,0,2,20468192,20466464,1728
22307341,983.76,1435.2,960,1460,0.279445,0,1,20479472,20478512,960
22310261,679.619,824.388,672,1460,0.0819112,0,1,20480960,20480288,672
22313181,695.959,695.181,696,1460,0.0911058,0,1,20482352,20481656,696
22326321,910.68,885.603,912,1460,0.236153,0,1,20489768,20488856,912
22327781,934.734,910.68,936,1460,0.244461,0,1,20490704,20489768,936
22329241,935.937,934.734,936,1460,0.271785,0,1,20491640,20490704,936
22339461,1127.82,1124.4,1128,1460,0.41786,0,1,20499056,20497928,1128
22340921,1150.79,1127.82,1152,1460,0.425144,0,1,20500208,20499056,1152
22342381,1151.94,1150.79,1152,1460,0.452058,0,1,20501360,20500208,1152
22343841,1197.6,1151.94,1200,1460,0.486823,0,1,20502560,20501360,1200
22361361,1487.82,1484.4,1488,1460,0.717773,0,2,20518856,20517368,1488
22367201,1559.82,1556.46,1560,1460,0.778359,0,2,20524976,20523416,1560
22368661,1582.79,1559.82,1584,1460,0.785344,0,2,20526560,20524976,1584
22375961,1703.88,1701.53,1704,1460,0.922471,0,2,20534840,20533136,1704
22377421,1772.39,1703.88,1776,1460,0.938988,0,2,20536616,20534840,1776
22383261,1800.05,1801.08,1800,1460,0.921014,0,2,20543816,20542016,1800
22384721,1731.6,1800.05,1728,1460,0.794406,0,2,20545544,20543816,1728
22386181,1500.18,1731.6,1488,1460,0.779762,0,2,20547032,20545544,1488
22400781,1485.53,1438.68,1488,1460,0.701315,0,2,20560952,20559464,1488
22406621,1557.48,1509.66,1560,1460,0.77333,0,2,20566976,20565416,1560
22408081,1582.67,1557.48,1584,1460,0.783332,0,2,20568560,20566976,1584
22416841,1703.94,1702.79,1704,1460,0.924119,0,2,20578544,20576840,1704
22425601,1286.94,1570.86,1272,1460,0.496628,0,1,20588528,20587256,1272
22428521,899.257,1113.15,888,1460,0.27986,0,1,20590520,20589632,888
22446041,1173.54,1126.85,1176,1460,0.454224,0,1,20602976,20601800,1176
22470861,1558.63,1532.51,1560,1460,0.775341,0,2,20626184,20624624,1560
22482541,1749.48,1701.65,1752,1460,0.921097,0,2,20639408,20637656,1752
22484001,1751.87,1749.48,1752,1460,0.938439,0,2,20641160,20639408,1752
22500061,1487.82,1484.33,1488,1460,0.71736,0,2,20657504,20656016,1488
22501521,1510.79,1487.82,1512,1460,0.724944,0,2,20659016,20657504,1512
22502981,1511.94,1510.79,1512,1460,0.763978,0,2,20660528,20659016,1512
22504441,1580.4,1511.94,1584,1460,0.767591,0,2,20662112,20660528,1584
22514661,1703.94,1702.79,1704,1460,0.923913,0,2,20673632,20671928,1704
22516121,1772.4,1703.94,1776,1460,0.927565,0,2,20675408,20673632,1776
22526341,893.301,994.017,888,1460,0.247292,0,1,20686016,20685128,888
22527801,865.465,893.301,864,1460,0.236917,0,1,20686880,20686016,864
22530721,934.684,909.673,936,1460,0.283907,0,1,20688728,20687792,936
22542401,1102.8,1079.94,1104,1460,0.409945,0,1,20697056,20695952,1104
22543861,1149.54,1102.8,1152,1460,0.421978,0,1,20698208,20697056,1152
22545321,1151.88,1149.54,1152,1460,0.450791,0,1,20699360,20698208,1152
22546781,1197.59,1151.88,1200,1460,0.462316,0,1,20700560,20699360,1200
22562841,1486.68,1461.53,1488,1460,0.715333,0,2,20715416,20713928,1488
22564301,1510.73,1486.68,1512,1460,0.724133,0,2,20716928,20715416,1512
22565761,1511.94,1510.73,1512,1460,0.751653,0,2,20718440,20716928,1512
22567221,1557.6,1511.94,1560,1460,0.762661,0,2,20720000,20718440,1560
22578901,1726.68,1701.59,1728,1460,0.915667,0,2,20733056,20731328,1728
22580361,1750.73,1726.68,1752,1460,0.924267,0,2,20734808,20733056,1752
22587661,1754.4,1800.05,1752,1460,0.771119,0,2,20743736,20741984,1752
22593501,1485.49,1437.7,1488,1460,0.728653,0,2,20749472,20747984,1488
22594961,1533.47,1485.49,1536,1460,0.729461,0,2,20751008,20749472,1536
22599341,1559.88,1557.65,1560,1460,0.791405,0,2,20755640,20754080,1560
22611021,1797.42,1748.46,1800,1460,0.94805,0,2,20769176,20767376,1800
22634381,1485.6,1439.94,1488,1460,0.726749,0,2,20792240,20790752,1488
22635841,1533.48,1485.6,1536,1460,0.740699,0,2,20793776,20792240,1536
22637301,1535.87,1533.48,1536,1460,0.77028,0,2,20795312,20793776,1536
22638761,1581.59,1535.87,1584,1460,0.782112,0,2,20796896,20795312,1584
22648981,1703.88,1701.59,1704,1460,0.911034,0,2,20808440,20806736,1704
22650441,1749.59,1703.88,1752,1460,0.934414,0,2,20810192,20808440,1752
22678181,1485.54,1438.8,1488,1460,0.701851,0,2,20837936,20836448,1488
22679641,1487.88,1485.54,1488,1460,0.70674,0,2,20839424,20837936,1488
22681101,1487.99,1487.88,1488,1460,0.732696,0,2,20840912,20839424,1488
22682561,1533.6,1487.99,1536,1460,0.755078,0,2,20842448,20840912,1536
22692781,1725.54,1678.74,1728,1460,0.901562,0,2,20853944,20852216,1728
22694241,1727.88,1725.54,1728,1460,0.906625,0,2,20855672,20853944,1728
22695701,1727.99,1727.88,1728,1460,0.94465,0,2,20857400,20855672,1728
22721981,1175.82,1172.45,1176,1460,0.457973,0,1,20879960,20878784,1176
22723441,1198.79,1175.82,1200,1460,0.465189,0,1,20881160,20879960,1200
22724901,1199.94,1198.79,1200,1460,0.492076,0,1,20882360,20881160,1200
22742421,1486.79,1463.82,1488,1460,0.717263,0,2,20898776,20897288,1488
22743881,1510.74,1486.79,1512,1460,0.736905,0,2,20900288,20898776,1512
22745341,1534.74,1510.74,1536,1460,0.756762,0,2,20901824,20900288,1536
22746801,1558.74,1534.74,1560,1460,0.776705,0,2,20903384,20901824,1560
22748261,1582.74,1558.74,1584,1460,0.796682,0,2,20904968,20903384,1584
22755561,1703.94,1702.73,1704,1460,0.911662,0,2,20913320,20911616,1704
22757021,1749.6,1703.94,1752,1460,0.922665,0,2,20915072,20913320,1752
22758481,1751.88,1749.6,1752,1460,0.927066,0,2,20916824,20915072,1752
22771621,1105.97,1143.35,1104,1460,0.434824,0,1,20930648,20929544,1104
22774541,1151.88,1149.7,1152,1460,0.466772,0,1,20932952,20931800,1152
22776001,1220.39,1151.88,1224,1460,0.468709,0,1,20934176,20932952,1224
22794981,1486.79,1463.82,1488,1460,0.717001,0,2,20951600,20950112,1488
22796441,1510.74,1486.79,1512,1460,0.736801,0,2,20953112,20951600,1512
22797901,1534.74,1510.74,1536,1460,0.74472,0,2,20954648,20953112,1536
22799361,1535.94,1534.74,1536,1460,0.771888,0,2,20956184,20954648,1536
22800821,1581.6,1535.94,1584,1460,0.782755,0,2,20957768,20956184,1584
22808121,1702.68,1677.65,1704,1460,0.908063,0,2,20966024,20964320,1704
22809581,1749.53,1702.68,1752,1460,0.921225,0,2,20967776,20966024,1752
22834401,1486.68,1461.6,1488,1460,0.715844,0,2,20993456,20991968,1488
22835861,1510.73,1486.68,1512,1460,0.748338,0,2,20994968,20993456,1512
22837321,1557.54,1510.73,1560,1460,0.761335,0,2,20996528,20994968,1560
22838781,1559.88,1557.54,1560,1460,0.778534,0,2,20998088,20996528,1560
22840241,1582.79,1559.88,1584,1460,0.797414,0,2,20999672,20998088,1584
22847541,1702.73,1678.68,1704,1460,0.908367,0,2,21007928,21006224,1704
22849001,1749.54,1702.73,1752,1460,0.921347,0,2,21009680,21007928,1752
22850461,1751.88,1749.54,1752,1460,0.938539,0,2,21011432,21009680,1752
22876741,1486.62,1460.4,1488,1460,0.714731,0,2,21038024,21036536,1488
22878201,1510.73,1486.62,1512,1460,0.723892,0,2,21039536,21038024,1512
22879661,1511.94,1510.73,1512,1460,0.739557,0,2,21041048,21039536,1512
22881121,1534.8,1511.94,1536,1460,0.757823,0,2,21042584,21041048,1536
22882581,1558.74,1534.8,1560,1460,0.789129,0,2,21044144,21042584,1560
22884041,1605.54,1558.74,1608,1460,0.789652,0,2,21045752,21044144,1608
22891341,1726.62,1700.39,1728,1460,0.902547,0,2,21054032,21052304,1728
22892801,1727.93,1726.62,1728,1460,0.931019,0,2,21055760,21054032,1728
22894261,1773.6,1727.93,1776,1460,0.942407,0,2,21057536,21055760,1776
22901561,1185.54,1366.85,1176,1460,0.497129,0,1,21065456,21064280,1176
22903021,1176.48,1185.54,1176,1460,0.492851,0,1,21066632,21065456,1176
22923461,1511.88,1509.65,1512,1460,0.751204,0,2,21085784,21084272,1512
22924921,1557.59,1511.88,1560,1460,0.774482,0,2,21087344,21085784,1560
22935141,1703.88,1701.65,1704,1460,0.911206,0,2,21098888,21097184,1704
22936601,1749.59,1703.88,1752,1460,0.934482,0,2,21100640,21098888,1752
22946821,892.164,971.277,888,1460,0.268573,0,1,21111320,21110432,888
22949741,934.75,911.008,936,1460,0.276972,0,1,21113168,21112232,936
22962881,1126.73,1102.68,1128,1460,0.428483,0,1,21122528,21121400,1128
22964341,1173.54,1126.73,1176,1460,0.453393,0,1,21123704,21122528,1176
22965801,1198.68,1173.54,1200,1460,0.475357,0,1,21124904,21123704,1200
22987701,1556.34,1486.86,1560,1460,0.783275,0,2,21145592,21144032,1560
22989161,1605.42,1556.34,1608,1460,0.79931,0,2,21147200,21145592,1608
23013981,1485.6,1439.94,1488,1460,0.703791,0,2,21174800,21173312,1488
23015441,1487.88,1485.6,1488,1460,0.719517,0,2,21176288,21174800,1488
23016901,1510.79,1487.88,1512,1460,0.749807,0,2,21177800,21176288,1512
23018361,1557.54,1510.79,1560,1460,0.773923,0,2,21179360,21177800,1560
23019821,1582.68,1557.54,1584,1460,0.783569,0,2,21180944,21179360,1584
23028581,1702.74,1678.85,1704,1460,0.909432,0,2,21190880,21189176,1704
23030041,1749.54,1702.74,1752,1460,0.921773,0,2,21192632,21190880,1752
23037341,1274.52,1778.33,1248,1460,0.401954,0,1,21201032,21199784,1248
23038801,907.326,1274.52,888,1460,0.286782,0,1,21201920,21201032,888
23040261,888.966,907.326,888,1460,0.252713,0,1,21202808,21201920,888
23043181,957.542,910.848,960,1460,0.267234,0,1,21204680,21203720,960
23044641,959.877,957.542,960,1460,0.292894,0,1,21205640,21204680,960
23053401,1125.54,1078.74,1128,1460,0.413656,0,1,21211976,21210848,1128
23054861,1150.68,1125.54,1152,1460,0.423462,0,1,21213128,21211976,1152
23056321,1151.93,1150.68,1152,1460,0.451385,0,1,21214280,21213128,1152
23057781,1197.6,1151.93,1200,1460,0.474554,0,1,21215480,21214280,1200
23078221,1463.94,1462.74,1464,1460,0.735956,0,2,21234344,21232880,1464
23079681,1555.2,1463.94,1560,1460,0.744383,0,2,21235904,21234344,1560
23091361,1747.2,1656,1752,1460,0.916821,0,2,21248984,21247232,1752
23092821,1751.76,1747.2,1752,1460,0.948729,0,2,21250736,21248984,1752
23111801,1486.74,1462.74,1488,1460,0.716733,0,2,21270416,21268928,1488
23113261,1510.74,1486.74,1512,1460,0.724693,0,2,21271928,21270416,1512
23114721,1511.94,1510.74,1512,1460,0.763877,0,2,21273440,21271928,1512
23116181,1580.4,1511.94,1584,1460,0.767551,0,2,21275024,21273440,1584
23126401,1702.74,1678.79,1704,1460,0.921041,0,2,21286496,21284792,1704
23127861,1772.34,1702.74,1776,1460,0.938416,0,2,21288272,21286496,1776
23129321,1775.82,1772.34,1776,1460,0.945367,0,2,21290048,21288272,1776
23136621,927.96,1687.19,888,1460,0.299207,0,1,21298040,21297152,888
23138081,844.398,927.96,840,1460,0.257683,0,1,21298880,21298040,840
23141001,934.631,908.62,936,1460,0.263229,0,1,21300728,21299792,936
23142461,958.732,934.631,960,1460,0.279292,0,1,21301688,21300728,960
23154141,1150.62,1124.46,1152,1460,0.435093,0,1,21310136,21308984,1152
23159981,1223.82,1220.46,1224,1460,0.49829,0,1,21314912,21313688,1224
23176041,1486.74,1462.74,1488,1460,0.716619,0,2,21329936,21328448,1488
23177501,1510.74,1486.74,1512,1460,0.736648,0,2,21331448,21329936,1512
23178961,1534.74,1510.74,1536,1460,0.744659,0,2,21332984,21331448,1536
23180421,1535.94,1534.74,1536,1460,0.771864,0,2,21334520,21332984,1536
23192101,1726.74,1702.79,1728,1460,0.91694,0,2,21347720,21345992,1728
23193561,1750.74,1726.74,1752,1460,0.936776,0,2,21349472,21347720,1752
23203781,1461.55,1414.9,1464,1460,0.709821,0,2,21360512,21359048,1464
23205241,1509.48,1461.55,1512,1460,0.721928,0,2,21362024,21360512,1512
23206701,1511.87,1509.48,1512,1460,0.738771,0,2,21363536,21362024,1512
23208161,1534.79,1511.87,1536,1460,0.745508,0,2,21365072,21363536,1536
23209621,1535.94,1534.79,1536,1460,0.772203,0,2,21366608,21365072,1536
23211081,1581.6,1535.94,1584,1460,0.794881,0,2,21368192,21366608,1584
23221301,1726.74,1702.85,1728,1460,0.929434,0,2,21379880,21378152,1728
23246121,1486.68,1461.65,1488,1460,0.71621,0,2,21404696,21403208,1488
23247581,1510.73,1486.68,1512,1460,0.736484,0,2,21406208,21404696,1512
23249041,1534.74,1510.73,1536,1460,0.756594,0,2,21407744,21406208,1536
23250501,1558.74,1534.74,1560,1460,0.776637,0,2,21409304,21407744,1560
23259261,1726.67,1701.48,1728,1460,0.903202,0,2,21419216,21417488,1728
23260721,1727.93,1726.67,1728,1460,0.907281,0,2,21420944,21419216,1728
23262181,1728,1727.93,1728,1460,0.920912,0,2,21422672,21420944,1728
23288461,1463.88,1461.59,1464,1460,0.710908,0,2,21448496,21447032,1464
23289921,1509.59,1463.88,1512,1460,0.734363,0,2,21450008,21448496,1512
23291381,1534.68,1509.59,1536,1460,0.755745,0,2,21451544,21450008,1536
23292841,1558.73,1534.68,1560,1460,0.764298,0,2,21453104,21451544,1560
23294301,1559.94,1558.73,1560,1460,0.779719,0,2,21454664,21453104,1560
23303061,1725.54,1678.74,1728,1460,0.913602,0,2,21464576,21462848,1728
23308901,1774.74,1750.86,1776,1460,0.943212,0,2,21471584,21469808,1776
23332261,1510.63,1484.51,1512,1460,0.735404,0,2,21493568,21492056,1512
23333721,1534.73,1510.63,1536,1460,0.744162,0,2,21495104,21493568,1536
23335181,1535.94,1534.73,1536,1460,0.771665,0,2,21496640,21495104,1536
23336641,1581.6,1535.94,1584,1460,0.782666,0,2,21498224,21496640,1584
23338101,1583.88,1581.6,1584,1460,0.799066,0,2,21499808,21498224,1584
23345401,1679.94,1678.79,1680,1460,0.904198,0,2,21508088,21506408,1680
23346861,1748.4,1679.94,1752,1460,0.907679,0,2,21509840,21508088,1752
23364381,1486.68,1461.6,1488,1460,0.716205,0,2,21528440,21526952,1488
23365841,1510.73,1486.68,1512,1460,0.736482,0,2,21529952,21528440,1512
23367301,1534.74,1510.73,1536,1460,0.744593,0,2,21531488,21529952,1536
23368761,1535.94,1534.74,1536,1460,0.771837,0,2,21533024,21531488,1536
23378981,1702.68,1677.65,1704,1460,0.908329,0,2,21544520,21542816,1704
23380441,1749.53,1702.68,1752,1460,0.909332,0,2,21546272,21544520,1752
23389201,1517.33,1618.68,1512,1460,0.740484,0,2,21556520,21555008,1512
23390661,1489.47,1517.33,1488,1460,0.734194,0,2,21558008,21556520,1488
23393581,1580.34,1510.87,1584,1460,0.793071,0,2,21561104,21559520,1584
23414021,1177.51,1206.12,1176,1460,0.482395,0,1,21584072,21582896,1176
23415481,1176.08,1177.51,1176,1460,0.474958,0,1,21585248,21584072,1176
23431541,1485.54,1438.8,1488,1460,0.701934,0,2,21600104,21598616,1488
23433001,1487.88,1485.54,1488,1460,0.718774,0,2,21601592,21600104,1488
23434461,1510.79,1487.88,1512,1460,0.737509,0,2,21603104,21601592,1512
23435921,1534.74,1510.79,1536,1460,0.757004,0,2,21604640,21603104,1536
23437381,1558.74,1534.74,1560,1460,0.788801,0,2,21606200,21604640,1560
23438841,1605.54,1558.74,1608,1460,0.789521,0,2,21607808,21606200,1608
23449061,1726.74,1702.79,1728,1460,0.917044,0,2,21619448,21617720,1728
23450521,1750.74,1726.74,1752,1460,0.948818,0,2,21621200,21619448,1752
23481181,1462.67,1437.47,1464,1460,0.706745,0,2,21651584,21650120,1464
23482641,1509.53,1462.67,1512,1460,0.720698,0,2,21653096,21651584,1512
23484101,1511.88,1509.53,1512,1460,0.738279,0,2,21654608,21653096,1512
23485561,1534.79,1511.88,1536,1460,0.769312,0,2,21656144,21654608,1536
23491401,1725.47,1677.47,1728,1460,0.911486,0,2,21662768,21661040,1728
23492861,1750.67,1725.47,1752,1460,0.946595,0,2,21664520,21662768,1752
23513301,1725.53,1678.62,1728,1460,0.936552,0,2,21687488,21685760,1728
23520601,1157.1,1710,1128,1460,0.468077,0,1,21695768,21694640,1128
23522061,1083.86,1157.1,1080,1460,0.421231,0,1,21696848,21695768,1080
23526441,1127.94,1126.75,1128,1460,0.446719,0,1,21700208,21699080,1128
23527901,1196.4,1127.94,1200,1460,0.460688,0,1,21701408,21700208,1200
23541041,1485.6,1439.93,1488,1460,0.738508,0,2,21713696,21712208,1488
23542501,1556.28,1485.6,1560,1460,0.769403,0,2,21715256,21713696,1560
23551261,1726.79,1703.88,1728,1460,0.941323,0,2,21725264,21723536,1728
23557101,1540.08,1617.59,1536,1460,0.768722,0,2,21732008,21730472,1536
23564401,1750.5,1722.05,1752,1460,0.944284,0,2,21740264,21738512,1752
23581921,1535.77,1531.31,1536,1460,0.781619,0,2,21759440,21757904,1536
23587761,1701.54,1654.73,1704,1460,0.905082,0,2,21766040,21764336,1704
23589221,1749.48,1701.54,1752,1460,0.932033,0,2,21767792,21766040,1752
23596521,1566.24,1684.86,1560,1460,0.792587,0,2,21776384,21774824,1560
23634481,1485.59,1439.76,1488,1460,0.701294,0,2,21815240,21813752,1488
23635941,1487.88,1485.59,1488,1460,0.730518,0,2,21816728,21815240,1488
23637401,1533.59,1487.88,1536,1460,0.742207,0,2,21818264,21816728,1536
23638861,1535.88,1533.59,1536,1460,0.794883,0,2,21819800,21818264,1536
23646161,1726.73,1702.68,1728,1460,0.928136,0,2,21828176,21826448,1728
23647621,1773.54,1726.73,1776,1460,0.935255,0,2,21829952,21828176,1776
23669521,1777.25,1801.02,1776,1460,0.736667,0,2,21854792,21853016,1776
23670981,1365.66,1777.25,1344,1460,0.420667,0,1,21856136,21854792,1344
23672441,911.883,1365.66,888,1460,0.282267,0,1,21857024,21856136,888
23673901,866.394,911.883,864,1460,0.274907,0,1,21857888,21857024,864
23678281,959.988,959.766,960,1460,0.294314,0,1,21860768,21859808,960
23726461,1439.76,1435.25,1440,1460,0.700621,0,2,21907640,21906200,1440
23727921,1508.39,1439.76,1512,1460,0.730248,0,2,21909152,21907640,1512
23729381,1534.62,1508.39,1536,1460,0.778099,0,2,21910688,21909152,1536
23761501,1559.71,1554.11,1560,1460,0.788089,0,2,21944336,21942776,1560
23783401,1124.28,1053.59,1128,1460,0.410261,0,1,21965480,21964352,1128
23784861,1150.61,1124.28,1152,1460,0.446104,0,1,21966632,21965480,1152
23786321,1197.53,1150.61,1200,1460,0.460442,0,1,21967832,21966632,1200
23787781,1199.88,1197.53,1200,1460,0.478177,0,1,21969032,21967832,1200
23799461,1462.73,1438.67,1464,1460,0.707938,0,2,21979832,21978368,1464
23800921,1509.54,1462.73,1512,1460,0.733175,0,2,21981344,21979832,1512
23802381,1534.68,1509.54,1536,1460,0.77927,0,2,21982880,21981344,1536
23803841,1604.33,1534.68,1608,1460,0.797708,0,2,21984488,21982880,1608
23808221,1701.48,1653.59,1704,1460,0.904253,0,2,21989456,21987752,1704
23809681,1749.47,1701.48,1752,1460,0.919701,0,2,21991208,21989456,1752
23816981,1635.9,1709.99,1632,1460,0.772896,0,2,21999944,21998312,1632
23818441,1495.39,1635.9,1488,1460,0.723158,0,2,22001432,21999944,1488
23819901,1465.57,1495.39,1464,1460,0.715263,0,2,22002896,22001432,1464
23822821,1533.54,1486.88,1536,1460,0.744442,0,2,22005920,22004384,1536
23824281,1535.88,1533.54,1536,1460,0.759777,0,2,22007456,22005920,1536
23830121,1679.87,1677.42,1680,1460,0.901642,0,2,22014008,22012328,1680
23831581,1748.39,1679.87,1752,1460,0.918657,0,2,22015760,22014008,1752
23840341,999.666,1753.32,960,1460,0.402418,0,1,22025648,22024688,960
23846181,671.985,671.699,672,1460,0.0627659,0,1,22028648,22027976,672
23847641,717.599,671.985,720,1460,0.0671064,0,1,22029368,22028648,720
23856401,886.734,862.682,888,1460,0.240361,0,1,22034288,22033400,888
23857861,956.337,886.734,960,1460,0.246145,0,1,22035248,22034288,960
23865161,1125.54,1078.73,1128,1460,0.436949,0,1,22040480,22039352,1128
23879761,1439.82,1436.45,1440,1460,0.713747,0,2,22053536,22052096,1440
23881221,1531.19,1439.82,1536,1460,0.723499,0,2,22055072,22053536,1536
23889981,1748.34,1678.73,1752,1460,0.905926,0,2,22064888,22063136,1752
23906041,1195.08,1101.62,1200,1460,0.444704,0,1,22080608,22079408,1200
23920641,1508.28,1437.6,1512,1460,0.729387,0,2,22093928,22092416,1512
23922101,1534.61,1508.28,1536,1460,0.741755,0,2,22095464,22093928,1536
23923561,1535.93,1534.61,1536,1460,0.770702,0,2,22097000,22095464,1536
23929401,1703.87,1701.41,1704,1460,0.92141,0,2,22103648,22101944,1704
23949841,1726.62,1700.45,1728,1460,0.938507,0,2,22126736,22125008,1728
23980501,1701.53,1654.62,1704,1460,0.904639,0,2,22158752,22157048,1704
23981961,1749.48,1701.53,1752,1460,0.919855,0,2,22160504,22158752,1752
23983421,1751.87,1749.48,1752,1460,0.937942,0,2,22162256,22160504,1752
23990721,1232.17,1387.37,1224,1460,0.446453,0,1,22170200,22168976,1224
23992181,1064.81,1232.17,1056,1460,0.400581,0,1,22171256,22170200,1056
23998021,1149.48,1101.66,1152,1460,0.458335,0,1,22175648,22174496,1152
23999481,1220.27,1149.48,1224,1460,0.465334,0,1,22176872,22175648,1224
24021381,1702.79,1679.87,1704,1460,0.921026,0,2,22198976,22197272,1704
24031601,1485.59,1439.82,1488,1460,0.72277,0,2,22210544,22209056,1488
24033061,1510.68,1485.59,1512,1460,0.739108,0,2,22212056,22210544,1512
24034521,1534.73,1510.68,1536,1460,0.781643,0,2,22213592,22212056,1536
24035981,1604.34,1534.73,1608,1460,0.786657,0,2,22215200,22213592,1608
24040361,1678.62,1652.45,1680,1460,0.910746,0,2,22220120,22218440,1680
24041821,1771.13,1678.62,1776,1460,0.922298,0,2,22221896,22220120,1776
24049121,1635.9,1709.93,1632,1460,0.737,0,2,22230608,22228976,1632
24050581,1426.99,1635.9,1416,1460,0.7088,0,2,22232024,22230608,1416
24063721,1725.54,1678.79,1728,1460,0.913533,0,2,22246352,22244624,1728
24069561,1593.71,1778.22,1584,1460,0.744202,0,2,22253288,22251704,1584
24071021,1447.69,1593.71,1440,1460,0.711681,0,2,22254728,22253288,1440
24073941,1486.76,1463.18,1488,1460,0.746269,0,2,22257680,22256192,1488
24075401,1556.34,1486.76,1560,1460,0.772508,0,2,22259240,22257680,1560
24082701,1749.42,1700.45,1752,1460,0.931479,0,2,22267568,22265816,1752
24090001,1477.43,1732.62,1464,1460,0.72807,0,2,22276112,22274648,1464
24094381,1511.88,1509.63,1512,1460,0.777876,0,2,22280600,22279088,1512
24095841,1603.19,1511.88,1608,1460,0.785151,0,2,22282208,22280600,1608
24119201,1726.73,1702.67,1728,1460,0.92824,0,2,22309448,22307720,1728
24126501,1477.38,1731.6,1464,1460,0.740996,0,2,22318016,22316552,1464
24129421,1556.37,1487.47,1560,1460,0.789359,0,2,22321064,22319504,1560
24136721,1725.54,1678.79,1728,1460,0.925699,0,2,22329392,22327664,1728
24138181,1773.48,1725.54,1776,1460,0.94028,0,2,22331168,22329392,1776
24146941,1156.3,1238.04,1152,1460,0.436583,0,1,22340456,22339304,1152
24161541,1462.74,1438.73,1464,1460,0.70817,0,2,22353536,22352072,1464
24163001,1509.54,1462.74,1512,1460,0.745268,0,2,22355048,22353536,1512
24164461,1557.48,1509.54,1560,1460,0.784107,0,2,22356608,22355048,1560
24165921,1605.47,1557.48,1608,1460,0.799643,0,2,22358216,22356608,1608
24171761,1702.73,1678.68,1704,1460,0.908231,0,2,22364864,22363160,1704
24173221,1749.54,1702.73,1752,1460,0.933292,0,2,22366616,22364864,1752
24184901,1126.77,1103.46,1128,1460,0.448542,0,1,22378016,22376888,1128
24186361,1196.34,1126.77,1200,1460,0.449417,0,1,22379216,22378016,1200
24199501,1485.48,1437.54,1488,1460,0.724168,0,2,22391240,22389752,1488
24200961,1533.47,1485.48,1536,1460,0.739667,0,2,22392776,22391240,1536
24202421,1535.87,1533.47,1536,1460,0.793867,0,2,22394312,22392776,1536
24208261,1726.62,1700.39,1728,1460,0.914035,0,2,22401008,22399280,1728
24209721,1750.73,1726.62,1752,1460,0.935614,0,2,22402760,22401008,1752
24219941,1462.71,1438.28,1464,1460,0.727118,0,2,22414088,22412624,1464
24221401,1532.34,1462.71,1536,1460,0.728847,0,2,22415624,22414088,1536
24230161,1725.53,1678.67,1728,1460,0.912718,0,2,22425368,22423640,1728
24231621,1750.68,1725.53,1752,1460,0.947087,0,2,22427120,22425368,1752
24240381,1226.7,1277.94,1224,1460,0.487191,0,1,22436912,22435688,1224
24241841,1155.73,1226.7,1152,1460,0.452877,0,1,22438064,22436912,1152
24256441,1486.68,1461.53,1488,1460,0.727081,0,2,22451288,22449800,1488
24257901,1533.53,1486.68,1536,1460,0.752832,0,2,22452824,22451288,1536
24259361,1558.68,1533.53,1560,1460,0.799133,0,2,22454384,22452824,1560
24265201,1678.74,1654.79,1680,1460,0.90073,0,2,22460984,22459304,1680
24266661,1748.34,1678.74,1752,1460,0.918292,0,2,22462736,22460984,1752
24273961,1432.98,1755.59,1416,1460,0.72133,0,2,22471304,22469888,1416
24287101,1463.77,1459.31,1464,1460,0.733126,0,2,22483712,22482248,1464
24288561,1555.19,1463.77,1560,1460,0.767251,0,2,22485272,22483712,1560
24295861,1679.88,1677.59,1680,1460,0.902797,0,2,22493480,22491800,1680
24297321,1748.39,1679.88,1752,1460,0.919119,0,2,22495232,22493480,1752
24304621,1431.84,1732.79,1416,1460,0.743418,0,2,22503776,22502360,1416
24314841,1702.73,1678.67,1704,1460,0.90792,0,2,22515032,22513328,1704
24316301,1749.54,1702.73,1752,1460,0.945168,0,2,22516784,22515032,1752
24336741,1605.36,1555.25,1608,1460,0.798225,0,2,22538288,22536680,1608
24342581,1747.14,1654.74,1752,1460,0.903107,0,2,22544936,22543184,1752
24360101,1479.72,1778.34,1464,1460,0.745898,0,2,22565864,22564400,1464
24371781,1727.76,1723.19,1728,1460,0.928294,0,2,22578680,22576952,1728
24389301,1300.28,1381.62,1296,1460,0.481164,0,1,22598864,22597568,1296
24390761,1113.81,1300.28,1104,1460,0.450466,0,1,22599968,22598864,1104
24393681,1151.9,1150.09,1152,1460,0.481274,0,1,22602272,22601120,1152
24405361,1461.59,1415.88,1464,1460,0.706094,0,2,22613072,22611608,1464
24406821,1509.48,1461.59,1512,1460,0.720437,0,2,22614584,22613072,1512
24408281,1511.87,1509.48,1512,1460,0.750175,0,2,22616096,22614584,1512
24409741,1557.59,1511.87,1560,1460,0.76207,0,2,22617656,22616096,1560
24417041,1703.82,1700.45,1704,1460,0.933772,0,2,22625912,22624208,1704
24424341,1472.88,1641.54,1464,1460,0.744029,0,2,22634432,22632968,1464
24427261,1534.7,1510.04,1536,1460,0.773045,0,2,22637480,22635944,1536
24434561,1702.57,1675.31,1704,1460,0.906121,0,2,22645664,22643960,1704
24436021,1749.53,1702.57,1752,1460,0.932448,0,2,22647416,22645664,1752
24446241,1183.55,1326.9,1176,1460,0.470401,0,1,22658576,22657400,1176
24459381,1463.87,1461.47,1464,1460,0.709792,0,2,22670504,22669040,1464
24460841,1509.59,1463.87,1512,1460,0.745917,0,2,22672016,22670504,1512
24462301,1557.48,1509.59,1560,1460,0.760367,0,2,22673576,22672016,1560
24463761,1559.87,1557.48,1560,1460,0.790147,0,2,22675136,22673576,1560
24469601,1725.48,1677.53,1728,1460,0.90002,0,2,22681784,22680056,1728
24475441,1663.25,1800.96,1656,1460,0.781776,0,2,22688792,22687136,1656
24491501,1487.87,1485.42,1488,1460,0.705731,0,2,22703864,22702376,1488
24492961,1487.99,1487.87,1488,1460,0.756292,0,2,22705352,22703864,1488
24494421,1579.2,1487.99,1584,1460,0.776517,0,2,22706936,22705352,1584
24498801,1655.82,1652.39,1656,1460,0.905297,0,2,22711832,22710176,1656
24500261,1769.99,1655.82,1776,1460,0.920119,0,2,22713608,22711832,1776
24535301,1462.62,1436.33,1464,1460,0.705998,0,2,22751288,22749824,1464
24536761,1509.53,1462.62,1512,1460,0.720399,0,2,22752800,22751288,1512
24538221,1511.88,1509.53,1512,1460,0.75016,0,2,22754312,22752800,1512
24539681,1557.59,1511.88,1560,1460,0.774064,0,2,22755872,22754312,1560
24545521,1748.33,1678.62,1752,1460,0.917176,0,2,22762544,22760792,1752
24546981,1751.82,1748.33,1752,1460,0.93687,0,2,22764296,22762544,1752
24558661,1487.72,1482.33,1488,1460,0.744383,0,2,22777256,22775768,1488
24560121,1556.39,1487.72,1560,1460,0.759753,0,2,22778816,22777256,1560
24561581,1559.82,1556.39,1560,1460,0.777901,0,2,22780376,22778816,1560
24568881,1727.87,1725.47,1728,1460,0.917883,0,2,22788728,22787000,1728
24570341,1750.79,1727.87,1752,1460,0.949153,0,2,22790480,22788728,1752
24590781,1558.62,1532.45,1560,1460,0.786705,0,2,22811504,22809944,1560
24598081,1726.67,1701.48,1728,1460,0.926977,0,2,22819808,22818080,1728
24599541,1773.53,1726.67,1776,1460,0.940791,0,2,22821584,22819808,1776
24608301,1227.78,1299.6,1224,1460,0.465961,0,1,22831328,22830104,1224
24609761,1110.19,1227.78,1104,1460,0.432384,0,1,22832432,22831328,1104
24612681,1173.56,1127.11,1176,1460,0.471181,0,1,22834736,22833560,1176
24625821,1463.82,1460.39,1464,1460,0.721544,0,2,22846784,22845320,1464
24627281,1532.39,1463.82,1536,1460,0.738618,0,2,22848320,22846784,1536
24628741,1535.82,1532.39,1536,1460,0.781447,0,2,22849856,22848320,1536
24630201,1604.39,1535.82,1608,1460,0.798579,0,2,22851464,22849856,1608
24637501,1727.88,1725.65,1728,1460,0.943016,0,2,22859912,22858184,1728
24644801,1159.27,1753.32,1128,1460,0.472943,0,1,22868192,22867064,1128
24653561,1126.62,1100.39,1128,1460,0.4153,0,1,22874552,22873424,1128
24655021,1150.73,1126.62,1152,1460,0.44812,0,1,22875704,22874552,1152
24656481,1197.54,1150.73,1200,1460,0.485248,0,1,22876904,22875704,1200
24668161,1485.42,1436.46,1488,1460,0.735858,0,2,22887824,22886336,1488
24669621,1556.27,1485.42,1560,1460,0.756343,0,2,22889384,22887824,1560
24671081,1559.81,1556.27,1560,1460,0.788537,0,2,22890944,22889384,1560
24679841,1749.49,1701.71,1752,1460,0.945157,0,2,22900976,22899224,1752
24681301,1797.47,1749.49,1800,1460,0.948063,0,2,22902776,22900976,1800
24697361,1484.39,1415.76,1488,1460,0.722462,0,2,22919000,22917512,1488
24698821,1533.42,1484.39,1536,1460,0.738985,0,2,22920536,22919000,1536
24700281,1535.87,1533.42,1536,1460,0.781594,0,2,22922072,22920536,1536
24707581,1703.88,1701.54,1704,1460,0.922432,0,2,22930376,22928672,1704
24709041,1772.39,1703.88,1776,1460,0.938973,0,2,22932152,22930376,1776
24717801,1110,1224.01,1104,1460,0.45198,0,1,22940936,22939832,1104
24720721,1175.83,1172.7,1176,1460,0.462317,0,1,22943288,22942112,1176
24722181,1198.79,1175.83,1200,1460,0.478927,0,1,22944488,22943288,1200
24732401,1486.61,1460.28,1488,1460,0.725656,0,2,22954040,22952552,1488
24733861,1533.53,1486.61,1536,1460,0.752262,0,2,22955576,22954040,1536
24735321,1558.68,1533.53,1560,1460,0.762905,0,2,22957136,22955576,1560
24736781,1559.93,1558.68,1560,1460,0.791162,0,2,22958696,22957136,1560
24744081,1726.8,1703.93,1728,1460,0.941481,0,2,22967120,22965392,1728
24764521,1559.71,1554.11,1560,1460,0.799933,0,2,22988096,22986536,1560
24771821,1726.73,1702.62,1728,1460,0.927881,0,2,22996448,22994720,1728
24790801,1439.93,1438.56,1440,1460,0.7147,0,2,23015768,23014328,1440
24792261,1531.2,1439.93,1536,1460,0.74788,0,2,23017304,23015768,1536
24793721,1558.56,1531.2,1560,1460,0.773152,0,2,23018864,23017304,1560
24801021,1726.62,1700.45,1728,1460,0.938685,0,2,23027168,23025440,1728
24817081,1439.88,1437.53,1440,1460,0.703381,0,2,23044376,23042936,1440
24818541,1508.39,1439.88,1512,1460,0.743353,0,2,23045888,23044376,1512
24820001,1557.42,1508.39,1560,1460,0.759341,0,2,23047448,23045888,1560
24828761,1726.61,1700.29,1728,1460,0.926056,0,2,23057288,23055560,1728
24836061,1516.2,1595.99,1512,1460,0.703361,0,2,23065808,23064296,1512
24846281,1486.68,1461.54,1488,1460,0.727578,0,2,23075672,23074184,1488
24847741,1533.53,1486.68,1536,1460,0.741031,0,2,23077208,23075672,1536
24849201,1535.88,1533.53,1536,1460,0.794412,0,2,23078744,23077208,1536
24855041,1679.94,1678.73,1680,1460,0.915297,0,2,23085392,23083712,1680
24856501,1771.2,1679.94,1776,1460,0.924119,0,2,23087168,23085392,1776
24874021,1507.2,1415.99,1512,1460,0.728719,0,2,23105360,23103848,1512
24875481,1534.56,1507.2,1536,1460,0.753488,0,2,23106896,23105360,1536
24876941,1558.73,1534.56,1560,1460,0.787395,0,2,23108456,23106896,1560
24882781,1702.73,1678.67,1704,1460,0.907917,0,2,23115104,23113400,1704
24897381,1702.74,1678.74,1704,1460,0.909534,0,2,23132408,23130704,1704
24898841,1749.54,1702.74,1752,1460,0.921813,0,2,23134160,23132408,1752
24907601,1093.09,1341.78,1080,1460,0.474358,0,1,23143712,23142632,1080
24925121,1534.62,1508.45,1536,1460,0.74261,0,2,23159816,23158280,1536
24926581,1535.93,1534.62,1536,1460,0.771044,0,2,23161352,23159816,1536
24932421,1724.39,1655.81,1728,1460,0.910379,0,2,23167976,23166248,1728
24933881,1750.62,1724.39,1752,1460,0.946151,0,2,23169728,23167976,1752
24944101,1200.41,1208.29,1200,1460,0.487166,0,1,23180696,23179496,1200
24955781,1486.68,1461.53,1488,1460,0.715089,0,2,23191616,23190128,1488
24957241,1510.73,1486.68,1512,1460,0.760036,0,2,23193128,23191616,1512
24958701,1580.34,1510.73,1584,1460,0.790014,0,2,23194712,23193128,1584
24964541,1725.48,1677.54,1728,1460,0.900016,0,2,23201360,23199632,1728
24966001,1727.87,1725.48,1728,1460,0.930007,0,2,23203088,23201360,1728
24979141,1415.87,1413.39,1416,1460,0.701892,0,2,23217752,23216336,1416
24980601,1507.19,1415.87,1512,1460,0.718757,0,2,23219264,23217752,1512
24982061,1511.76,1507.19,1512,1460,0.749503,0,2,23220776,23219264,1512
24983521,1557.59,1511.76,1560,1460,0.773801,0,2,23222336,23220776,1560
25018561,861.483,813.66,864,1460,0.205465,0,1,23251724,23250860,864
25024401,957.486,909.714,960,1460,0.285436,0,1,23255372,23254412,960
25036081,1150.63,1124.51,1152,1460,0.447355,0,1,23263844,23262692,1152
25037541,1197.53,1150.63,1200,1460,0.448942,0,1,23265044,23263844,1200
25060901,1510.74,1486.85,1512,1460,0.737445,0,2,23286908,23285396,1512
25062361,1534.74,1510.74,1536,1460,0.768978,0,2,23288444,23286908,1536
25063821,1581.54,1534.74,1584,1460,0.781591,0,2,23290028,23288444,1584
25071121,1725.54,1678.79,1728,1460,0.901619,0,2,23298332,23296604,1728
25072581,1727.88,1725.54,1728,1460,0.918648,0,2,23300060,23298332,1728
25074041,1750.79,1727.88,1752,1460,0.925459,0,2,23301812,23300060,1752
25081341,1572.06,1801.13,1560,1460,0.764968,0,2,23310548,23308988,1560
25084261,1214.61,1492.2,1200,1460,0.481195,0,1,23313236,23312036,1200
25085721,1132.33,1214.61,1128,1460,0.462478,0,1,23314364,23313236,1128
25091561,1223.82,1220.45,1224,1460,0.498991,0,1,23319140,23317916,1224
25107621,1485.54,1438.8,1488,1460,0.701844,0,2,23333996,23332508,1488
25109081,1487.88,1485.54,1488,1460,0.718737,0,2,23335484,23333996,1488
25110541,1510.79,1487.88,1512,1460,0.749495,0,2,23336996,23335484,1512
25112001,1557.54,1510.79,1560,1460,0.773798,0,2,23338556,23336996,1560
25113461,1582.68,1557.54,1584,1460,0.795519,0,2,23340140,23338556,1584
25145581,1102.68,1077.65,1104,1460,0.4084,0,1,23371340,23370236,1104
25147041,1149.53,1102.68,1152,1460,0.42136,0,1,23372492,23371340,1152
25148501,1151.88,1149.53,1152,1460,0.426544,0,1,23373644,23372492,1152
25149961,1151.99,1151.88,1152,1460,0.452618,0,1,23374796,23373644,1152
25151421,1197.6,1151.99,1200,1460,0.475047,0,1,23375996,23374796,1200
25152881,1222.68,1197.6,1224,1460,0.496019,0,1,23377220,23375996,1224
25168941,1485.59,1439.88,1488,1460,0.702263,0,2,23392124,23390636,1488
25170401,1487.88,1485.59,1488,1460,0.742905,0,2,23393612,23392124,1488
25171861,1556.39,1487.88,1560,1460,0.759162,0,2,23395172,23393612,1560
25173321,1559.82,1556.39,1560,1460,0.777665,0,2,23396732,23395172,1560
25174781,1582.79,1559.82,1584,1460,0.797066,0,2,23398316,23396732,1584
25182081,1701.6,1655.94,1704,1460,0.906751,0,2,23406572,23404868,1704
25183541,1749.48,1701.6,1752,1460,0.9207,0,2,23408324,23406572,1752
25185001,1751.87,1749.48,1752,1460,0.93828,0,2,23410076,23408324,1752
25192301,1455.72,1754.4,1440,1460,0.724299,0,2,23418644,23417204,1440
25195221,1509.58,1463.59,1512,1460,0.753088,0,2,23421620,23420108,1512
25196681,1557.48,1509.58,1560,1460,0.775235,0,2,23423180,23421620,1560
25208361,1703.93,1702.68,1704,1460,0.911675,0,2,23436308,23434604,1704
25209821,1749.6,1703.93,1752,1460,0.94667,0,2,23438060,23436308,1752
25211281,1797.48,1749.6,1800,1460,0.948668,0,2,23439860,23438060,1800
25217121,1371.36,1435.14,1368,1460,0.419566,0,1,23446220,23444852,1368
25220041,914.288,957.768,912,1460,0.284331,0,1,23448068,23447156,912
25233181,1125.59,1079.88,1128,1460,0.40253,0,1,23457308,23456180,1128
25234641,1127.88,1125.59,1128,1460,0.419012,0,1,23458436,23457308,1128
25236101,1150.79,1127.88,1152,1460,0.437605,0,1,23459588,23458436,1152
25237561,1174.74,1150.79,1176,1460,0.457042,0,1,23460764,23459588,1176
25239021,1198.74,1174.74,1200,1460,0.476817,0,1,23461964,23460764,1200
25240481,1222.74,1198.74,1224,1460,0.496727,0,1,23463188,23461964,1224
25262381,1559.82,1556.45,1560,1460,0.790074,0,2,23484356,23482796,1560
25274061,1751.88,1749.65,1752,1460,0.939382,0,2,23497844,23496092,1752
25282821,899.403,1116.06,888,1460,0.275487,0,1,23507012,23506124,888
25284281,888.57,899.403,888,1460,0.260195,0,1,23507900,23507012,888
25287201,958.681,933.629,960,1460,0.280431,0,1,23509796,23508836,960
25288661,982.734,958.681,984,1460,0.286172,0,1,23510780,23509796,984
25295961,1079.94,1078.73,1080,1460,0.403759,0,1,23516012,23514932,1080
25297421,1148.4,1079.94,1152,1460,0.419504,0,1,23517164,23516012,1152
25298881,1151.82,1148.4,1152,1460,0.425801,0,1,23518316,23517164,1152
25300341,1151.99,1151.82,1152,1460,0.452321,0,1,23519468,23518316,1152
25301801,1197.6,1151.99,1200,1460,0.474928,0,1,23520668,23519468,1200
25303261,1222.68,1197.6,1224,1460,0.483971,0,1,23521892,23520668,1224
25304721,1223.93,1222.68,1224,1460,0.499589,0,1,23523116,23521892,1224
25320781,1487.82,1484.34,1488,1460,0.717496,0,2,23538164,23536676,1488
25322241,1510.79,1487.82,1512,1460,0.748999,0,2,23539676,23538164,1512
25323701,1557.54,1510.79,1560,1460,0.761599,0,2,23541236,23539676,1560
25325161,1559.88,1557.54,1560,1460,0.79064,0,2,23542796,23541236,1560
25336841,1726.79,1703.88,1728,1460,0.917698,0,2,23556116,23554388,1728
25338301,1750.74,1726.79,1752,1460,0.949079,0,2,23557868,23556116,1752
25349981,1463.88,1461.56,1464,1460,0.701128,0,2,23570612,23569148,1464
25351441,1486.79,1463.88,1488,1460,0.718451,0,2,23572100,23570612,1488
25352901,1510.74,1486.79,1512,1460,0.73738,0,2,23573612,23572100,1512
25354361,1534.74,1510.74,1536,1460,0.756952,0,2,23575148,23573612,1536
25366041,1702.74,1678.85,1704,1460,0.921398,0,2,23588180,23586476,1704
25392321,1439.94,1438.8,1440,1460,0.704381,0,2,23614868,23613428,1440
25393781,1508.4,1439.94,1512,1460,0.719753,0,2,23616380,23614868,1512
25395241,1511.82,1508.4,1512,1460,0.725901,0,2,23617892,23616380,1512
25396701,1511.99,1511.82,1512,1460,0.75236,0,2,23619404,23617892,1512
25398161,1557.6,1511.99,1560,1460,0.774944,0,2,23620964,23619404,1560
25399621,1582.68,1557.6,1584,1460,0.783978,0,2,23622548,23620964,1584
25401081,1583.93,1582.68,1584,1460,0.799591,0,2,23624132,23622548,1584
25408381,1726.74,1702.73,1728,1460,0.916492,0,2,23632508,23630780,1728
25409841,1750.74,1726.74,1752,1460,0.936597,0,2,23634260,23632508,1752
25411301,1774.74,1750.74,1776,1460,0.944639,0,2,23636036,23634260,1776
25422981,1485.49,1437.76,1488,1460,0.728923,0,2,23648924,23647436,1488
25440501,1727.89,1725.71,1728,1460,0.943832,0,2,23668436,23666708,1728
25447801,1069.32,1778.4,1032,1460,0.405367,0,1,23676692,23675660,1032
25449261,988.266,1069.32,984,1460,0.216147,0,1,23677676,23676692,984
25465321,959.883,957.651,960,1460,0.291313,0,1,23687108,23686148,960
25474081,1125.6,1079.93,1128,1460,0.402479,0,1,23693444,23692316,1128
25475541,1127.88,1125.6,1128,1460,0.406992,0,1,23694572,23693444,1128
25477001,1127.99,1127.88,1128,1460,0.432797,0,1,23695700,23694572,1128
25478461,1173.6,1127.99,1176,1460,0.455119,0,1,23696876,23695700,1176
25479921,1198.68,1173.6,1200,1460,0.476047,0,1,23698076,23696876,1200
25481381,1222.73,1198.68,1224,1460,0.496419,0,1,23699300,23698076,1224
25497441,1486.79,1463.88,1488,1460,0.717493,0,2,23714444,23712956,1488
25498901,1510.74,1486.79,1512,1460,0.724997,0,2,23715956,23714444,1512
25500361,1511.94,1510.74,1512,1460,0.763999,0,2,23717468,23715956,1512
25501821,1580.4,1511.94,1584,1460,0.7676,0,2,23719052,23717468,1584
25512041,1725.6,1679.94,1728,1460,0.914781,0,2,23730620,23728892,1728
25513501,1750.68,1725.6,1752,1460,0.935912,0,2,23732372,23730620,1752
25514961,1774.73,1750.68,1776,1460,0.944365,0,2,23734148,23732372,1776
25520801,1452.3,1685.94,1440,1460,0.732128,0,2,23740844,23739404,1440
25523721,1510.71,1486.21,1512,1460,0.74234,0,2,23743844,23742332,1512
25525181,1534.74,1510.71,1536,1460,0.746936,0,2,23745380,23743844,1536
25526641,1535.94,1534.74,1536,1460,0.784774,0,2,23746916,23745380,1536
25536861,1725.54,1678.74,1728,1460,0.901611,0,2,23758460,23756732,1728
25538321,1727.88,1725.54,1728,1460,0.930644,0,2,23760188,23758460,1728
25552921,1702.62,1676.45,1704,1460,0.907277,0,2,23777084,23775380,1704
25554381,1749.53,1702.62,1752,1460,0.908911,0,2,23778836,23777084,1752
25563141,1137.72,1778.34,1104,1460,0.480699,0,1,23788844,23787740,1104
25564601,1099.04,1137.72,1097,1460,0.43828,0,1,23789941,23788844,1097
25567521,1127.93,1126.55,1128,1460,0.438525,0,1,23792197,23791069,1128
25568981,1173.6,1127.93,1176,1460,0.44541,0,1,23793373,23792197,1176
25570441,1175.88,1173.6,1176,1460,0.484164,0,1,23794549,23793373,1176
25590881,1535.76,1531.25,1536,1460,0.756954,0,2,23813749,23812213,1536
25592341,1558.79,1535.76,1560,1460,0.764782,0,2,23815309,23813749,1560
25593801,1559.94,1558.79,1560,1460,0.791913,0,2,23816869,23815309,1560
25614241,887.544,1334.88,864,1460,0.294652,0,1,23839429,23838565,864
25628841,1103.83,1100.51,1104,1460,0.41065,0,1,23849509,23848405,1104
25630301,1149.59,1103.83,1152,1460,0.42226,0,1,23850661,23849509,1152
25631761,1151.88,1149.59,1152,1460,0.438904,0,1,23851813,23850661,1152
25633221,1174.79,1151.88,1176,1460,0.457562,0,1,23852989,23851813,1176
25634681,1198.74,1174.79,1200,1460,0.465025,0,1,23854189,23852989,1200
25636141,1199.94,1198.74,1200,1460,0.49201,0,1,23855389,23854189,1200
25653661,1510.68,1485.65,1512,1460,0.748163,0,2,23871925,23870413,1512
25655121,1557.53,1510.68,1560,1460,0.749265,0,2,23873485,23871925,1560
25690161,1556.34,1486.86,1560,1460,0.771159,0,2,23911237,23909677,1560
25701841,1748.34,1678.86,1752,1460,0.931149,0,2,23924389,23922637,1752
25703301,1774.62,1748.34,1776,1460,0.94246,0,2,23926165,23924389,1776
25704761,1775.93,1774.62,1776,1460,0.946984,0,2,23927941,23926165,1776
25717901,1102.8,1079.94,1104,1460,0.401831,0,1,23940445,23939341,1104
25719361,1126.74,1102.8,1128,1460,0.418732,0,1,23941573,23940445,1128
25720821,1150.74,1126.74,1152,1460,0.437493,0,1,23942725,23941573,1152
25722281,1174.74,1150.74,1176,1460,0.444997,0,1,23943901,23942725,1176
25723741,1175.94,1174.74,1176,1460,0.459999,0,1,23945077,23943901,1176
25725201,1198.8,1175.94,1200,1460,0.49,0,1,23946277,23945077,1200
25742721,1487.83,1484.51,1488,1460,0.74235,0,2,23962693,23961205,1488
25744181,1556.39,1487.83,1560,1460,0.74694,0,2,23964253,23962693,1560
25767541,1543.5,1686.06,1536,1460,0.776453,0,2,23991133,23989597,1536
25769001,1536.38,1543.5,1536,1460,0.772581,0,2,23992669,23991133,1536
25771921,1582.74,1558.82,1584,1460,0.787213,0,2,23995813,23994229,1584
25782141,1726.68,1701.65,1728,1460,0.928272,0,2,24007429,24005701,1728
25783601,1773.53,1726.68,1776,1460,0.929309,0,2,24009205,24007429,1776
25792361,1306.44,1504.8,1296,1460,0.485533,0,1,24019189,24017893,1296
25795281,920.966,1091.32,912,1460,0.282885,0,1,24021181,24020269,912
25799661,935.998,935.962,936,1460,0.288105,0,1,24023989,24023053,936
25801121,1004.4,935.998,1008,1460,0.289242,0,1,24024997,24023989,1008
25811341,1150.63,1124.51,1152,1460,0.447475,0,1,24032533,24031381,1152
25812801,1197.53,1150.63,1200,1460,0.44899,0,1,24033733,24032533,1200
25833241,1486.74,1462.8,1488,1460,0.705142,0,2,24052621,24051133,1488
25834701,1487.94,1486.74,1488,1460,0.732057,0,2,24054109,24052621,1488
25836161,1533.6,1487.94,1536,1460,0.754823,0,2,24055645,24054109,1536
25837621,1558.68,1533.6,1560,1460,0.787929,0,2,24057205,24055645,1560
25846381,1703.88,1701.59,1704,1460,0.91094,0,2,24067141,24065437,1704
25847841,1749.59,1703.88,1752,1460,0.922376,0,2,24068893,24067141,1752
25858061,885.726,1298.51,864,1460,0.296943,0,1,24080029,24079165,864
25862441,935.937,934.734,936,1460,0.265004,0,1,24082813,24081877,936
25863901,958.797,935.937,960,1460,0.292002,0,1,24083773,24082813,960
25874121,1126.74,1102.73,1128,1460,0.428569,0,1,24091165,24090037,1128
25875581,1173.54,1126.74,1176,1460,0.453428,0,1,24092341,24091165,1176
25877041,1198.68,1173.54,1200,1460,0.463371,0,1,24093541,24092341,1200
25878501,1199.93,1198.68,1200,1460,0.491348,0,1,24094741,24093541,1200
25901861,1581.49,1533.71,1584,1460,0.78133,0,2,24117157,24115573,1584
25903321,1583.87,1581.49,1584,1460,0.798532,0,2,24118741,24117157,1584
25912081,1725.6,1679.93,1728,1460,0.914631,0,2,24128701,24126973,1728
25913541,1750.68,1725.6,1752,1460,0.947853,0,2,24130453,24128701,1752
25920841,1341.72,1754.4,1320,1460,0.463277,0,1,24138925,24137605,1320
25922301,1001.89,1341.72,984,1460,0.215311,0,1,24139909,24138925,984
25925221,696.765,711.294,696,1460,0.0884497,0,1,24141301,24140605,696
25928141,742.742,718.838,744,1460,0.089752,0,1,24142765,24142021,744
25935441,863.823,860.451,864,1460,0.210055,0,1,24146845,24145981,864
25936901,909.591,863.823,912,1460,0.222022,0,1,24147757,24146845,912
25938361,911.88,909.591,912,1460,0.238809,0,1,24148669,24147757,912
25939821,934.794,911.88,936,1460,0.257524,0,1,24149605,24148669,936
25971941,1463.88,1461.59,1464,1460,0.710964,0,2,24176629,24175165,1464
25988001,1726.68,1701.6,1728,1460,0.915835,0,2,24194221,24192493,1728
25989461,1750.73,1726.68,1752,1460,0.936334,0,2,24195973,24194221,1752
25996761,1570.91,1778.22,1560,1460,0.799889,0,2,24204661,24203101,1560
26014281,1486.8,1463.93,1488,1460,0.729799,0,2,24221461,24219973,1488
26015741,1533.54,1486.8,1536,1460,0.765919,0,2,24222997,24221461,1536
26017201,1581.48,1533.54,1584,1460,0.768368,0,2,24224581,24222997,1584
26037641,1132.01,1208.28,1128,1460,0.497325,0,1,24247333,24246205,1128
26056621,1463.82,1460.34,1464,1460,0.709686,0,2,24264637,24263173,1464
26058081,1509.59,1463.82,1512,1460,0.721874,0,2,24266149,24264637,1512
26059541,1511.88,1509.59,1512,1460,0.75075,0,2,24267661,24266149,1512
26061001,1557.59,1511.88,1560,1460,0.7623,0,2,24269221,24267661,1560
26062461,1559.88,1557.59,1560,1460,0.77892,0,2,24270781,24269221,1560
26063921,1582.79,1559.88,1584,1460,0.797568,0,2,24272365,24270781,1584
26071221,1703.88,1701.54,1704,1460,0.910596,0,2,24280669,24278965,1704
26072681,1749.59,1703.88,1752,1460,0.934238,0,2,24282421,24280669,1752
26091661,1486.68,1461.66,1488,1460,0.704469,0,2,24302749,24301261,1488
26093121,1487.93,1486.68,1488,1460,0.719787,0,2,24304237,24302749,1488
26094581,1510.8,1487.93,1512,1460,0.761915,0,2,24305749,24304237,1512
26096041,1580.34,1510.8,1584,1460,0.778766,0,2,24307333,24305749,1584
26097501,1583.82,1580.34,1584,1460,0.797506,0,2,24308917,24307333,1584
26129621,1485.54,1438.85,1488,1460,0.726237,0,2,24342973,24341485,1488
26131081,1533.48,1485.54,1536,1460,0.728495,0,2,24344509,24342973,1536
26135461,1581.54,1534.85,1584,1460,0.794224,0,2,24349141,24347557,1584
26145681,1727.88,1725.65,1728,1460,0.931353,0,2,24360853,24359125,1728
26147141,1773.59,1727.88,1776,1460,0.942541,0,2,24362629,24360853,1776
26164661,1463.94,1462.74,1464,1460,0.711931,0,2,24380677,24379213,1464
26177801,1725.53,1678.63,1728,1460,0.900958,0,2,24395101,24393373,1728
26179261,1727.88,1725.53,1728,1460,0.918383,0,2,24396829,24395101,1728
26180721,1750.79,1727.88,1752,1460,0.937353,0,2,24398581,24396829,1752
26182181,1774.74,1750.79,1776,1460,0.944941,0,2,24400357,24398581,1776
26188021,1684.86,1777.14,1680,1460,0.705359,0,2,24407389,24405709,1680
26202621,1486.68,1461.6,1488,1460,0.704098,0,2,24421285,24419797,1488
26204081,1487.93,1486.68,1488,1460,0.731639,0,2,24422773,24421285,1488
26205541,1533.6,1487.93,1536,1460,0.754656,0,2,24424309,24422773,1536
26207001,1558.68,1533.6,1560,1460,0.775862,0,2,24425869,24424309,1560
26208461,1582.73,1558.68,1584,1460,0.784345,0,2,24427453,24425869,1584
26217221,1725.6,1679.94,1728,1460,0.914696,0,2,24437413,24435685,1728
26218681,1750.68,1725.6,1752,1460,0.935878,0,2,24439165,24437413,1752
26237661,1486.79,1463.88,1488,1460,0.717424,0,2,24458653,24457165,1488
26239121,1510.74,1486.79,1512,1460,0.72497,0,2,24460165,24458653,1512
26240581,1511.94,1510.74,1512,1460,0.763988,0,2,24461677,24460165,1512
26242041,1580.4,1511.94,1584,1460,0.767595,0,2,24463261,24461677,1584
26262481,1458.05,1801.08,1440,1460,0.441828,0,1,24486877,24485437,1440
26265401,889.425,916.503,888,1460,0.283092,0,1,24488653,24487765,888
26278541,1126.67,1101.49,1128,1460,0.403382,0,1,24497893,24496765,1128
26280001,1127.93,1126.67,1128,1460,0.431353,0,1,24499021,24497893,1128
26281461,1173.6,1127.93,1176,1460,0.454541,0,1,24500197,24499021,1176
26282921,1198.68,1173.6,1200,1460,0.487816,0,1,24501397,24500197,1200
26301901,1486.62,1460.4,1488,1460,0.702711,0,2,24518821,24517333,1488
26303361,1487.93,1486.62,1488,1460,0.719084,0,2,24520309,24518821,1488
26304821,1510.8,1487.93,1512,1460,0.761634,0,2,24521821,24520309,1512
26306281,1580.34,1510.8,1584,1460,0.766654,0,2,24523405,24521821,1584
26316501,1702.8,1679.94,1704,1460,0.92193,0,2,24534925,24533221,1704
26317961,1772.34,1702.8,1776,1460,0.926772,0,2,24536701,24534925,1776
26325261,1639.31,1778.28,1632,1460,0.468418,0,1,24545461,24543829,1632
26331101,720.593,731.857,720,1460,0.0758795,0,1,24548725,24548005,720
26341321,884.4,815.997,888,1460,0.200057,0,1,24554317,24553429,888
26342781,887.82,884.4,888,1460,0.206023,0,1,24555205,24554317,888
26344241,887.991,887.82,888,1460,0.220409,0,1,24556093,24555205,888
26345701,910.8,887.991,912,1460,0.262164,0,1,24557005,24556093,912
26347161,980.34,910.8,984,1460,0.290865,0,1,24557989,24557005,984
26355921,1125.53,1078.68,1128,1460,0.401341,0,1,24564301,24563173,1128
26357381,1127.88,1125.53,1128,1460,0.430536,0,1,24565429,24564301,1128
26358841,1173.59,1127.88,1176,1460,0.442214,0,1,24566605,24565429,1176
26360301,1175.88,1173.59,1176,1460,0.446886,0,1,24567781,24566605,1176
26361761,1175.99,1175.88,1176,1460,0.472754,0,1,24568957,24567781,1176
26363221,1221.6,1175.99,1224,1460,0.495102,0,1,24570181,24568957,1224
26379281,1463.88,1461.6,1464,1460,0.711056,0,2,24585109,24583645,1464
26380741,1509.59,1463.88,1512,1460,0.722422,0,2,24586621,24585109,1512
26382201,1511.88,1509.59,1512,1460,0.738969,0,2,24588133,24586621,1512
26383661,1534.79,1511.88,1536,1460,0.757588,0,2,24589669,24588133,1536
26385121,1558.74,1534.79,1560,1460,0.777035,0,2,24591229,24589669,1560
26386581,1582.74,1558.74,1584,1460,0.796814,0,2,24592813,24591229,1584
26395341,1727.82,1724.39,1728,1460,0.917696,0,2,24602797,24601069,1728
26396801,1750.79,1727.82,1752,1460,0.937079,0,2,24604549,24602797,1752
26404101,1540.14,1618.74,1536,1460,0.721311,0,2,24613093,24611557,1536
26420161,1532.34,1462.8,1536,1460,0.739108,0,2,24628693,24627157,1536
26421621,1535.82,1532.34,1536,1460,0.769643,0,2,24630229,24628693,1536
26423081,1581.59,1535.82,1584,1460,0.781857,0,2,24631813,24630229,1584
26424541,1583.88,1581.59,1584,1460,0.798743,0,2,24633397,24631813,1584
26433301,1726.74,1702.79,1728,1460,0.928982,0,2,24643429,24641701,1728
26462501,1486.68,1461.6,1488,1460,0.70391,0,2,24671941,24670453,1488
26463961,1487.93,1486.68,1488,1460,0.719564,0,2,24673429,24671941,1488
26465421,1510.8,1487.93,1512,1460,0.737826,0,2,24674941,24673429,1512
26466881,1534.74,1510.8,1536,1460,0.75713,0,2,24676477,24674941,1536
26468341,1558.74,1534.74,1560,1460,0.764852,0,2,24678037,24676477,1560
26469801,1559.94,1558.74,1560,1460,0.791941,0,2,24679597,24678037,1560
26477101,1679.94,1678.79,1680,1460,0.904125,0,2,24687877,24686197,1680
26478561,1748.4,1679.94,1752,1460,0.90765,0,2,24689629,24687877,1752
26482941,1774.74,1750.85,1776,1460,0.93937,0,2,24694885,24693109,1776
26496081,1485.59,1439.88,1488,1460,0.702758,0,2,24708181,24706693,1488
26497541,1487.88,1485.59,1488,1460,0.719103,0,2,24709669,24708181,1488
26499001,1510.79,1487.88,1512,1460,0.749641,0,2,24711181,24709669,1512
26500461,1557.54,1510.79,1560,1460,0.785857,0,2,24712741,24711181,1560
26512141,1750.63,1724.51,1752,1460,0.947198,0,2,24726037,24724285,1752
26531121,1150.68,1125.6,1152,1460,0.448511,0,1,24743845,24742693,1152
26532581,1197.53,1150.68,1200,1460,0.461404,0,1,24745045,24743845,1200
26534041,1199.88,1197.53,1200,1460,0.478562,0,1,24746245,24745045,1200
26535501,1222.79,1199.88,1224,1460,0.497425,0,1,24747469,24746245,1224
26551561,1485.6,1439.94,1488,1460,0.702847,0,2,24762469,24760981,1488
26553021,1487.88,1485.6,1488,1460,0.731139,0,2,24763957,24762469,1488
26554481,1533.59,1487.88,1536,1460,0.754456,0,2,24765493,24763957,1536
26555941,1558.68,1533.59,1560,1460,0.775782,0,2,24767053,24765493,1560
26566161,1726.79,1703.88,1728,1460,0.905482,0,2,24778693,24776965,1728
26567621,1727.94,1726.79,1728,1460,0.920193,0,2,24780421,24778693,1728
26583681,1102.74,1078.85,1104,1460,0.422214,0,1,24795013,24793909,1104
26585141,1172.34,1102.74,1176,1460,0.426886,0,1,24796189,24795013,1176
26589521,1222.68,1197.65,1224,1460,0.496041,0,1,24799765,24798541,1224
26605581,1486.68,1461.54,1488,1460,0.70347,0,2,24814741,24813253,1488
26607041,1487.93,1486.68,1488,1460,0.731388,0,2,24816229,24814741,1488
26608501,1533.6,1487.93,1536,1460,0.754555,0,2,24817765,24816229,1536
26621641,1726.68,1701.54,1728,1460,0.915731,0,2,24832453,24830725,1728
26623101,1750.73,1726.68,1752,1460,0.924292,0,2,24834205,24832453,1752
26630401,1475.16,1687.19,1464,1460,0.750191,0,2,24842749,24841285,1464
26633321,1534.71,1510.16,1536,1460,0.762031,0,2,24845797,24844261,1536
26645001,1725.59,1679.82,1728,1460,0.901924,0,2,24858781,24857053,1728
26646461,1727.88,1725.59,1728,1460,0.93077,0,2,24860509,24858781,1728
26647921,1773.59,1727.88,1776,1460,0.942308,0,2,24862285,24860509,1776
26675661,1486.79,1463.82,1488,1460,0.729321,0,2,24888997,24887509,1488
26677121,1533.54,1486.79,1536,1460,0.741728,0,2,24890533,24888997,1536
26678581,1535.88,1533.54,1536,1460,0.770691,0,2,24892069,24890533,1536
26709241,1485.6,1439.94,1488,1460,0.714922,0,2,24925333,24923845,1488
26710701,1510.68,1485.6,1512,1460,0.747969,0,2,24926845,24925333,1512
26712161,1557.53,1510.68,1560,1460,0.773188,0,2,24928405,24926845,1560
26713621,1582.68,1557.53,1584,1460,0.783275,0,2,24929989,24928405,1584
26722381,1679.94,1678.74,1680,1460,0.904017,0,2,24939853,24938173,1680
26723841,1748.4,1679.94,1752,1460,0.907607,0,2,24941605,24939853,1752
26747201,1487.82,1484.4,1488,1460,0.71783,0,2,24965413,24963925,1488
26748661,1510.79,1487.82,1512,1460,0.725132,0,2,24966925,24965413,1512
26750121,1511.94,1510.79,1512,1460,0.752053,0,2,24968437,24966925,1512
26751581,1557.6,1511.94,1560,1460,0.774821,0,2,24969997,24968437,1560
26753041,1582.68,1557.6,1584,1460,0.795928,0,2,24971581,24969997,1584
26761801,1702.74,1678.8,1704,1460,0.909176,0,2,24981517,24979813,1704
26763261,1749.54,1702.74,1752,1460,0.92167,0,2,24983269,24981517,1752
26770561,1639.32,1778.39,1632,1460,0.743444,0,2,24992077,24990445,1632
26772021,1427.17,1639.32,1416,1460,0.711378,0,2,24993493,24992077,1416
26774941,1463.91,1462.16,1464,1460,0.70542,0,2,24996421,24994957,1464
26776401,1486.8,1463.91,1488,1460,0.720168,0,2,24997909,24996421,1488
26777861,1510.74,1486.8,1512,1460,0.738067,0,2,24999421,24997909,1512
26779321,1534.74,1510.74,1536,1460,0.745227,0,2,25000957,24999421,1536
26780781,1535.94,1534.74,1536,1460,0.784091,0,2,25002493,25000957,1536
26782241,1604.4,1535.94,1608,1460,0.799636,0,2,25004101,25002493,1608
26789541,1725.48,1677.6,1728,1460,0.912729,0,2,25012381,25010653,1728
26815821,1462.74,1438.79,1464,1460,0.708971,0,2,25039069,25037605,1464
26817281,1509.54,1462.74,1512,1460,0.709589,0,2,25040581,25039069,1512
26821661,1557.54,1510.85,1560,1460,0.774294,0,2,25045141,25043581,1560
26823121,1582.68,1557.54,1584,1460,0.795717,0,2,25046725,25045141,1584
26831881,1726.79,1703.88,1728,1460,0.917431,0,2,25056757,25055029,1728
26833341,1750.74,1726.79,1752,1460,0.948972,0,2,25058509,25056757,1752
26840641,1570.86,1777.14,1560,1460,0.717324,0,2,25067221,25065661,1560
26849401,1486.74,1462.74,1488,1460,0.705161,0,2,25075813,25074325,1488
26850861,1487.94,1486.74,1488,1460,0.744064,0,2,25077301,25075813,1488
26852321,1556.4,1487.94,1560,1460,0.771626,0,2,25078861,25077301,1560
26888821,1486.8,1463.93,1488,1460,0.717591,0,2,25117069,25115581,1488
26890281,1510.74,1486.8,1512,1460,0.749037,0,2,25118581,25117069,1512
26891741,1557.54,1510.74,1560,1460,0.761615,0,2,25120141,25118581,1560
26893201,1559.88,1557.54,1560,1460,0.778646,0,2,25121701,25120141,1560
26904881,1727.88,1725.65,1728,1460,0.931353,0,2,25135045,25133317,1728
26906341,1773.59,1727.88,1776,1460,0.942541,0,2,25136821,25135045,1776
26907801,1775.88,1773.59,1776,1460,0.947017,0,2,25138597,25136821,1776
26920941,1485.54,1438.8,1488,1460,0.702114,0,2,25151677,25150189,1488
26922401,1487.88,1485.54,1488,1460,0.718846,0,2,25153165,25151677,1488
26923861,1510.79,1487.88,1512,1460,0.749538,0,2,25154677,25153165,1512
26925321,1557.54,1510.79,1560,1460,0.773815,0,2,25156237,25154677,1560
26926781,1582.68,1557.54,1584,1460,0.795526,0,2,25157821,25156237,1584
26935541,1702.79,1679.88,1704,1460,0.909512,0,2,25167733,25166029,1704
26937001,1749.54,1702.79,1752,1460,0.933805,0,2,25169485,25167733,1752
26948681,910.86,1345.2,888,1460,0.29396,0,1,25182517,25181629,888
26950141,889.143,910.86,888,1460,0.255584,0,1,25183405,25182517,888
26953061,934.743,910.857,936,1460,0.262893,0,1,25185253,25184317,936
26954521,958.737,934.743,960,1460,0.291157,0,1,25186213,25185253,960
26967661,1175.82,1172.46,1176,1460,0.446282,0,1,25196005,25194829,1176
26969121,1175.99,1175.82,1176,1460,0.472513,0,1,25197181,25196005,1176
26970581,1221.6,1175.99,1224,1460,0.495005,0,1,25198405,25197181,1224
26986641,1486.73,1462.68,1488,1460,0.716304,0,2,25213405,25211917,1488
26988101,1510.74,1486.73,1512,1460,0.748521,0,2,25214917,25213405,1512
27001241,1726.68,1701.54,1728,1460,0.903481,0,2,25229485,25227757,1728
27002701,1727.93,1726.68,1728,1460,0.931392,0,2,25231213,25229485,1728
27004161,1773.6,1727.93,1776,1460,0.942557,0,2,25232989,25231213,1776
27014381,1485.49,1437.76,1488,1460,0.729042,0,2,25244125,25242637,1488
27015841,1533.47,1485.49,1536,1460,0.741617,0,2,25245661,25244125,1536
27017301,1535.87,1533.47,1536,1460,0.758647,0,2,25247197,25245661,1536
27018761,1558.79,1535.87,1560,1460,0.777459,0,2,25248757,25247197,1560
27020221,1582.74,1558.79,1584,1460,0.796983,0,2,25250341,25248757,1584
27030441,1726.8,1703.94,1728,1460,0.917972,0,2,25262029,25260301,1728
27031901,1750.74,1726.8,1752,1460,0.937189,0,2,25263781,25262029,1752
27050881,885.6,839.997,888,1460,0.227302,0,1,25278589,25277701,888
27052341,933.48,885.6,936,1460,0.228921,0,1,25279525,25278589,936
27056721,1004.34,934.854,1008,1460,0.299051,0,1,25282381,25281373,1008
27065481,1125.54,1078.74,1128,1460,0.401681,0,1,25288717,25287589,1128
27066941,1127.88,1125.54,1128,1460,0.430672,0,1,25289845,25288717,1128
27068401,1173.59,1127.88,1176,1460,0.454269,0,1,25291021,25289845,1176
27069861,1198.68,1173.59,1200,1460,0.475708,0,1,25292221,25291021,1200
27071321,1222.73,1198.68,1224,1460,0.484283,0,1,25293445,25292221,1224
27072781,1223.94,1222.73,1224,1460,0.499713,0,1,25294669,25293445,1224
27087381,1487.82,1484.45,1488,1460,0.729959,0,2,25308373,25306885,1488
27088841,1533.59,1487.82,1536,1460,0.729984,0,2,25309909,25308373,1536
27093221,1582.68,1557.65,1584,1460,0.796239,0,2,25314565,25312981,1584
27103441,1726.73,1702.68,1728,1460,0.904392,0,2,25326157,25324429,1728
27104901,1727.94,1726.73,1728,1460,0.943757,0,2,25327885,25326157,1728
27125341,1485.6,1439.93,1488,1460,0.702561,0,2,25348597,25347109,1488
27126801,1487.88,1485.6,1488,1460,0.731025,0,2,25350085,25348597,1488
27139941,1726.68,1701.54,1728,1460,0.903506,0,2,25364629,25362901,1728
27141401,1727.93,1726.68,1728,1460,0.907402,0,2,25366357,25364629,1728
27142861,1728,1727.93,1728,1460,0.932961,0,2,25368085,25366357,1728
27160381,1486.79,1463.82,1488,1460,0.705401,0,2,25386661,25385173,1488
27161841,1487.94,1486.79,1488,1460,0.73216,0,2,25388149,25386661,1488
27163301,1533.6,1487.94,1536,1460,0.742864,0,2,25389685,25388149,1536
27164761,1535.88,1533.6,1536,1460,0.771146,0,2,25391221,25389685,1536
27166221,1581.59,1535.88,1584,1460,0.782458,0,2,25392805,25391221,1584
27173521,1701.6,1655.93,1704,1460,0.906601,0,2,25401037,25399333,1704
27174981,1749.48,1701.6,1752,1460,0.90864,0,2,25402789,25401037,1752
27198341,1507.19,1415.89,1512,1460,0.704274,0,2,25426861,25425349,1512
27202721,1534.74,1510.85,1536,1460,0.781154,0,2,25431397,25429861,1536
27212941,1725.59,1679.88,1728,1460,0.914226,0,2,25442893,25441165,1728
27214401,1750.68,1725.59,1752,1460,0.92369,0,2,25444645,25442893,1752
27215861,1751.93,1750.68,1752,1460,0.939476,0,2,25446397,25444645,1752
27221701,1662.06,1777.14,1656,1460,0.756099,0,2,25453405,25451749,1656
27224621,1349.36,1451.1,1344,1460,0.484576,0,1,25456189,25454845,1344
27226081,1093.47,1349.36,1080,1460,0.45183,0,1,25457269,25456189,1080
27229001,1151.85,1149.07,1152,1460,0.457493,0,1,25459573,25458421,1152
27249441,1484.4,1415.94,1488,1460,0.711802,0,2,25478077,25476589,1488
27250901,1510.62,1484.4,1512,1460,0.722721,0,2,25479589,25478077,1512
27252361,1511.93,1510.62,1512,1460,0.739088,0,2,25481101,25479589,1512
27253821,1534.8,1511.93,1536,1460,0.757635,0,2,25482637,25481101,1536
27255281,1558.74,1534.8,1560,1460,0.777054,0,2,25484197,25482637,1560
27265501,1704,1703.93,1704,1460,0.936992,0,2,25495837,25494133,1704
27266961,1795.2,1704,1800,1460,0.944797,0,2,25497637,25495837,1800
27272801,1708.85,1801.08,1704,1460,0.791563,0,2,25504741,25503037,1704
27274261,1499.04,1708.85,1488,1460,0.766625,0,2,25506229,25504741,1488
27283021,1463.94,1462.82,1464,1460,0.725976,0,2,25515181,25513717,1464
27284481,1532.4,1463.94,1536,1460,0.75239,0,2,25516717,25515181,1536
27285941,1558.62,1532.4,1560,1460,0.762956,0,2,25518277,25516717,1560
27287401,1559.93,1558.62,1560,1460,0.779182,0,2,25519837,25518277,1560
27297621,1727.82,1724.4,1728,1460,0.917995,0,2,25531477,25529749,1728
27299081,1750.79,1727.82,1752,1460,0.925198,0,2,25533229,25531477,1752
27309301,1128.04,1128.79,1128,1460,0.436112,0,1,25543817,25542689,1128
27312221,1197.54,1150.8,1200,1460,0.464578,0,1,25546169,25544969,1200
27313681,1199.88,1197.54,1200,1460,0.479831,0,1,25547369,25546169,1200
27315141,1222.79,1199.88,1224,1460,0.497932,0,1,25548593,25547369,1224
27329741,1485.54,1438.74,1488,1460,0.701593,0,2,25562225,25560737,1488
27331201,1487.88,1485.54,1488,1460,0.730637,0,2,25563713,25562225,1488
27347261,1726.73,1702.69,1728,1460,0.928674,0,2,25581545,25579817,1728
27348721,1773.54,1726.73,1776,1460,0.94147,0,2,25583321,25581545,1776
27356021,1420.38,1503.54,1416,1460,0.493183,0,1,25591577,25590161,1416
27357481,1074.22,1420.38,1056,1460,0.419273,0,1,25592633,25591577,1056
27360401,1102.79,1079.71,1104,1460,0.418684,0,1,25594817,25593713,1104
27366241,1175.83,1172.51,1176,1460,0.482894,0,1,25599425,25598249,1176
27367701,1244.39,1175.83,1248,1460,0.487158,0,1,25600673,25599425,1248
27383761,1485.59,1439.88,1488,1460,0.714206,0,2,25615577,25614089,1488
27385221,1510.68,1485.59,1512,1460,0.735682,0,2,25617089,25615577,1512
27399821,1704,1703.93,1704,1460,0.912968,0,2,25633361,25631657,1704
27401281,1749.6,1704,1752,1460,0.947187,0,2,25635113,25633361,1752
27407121,1662.06,1777.19,1656,1460,0.792776,0,2,25642145,25640489,1656
27408581,1519.5,1662.06,1512,1460,0.77911,0,2,25643657,25642145,1512
27421721,1726.62,1700.46,1728,1460,0.927183,0,2,25658321,25656593,1728
27431941,1169.58,1503.66,1152,1460,0.492682,0,1,25669889,25668737,1152
27433401,1152.88,1169.58,1152,1460,0.467073,0,1,25671041,25669889,1152
27452381,1485.59,1439.88,1488,1460,0.714352,0,2,25688393,25686905,1488
27453841,1510.68,1485.59,1512,1460,0.735741,0,2,25689905,25688393,1512
27455301,1534.73,1510.68,1536,1460,0.756296,0,2,25691441,25689905,1536
27456761,1558.74,1534.73,1560,1460,0.764518,0,2,25693001,25691441,1560
27458221,1559.94,1558.74,1560,1460,0.779807,0,2,25694561,25693001,1560
27459681,1582.8,1559.94,1584,1460,0.785923,0,2,25696145,25694561,1584
27466981,1702.79,1679.87,1704,1460,0.909325,0,2,25704425,25702721,1704
27468441,1749.54,1702.79,1752,1460,0.93373,0,2,25706177,25704425,1752
27478661,1187.88,1413.6,1176,1460,0.231477,0,1,25717721,25716545,1176
27480121,671.194,1187.88,644,1460,0.098591,0,1,25718365,25717721,644
27484501,718.683,693.658,720,1460,0.0939098,0,1,25720429,25719709,720
27496181,886.743,862.851,888,1460,0.217335,0,1,25726957,25726069,888
27497641,910.737,886.743,912,1460,0.236934,0,1,25727869,25726957,912
27499101,934.737,910.737,936,1460,0.256774,0,1,25728805,25727869,936
27500561,958.737,934.737,960,1460,0.276709,0,1,25729765,25728805,960
27502021,982.737,958.737,984,1460,0.296684,0,1,25730749,25729765,984
27510781,1126.74,1102.74,1128,1460,0.416667,0,1,25737157,25736029,1128
27512241,1150.74,1126.74,1152,1460,0.436667,0,1,25738309,25737157,1152
27513701,1174.74,1150.74,1176,1460,0.456667,0,1,25739485,25738309,1176
27515161,1198.74,1174.74,1200,1460,0.476667,0,1,25740685,25739485,1200
27516621,1222.74,1198.74,1224,1460,0.496667,0,1,25741909,25740685,1224
27534141,1509.54,1462.85,1512,1460,0.746119,0,2,25758421,25756909,1512
27535601,1557.48,1509.54,1560,1460,0.748448,0,2,25759981,25758421,1560
27547281,1702.68,1677.65,1704,1460,0.908263,0,2,25772965,25771261,1704
27548741,1749.53,1702.68,1752,1460,0.909305,0,2,25774717,25772965,1752
27577941,1726.73,1702.68,1728,1460,0.904447,0,2,25807549,25805821,1728
27579401,1727.94,1726.73,1728,1460,0.931779,0,2,25809277,25807549,1728
27580861,1773.6,1727.94,1776,1460,0.942711,0,2,25811053,25809277,1776
27604221,1486.79,1463.88,1488,1460,0.717494,0,2,25833853,25832365,1488
27605681,1510.74,1486.79,1512,1460,0.748998,0,2,25835365,25833853,1512
27617361,1702.62,1676.45,1704,1460,0.907026,0,2,25848253,25846549,1704
27624661,1776.05,1776.97,1776,1460,0.943406,0,2,25857061,25855285,1776
27640721,1535.88,1533.65,1536,1460,0.771345,0,2,25873501,25871965,1536
27642181,1581.59,1535.88,1584,1460,0.782538,0,2,25875085,25873501,1584
27652401,1727.88,1725.65,1728,1460,0.931309,0,2,25886797,25885069,1728
27653861,1773.59,1727.88,1776,1460,0.942524,0,2,25888573,25886797,1776
27659701,1800.11,1802.22,1800,1460,0.795249,0,2,25895797,25893997,1800
27675761,1463.99,1463.88,1464,1460,0.700666,0,2,25911037,25909573,1464
27677221,1486.8,1463.99,1488,1460,0.742266,0,2,25912525,25911037,1488
27678681,1556.34,1486.8,1560,1460,0.758906,0,2,25914085,25912525,1560
27680141,1559.82,1556.34,1560,1460,0.765563,0,2,25915645,25914085,1560
27681601,1559.99,1559.82,1560,1460,0.768225,0,2,25917205,25915645,1560
27710801,1486.8,1463.93,1488,1460,0.7179,0,2,25949245,25947757,1488
27712261,1510.74,1486.8,1512,1460,0.73716,0,2,25950757,25949245,1512
27713721,1534.74,1510.74,1536,1460,0.756864,0,2,25952293,25950757,1536
27715181,1558.74,1534.74,1560,1460,0.764746,0,2,25953853,25952293,1560
27723941,1702.73,1678.68,1704,1460,0.908434,0,2,25963693,25961989,1704
27725401,1749.54,1702.73,1752,1460,0.909373,0,2,25965445,25963693,1752
27748761,1486.74,1462.74,1488,1460,0.716716,0,2,25989253,25987765,1488
27750221,1510.74,1486.74,1512,1460,0.736687,0,2,25990765,25989253,1512
27751681,1534.74,1510.74,1536,1460,0.744675,0,2,25992301,25990765,1536
27753141,1535.94,1534.74,1536,1460,0.75987,0,2,25993837,25992301,1536
27754601,1558.8,1535.94,1560,1460,0.789948,0,2,25995397,25993837,1560
27763361,1725.6,1679.93,1728,1460,0.914596,0,2,26005357,26003629,1728
27764821,1750.68,1725.6,1752,1460,0.935838,0,2,26007109,26005357,1752
27773581,1451.22,1664.34,1440,1460,0.707615,0,2,26017429,26015989,1440
27780881,1558.68,1533.65,1560,1460,0.788523,0,2,26024965,26023405,1560
27782341,1605.53,1558.68,1608,1460,0.789409,0,2,26026573,26024965,1608
27792561,1725.6,1679.99,1728,1460,0.903001,0,2,26038165,26036437,1728
27794021,1727.88,1725.6,1728,1460,0.9192,0,2,26039893,26038165,1728
27795481,1750.79,1727.88,1752,1460,0.93768,0,2,26041645,26039893,1752
27818841,1486.74,1462.79,1488,1460,0.72898,0,2,26064397,26062909,1488
27820301,1533.54,1486.74,1536,1460,0.741592,0,2,26065933,26064397,1536
27821761,1535.88,1533.54,1536,1460,0.758637,0,2,26067469,26065933,1536
27823221,1558.79,1535.88,1560,1460,0.777455,0,2,26069029,26067469,1560
27846581,1185.87,1373.36,1176,1460,0.498319,0,1,26095189,26094013,1176
27864101,1485.6,1439.93,1488,1460,0.702561,0,2,26111269,26109781,1488
27865561,1487.88,1485.6,1488,1460,0.731025,0,2,26112757,26111269,1488
27878701,1703.93,1702.68,1704,1460,0.911419,0,2,26127325,26125621,1704
27907901,1509.48,1461.65,1512,1460,0.73294,0,2,26156197,26154685,1512
27909361,1534.67,1509.48,1536,1460,0.755176,0,2,26157733,26156197,1536
27921041,1726.62,1700.34,1728,1460,0.902304,0,2,26170693,26168965,1728
27922501,1727.93,1726.62,1728,1460,0.918922,0,2,26172421,26170693,1728
27923961,1750.8,1727.93,1752,1460,0.937569,0,2,26174173,26172421,1752
27929801,1570.86,1777.14,1560,1460,0.71621,0,2,26181085,26179525,1560
27938561,1462.8,1440,1464,1460,0.710866,0,2,26189677,26188213,1464
27940021,1509.54,1462.8,1512,1460,0.734347,0,2,26191189,26189677,1512
27941481,1534.68,1509.54,1536,1460,0.755739,0,2,26192725,26191189,1536
27942941,1558.73,1534.68,1560,1460,0.776295,0,2,26194285,26192725,1560
27944401,1582.74,1558.73,1584,1460,0.796518,0,2,26195869,26194285,1584
27953161,1726.74,1702.8,1728,1460,0.917096,0,2,26205925,26204197,1728
27954621,1750.74,1726.74,1752,1460,0.936838,0,2,26207677,26205925,1752
27963381,1298.46,1801.19,1272,1460,0.421286,0,1,26217925,26216653,1272
27964841,931.323,1298.46,912,1460,0.294514,0,1,26218837,26217925,912
27966301,890.166,931.323,888,1460,0.267806,0,1,26219725,26218837,888
27980901,1149.54,1102.85,1152,1460,0.422128,0,1,26230045,26228893,1152
27982361,1151.88,1149.54,1152,1460,0.438851,0,1,26231197,26230045,1152
27983821,1174.79,1151.88,1176,1460,0.469541,0,1,26232373,26231197,1176
27985281,1221.54,1174.79,1224,1460,0.493816,0,1,26233597,26232373,1224
28004261,1486.79,1463.82,1488,1460,0.705106,0,2,26251237,26249749,1488
28005721,1487.94,1486.79,1488,1460,0.744042,0,2,26252725,26251237,1488
28007181,1556.4,1487.94,1560,1460,0.759617,0,2,26254285,26252725,1560
28008641,1559.82,1556.4,1560,1460,0.777847,0,2,26255845,26254285,1560
28017401,1703.88,1701.65,1704,1460,0.923329,0,2,26265805,26264101,1704
28018861,1772.39,1703.88,1776,1460,0.927332,0,2,26267581,26265805,1776
28026161,1800.05,1801.08,1800,1460,0.744904,0,2,26276533,26274733,1800
28039301,1463.99,1463.87,1464,1460,0.712594,0,2,26289133,26287669,1464
28040761,1509.6,1463.99,1512,1460,0.747038,0,2,26290645,26289133,1512
28042221,1557.48,1509.6,1560,1460,0.760815,0,2,26292205,26290645,1560
28043681,1559.87,1557.48,1560,1460,0.778326,0,2,26293765,26292205,1560
28045141,1582.79,1559.87,1584,1460,0.79733,0,2,26295349,26293765,1584
28053901,1702.8,1679.94,1704,1460,0.909949,0,2,26305309,26303605,1704
28055361,1749.54,1702.8,1752,1460,0.92198,0,2,26307061,26305309,1752
28056821,1751.88,1749.54,1752,1460,0.938792,0,2,26308813,26307061,1752
28064121,864.06,1321.2,840,1460,0.269207,0,1,26316325,26315485,840
28068501,934.68,909.6,936,1460,0.273309,0,1,26319037,26318101,936
28081641,1125.6,1080,1128,1460,0.415255,0,1,26328445,26327317,1128
28083101,1150.68,1125.6,1152,1460,0.448102,0,1,26329597,26328445,1152
28084561,1197.53,1150.68,1200,1460,0.449241,0,1,26330797,26329597,1200
28102081,1462.74,1438.74,1464,1460,0.708613,0,2,26346733,26345269,1464
28103541,1509.54,1462.74,1512,1460,0.733445,0,2,26348245,26346733,1512
28105001,1534.68,1509.54,1536,1460,0.743378,0,2,26349781,26348245,1536
28106461,1535.93,1534.68,1536,1460,0.771351,0,2,26351317,26349781,1536
28107921,1581.6,1535.93,1584,1460,0.782541,0,2,26352901,26351317,1584
28134201,1123.02,1028.42,1128,1460,0.432091,0,1,26380045,26378917,1128
28135661,1196.15,1123.02,1200,1460,0.442837,0,1,26381245,26380045,1200
28154641,1486.62,1460.4,1488,1460,0.702784,0,2,26398453,26396965,1488
28156101,1487.93,1486.62,1488,1460,0.719113,0,2,26399941,26398453,1488
28157561,1510.8,1487.93,1512,1460,0.749645,0,2,26401453,26399941,1512
28159021,1557.54,1510.8,1560,1460,0.773858,0,2,26403013,26401453,1560
28160481,1582.68,1557.54,1584,1460,0.783543,0,2,26404597,26403013,1584
28170701,1750.62,1724.45,1752,1460,0.946986,0,2,26416261,26414509,1752
28180921,835.107,1198.14,816,1460,0.200416,0,1,26427085,26426269,816
28188221,839.997,839.934,840,1460,0.206004,0,1,26431189,26430349,840
28189681,908.4,839.997,912,1460,0.232402,0,1,26432101,26431189,912
28207201,1174.68,1149.65,1176,1460,0.456267,0,1,26444725,26443549,1176
28208661,1198.73,1174.68,1200,1460,0.476507,0,1,26445925,26444725,1200
28210121,1222.74,1198.73,1224,1460,0.484603,0,1,26447149,26445925,1224
28211581,1223.94,1222.74,1224,1460,0.499841,0,1,26448373,26447149,1224
28232021,1559.82,1556.45,1560,1460,0.778123,0,2,26468221,26466661,1560
28233481,1582.79,1559.82,1584,1460,0.797249,0,2,26469805,26468221,1584
28240781,1726.68,1701.59,1728,1460,0.9277,0,2,26478157,26476429,1728
28242241,1773.53,1726.68,1776,1460,0.94108,0,2,26479933,26478157,1776
28249541,697.277,721.543,696,1460,0.0874063,0,1,26485615,26484919,696
28269981,886.743,862.857,888,1460,0.217718,0,1,26496871,26495983,888
28275821,934.743,910.857,936,1460,0.245718,0,1,26500519,26499583,936
28277281,935.937,934.743,936,1460,0.260287,0,1,26501455,26500519,936
28283121,982.743,958.857,984,1460,0.297783,0,1,26505295,26504311,984
28300641,1126.74,1102.86,1128,1460,0.417718,0,1,26517967,26516839,1128
28306481,1174.74,1150.86,1176,1460,0.457718,0,1,26522575,26521399,1176
28313781,1222.74,1198.8,1224,1460,0.497599,0,1,26528551,26527327,1224
28350281,1510.74,1486.8,1512,1460,0.737599,0,2,26562847,26561335,1512
28356121,1558.74,1534.86,1560,1460,0.777715,0,2,26568991,26567431,1560
28379481,1750.74,1726.86,1752,1460,0.937718,0,2,26595487,26593735,1752
28392621,1594.8,1800.06,1584,1460,0.491251,0,1,26611351,26609767,1584
28395541,660.342,970.84,644,1460,0.0786001,0,1,26612933,26612289,644
28397001,644.817,660.342,644,1460,0.03144,0,1,26613577,26612933,644
28398461,644.041,644.817,644,1460,0.012576,0,1,26614221,26613577,644
28399921,644.002,644.041,644,1460,0.00503041,0,1,26614865,26614221,644
28401381,644,644.002,644,1460,0.00201216,0,1,26615509,26614865,644
28402841,644,644,644,1460,0.000804865,0,1,26616153,26615509,644
28404301,644,644,644,1460,0.000321946,0,1,26616797,26616153,644
28405761,644,644,644,1460,0.000128778,0,1,26617441,26616797,644
28407221,644,644,644,1460,5.15114e-05,0,1,26618085,26617441,644
28408681,644,644,644,1460,2.06045e-05,0,1,26618729,26618085,644
28410141,644,644,644,1460,8.24182e-06,0,1,26619373,26618729,644
28411601,644,644,644,1460,3.29673e-06,0,1,26620017,26619373,644
28413061,644,644,644,1460,1.31869e-06,0,1,26620661,26620017,644
28414521,644,644,644,1460,5.27476e-07,0,1,26621305,26620661,644
28415981,644,644,644,1460,2.1099e-07,0,1,26621949,26621305,644
28417441,644,644,644,1460,8.43962e-08,0,1,26622593,26621949,644
28418901,644,644,644,1460,3.37585e-08,0,1,26623237,26622593,644
28420361,644,644,644,1460,1.35034e-08,0,1,26623881,26623237,644
28421821,644,644,644,1460,0.00600001,0,1,26624525,26623881,644
28423281,647.8,644,648,1460,0.0204,0,1,26625173,26624525,648
28429121,694.743,670.857,696,1460,0.0577862,0,1,26627861,26627165,696
28434961,742.743,718.857,744,1460,0.0977193,0,1,26630741,26629997,744
28453941,886.743,862.857,888,1460,0.217783,0,1,26641373,26640485,888
28459781,934.743,910.857,936,1460,0.257719,0,1,26645021,26644085,936
28465621,982.743,958.857,984,1460,0.297718,0,1,26648861,26647877,984
28484601,1126.74,1102.8,1128,1460,0.417599,0,1,26662613,26661485,1128
28490441,1174.74,1150.86,1176,1460,0.457715,0,1,26667221,26666045,1176
28496281,1222.74,1198.86,1224,1460,0.497717,0,1,26672021,26670797,1224
28532781,1510.74,1486.86,1512,1460,0.737718,0,2,26706221,26704709,1512
28538621,1558.74,1534.86,1560,1460,0.777718,0,2,26712365,26710805,1560
28563441,1750.74,1726.86,1752,1460,0.937719,0,2,26740517,26738765,1752
28575121,1594.8,1800.06,1584,1460,0.492214,0,1,26754629,26753045,1584
28578041,660.627,976.54,644,1460,0.0787542,0,1,26756217,26755573,644
28579501,644.831,660.627,644,1460,0.0315017,0,1,26756861,26756217,644
28580961,644.042,644.831,644,1460,0.0126007,0,1,26757505,26756861,644
28582421,644.002,644.042,644,1460,0.00504027,0,1,26758149,26757505,644
28583881,644,644.002,644,1460,0.00201611,0,1,26758793,26758149,644
28585341,644,644,644,1460,0.000806443,0,1,26759437,26758793,644
28586801,644,644,644,1460,0.000322577,0,1,26760081,26759437,644
28588261,644,644,644,1460,0.000129031,0,1,26760725,26760081,644
28589721,644,644,644,1460,5.16123e-05,0,1,26761369,26760725,644
28591181,644,644,644,1460,2.06449e-05,0,1,26762013,26761369,644
28592641,644,644,644,1460,8.25797e-06,0,1,26762657,26762013,644
28594101,644,644,644,1460,3.30319e-06,0,1,26763301,26762657,644
28595561,644,644,644,1460,1.32128e-06,0,1,26763945,26763301,644
28597021,644,644,644,1460,5.2851e-07,0,1,26764589,26763945,644
28598481,644,644,644,1460,2.11404e-07,0,1,26765233,26764589,644
28599941,644,644,644,1460,8.45616e-08,0,1,26765877,26765233,644
28601401,644,644,644,1460,3.38247e-08,0,1,26766521,26765877,644
28602861,644,644,644,1460,1.35299e-08,0,1,26767165,26766521,644
28604321,644,644,644,1460,0.00600001,0,1,26767809,26767165,644
28605781,647.8,644,648,1460,0.0204,0,1,26768457,26767809,648
28611621,694.743,670.857,696,1460,0.0577862,0,1,26771145,26770449,696
28617461,742.743,718.857,744,1460,0.0977193,0,1,26774025,26773281,744
28636441,886.743,862.857,888,1460,0.217783,0,1,26784657,26783769,888
28642281,934.743,910.857,936,1460,0.257719,0,1,26788305,26787369,936
28648121,982.743,958.857,984,1460,0.297718,0,1,26792145,26791161,984
28667101,1126.74,1102.8,1128,1460,0.417599,0,1,26805897,26804769,1128
28672941,1174.74,1150.86,1176,1460,0.457715,0,1,26810505,26809329,1176
28678781,1222.74,1198.86,1224,1460,0.497717,0,1,26815305,26814081,1224
28715281,1510.74,1486.86,1512,1460,0.737718,0,2,26849505,26847993,1512
28721121,1558.74,1534.86,1560,1460,0.777718,0,2,26855649,26854089,1560
28745941,1750.74,1726.86,1752,1460,0.937719,0,2,26883801,26882049,1752
28757621,1594.8,1800.06,1584,1460,0.492214,0,1,26897913,26896329,1584
28760541,660.627,976.54,644,1460,0.0787542,0,1,26899501,26898857,644
28762001,644.831,660.627,644,1460,0.0315017,0,1,26900145,26899501,644
28763461,644.042,644.831,644,1460,0.0126007,0,1,26900789,26900145,644
28764921,644.002,644.042,644,1460,0.00504027,0,1,26901433,26900789,644
28766381,644,644.002,644,1460,0.00201611,0,1,26902077,26901433,644
28767841,644,644,644,1460,0.000806443,0,1,26902721,26902077,644
28769301,644,644,644,1460,0.000322577,0,1,26903365,26902721,644
28770761,644,644,644,1460,0.000129031,0,1,26904009,26903365,644
28772221,644,644,644,1460,5.16123e-05,0,1,26904653,26904009,644
28773681,644,644,644,1460,2.06449e-05,0,1,26905297,26904653,644
28775141,644,644,644,1460,8.25797e-06,0,1,26905941,26905297,644
28776601,644,644,644,1460,3.30319e-06,0,1,26906585,26905941,644
28778061,644,644,644,1460,1.32128e-06,0,1,26907229,26906585,644
28779521,644,644,644,1460,5.2851e-07,0,1,26907873,26907229,644
28780981,644,644,644,1460,2.11404e-07,0,1,26908517,26907873,644
28782441,644,644,644,1460,8.45616e-08,0,1,26909161,26908517,644
28783901,644,644,644,1460,3.38247e-08,0,1,26909805,26909161,644
28785361,644,644,644,1460,1.35299e-08,0,1,26910449,26909805,644
28786821,644,644,644,1460,0.00600001,0,1,26911093,26910449,644
28788281,647.8,644,648,1460,0.0204,0,1,26911741,26911093,648
28794121,694.743,670.857,696,1460,0.0577862,0,1,26914429,26913733,696
28799961,742.743,718.857,744,1460,0.0977193,0,1,26917309,26916565,744
28818941,886.743,862.857,888,1460,0.217783,0,1,26927941,26927053,888
28824781,934.743,910.857,936,1460,0.257719,0,1,26931589,26930653,936
28830621,982.743,958.857,984,1460,0.297718,0,1,26935429,26934445,984
28849601,1126.74,1102.8,1128,1460,0.417599,0,1,26949181,26948053,1128
28855441,1174.74,1150.86,1176,1460,0.457715,0,1,26953789,26952613,1176
28861281,1222.74,1198.86,1224,1460,0.497717,0,1,26958589,26957365,1224
28897781,1510.74,1486.86,1512,1460,0.737718,0,2,26992789,26991277,1512
28903621,1558.74,1534.86,1560,1460,0.777718,0,2,26998933,26997373,1560
28928441,1750.74,1726.86,1752,1460,0.937719,0,2,27027085,27025333,1752
28940121,1594.8,1800.06,1584,1460,0.492214,0,1,27041197,27039613,1584
28943041,660.627,976.54,644,1460,0.0787542,0,1,27042785,27042141,644
28944501,644.831,660.627,644,1460,0.0315017,0,1,27043429,27042785,644
28945961,644.042,644.831,644,1460,0.0126007,0,1,27044073,27043429,644
28947421,644.002,644.042,644,1460,0.00504027,0,1,27044717,27044073,644
28948881,644,644.002,644,1460,0.00201611,0,1,27045361,27044717,644
28950341,644,644,644,1460,0.000806443,0,1,27046005,27045361,644
28951801,644,644,644,1460,0.000322577,0,1,27046649,27046005,644
28953261,644,644,644,1460,0.000129031,0,1,27047293,27046649,644
28954721,644,644,644,1460,5.16123e-05,0,1,27047937,27047293,644
28956181,644,644,644,1460,2.06449e-05,0,1,27048581,27047937,644
28957641,644,644,644,1460,8.25797e-06,0,1,27049225,27048581,644
28959101,644,644,644,1460,3.30319e-06,0,1,27049869,27049225,644
28960561,644,644,644,1460,1.32128e-06,0,1,27050513,27049869,644
28962021,644,644,644,1460,5.2851e-07,0,1,27051157,27050513,644
28963481,644,644,644,1460,2.11404e-07,0,1,27051801,27051157,644
28964941,644,644,644,1460,8.45616e-08,0,1,27052445,27051801,644
28966401,644,644,644,1460,3.38247e-08,0,1,27053089,27052445,644
28967861,644,644,644,1460,1.35299e-08,0,1,27053733,27053089,644
28969321,644,644,644,1460,0.00600001,0,1,27054377,27053733,644
28970781,647.8,644,648,1460,0.0204,0,1,27055025,27054377,648
28976621,694.743,670.857,696,1460,0.0577862,0,1,27057713,27057017,696
28982461,742.743,718.857,744,1460,0.0977193,0,1,27060593,27059849,744
29001441,886.743,862.857,888,1460,0.217783,0,1,27071225,27070337,888
29007281,934.743,910.857,936,1460,0.257719,0,1,27074873,27073937,936
29013121,982.743,958.857,984,1460,0.297718,0,1,27078713,27077729,984
29032101,1126.74,1102.8,1128,1460,0.417599,0,1,27092465,27091337,1128
29037941,1174.74,1150.86,1176,1460,0.457715,0,1,27097073,27095897,1176
29043781,1222.74,1198.86,1224,1460,0.497717,0,1,27101873,27100649,1224
29080281,1510.74,1486.86,1512,1460,0.737718,0,2,27136073,27134561,1512
29086121,1558.74,1534.86,1560,1460,0.777718,0,2,27142217,27140657,1560
29110941,1750.74,1726.86,1752,1460,0.937719,0,2,27170369,27168617,1752
29122621,1594.8,1800.06,1584,1460,0.492214,0,1,27184481,27182897,1584
29125541,660.627,976.54,644,1460,0.0787542,0,1,27186069,27185425,644
29127001,644.831,660.627,644,1460,0.0315017,0,1,27186713,27186069,644
29128461,644.042,644.831,644,1460,0.0126007,0,1,27187357,27186713,644
29129921,644.002,644.042,644,1460,0.00504027,0,1,27188001,27187357,644
29131381,644,644.002,644,1460,0.00201611,0,1,27188645,27188001,644
29132841,644,644,644,1460,0.000806443,0,1,27189289,27188645,644
29134301,644,644,644,1460,0.000322577,0,1,27189933,27189289,644
29135761,644,644,644,1460,0.000129031,0,1,27190577,27189933,644
29137221,644,644,644,1460,5.16123e-05,0,1,27191221,27190577,644
29138681,644,644,644,1460,2.06449e-05,0,1,27191865,27191221,644
29140141,644,644,644,1460,8.25797e-06,0,1,27192509,27191865,644
29141601,644,644,644,1460,3.30319e-06,0,1,27193153,27192509,644
29143061,644,644,644,1460,1.32128e-06,0,1,27193797,27193153,644
29144521,644,644,644,1460,5.2851e-07,0,1,27194441,27193797,644
29145981,644,644,644,1460,2.11404e-07,0,1,27195085,27194441,644
29147441,644,644,644,1460,8.45616e-08,0,1,27195729,27195085,644
29148901,644,644,644,1460,3.38247e-08,0,1,27196373,27195729,644
29150361,644,644,644,1460,1.35299e-08,0,1,27197017,27196373,644
29151821,644,644,644,1460,0.00600001,0,1,27197661,27197017,644
29153281,647.8,644,648,1460,0.0204,0,1,27198309,27197661,648
29159121,694.743,670.857,696,1460,0.0577862,0,1,27200997,27200301,696
29164961,742.743,718.857,744,1460,0.0977193,0,1,27203877,27203133,744
29183941,886.743,862.857,888,1460,0.217783,0,1,27214509,27213621,888
29189781,934.743,910.857,936,1460,0.257719,0,1,27218157,27217221,936
29195621,982.743,958.857,984,1460,0.297718,0,1,27221997,27221013,984
29214601,1126.74,1102.8,1128,1460,0.417599,0,1,27235749,27234621,1128
29220441,1174.74,1150.86,1176,1460,0.457715,0,1,27240357,27239181,1176
29226281,1222.74,1198.86,1224,1460,0.497717,0,1,27245157,27243933,1224
29262781,1510.74,1486.86,1512,1460,0.737718,0,2,27279357,27277845,1512
29268621,1558.74,1534.86,1560,1460,0.777718,0,2,27285501,27283941,1560
29293441,1750.74,1726.86,1752,1460,0.937719,0,2,27313653,27311901,1752
29305121,1594.8,1800.06,1584,1460,0.492214,0,1,27327765,27326181,1584
29308041,660.627,976.54,644,1460,0.0787542,0,1,27329353,27328709,644
29309501,644.831,660.627,644,1460,0.0315017,0,1,27329997,27329353,644
29310961,644.042,644.831,644,1460,0.0126007,0,1,27330641,27329997,644
29312421,644.002,644.042,644,1460,0.00504027,0,1,27331285,27330641,644
29313881,644,644.002,644,1460,0.00201611,0,1,27331929,27331285,644
29315341,644,644,644,1460,0.000806443,0,1,27332573,27331929,644
29316801,644,644,644,1460,0.000322577,0,1,27333217,27332573,644
29318261,644,644,644,1460,0.000129031,0,1,27333861,27333217,644
29319721,644,644,644,1460,5.16123e-05,0,1,27334505,27333861,644
29321181,644,644,644,1460,2.06449e-05,0,1,27335149,27334505,644
29322641,644,644,644,1460,8.25797e-06,0,1,27335793,27335149,644
29324101,644,644,644,1460,3.30319e-06,0,1,27336437,27335793,644
29325561,644,644,644,1460,1.32128e-06,0,1,27337081,27336437,644
29327021,644,644,644,1460,5.2851e-07,0,1,27337725,27337081,644
29328481,644,644,644,1460,2.11404e-07,0,1,27338369,27337725,644
29329941,644,644,644,1460,8.45616e-08,0,1,27339013,27338369,644
29331401,644,644,644,1460,3.38247e-08,0,1,27339657,27339013,644
29332861,644,644,644,1460,1.35299e-08,0,1,27340301,27339657,644
29334321,644,644,644,1460,0.00600001,0,1,27340945,27340301,644
29335781,647.8,644,648,1460,0.0204,0,1,27341593,27340945,648
29341621,694.743,670.857,696,1460,0.0577862,0,1,27344281,27343585,696
29347461,742.743,718.857,744,1460,0.0977193,0,1,27347161,27346417,744
29366441,886.743,862.857,888,1460,0.217783,0,1,27357793,27356905,888
29372281,934.743,910.857,936,1460,0.257719,0,1,27361441,27360505,936
29378121,982.743,958.857,984,1460,0.297718,0,1,27365281,27364297,984
29397101,1126.74,1102.8,1128,1460,0.417599,0,1,27379033,27377905,1128
29402941,1174.74,1150.86,1176,1460,0.457715,0,1,27383641,27382465,1176
29408781,1222.74,1198.86,1224,1460,0.497717,0,1,27388441,27387217,1224
29445281,1510.74,1486.86,1512,1460,0.737718,0,2,27422641,27421129,1512
29451121,1558.74,1534.86,1560,1460,0.777718,0,2,27428785,27427225,1560
29475941,1750.74,1726.86,1752,1460,0.937719,0,2,27456937,27455185,1752
29487621,1594.8,1800.06,1584,1460,0.492214,0,1,27471049,27469465,1584
29490541,660.627,976.54,644,1460,0.0787542,0,1,27472637,27471993,644
29492001,644.831,660.627,644,1460,0.0315017,0,1,27473281,27472637,644
29493461,644.042,644.831,644,1460,0.0126007,0,1,27473925,27473281,644
29494921,644.002,644.042,644,1460,0.00504027,0,1,27474569,27473925,644
29496381,644,644.002,644,1460,0.00201611,0,1,27475213,27474569,644
29497841,644,644,644,1460,0.000806443,0,1,27475857,27475213,644
29499301,644,644,644,1460,0.000322577,0,1,27476501,27475857,644
29500761,644,644,644,1460,0.000129031,0,1,27477145,27476501,644
29502221,644,644,644,1460,5.16123e-05,0,1,27477789,27477145,644
29503681,644,644,644,1460,2.06449e-05,0,1,27478433,27477789,644
29505141,644,644,644,1460,8.25797e-06,0,1,27479077,27478433,644
29506601,644,644,644,1460,3.30319e-06,0,1,27479721,27479077,644
29508061,644,644,644,1460,1.32128e-06,0,1,27480365,27479721,644
29509521,644,644,644,1460,5.2851e-07,0,1,27481009,27480365,644
29510981,644,644,644,1460,2.11404e-07,0,1,27481653,27481009,644
29512441,644,644,644,1460,8.45616e-08,0,1,27482297,27481653,644
29513901,644,644,644,1460,3.38247e-08,0,1,27482941,27482297,644
29515361,644,644,644,1460,1.35299e-08,0,1,27483585,27482941,644
29516821,644,644,644,1460,0.00600001,0,1,27484229,27483585,644
29518281,647.8,644,648,1460,0.0204,0,1,27484877,27484229,648
29524121,694.743,670.857,696,1460,0.0577862,0,1,27487565,27486869,696
29529961,742.743,718.857,744,1460,0.0977193,0,1,27490445,27489701,744
29548941,886.743,862.857,888,1460,0.217783,0,1,27501077,27500189,888
29554781,934.743,910.857,936,1460,0.257719,0,1,27504725,27503789,936
29560621,982.743,958.857,984,1460,0.297718,0,1,27508565,27507581,984
29579601,1126.74,1102.8,1128,1460,0.417599,0,1,27522317,27521189,1128
29585441,1174.74,1150.86,1176,1460,0.457715,0,1,27526925,27525749,1176
29591281,1222.74,1198.86,1224,1460,0.497717,0,1,27531725,27530501,1224
29627781,1510.74,1486.86,1512,1460,0.737718,0,2,27565925,27564413,1512
29633621,1558.74,1534.86,1560,1460,0.777718,0,2,27572069,27570509,1560
29658441,1750.74,1726.86,1752,1460,0.937719,0,2,27600221,27598469,1752
29670121,1594.8,1800.06,1584,1460,0.492214,0,1,27614333,27612749,1584
29673041,660.627,976.54,644,1460,0.0787542,0,1,27615921,27615277,644
29674501,644.831,660.627,644,1460,0.0315017,0,1,27616565,27615921,644
29675961,644.042,644.831,644,1460,0.0126007,0,1,27617209,27616565,644
29677421,644.002,644.042,644,1460,0.00504027,0,1,27617853,27617209,644
29678881,644,644.002,644,1460,0.00201611,0,1,27618497,27617853,644
29680341,644,644,644,1460,0.000806443,0,1,27619141,27618497,644
29681801,644,644,644,1460,0.000322577,0,1,27619785,27619141,644
29683261,644,644,644,1460,0.000129031,0,1,27620429,27619785,644
29684721,644,644,644,1460,5.16123e-05,0,1,27621073,27620429,644
29686181,644,644,644,1460,2.06449e-05,0,1,27621717,27621073,644
29687641,644,644,644,1460,8.25797e-06,0,1,27622361,27621717,644
29689101,644,644,644,1460,3.30319e-06,0,1,27623005,27622361,644
29690561,644,644,644,1460,1.32128e-06,0,1,27623649,27623005,644
29692021,644,644,644,1460,5.2851e-07,0,1,27624293,27623649,644
29693481,644,644,644,1460,2.11404e-07,0,1,27624937,27624293,644
29694941,644,644,644,1460,8.45616e-08,0,1,27625581,27624937,644
29696401,644,644,644,1460,3.38247e-08,0,1,27626225,27625581,644
29697861,644,644,644,1460,1.35299e-08,0,1,27626869,27626225,644
29699321,644,644,644,1460,0.00600001,0,1,27627513,27626869,644
29700781,647.8,644,648,1460,0.0204,0,1,27628161,27627513,648
29706621,694.743,670.857,696,1460,0.0577862,0,1,27630849,27630153,696
29712461,742.743,718.857,744,1460,0.0977193,0,1,27633729,27632985,744
29731441,886.743,862.857,888,1460,0.217783,0,1,27644361,27643473,888
29737281,934.743,910.857,936,1460,0.257719,0,1,27648009,27647073,936
29743121,982.743,958.857,984,1460,0.297718,0,1,27651849,27650865,984
29762101,1126.74,1102.8,1128,1460,0.417599,0,1,27665601,27664473,1128
29767941,1174.74,1150.86,1176,1460,0.457715,0,1,27670209,27669033,1176
29773781,1222.74,1198.86,1224,1460,0.497717,0,1,27675009,27673785,1224
29810281,1510.74,1486.86,1512,1460,0.737718,0,2,27709209,27707697,1512
29816121,1558.74,1534.86,1560,1460,0.777718,0,2,27715353,27713793,1560
29840941,1750.74,1726.86,1752,1460,0.937719,0,2,27743505,27741753,1752
29852621,1594.8,1800.06,1584,1460,0.492214,0,1,27757617,27756033,1584
29855541,660.627,976.54,644,1460,0.0787542,0,1,27759205,27758561,644
29857001,644.831,660.627,644,1460,0.0315017,0,1,27759849,27759205,644
29858461,644.042,644.831,644,1460,0.0126007,0,1,27760493,27759849,644
29859921,644.002,644.042,644,1460,0.00504027,0,1,27761137,27760493,644
29861381,644,644.002,644,1460,0.00201611,0,1,27761781,27761137,644
29862841,644,644,644,1460,0.000806443,0,1,27762425,27761781,644
29864301,644,644,644,1460,0.000322577,0,1,27763069,27762425,644
29865761,644,644,644,1460,0.000129031,0,1,27763713,27763069,644
29867221,644,644,644,1460,5.16123e-05,0,1,27764357,27763713,644
29868681,644,644,644,1460,2.06449e-05,0,1,27765001,27764357,644
29870141,644,644,644,1460,8.25797e-06,0,1,27765645,27765001,644
29871601,644,644,644,1460,3.30319e-06,0,1,27766289,27765645,644
29873061,644,644,644,1460,1.32128e-06,0,1,27766933,27766289,644
29874521,644,644,644,1460,5.2851e-07,0,1,27767577,27766933,644
29875981,644,644,644,1460,2.11404e-07,0,1,27768221,27767577,644
29877441,644,644,644,1460,8.45616e-08,0,1,27768865,27768221,644
29878901,644,644,644,1460,3.38247e-08,0,1,27769509,27768865,644
29880361,644,644,644,1460,1.35299e-08,0,1,27770153,27769509,644
29881821,644,644,644,1460,0.00600001,0,1,27770797,27770153,644
29883281,647.8,644,648,1460,0.0204,0,1,27771445,27770797,648
29889121,694.743,670.857,696,1460,0.0577862,0,1,27774133,27773437,696
29894961,742.743,718.857,744,1460,0.0977193,0,1,27777013,27776269,744
29913941,886.743,862.857,888,1460,0.217783,0,1,27787645,27786757,888
29919781,934.743,910.857,936,1460,0.257719,0,1,27791293,27790357,936
29925621,982.743,958.857,984,1460,0.297718,0,1,27795133,27794149,984
29944601,1126.74,1102.8,1128,1460,0.417599,0,1,27808885,27807757,1128
29950441,1174.74,1150.86,1176,1460,0.457715,0,1,27813493,27812317,1176
29956281,1222.74,1198.86,1224,1460,0.497717,0,1,27818293,27817069,1224
29992781,1510.74,1486.86,1512,1460,0.737718,0,2,27852493,27850981,1512
29998621,1558.74,1534.86,1560,1460,0.777718,0,2,27858637,27857077,1560
30023441,1750.74,1726.86,1752,1460,0.937719,0,2,27886789,27885037,1752
30035121,1594.8,1800.06,1584,1460,0.492214,0,1,27900901,27899317,1584
30038041,660.627,976.54,644,1460,0.0787542,0,1,27902489,27901845,644
30039501,644.831,660.627,644,1460,0.0315017,0,1,27903133,27902489,644
30040961,644.042,644.831,644,1460,0.0126007,0,1,27903777,27903133,644
30042421,644.002,644.042,644,1460,0.00504027,0,1,27904421,27903777,644
30043881,644,644.002,644,1460,0.00201611,0,1,27905065,27904421,644
30045341,644,644,644,1460,0.000806443,0,1,27905709,27905065,644
30046801,644,644,644,1460,0.000322577,0,1,27906353,27905709,644
30048261,644,644,644,1460,0.000129031,0,1,27906997,27906353,644
30049721,644,644,644,1460,5.16123e-05,0,1,27907641,27906997,644
30051181,644,644,644,1460,2.06449e-05,0,1,27908285,27907641,644
30052641,644,644,644,1460,8.25797e-06,0,1,27908929,27908285,644
30054101,644,644,644,1460,3.30319e-06,0,1,27909573,27908929,644
30055561,644,644,644,1460,1.32128e-06,0,1,27910217,27909573,644
30057021,644,644,644,1460,5.2851e-07,0,1,27910861,27910217,644
30058481,644,644,644,1460,2.11404e-07,0,1,27911505,27910861,644
30059941,644,644,644,1460,8.45616e-08,0,1,27912149,27911505,644
30061401,644,644,644,1460,3.38247e-08,0,1,27912793,27912149,644
30062861,644,644,644,1460,1.35299e-08,0,1,27913437,27912793,644
30064321,644,644,644,1460,0.00600001,0,1,27914081,27913437,644
30065781,647.8,644,648,1460,0.0204,0,1,27914729,27914081,648
30071621,694.743,670.857,696,1460,0.0577862,0,1,27917417,27916721,696
30077461,742.743,718.857,744,1460,0.0977193,0,1,27920297,27919553,744
30096441,886.743,862.857,888,1460,0.217783,0,1,27930929,27930041,888
30102281,934.743,910.857,936,1460,0.257719,0,1,27934577,27933641,936
30108121,982.743,958.857,984,1460,0.297718,0,1,27938417,27937433,984
30127101,1126.74,1102.8,1128,1460,0.417599,0,1,27952169,27951041,1128
30132941,1174.74,1150.86,1176,1460,0.457715,0,1,27956777,27955601,1176
30138781,1222.74,1198.86,1224,1460,0.497717,0,1,27961577,27960353,1224
30175281,1510.74,1486.86,1512,1460,0.737718,0,2,27995777,27994265,1512
30181121,1558.74,1534.86,1560,1460,0.777718,0,2,28001921,28000361,1560
30205941,1750.74,1726.86,1752,1460,0.937719,0,2,28030073,28028321,1752
30217621,1594.8,1800.06,1584,1460,0.492214,0,1,28044185,28042601,1584
30220541,660.627,976.54,644,1460,0.0787542,0,1,28045773,28045129,644
30222001,644.831,660.627,644,1460,0.0315017,0,1,28046417,28045773,644
30223461,644.042,644.831,644,1460,0.0126007,0,1,28047061,28046417,644
30224921,644.002,644.042,644,1460,0.00504027,0,1,28047705,28047061,644
30226381,644,644.002,644,1460,0.00201611,0,1,28048349,28047705,644
30227841,644,644,644,1460,0.000806443,0,1,28048993,28048349,644
30229301,644,644,644,1460,0.000322577,0,1,28049637,28048993,644
30230761,644,644,644,1460,0.000129031,0,1,28050281,28049637,644
30232221,644,644,644,1460,5.16123e-05,0,1,28050925,28050281,644
30233681,644,644,644,1460,2.06449e-05,0,1,28051569,28050925,644
30235141,644,644,644,1460,8.25797e-06,0,1,28052213,28051569,644
30236601,644,644,644,1460,3.30319e-06,0,1,28052857,28052213,644
30238061,644,644,644,1460,1.32128e-06,0,1,28053501,28052857,644
30239521,644,644,644,1460,5.2851e-07,0,1,28054145,28053501,644
30240981,644,644,644,1460,2.11404e-07,0,1,28054789,28054145,644
30242441,644,644,644,1460,8.45616e-08,0,1,28055433,28054789,644
30243901,644,644,644,1460,3.38247e-08,0,1,28056077,28055433,644
30245361,644,644,644,1460,1.35299e-08,0,1,28056721,28056077,644
30246821,644,644,644,1460,0.00600001,0,1,28057365,28056721,644
30248281,647.8,644,648,1460,0.0204,0,1,28058013,28057365,648
30254121,694.743,670.857,696,1460,0.0577862,0,1,28060701,28060005,696
30259961,742.743,718.857,744,1460,0.0977193,0,1,28063581,28062837,744
30278941,886.743,862.857,888,1460,0.217783,0,1,28074213,28073325,888
30284781,934.743,910.857,936,1460,0.257719,0,1,28077861,28076925,936
30290621,982.743,958.857,984,1460,0.297718,0,1,28081701,28080717,984
30309601,1126.74,1102.8,1128,1460,0.417599,0,1,28095453,28094325,1128
30315441,1174.74,1150.86,1176,1460,0.457715,0,1,28100061,28098885,1176
30321281,1222.74,1198.86,1224,1460,0.497717,0,1,28104861,28103637,1224
30357781,1510.74,1486.86,1512,1460,0.737718,0,2,28139061,28137549,1512
30363621,1558.74,1534.86,1560,1460,0.777718,0,2,28145205,28143645,1560
30388441,1750.74,1726.86,1752,1460,0.937719,0,2,28173357,28171605,1752
30400121,1594.8,1800.06,1584,1460,0.492214,0,1,28187469,28185885,1584
30403041,660.627,976.54,644,1460,0.0787542,0,1,28189057,28188413,644
30404501,644.831,660.627,644,1460,0.0315017,0,1,28189701,28189057,644
30405961,644.042,644.831,644,1460,0.0126007,0,1,28190345,28189701,644
30407421,644.002,644.042,644,1460,0.00504027,0,1,28190989,28190345,644
30408881,644,644.002,644,1460,0.00201611,0,1,28191633,28190989,644
30410341,644,644,644,1460,0.000806443,0,1,28192277,28191633,644
30411801,644,644,644,1460,0.000322577,0,1,28192921,28192277,644
30413261,644,644,644,1460,0.000129031,0,1,28193565,28192921,644
30414721,644,644,644,1460,5.16123e-05,0,1,28194209,28193565,644
30416181,644,644,644,1460,2.06449e-05,0,1,28194853,28194209,644
30417641,644,644,644,1460,8.25797e-06,0,1,28195497,28194853,644
30419101,644,644,644,1460,3.30319e-06,0,1,28196141,28195497,644
30420561,644,644,644,1460,1.32128e-06,0,1,28196785,28196141,644
30422021,644,644,644,1460,5.2851e-07,0,1,28197429,28196785,644
30423481,644,644,644,1460,2.11404e-07,0,1,28198073,28197429,644
30424941,644,644,644,1460,8.45616e-08,0,1,28198717,28198073,644
30426401,644,644,644,1460,3.38247e-08,0,1,28199361,28198717,644
30427861,644,644,644,1460,1.35299e-08,0,1,28200005,28199361,644
30429321,644,644,644,1460,0.00600001,0,1,28200649,28200005,644
30430781,647.8,644,648,1460,0.0204,0,1,28201297,28200649,648
30436621,694.743,670.857,696,1460,0.0577862,0,1,28203985,28203289,696
30442461,742.743,718.857,744,1460,0.0977193,0,1,28206865,28206121,744
30461441,886.743,862.857,888,1460,0.217783,0,1,28217497,28216609,888
30467281,934.743,910.857,936,1460,0.257719,0,1,28221145,28220209,936
30473121,982.743,958.857,984,1460,0.297718,0,1,28224985,28224001,984
30492101,1126.74,1102.8,1128,1460,0.417599,0,1,28238737,28237609,1128
30497941,1174.74,1150.86,1176,1460,0.457715,0,1,28243345,28242169,1176
30503781,1222.74,1198.86,1224,1460,0.497717,0,1,28248145,28246921,1224
30540281,1510.74,1486.86,1512,1460,0.737718,0,2,28282345,28280833,1512
30546121,1558.74,1534.86,1560,1460,0.777718,0,2,28288489,28286929,1560
30570941,1750.74,1726.86,1752,1460,0.937719,0,2,28316641,28314889,1752
30582621,1594.8,1800.06,1584,1460,0.492214,0,1,28330753,28329169,1584
30585541,660.627,976.54,644,1460,0.0787542,0,1,28332341,28331697,644
30587001,644.831,660.627,644,1460,0.0315017,0,1,28332985,28332341,644
30588461,644.042,644.831,644,1460,0.0126007,0,1,28333629,28332985,644
30589921,644.002,644.042,644,1460,0.00504027,0,1,28334273,28333629,644
30591381,644,644.002,644,1460,0.00201611,0,1,28334917,28334273,644
30592841,644,644,644,1460,0.000806443,0,1,28335561,28334917,644
30594301,644,644,644,1460,0.000322577,0,1,28336205,28335561,644
30595761,644,644,644,1460,0.000129031,0,1,28336849,28336205,644
30597221,644,644,644,1460,5.16123e-05,0,1,28337493,28336849,644
30598681,644,644,644,1460,2.06449e-05,0,1,28338137,28337493,644
30600141,644,644,644,1460,8.25797e-06,0,1,28338781,28338137,644
30601601,644,644,644,1460,3.30319e-06,0,1,28339425,28338781,644
30603061,644,644,644,1460,1.32128e-06,0,1,28340069,28339425,644
30604521,644,644,644,1460,5.2851e-07,0,1,28340713,28340069,644
30605981,644,644,644,1460,2.11404e-07,0,1,28341357,28340713,644
30607441,644,644,644,1460,8.45616e-08,0,1,28342001,28341357,644
30608901,644,644,644,1460,3.38247e-08,0,1,28342645,28342001,644
30610361,644,644,644,1460,1.35299e-08,0,1,28343289,28342645,644
30611821,644,644,644,1460,0.00600001,0,1,28343933,28343289,644
30613281,647.8,644,648,1460,0.0204,0,1,28344581,28343933,648
30619121,694.743,670.857,696,1460,0.0577862,0,1,28347269,28346573,696
30624961,742.743,718.857,744,1460,0.0977193,0,1,28350149,28349405,744
30643941,886.743,862.857,888,1460,0.217783,0,1,28360781,28359893,888
30649781,934.743,910.857,936,1460,0.257719,0,1,28364429,28363493,936
30655621,982.743,958.857,984,1460,0.297718,0,1,28368269,28367285,984
30674601,1126.74,1102.8,1128,1460,0.417599,0,1,28382021,28380893,1128
30680441,1174.74,1150.86,1176,1460,0.457715,0,1,28386629,28385453,1176
30686281,1222.74,1198.86,1224,1460,0.497717,0,1,28391429,28390205,1224
30722781,1510.74,1486.86,1512,1460,0.737718,0,2,28425629,28424117,1512
30728621,1558.74,1534.86,1560,1460,0.777718,0,2,28431773,28430213,1560
30753441,1750.74,1726.86,1752,1460,0.937719,0,2,28459925,28458173,1752
30765121,1594.8,1800.06,1584,1460,0.492214,0,1,28474037,28472453,1584
30768041,660.627,976.54,644,1460,0.0787542,0,1,28475625,28474981,644
30769501,644.831,660.627,644,1460,0.0315017,0,1,28476269,28475625,644
30770961,644.042,644.831,644,1460,0.0126007,0,1,28476913,28476269,644
30772421,644.002,644.042,644,1460,0.00504027,0,1,28477557,28476913,644
30773881,644,644.002,644,1460,0.00201611,0,1,28478201,28477557,644
30775341,644,644,644,1460,0.000806443,0,1,28478845,28478201,644
30776801,644,644,644,1460,0.000322577,0,1,28479489,28478845,644
30778261,644,644,644,1460,0.000129031,0,1,28480133,28479489,644
30779721,644,644,644,1460,5.16123e-05,0,1,28480777,28480133,644
30781181,644,644,644,1460,2.06449e-05,0,1,28481421,28480777,644
30782641,644,644,644,1460,8.25797e-06,0,1,28482065,28481421,644
30784101,644,644,644,1460,3.30319e-06,0,1,28482709,28482065,644
30785561,644,644,644,1460,1.32128e-06,0,1,28483353,28482709,644
30787021,644,644,644,1460,5.2851e-07,0,1,28483997,28483353,644
30788481,644,644,644,1460,2.11404e-07,0,1,28484641,28483997,644
30789941,644,644,644,1460,8.45616e-08,0,1,28485285,28484641,644
30791401,644,644,644,1460,3.38247e-08,0,1,28485929,28485285,644
30792861,644,644,644,1460,1.35299e-08,0,1,28486573,28485929,644
30794321,644,644,644,1460,0.00600001,0,1,28487217,28486573,644
30795781,647.8,644,648,1460,0.0204,0,1,28487865,28487217,648
30801621,694.743,670.857,696,1460,0.0577862,0,1,28490553,28489857,696
30807461,742.743,718.857,744,1460,0.0977193,0,1,28493433,28492689,744
30826441,886.743,862.857,888,1460,0.217783,0,1,28504065,28503177,888
30832281,934.743,910.857,936,1460,0.257719,0,1,28507713,28506777,936
30838121,982.743,958.857,984,1460,0.297718,0,1,28511553,28510569,984
30857101,1126.74,1102.8,1128,1460,0.417599,0,1,28525305,28524177,1128
30862941,1174.74,1150.86,1176,1460,0.457715,0,1,28529913,28528737,1176
30868781,1222.74,1198.86,1224,1460,0.497717,0,1,28534713,28533489,1224
30905281,1510.74,1486.86,1512,1460,0.737718,0,2,28568913,28567401,1512
30911121,1558.74,1534.86,1560,1460,0.777718,0,2,28575057,28573497,1560
30935941,1750.74,1726.86,1752,1460,0.937719,0,2,28603209,28601457,1752
30947621,1594.8,1800.06,1584,1460,0.492214,0,1,28617321,28615737,1584
30950541,660.627,976.54,644,1460,0.0787542,0,1,28618909,28618265,644
30952001,644.831,660.627,644,1460,0.0315017,0,1,28619553,28618909,644
30953461,644.042,644.831,644,1460,0.0126007,0,1,28620197,28619553,644
30954921,644.002,644.042,644,1460,0.00504027,0,1,28620841,28620197,644
30956381,644,644.002,644,1460,0.00201611,0,1,28621485,28620841,644
30957841,644,644,644,1460,0.000806443,0,1,28622129,28621485,644
30959301,644,644,644,1460,0.000322577,0,1,28622773,28622129,644
30960761,644,644,644,1460,0.000129031,0,1,28623417,28622773,644
30962221,644,644,644,1460,5.16123e-05,0,1,28624061,28623417,644
30963681,644,644,644,1460,2.06449e-05,0,1,28624705,28624061,644
30965141,644,644,644,1460,8.25797e-06,0,1,28625349,28624705,644
30966601,644,644,644,1460,3.30319e-06,0,1,28625993,28625349,644
30968061,644,644,644,1460,1.32128e-06,0,1,28626637,28625993,644
30969521,644,644,644,1460,5.2851e-07,0,1,28627281,28626637,644
30970981,644,644,644,1460,2.11404e-07,0,1,28627925,28627281,644
30972441,644,644,644,1460,8.45616e-08,0,1,28628569,28627925,644
30973901,644,644,644,1460,3.38247e-08,0,1,28629213,28628569,644
30975361,644,644,644,1460,1.35299e-08,0,1,28629857,28629213,644
30976821,644,644,644,1460,0.00600001,0,1,28630501,28629857,644
30978281,647.8,644,648,1460,0.0204,0,1,28631149,28630501,648
30984121,694.743,670.857,696,1460,0.0577862,0,1,28633837,28633141,696
30989961,742.743,718.857,744,1460,0.0977193,0,1,28636717,28635973,744
31008941,886.743,862.857,888,1460,0.217783,0,1,28647349,28646461,888
31014781,934.743,910.857,936,1460,0.257719,0,1,28650997,28650061,936
31020621,982.743,958.857,984,1460,0.297718,0,1,28654837,28653853,984
31039601,1126.74,1102.8,1128,1460,0.417599,0,1,28668589,28667461,1128
31045441,1174.74,1150.86,1176,1460,0.457715,0,1,28673197,28672021,1176
31051281,1222.74,1198.86,1224,1460,0.497717,0,1,28677997,28676773,1224
31087781,1510.74,1486.86,1512,1460,0.737718,0,2,28712197,28710685,1512
31093621,1558.74,1534.86,1560,1460,0.777718,0,2,28718341,28716781,1560
31118441,1750.74,1726.86,1752,1460,0.937719,0,2,28746493,28744741,1752
31130121,1594.8,1800.06,1584,1460,0.492214,0,1,28760605,28759021,1584
31133041,660.627,976.54,644,1460,0.0787542,0,1,28762193,28761549,644
31134501,644.831,660.627,644,1460,0.0315017,0,1,28762837,28762193,644
31135961,644.042,644.831,644,1460,0.0126007,0,1,28763481,28762837,644
31137421,644.002,644.042,644,1460,0.00504027,0,1,28764125,28763481,644
31138881,644,644.002,644,1460,0.00201611,0,1,28764769,28764125,644
31140341,644,644,644,1460,0.000806443,0,1,28765413,28764769,644
31141801,644,644,644,1460,0.000322577,0,1,28766057,28765413,644
31143261,644,644,644,1460,0.000129031,0,1,28766701,28766057,644
31144721,644,644,644,1460,5.16123e-05,0,1,28767345,28766701,644
31146181,644,644,644,1460,2.06449e-05,0,1,28767989,28767345,644
31147641,644,644,644,1460,8.25797e-06,0,1,28768633,28767989,644
31149101,644,644,644,1460,3.30319e-06,0,1,28769277,28768633,644
31150561,644,644,644,1460,1.32128e-06,0,1,28769921,28769277,644
31152021,644,644,644,1460,5.2851e-07,0,1,28770565,28769921,644
31153481,644,644,644,1460,2.11404e-07,0,1,28771209,28770565,644
31154941,644,644,644,1460,8.45616e-08,0,1,28771853,28771209,644
31156401,644,644,644,1460,3.38247e-08,0,1,28772497,28771853,644
31157861,644,644,644,1460,1.35299e-08,0,1,28773141,28772497,644
31159321,644,644,644,1460,0.00600001,0,1,28773785,28773141,644
31160781,647.8,644,648,1460,0.0204,0,1,28774433,28773785,648
31166621,694.743,670.857,696,1460,0.0577862,0,1,28777121,28776425,696
31172461,742.743,718.857,744,1460,0.0977193,0,1,28780001,28779257,744
31191441,886.743,862.857,888,1460,0.217783,0,1,28790633,28789745,888
31197281,934.743,910.857,936,1460,0.257719,0,1,28794281,28793345,936
31203121,982.743,958.857,984,1460,0.297718,0,1,28798121,28797137,984
31222101,1126.74,1102.8,1128,1460,0.417599,0,1,28811873,28810745,1128
31227941,1174.74,1150.86,1176,1460,0.457715,0,1,28816481,28815305,1176
31233781,1222.74,1198.86,1224,1460,0.497717,0,1,28821281,28820057,1224
31270281,1510.74,1486.86,1512,1460,0.737718,0,2,28855481,28853969,1512
31276121,1558.74,1534.86,1560,1460,0.777718,0,2,28861625,28860065,1560
31300941,1750.74,1726.86,1752,1460,0.937719,0,2,28889777,28888025,1752
31312621,1594.8,1800.06,1584,1460,0.492214,0,1,28903889,28902305,1584
31315541,660.627,976.54,644,1460,0.0787542,0,1,28905477,28904833,644
31317001,644.831,660.627,644,1460,0.0315017,0,1,28906121,28905477,644
31318461,644.042,644.831,644,1460,0.0126007,0,1,28906765,28906121,644
31319921,644.002,644.042,644,1460,0.00504027,0,1,28907409,28906765,644
31321381,644,644.002,644,1460,0.00201611,0,1,28908053,28907409,644
31322841,644,644,644,1460,0.000806443,0,1,28908697,28908053,644
31324301,644,644,644,1460,0.000322577,0,1,28909341,28908697,644
31325761,644,644,644,1460,0.000129031,0,1,28909985,28909341,644
31327221,644,644,644,1460,5.16123e-05,0,1,28910629,28909985,644
31328681,644,644,644,1460,2.06449e-05,0,1,28911273,28910629,644
31330141,644,644,644,1460,8.25797e-06,0,1,28911917,28911273,644
31331601,644,644,644,1460,3.30319e-06,0,1,28912561,28911917,644
31333061,644,644,644,1460,1.32128e-06,0,1,28913205,28912561,644
31334521,644,644,644,1460,5.2851e-07,0,1,28913849,28913205,644
31335981,644,644,644,1460,2.11404e-07,0,1,28914493,28913849,644
31337441,644,644,644,1460,8.45616e-08,0,1,28915137,28914493,644
31338901,644,644,644,1460,3.38247e-08,0,1,28915781,28915137,644
31340361,644,644,644,1460,1.35299e-08,0,1,28916425,28915781,644
31341821,644,644,644,1460,0.00600001,0,1,28917069,28916425,644
31343281,647.8,644,648,1460,0.0204,0,1,28917717,28917069,648
31349121,694.743,670.857,696,1460,0.0577862,0,1,28920405,28919709,696
31354961,742.743,718.857,744,1460,0.0977193,0,1,28923285,28922541,744
31373941,886.743,862.857,888,1460,0.217783,0,1,28933917,28933029,888
31379781,934.743,910.857,936,1460,0.257719,0,1,28937565,28936629,936
31385621,982.743,958.857,984,1460,0.297718,0,1,28941405,28940421,984
31404601,1126.74,1102.8,1128,1460,0.417599,0,1,28955157,28954029,1128
31410441,1174.74,1150.86,1176,1460,0.457715,0,1,28959765,28958589,1176
31416281,1222.74,1198.86,1224,1460,0.497717,0,1,28964565,28963341,1224
31452781,1510.74,1486.86,1512,1460,0.737718,0,2,28998765,28997253,1512
31458621,1558.74,1534.86,1560,1460,0.777718,0,2,29004909,29003349,1560
31483441,1750.74,1726.86,1752,1460,0.937719,0,2,29033061,29031309,1752
31495121,1594.8,1800.06,1584,1460,0.492214,0,1,29047173,29045589,1584
31498041,660.627,976.54,644,1460,0.0787542,0,1,29048761,29048117,644
31499501,644.831,660.627,644,1460,0.0315017,0,1,29049405,29048761,644
31500961,644.042,644.831,644,1460,0.0126007,0,1,29050049,29049405,644
31502421,644.002,644.042,644,1460,0.00504027,0,1,29050693,29050049,644
31503881,644,644.002,644,1460,0.00201611,0,1,29051337,29050693,644
31505341,644,644,644,1460,0.000806443,0,1,29051981,29051337,644
31506801,644,644,644,1460,0.000322577,0,1,29052625,29051981,644
31508261,644,644,644,1460,0.000129031,0,1,29053269,29052625,644
31509721,644,644,644,1460,5.16123e-05,0,1,29053913,29053269,644
31511181,644,644,644,1460,2.06449e-05,0,1,29054557,29053913,644
31512641,644,644,644,1460,8.25797e-06,0,1,29055201,29054557,644
31514101,644,644,644,1460,3.30319e-06,0,1,29055845,29055201,644
31515561,644,644,644,1460,1.32128e-06,0,1,29056489,29055845,644
31517021,644,644,644,1460,5.2851e-07,0,1,29057133,29056489,644
31518481,644,644,644,1460,2.11404e-07,0,1,29057777,29057133,644
31519941,644,644,644,1460,8.45616e-08,0,1,29058421,29057777,644
31521401,644,644,644,1460,3.38247e-08,0,1,29059065,29058421,644
31522861,644,644,644,1460,1.35299e-08,0,1,29059709,29059065,644
31524321,644,644,644,1460,0.00600001,0,1,29060353,29059709,644
31525781,647.8,644,648,1460,0.0204,0,1,29061001,29060353,648
31531621,694.743,670.857,696,1460,0.0577862,0,1,29063689,29062993,696
31537461,742.743,718.857,744,1460,0.0977193,0,1,29066569,29065825,744
31556441,886.743,862.857,888,1460,0.217783,0,1,29077201,29076313,888
31562281,934.743,910.857,936,1460,0.257719,0,1,29080849,29079913,936
31568121,982.743,958.857,984,1460,0.297718,0,1,29084689,29083705,984
31587101,1126.74,1102.8,1128,1460,0.417599,0,1,29098441,29097313,1128
31592941,1174.74,1150.86,1176,1460,0.457715,0,1,29103049,29101873,1176
31598781,1222.74,1198.86,1224,1460,0.497717,0,1,29107849,29106625,1224
31635281,1510.74,1486.86,1512,1460,0.737718,0,2,29142049,29140537,1512
31641121,1558.74,1534.86,1560,1460,0.777718,0,2,29148193,29146633,1560
31665941,1750.74,1726.86,1752,1460,0.937719,0,2,29176345,29174593,1752
31677621,1594.8,1800.06,1584,1460,0.492214,0,1,29190457,29188873,1584
31680541,660.627,976.54,644,1460,0.0787542,0,1,29192045,29191401,644
31682001,644.831,660.627,644,1460,0.0315017,0,1,29192689,29192045,644
31683461,644.042,644.831,644,1460,0.0126007,0,1,29193333,29192689,644
31684921,644.002,644.042,644,1460,0.00504027,0,1,29193977,29193333,644
31686381,644,644.002,644,1460,0.00201611,0,1,29194621,29193977,644
31687841,644,644,644,1460,0.000806443,0,1,29195265,29194621,644
31689301,644,644,644,1460,0.000322577,0,1,29195909,29195265,644
31690761,644,644,644,1460,0.000129031,0,1,29196553,29195909,644
31692221,644,644,644,1460,5.16123e-05,0,1,29197197,29196553,644
31693681,644,644,644,1460,2.06449e-05,0,1,29197841,29197197,644
31695141,644,644,644,1460,8.25797e-06,0,1,29198485,29197841,644
31696601,644,644,644,1460,3.30319e-06,0,1,29199129,29198485,644
31698061,644,644,644,1460,1.32128e-06,0,1,29199773,29199129,644
31699521,644,644,644,1460,5.2851e-07,0,1,29200417,29199773,644
31700981,644,644,644,1460,2.11404e-07,0,1,29201061,29200417,644
31702441,644,644,644,1460,8.45616e-08,0,1,29201705,29201061,644
31703901,644,644,644,1460,3.38247e-08,0,1,29202349,29201705,644
31705361,644,644,644,1460,1.35299e-08,0,1,29202993,29202349,644
31706821,644,644,644,1460,0.00600001,0,1,29203637,29202993,644
31708281,647.8,644,648,1460,0.0204,0,1,29204285,29203637,648
31714121,694.743,670.857,696,1460,0.0577862,0,1,29206973,29206277,696
31719961,742.743,718.857,744,1460,0.0977193,0,1,29209853,29209109,744
31738941,886.743,862.857,888,1460,0.217783,0,1,29220485,29219597,888
31744781,934.743,910.857,936,1460,0.257719,0,1,29224133,29223197,936
31750621,982.743,958.857,984,1460,0.297718,0,1,29227973,29226989,984
31769601,1126.74,1102.8,1128,1460,0.417599,0,1,29241725,29240597,1128
31775441,1174.74,1150.86,1176,1460,0.457715,0,1,29246333,29245157,1176
31781281,1222.74,1198.86,1224,1460,0.497717,0,1,29251133,29249909,1224
31817781,1510.74,1486.86,1512,1460,0.737718,0,2,29285333,29283821,1512
31823621,1558.74,1534.86,1560,1460,0.777718,0,2,29291477,29289917,1560
31848441,1750.74,1726.86,1752,1460,0.937719,0,2,29319629,29317877,1752
31860121,1594.8,1800.06,1584,1460,0.492214,0,1,29333741,29332157,1584
31863041,660.627,976.54,644,1460,0.0787542,0,1,29335329,29334685,644
31864501,644.831,660.627,644,1460,0.0315017,0,1,29335973,29335329,644
31865961,644.042,644.831,644,1460,0.0126007,0,1,29336617,29335973,644
31867421,644.002,644.042,644,1460,0.00504027,0,1,29337261,29336617,644
31868881,644,644.002,644,1460,0.00201611,0,1,29337905,29337261,644
31870341,644,644,644,1460,0.000806443,0,1,29338549,29337905,644
31871801,644,644,644,1460,0.000322577,0,1,29339193,29338549,644
31873261,644,644,644,1460,0.000129031,0,1,29339837,29339193,644
31874721,644,644,644,1460,5.16123e-05,0,1,29340481,29339837,644
31876181,644,644,644,1460,2.06449e-05,0,1,29341125,29340481,644
31877641,644,644,644,1460,8.25797e-06,0,1,29341769,29341125,644
31879101,644,644,644,1460,3.30319e-06,0,1,29342413,29341769,644
31880561,644,644,644,1460,1.32128e-06,0,1,29343057,29342413,644
31882021,644,644,644,1460,5.2851e-07,0,1,29343701,29343057,644
31883481,644,644,644,1460,2.11404e-07,0,1,29344345,29343701,644
31884941,644,644,644,1460,8.45616e-08,0,1,29344989,29344345,644
31886401,644,644,644,1460,3.38247e-08,0,1,29345633,29344989,644
31887861,644,644,644,1460,1.35299e-08,0,1,29346277,29345633,644
31889321,644,644,644,1460,0.00600001,0,1,29346921,29346277,644
31890781,647.8,644,648,1460,0.0204,0,1,29347569,29346921,648
31896621,694.743,670.857,696,1460,0.0577862,0,1,29350257,29349561,696
31902461,742.743,718.857,744,1460,0.0977193,0,1,29353137,29352393,744
31921441,886.743,862.857,888,1460,0.217783,0,1,29363769,29362881,888
31927281,934.743,910.857,936,1460,0.257719,0,1,29367417,29366481,936
31933121,982.743,958.857,984,1460,0.297718,0,1,29371257,29370273,984
31952101,1126.74,1102.8,1128,1460,0.417599,0,1,29385009,29383881,1128
31957941,1174.74,1150.86,1176,1460,0.457715,0,1,29389617,29388441,1176
31963781,1222.74,1198.86,1224,1460,0.497717,0,1,29394417,29393193,1224
32000281,1510.74,1486.86,1512,1460,0.737718,0,2,29428617,29427105,1512
32006121,1558.74,1534.86,1560,1460,0.777718,0,2,29434761,29433201,1560
32030941,1750.74,1726.86,1752,1460,0.937719,0,2,29462913,29461161,1752
32042621,1594.8,1800.06,1584,1460,0.492214,0,1,29477025,29475441,1584
32045541,660.627,976.54,644,1460,0.0787542,0,1,29478613,29477969,644
32047001,644.831,660.627,644,1460,0.0315017,0,1,29479257,29478613,644
32048461,644.042,644.831,644,1460,0.0126007,0,1,29479901,29479257,644
32049921,644.002,644.042,644,1460,0.00504027,0,1,29480545,29479901,644
32051381,644,644.002,644,1460,0.00201611,0,1,29481189,29480545,644
32052841,644,644,644,1460,0.000806443,0,1,29481833,29481189,644
32054301,644,644,644,1460,0.000322577,0,1,29482477,29481833,644
32055761,644,644,644,1460,0.000129031,0,1,29483121,29482477,644
32057221,644,644,644,1460,5.16123e-05,0,1,29483765,29483121,644
32058681,644,644,644,1460,2.06449e-05,0,1,29484409,29483765,644
32060141,644,644,644,1460,8.25797e-06,0,1,29485053,29484409,644
32061601,644,644,644,1460,3.30319e-06,0,1,29485697,29485053,644
32063061,644,644,644,1460,1.32128e-06,0,1,29486341,29485697,644
32064521,644,644,644,1460,5.2851e-07,0,1,29486985,29486341,644
32065981,644,644,644,1460,2.11404e-07,0,1,29487629,29486985,644
32067441,644,644,644,1460,8.45616e-08,0,1,29488273,29487629,644
32068901,644,644,644,1460,3.38247e-08,0,1,29488917,29488273,644
32070361,644,644,644,1460,1.35299e-08,0,1,29489561,29488917,644
32071821,644,644,644,1460,0.00600001,0,1,29490205,29489561,644
32073281,647.8,644,648,1460,0.0204,0,1,29490853,29490205,648
32079121,694.743,670.857,696,1460,0.0577862,0,1,29493541,29492845,696
32084961,742.743,718.857,744,1460,0.0977193,0,1,29496421,29495677,744
32103941,886.743,862.857,888,1460,0.217783,0,1,29507053,29506165,888
32109781,934.743,910.857,936,1460,0.257719,0,1,29510701,29509765,936
32115621,982.743,958.857,984,1460,0.297718,0,1,29514541,29513557,984
32134601,1126.74,1102.8,1128,1460,0.417599,0,1,29528293,29527165,1128
32140441,1174.74,1150.86,1176,1460,0.457715,0,1,29532901,29531725,1176
32146281,1222.74,1198.86,1224,1460,0.497717,0,1,29537701,29536477,1224
32182781,1510.74,1486.86,1512,1460,0.737718,0,2,29571901,29570389,1512
32188621,1558.74,1534.86,1560,1460,0.777718,0,2,29578045,29576485,1560
32213441,1750.74,1726.86,1752,1460,0.937719,0,2,29606197,29604445,1752
32225121,1594.8,1800.06,1584,1460,0.492214,0,1,29620309,29618725,1584
32228041,660.627,976.54,644,1460,0.0787542,0,1,29621897,29621253,644
32229501,644.831,660.627,644,1460,0.0315017,0,1,29622541,29621897,644
32230961,644.042,644.831,644,1460,0.0126007,0,1,29623185,29622541,644
32232421,644.002,644.042,644,1460,0.00504027,0,1,29623829,29623185,644
32233881,644,644.002,644,1460,0.00201611,0,1,29624473,29623829,644
32235341,644,644,644,1460,0.000806443,0,1,29625117,29624473,644
32236801,644,644,644,1460,0.000322577,0,1,29625761,29625117,644
32238261,644,644,644,1460,0.000129031,0,1,29626405,29625761,644
32239721,644,644,644,1460,5.16123e-05,0,1,29627049,29626405,644
32241181,644,644,644,1460,2.06449e-05,0,1,29627693,29627049,644
32242641,644,644,644,1460,8.25797e-06,0,1,29628337,29627693,644
32244101,644,644,644,1460,3.30319e-06,0,1,29628981,29628337,644
32245561,644,644,644,1460,1.32128e-06,0,1,29629625,29628981,644
32247021,644,644,644,1460,5.2851e-07,0,1,29630269,29629625,644
32248481,644,644,644,1460,2.11404e-07,0,1,29630913,29630269,644
32249941,644,644,644,1460,8.45616e-08,0,1,29631557,29630913,644
32251401,644,644,644,1460,3.38247e-08,0,1,29632201,29631557,644
32252861,644,644,644,1460,1.35299e-08,0,1,29632845,29632201,644
32254321,644,644,644,1460,0.00600001,0,1,29633489,29632845,644
32255781,647.8,644,648,1460,0.0204,0,1,29634137,29633489,648
32261621,694.743,670.857,696,1460,0.0577862,0,1,29636825,29636129,696
32267461,742.743,718.857,744,1460,0.0977193,0,1,29639705,29638961,744
32286441,886.743,862.857,888,1460,0.217783,0,1,29650337,29649449,888
32292281,934.743,910.857,936,1460,0.257719,0,1,29653985,29653049,936
32298121,982.743,958.857,984,1460,0.297718,0,1,29657825,29656841,984
32317101,1126.74,1102.8,1128,1460,0.417599,0,1,29671577,29670449,1128
32322941,1174.74,1150.86,1176,1460,0.457715,0,1,29676185,29675009,1176
32328781,1222.74,1198.86,1224,1460,0.497717,0,1,29680985,29679761,1224
32365281,1510.74,1486.86,1512,1460,0.737718,0,2,29715185,29713673,1512
32374041,659.207,948.137,644,1460,0.0831548,0,1,29722889,29722245,644
32375501,644.76,659.207,644,1460,0.0332619,0,1,29723533,29722889,644
32376961,644.038,644.76,644,1460,0.0133048,0,1,29724177,29723533,644
32378421,644.002,644.038,644,1460,0.00532191,0,1,29724821,29724177,644
32379881,644,644.002,644,1460,0.00212876,0,1,29725465,29724821,644
32381341,644,644,644,1460,0.000851505,0,1,29726109,29725465,644
32382801,644,644,644,1460,0.000340602,0,1,29726753,29726109,644
32384261,644,644,644,1460,0.000136241,0,1,29727397,29726753,644
32385721,644,644,644,1460,5.44963e-05,0,1,29728041,29727397,644
32387181,644,644,644,1460,2.17985e-05,0,1,29728685,29728041,644
32388641,644,644,644,1460,8.71941e-06,0,1,29729329,29728685,644
32390101,644,644,644,1460,3.48777e-06,0,1,29729973,29729329,644
32391561,644,644,644,1460,1.39511e-06,0,1,29730617,29729973,644
32393021,644,644,644,1460,5.58042e-07,0,1,29731261,29730617,644
32394481,644,644,644,1460,2.23217e-07,0,1,29731905,29731261,644
32395941,644,644,644,1460,8.92868e-08,0,1,29732549,29731905,644
32397401,644,644,644,1460,3.57147e-08,0,1,29733193,29732549,644
32398861,644,644,644,1460,1.42859e-08,0,1,29733837,29733193,644
32400321,644,644,644,1460,5.71436e-09,0,1,29734481,29733837,644
32401781,644,644,644,1460,2.28574e-09,0,1,29735125,29734481,644
32403241,644,644,644,1460,9.14297e-10,0,1,29735769,29735125,644
32404701,644,644,644,1460,3.65719e-10,0,1,29736413,29735769,644
32406161,644,644,644,1460,1.46287e-10,0,1,29737057,29736413,644
32407621,644,644,644,1460,5.8515e-11,0,1,29737701,29737057,644
32409081,644,644,644,1460,2.3406e-11,0,1,29738345,29737701,644
32410541,644,644,644,1460,9.3624e-12,0,1,29738989,29738345,644
32412001,644,644,644,1460,3.74496e-12,0,1,29739633,29738989,644
32413461,644,644,644,1460,1.49798e-12,0,1,29740277,29739633,644
32414921,644,644,644,1460,5.99194e-13,0,1,29740921,29740277,644
32416381,644,644,644,1460,2.39677e-13,0,1,29741565,29740921,644
32417841,644,644,644,1460,9.5871e-14,0,1,29742209,29741565,644
32419301,644,644,644,1460,3.83484e-14,0,1,29742853,29742209,644
32420761,644,644,644,1460,1.53394e-14,0,1,29743497,29742853,644
32422221,644,644,644,1460,6.13574e-15,0,1,29744141,29743497,644
32423681,644,644,644,1460,2.4543e-15,0,1,29744785,29744141,644
32425141,644,644,644,1460,9.81719e-16,0,1,29745429,29744785,644
32426601,644,644,644,1460,3.92687e-16,0,1,29746073,29745429,644
32428061,644,644,644,1460,1.57075e-16,0,1,29746717,29746073,644
32429521,644,644,644,1460,6.283e-17,0,1,29747361,29746717,644
32430981,644,644,644,1460,2.5132e-17,0,1,29748005,29747361,644
32432441,644,644,644,1460,1.00528e-17,0,1,29748649,29748005,644
32433901,644,644,644,1460,4.02112e-18,0,1,29749293,29748649,644
32435361,644,644,644,1460,1.60845e-18,0,1,29749937,29749293,644
32436821,644,644,644,1460,6.43379e-19,0,1,29750581,29749937,644
32438281,644,644,644,1460,2.57352e-19,0,1,29751225,29750581,644
32439741,644,644,644,1460,1.02941e-19,0,1,29751869,29751225,644
32441201,644,644,644,1460,4.11763e-20,0,1,29752513,29751869,644
32442661,644,644,644,1460,1.64705e-20,0,1,29753157,29752513,644
32444121,644,644,644,1460,6.5882e-21,0,1,29753801,29753157,644
32445581,644,644,644,1460,2.63528e-21,0,1,29754445,29753801,644
32447041,644,644,644,1460,1.05411e-21,0,1,29755089,29754445,644
32448501,644,644,644,1460,4.21645e-22,0,1,29755733,29755089,644
32449961,644,644,644,1460,1.68658e-22,0,1,29756377,29755733,644
32451421,644,644,644,1460,6.74632e-23,0,1,29757021,29756377,644
32452881,644,644,644,1460,2.69853e-23,0,1,29757665,29757021,644
32454341,644,644,644,1460,1.07941e-23,0,1,29758309,29757665,644
32455801,644,644,644,1460,4.31764e-24,0,1,29758953,29758309,644
32457261,644,644,644,1460,1.72706e-24,0,1,29759597,29758953,644
32458721,644,644,644,1460,6.90823e-25,0,1,29760241,29759597,644
32460181,644,644,644,1460,2.76329e-25,0,1,29760885,29760241,644
32461641,644,644,644,1460,1.10532e-25,0,1,29761529,29760885,644
32463101,644,644,644,1460,4.42127e-26,0,1,29762173,29761529,644
32464561,644,644,644,1460,1.76851e-26,0,1,29762817,29762173,644
32466021,644,644,644,1460,7.07403e-27,0,1,29763461,29762817,644
32467481,644,644,644,1460,2.82961e-27,0,1,29764105,29763461,644
32468941,644,644,644,1460,1.13184e-27,0,1,29764749,29764105,644
32470401,644,644,644,1460,4.52738e-28,0,1,29765393,29764749,644
32471861,644,644,644,1460,1.81095e-28,0,1,29766037,29765393,644
32473321,644,644,644,1460,7.24381e-29,0,1,29766681,29766037,644
32474781,644,644,644,1460,2.89752e-29,0,1,29767325,29766681,644
32476241,644,644,644,1460,1.15901e-29,0,1,29767969,29767325,644
32477701,644,644,644,1460,4.63604e-30,0,1,29768613,29767969,644
32479161,644,644,644,1460,1.85441e-30,0,1,29769257,29768613,644
32480621,644,644,644,1460,7.41766e-31,0,1,29769901,29769257,644
32482081,644,644,644,1460,2.96706e-31,0,1,29770545,29769901,644
32483541,644,644,644,1460,1.18683e-31,0,1,29771189,29770545,644
32485001,644,644,644,1460,4.7473e-32,0,1,29771833,29771189,644
32486461,644,644,644,1460,1.89892e-32,0,1,29772477,29771833,644
32487921,644,644,644,1460,7.59568e-33,0,1,29773121,29772477,644
32489381,644,644,644,1460,3.03827e-33,0,1,29773765,29773121,644
32490841,644,644,644,1460,1.21531e-33,0,1,29774409,29773765,644
32492301,644,644,644,1460,4.86124e-34,0,1,29775053,29774409,644
32493761,644,644,644,1460,1.94449e-34,0,1,29775697,29775053,644
32495221,644,644,644,1460,7.77798e-35,0,1,29776341,29775697,644
32496681,644,644,644,1460,3.11119e-35,0,1,29776985,29776341,644
32498141,644,644,644,1460,1.24448e-35,0,1,29777629,29776985,644
32499601,644,644,644,1460,4.97791e-36,0,1,29778273,29777629,644
32501061,644,644,644,1460,1.99116e-36,0,1,29778917,29778273,644
32502521,644,644,644,1460,7.96465e-37,0,1,29779561,29778917,644
32503981,644,644,644,1460,3.18586e-37,0,1,29780205,29779561,644
32505441,644,644,644,1460,1.27434e-37,0,1,29780849,29780205,644
32506901,644,644,644,1460,5.09738e-38,0,1,29781493,29780849,644
32508361,644,644,644,1460,2.03895e-38,0,1,29782137,29781493,644
32509821,644,644,644,1460,8.1558e-39,0,1,29782781,29782137,644
32511281,644,644,644,1460,3.26232e-39,0,1,29783425,29782781,644
32512741,644,644,644,1460,1.30493e-39,0,1,29784069,29783425,644
32514201,644,644,644,1460,5.21971e-40,0,1,29784713,29784069,644
32515661,644,644,644,1460,2.08788e-40,0,1,29785357,29784713,644
32517121,644,644,644,1460,8.3516e-41,0,1,29786001,29785357,644
32518581,644,644,644,1460,3.34056e-41,0,1,29786645,29786001,644
32520041,644,644,644,1460,1.33628e-41,0,1,29787289,29786645,644
32521501,644,644,644,1460,5.34455e-42,0,1,29787933,29787289,644
32522961,644,644,644,1460,2.13838e-42,0,1,29788577,29787933,644
32524421,644,644,644,1460,8.54792e-43,0,1,29789221,29788577,644
32525881,644,644,644,1460,3.41917e-43,0,1,29789865,29789221,644
32527341,644,644,644,1460,1.37327e-43,0,1,29790509,29789865,644
32528801,644,644,644,1460,5.46506e-44,0,1,29791153,29790509,644
32530261,644,644,644,1460,2.24208e-44,0,1,29791797,29791153,644
32531721,644,644,644,1460,8.40779e-45,0,1,29792441,29791797,644
32533181,644,644,644,1460,2.8026e-45,0,1,29793085,29792441,644
32534641,644,644,644,1460,1.4013e-45,0,1,29793729,29793085,644
32536101,644,644,644,1460,0,0,1,29794373,29793729,644
32537561,644,644,644,1460,0,0,1,29795017,29794373,644
32539021,644,644,644,1460,0,0,1,29795661,29795017,644
32540481,644,644,644,1460,0,0,1,29796305,29795661,644
32541941,644,644,644,1460,0,0,1,29796949,29796305,644
32543401,644,644,644,1460,0,0,1,29797593,29796949,644
32544861,644,644,644,1460,0,0,1,29798237,29797593,644
32546321,644,644,644,1460,0,0,1,29798881,29798237,644
32547781,644,644,644,1460,0,0,1,29799525,29798881,644
32549241,644,644,644,1460,0,0,1,29800169,29799525,644
32550701,644,644,644,1460,0,0,1,29800813,29800169,644
32552161,644,644,644,1460,0,0,1,29801457,29800813,644
32553621,644,644,644,1460,0,0,1,29802101,29801457,644
32555081,644,644,644,1460,0,0,1,29802745,29802101,644
32556541,644,644,644,1460,0,0,1,29803389,29802745,644
32558001,644,644,644,1460,0,0,1,29804033,29803389,644
32559461,644,644,644,1460,0,0,1,29804677,29804033,644
32560921,644,644,644,1460,0,0,1,29805321,29804677,644
32562381,644,644,644,1460,0,0,1,29805965,29805321,644
32563841,644,644,644,1460,0,0,1,29806609,29805965,644
32565301,644,644,644,1460,0,0,1,29807253,29806609,644
32566761,644,644,644,1460,0,0,1,29807897,29807253,644
32568221,644,644,644,1460,0,0,1,29808541,29807897,644
32569681,644,644,644,1460,0,0,1,29809185,29808541,644
32571141,644,644,644,1460,0,0,1,29809829,29809185,644
32572601,644,644,644,1460,0,0,1,29810473,29809829,644
32574061,644,644,644,1460,0,0,1,29811117,29810473,644
32575521,644,644,644,1460,0,0,1,29811761,29811117,644
32576981,644,644,644,1460,0,0,1,29812405,29811761,644
32578441,644,644,644,1460,0,0,1,29813049,29812405,644
32579901,644,644,644,1460,0,0,1,29813693,29813049,644
32581361,644,644,644,1460,0,0,1,29814337,29813693,644
32582821,644,644,644,1460,0,0,1,29814981,29814337,644
32584281,644,644,644,1460,0,0,1,29815625,29814981,644
32585741,644,644,644,1460,0,0,1,29816269,29815625,644
32587201,644,644,644,1460,0,0,1,29816913,29816269,644
32588661,644,644,644,1460,0,0,1,29817557,29816913,644
32590121,644,644,644,1460,0,0,1,29818201,29817557,644
32591581,644,644,644,1460,0,0,1,29818845,29818201,644
32593041,644,644,644,1460,0,0,1,29819489,29818845,644
32594501,644,644,644,1460,0,0,1,29820133,29819489,644
32595961,644,644,644,1460,0,0,1,29820777,29820133,644
32597421,644,644,644,1460,0,0,1,29821421,29820777,644
32598881,644,644,644,1460,0,0,1,29822065,29821421,644
32600341,644,644,644,1460,0,0,1,29822709,29822065,644
32601801,644,644,644,1460,0,0,1,29823353,29822709,644
32603261,644,644,644,1460,0,0,1,29823997,29823353,644
32604721,644,644,644,1460,0,0,1,29824641,29823997,644
32606181,644,644,644,1460,0,0,1,29825285,29824641,644
32607641,644,644,644,1460,0,0,1,29825929,29825285,644
32609101,644,644,644,1460,0,0,1,29826573,29825929,644
32610561,644,644,644,1460,0,0,1,29827217,29826573,644
32612021,644,644,644,1460,0,0,1,29827861,29827217,644
32613481,644,644,644,1460,0,0,1,29828505,29827861,644
32614941,644,644,644,1460,0,0,1,29829149,29828505,644
32616401,644,644,644,1460,0,0,1,29829793,29829149,644
32617861,644,644,644,1460,0,0,1,29830437,29829793,644
32619321,644,644,644,1460,0,0,1,29831081,29830437,644
32620781,644,644,644,1460,0,0,1,29831725,29831081,644
32622241,644,644,644,1460,0,0,1,29832369,29831725,644
32623701,644,644,644,1460,0,0,1,29833013,29832369,644
32625161,644,644,644,1460,0,0,1,29833657,29833013,644
32626621,644,644,644,1460,0,0,1,29834301,29833657,644
32628081,644,644,644,1460,0,0,1,29834945,29834301,644
32629541,644,644,644,1460,0,0,1,29835589,29834945,644
32631001,644,644,644,1460,0,0,1,29836233,29835589,644
32632461,644,644,644,1460,0,0,1,29836877,29836233,644
32633921,644,644,644,1460,0,0,1,29837521,29836877,644
32635381,644,644,644,1460,0,0,1,29838165,29837521,644
32636841,644,644,644,1460,0,0,1,29838809,29838165,644
32638301,644,644,644,1460,0,0,1,29839453,29838809,644
32639761,644,644,644,1460,0,0,1,29840097,29839453,644
32641221,644,644,644,1460,0,0,1,29840741,29840097,644
32642681,644,644,644,1460,0,0,1,29841385,29840741,644
32644141,644,644,644,1460,0,0,1,29842029,29841385,644
32645601,644,644,644,1460,0,0,1,29842673,29842029,644
32647061,644,644,644,1460,0,0,1,29843317,29842673,644
32648521,644,644,644,1460,0,0,1,29843961,29843317,644
32649981,644,644,644,1460,0,0,1,29844605,29843961,644
32651441,644,644,644,1460,0,0,1,29845249,29844605,644
32652901,644,644,644,1460,0,0,1,29845893,29845249,644
32654361,644,644,644,1460,0,0,1,29846537,29845893,644
32655821,644,644,644,1460,0,0,1,29847181,29846537,644
32657281,644,644,644,1460,0,0,1,29847825,29847181,644
32658741,644,644,644,1460,0,0,1,29848469,29847825,644
32660201,644,644,644,1460,0,0,1,29849113,29848469,644
32661661,644,644,644,1460,0,0,1,29849757,29849113,644
32663121,644,644,644,1460,0,0,1,29850401,29849757,644
32664581,644,644,644,1460,0,0,1,29851045,29850401,644
32666041,644,644,644,1460,0,0,1,29851689,29851045,644
32667501,644,644,644,1460,0,0,1,29852333,29851689,644
32668961,644,644,644,1460,0,0,1,29852977,29852333,644
32670421,644,644,644,1460,0,0,1,29853621,29852977,644
32671881,644,644,644,1460,0,0,1,29854265,29853621,644
32673341,644,644,644,1460,0,0,1,29854909,29854265,644
32674801,644,644,644,1460,0,0,1,29855553,29854909,644
32676261,644,644,644,1460,0,0,1,29856197,29855553,644
32677721,644,644,644,1460,0,0,1,29856841,29856197,644
32679181,644,644,644,1460,0,0,1,29857485,29856841,644
32680641,644,644,644,1460,0,0,1,29858129,29857485,644
32682101,644,644,644,1460,0,0,1,29858773,29858129,644
32683561,644,644,644,1460,0,0,1,29859417,29858773,644
32685021,644,644,644,1460,0,0,1,29860061,29859417,644
32686481,644,644,644,1460,0,0,1,29860705,29860061,644
32687941,644,644,644,1460,0,0,1,29861349,29860705,644
32689401,644,644,644,1460,0,0,1,29861993,29861349,644
32690861,644,644,644,1460,0,0,1,29862637,29861993,644
32692321,644,644,644,1460,0,0,1,29863281,29862637,644
32693781,644,644,644,1460,0,0,1,29863925,29863281,644
32695241,644,644,644,1460,0,0,1,29864569,29863925,644
32696701,644,644,644,1460,0,0,1,29865213,29864569,644
32698161,644,644,644,1460,0,0,1,29865857,29865213,644
32699621,644,644,644,1460,0,0,1,29866501,29865857,644
32701081,644,644,644,1460,0,0,1,29867145,29866501,644
32702541,644,644,644,1460,0,0,1,29867789,29867145,644
32704001,644,644,644,1460,0,0,1,29868433,29867789,644
32705461,644,644,644,1460,0,0,1,29869077,29868433,644
32706921,644,644,644,1460,0,0,1,29869721,29869077,644
32708381,644,644,644,1460,0,0,1,29870365,29869721,644
32709841,644,644,644,1460,0,0,1,29871009,29870365,644
32711301,644,644,644,1460,0,0,1,29871653,29871009,644
32712761,644,644,644,1460,0,0,1,29872297,29871653,644
32714221,644,644,644,1460,0,0,1,29872941,29872297,644
32715681,644,644,644,1460,0,0,1,29873585,29872941,644
32717141,644,644,644,1460,0,0,1,29874229,29873585,644
32718601,644,644,644,1460,0,0,1,29874873,29874229,644
32720061,644,644,644,1460,0,0,1,29875517,29874873,644
32721521,644,644,644,1460,0,0,1,29876161,29875517,644
32722981,644,644,644,1460,0,0,1,29876805,29876161,644
32724441,644,644,644,1460,0,0,1,29877449,29876805,644
32725901,644,644,644,1460,0,0,1,29878093,29877449,644
32727361,644,644,644,1460,0,0,1,29878737,29878093,644
32728821,644,644,644,1460,0,0,1,29879381,29878737,644
32730281,644,644,644,1460,0,0,1,29880025,29879381,644
32731741,644,644,644,1460,0,0,1,29880669,29880025,644
32733201,644,644,644,1460,0,0,1,29881313,29880669,644
32734661,644,644,644,1460,0,0,1,29881957,29881313,644
32736121,644,644,644,1460,0,0,1,29882601,29881957,644
32737581,644,644,644,1460,0,0,1,29883245,29882601,644
32739041,644,644,644,1460,0,0,1,29883889,29883245,644
32740501,644,644,644,1460,0,0,1,29884533,29883889,644
32741961,644,644,644,1460,0,0,1,29885177,29884533,644
32743421,644,644,644,1460,0,0,1,29885821,29885177,644
32744881,644,644,644,1460,0,0,1,29886465,29885821,644
32746341,644,644,644,1460,0,0,1,29887109,29886465,644
32747801,644,644,644,1460,0,0,1,29887753,29887109,644
32749261,644,644,644,1460,0,0,1,29888397,29887753,644
32750721,644,644,644,1460,0,0,1,29889041,29888397,644
32752181,644,644,644,1460,0,0,1,29889685,29889041,644
32753641,644,644,644,1460,0,0,1,29890329,29889685,644
32755101,644,644,644,1460,0,0,1,29890973,29890329,644
32756561,644,644,644,1460,0,0,1,29891617,29890973,644
32758021,644,644,644,1460,0,0,1,29892261,29891617,644
32759481,644,644,644,1460,0,0,1,29892905,29892261,644
32760941,644,644,644,1460,0,0,1,29893549,29892905,644
32762401,644,644,644,1460,0,0,1,29894193,29893549,644
32763861,644,644,644,1460,0,0,1,29894837,29894193,644
32765321,644,644,644,1460,0,0,1,29895481,29894837,644
32766781,644,644,644,1460,0,0,1,29896125,29895481,644
32768241,644,644,644,1460,0,0,1,29896769,29896125,644
32769701,644,644,644,1460,0,0,1,29897413,29896769,644
32771161,644,644,644,1460,0,0,1,29898057,29897413,644
32772621,644,644,644,1460,0,0,1,29898701,29898057,644
32774081,644,644,644,1460,0,0,1,29899345,29898701,644
32775541,644,644,644,1460,0,0,1,29899989,29899345,644
32777001,644,644,644,1460,0,0,1,29900633,29899989,644
32778461,644,644,644,1460,0,0,1,29901277,29900633,644
32779921,644,644,644,1460,0,0,1,29901921,29901277,644
32781381,644,644,644,1460,0,0,1,29902565,29901921,644
32782841,644,644,644,1460,0,0,1,29903209,29902565,644
32784301,644,644,644,1460,0,0,1,29903853,29903209,644
32785761,644,644,644,1460,0,0,1,29904497,29903853,644
32787221,644,644,644,1460,0,0,1,29905141,29904497,644
32788681,644,644,644,1460,0,0,1,29905785,29905141,644
32790141,644,644,644,1460,0,0,1,29906429,29905785,644
32791601,644,644,644,1460,0,0,1,29907073,29906429,644
32793061,644,644,644,1460,0,0,1,29907717,29907073,644
32794521,644,644,644,1460,0,0,1,29908361,29907717,644
32795981,644,644,644,1460,0,0,1,29909005,29908361,644
32797441,644,644,644,1460,0,0,1,29909649,29909005,644
32798901,644,644,644,1460,0,0,1,29910293,29909649,644
32800361,644,644,644,1460,0,0,1,29910937,29910293,644
32801821,644,644,644,1460,0,0,1,29911581,29910937,644
32803281,644,644,644,1460,0,0,1,29912225,29911581,644
32804741,644,644,644,1460,0,0,1,29912869,29912225,644
32806201,644,644,644,1460,0,0,1,29913513,29912869,644
32807661,644,644,644,1460,0,0,1,29914157,29913513,644
32809121,644,644,644,1460,0,0,1,29914801,29914157,644
32810581,644,644,644,1460,0,0,1,29915445,29914801,644
32812041,644,644,644,1460,0,0,1,29916089,29915445,644
32813501,644,644,644,1460,0,0,1,29916733,29916089,644
32814961,644,644,644,1460,0,0,1,29917377,29916733,644
32816421,644,644,644,1460,0,0,1,29918021,29917377,644
32817881,644,644,644,1460,0,0,1,29918665,29918021,644
32819341,644,644,644,1460,0,0,1,29919309,29918665,644
32820801,644,644,644,1460,0,0,1,29919953,29919309,644
32822261,644,644,644,1460,0,0,1,29920597,29919953,644
32823721,644,644,644,1460,0,0,1,29921241,29920597,644
32825181,644,644,644,1460,0,0,1,29921885,29921241,644
32826641,644,644,644,1460,0,0,1,29922529,29921885,644
32828101,644,644,644,1460,0,0,1,29923173,29922529,644
32829561,644,644,644,1460,0,0,1,29923817,29923173,644
32831021,644,644,644,1460,0,0,1,29924461,29923817,644
32832481,644,644,644,1460,0,0,1,29925105,29924461,644
32833941,644,644,644,1460,0,0,1,29925749,29925105,644
32835401,644,644,644,1460,0,0,1,29926393,29925749,644
32836861,644,644,644,1460,0,0,1,29927037,29926393,644
32838321,644,644,644,1460,0,0,1,29927681,29927037,644
32839781,644,644,644,1460,0,0,1,29928325,29927681,644
32841241,644,644,644,1460,0,0,1,29928969,29928325,644
32842701,644,644,644,1460,0,0,1,29929613,29928969,644
32844161,644,644,644,1460,0,0,1,29930257,29929613,644
32845621,644,644,644,1460,0,0,1,29930901,29930257,644
32847081,644,644,644,1460,0,0,1,29931545,29930901,644
32848541,644,644,644,1460,0,0,1,29932189,29931545,644
32850001,644,644,644,1460,0,0,1,29932833,29932189,644
32851461,644,644,644,1460,0,0,1,29933477,29932833,644
32852921,644,644,644,1460,0,0,1,29934121,29933477,644
32854381,644,644,644,1460,0,0,1,29934765,29934121,644
32855841,644,644,644,1460,0,0,1,29935409,29934765,644
32857301,644,644,644,1460,0,0,1,29936053,29935409,644
32858761,644,644,644,1460,0,0,1,29936697,29936053,644
32860221,644,644,644,1460,0,0,1,29937341,29936697,644
32861681,644,644,644,1460,0,0,1,29937985,29937341,644
32863141,644,644,644,1460,0,0,1,29938629,29937985,644
32864601,644,644,644,1460,0,0,1,29939273,29938629,644
32866061,644,644,644,1460,0,0,1,29939917,29939273,644
32867521,644,644,644,1460,0,0,1,29940561,29939917,644
32868981,644,644,644,1460,0,0,1,29941205,29940561,644
32870441,644,644,644,1460,0,0,1,29941849,29941205,644
32871901,644,644,644,1460,0,0,1,29942493,29941849,644
32873361,644,644,644,1460,0,0,1,29943137,29942493,644
32874821,644,644,644,1460,0,0,1,29943781,29943137,644
32876281,644,644,644,1460,0,0,1,29944425,29943781,644
32877741,644,644,644,1460,0,0,1,29945069,29944425,644
32879201,644,644,644,1460,0,0,1,29945713,29945069,644
32880661,644,644,644,1460,0,0,1,29946357,29945713,644
32882121,644,644,644,1460,0,0,1,29947001,29946357,644
32883581,644,644,644,1460,0,0,1,29947645,29947001,644
32885041,644,644,644,1460,0,0,1,29948289,29947645,644
32886501,644,644,644,1460,0,0,1,29948933,29948289,644
32887961,644,644,644,1460,0,0,1,29949577,29948933,644
32889421,644,644,644,1460,0,0,1,29950221,29949577,644
32890881,644,644,644,1460,0,0,1,29950865,29950221,644
32892341,644,644,644,1460,0,0,1,29951509,29950865,644
32893801,644,644,644,1460,0,0,1,29952153,29951509,644
32895261,644,644,644,1460,0,0,1,29952797,29952153,644
32896721,644,644,644,1460,0,0,1,29953441,29952797,644
32898181,644,644,644,1460,0,0,1,29954085,29953441,644
32899641,644,644,644,1460,0,0,1,29954729,29954085,644
32901101,644,644,644,1460,0,0,1,29955373,29954729,644
32902561,644,644,644,1460,0,0,1,29956017,29955373,644
32904021,644,644,644,1460,0,0,1,29956661,29956017,644
32905481,644,644,644,1460,0,0,1,29957305,29956661,644
32906941,644,644,644,1460,0,0,1,29957949,29957305,644
32908401,644,644,644,1460,0,0,1,29958593,29957949,644
32909861,644,644,644,1460,0,0,1,29959237,29958593,644
32911321,644,644,644,1460,0,0,1,29959881,29959237,644
32912781,644,644,644,1460,0,0,1,29960525,29959881,644
32914241,644,644,644,1460,0,0,1,29961169,29960525,644
32915701,644,644,644,1460,0,0,1,29961813,29961169,644
32917161,644,644,644,1460,0,0,1,29962457,29961813,644
32918621,644,644,644,1460,0,0,1,29963101,29962457,644
32920081,644,644,644,1460,0,0,1,29963745,29963101,644
32921541,644,644,644,1460,0,0,1,29964389,29963745,644
32923001,644,644,644,1460,0,0,1,29965033,29964389,644
32924461,644,644,644,1460,0,0,1,29965677,29965033,644
32925921,644,644,644,1460,0,0,1,29966321,29965677,644
32927381,644,644,644,1460,0,0,1,29966965,29966321,644
32928841,644,644,644,1460,0,0,1,29967609,29966965,644
32930301,644,644,644,1460,0,0,1,29968253,29967609,644
32931761,644,644,644,1460,0,0,1,29968897,29968253,644
32933221,644,644,644,1460,0,0,1,29969541,29968897,644
32934681,644,644,644,1460,0,0,1,29970185,29969541,644
32936141,644,644,644,1460,0,0,1,29970829,29970185,644
32937601,644,644,644,1460,0,0,1,29971473,29970829,644
32939061,644,644,644,1460,0,0,1,29972117,29971473,644
32940521,644,644,644,1460,0,0,1,29972761,29972117,644
32941981,644,644,644,1460,0,0,1,29973405,29972761,644
32943441,644,644,644,1460,0,0,1,29974049,29973405,644
32944901,644,644,644,1460,0,0,1,29974693,29974049,644
32946361,644,644,644,1460,0,0,1,29975337,29974693,644
32947821,644,644,644,1460,0,0,1,29975981,29975337,644
32949281,644,644,644,1460,0,0,1,29976625,29975981,644
32950741,644,644,644,1460,0,0,1,29977269,29976625,644
32952201,644,644,644,1460,0,0,1,29977913,29977269,644
32953661,644,644,644,1460,0,0,1,29978557,29977913,644
32955121,644,644,644,1460,0,0,1,29979201,29978557,644
32956581,644,644,644,1460,0,0,1,29979845,29979201,644
32958041,644,644,644,1460,0,0,1,29980489,29979845,644
32959501,644,644,644,1460,0,0,1,29981133,29980489,644
32960961,644,644,644,1460,0,0,1,29981777,29981133,644
32962421,644,644,644,1460,0,0,1,29982421,29981777,644
32963881,644,644,644,1460,0,0,1,29983065,29982421,644
32965341,644,644,644,1460,0,0,1,29983709,29983065,644
32966801,644,644,644,1460,0,0,1,29984353,29983709,644
32968261,644,644,644,1460,0,0,1,29984997,29984353,644
32969721,644,644,644,1460,0,0,1,29985641,29984997,644
32971181,644,644,644,1460,0,0,1,29986285,29985641,644
32972641,644,644,644,1460,0,0,1,29986929,29986285,644
32974101,644,644,644,1460,0,0,1,29987573,29986929,644
32975561,644,644,644,1460,0,0,1,29988217,29987573,644
32977021,644,644,644,1460,0,0,1,29988861,29988217,644
32978481,644,644,644,1460,0,0,1,29989505,29988861,644
32979941,644,644,644,1460,0,0,1,29990149,29989505,644
32981401,644,644,644,1460,0,0,1,29990793,29990149,644
32982861,644,644,644,1460,0,0,1,29991437,29990793,644
32984321,644,644,644,1460,0,0,1,29992081,29991437,644
32985781,644,644,644,1460,0,0,1,29992725,29992081,644
32987241,644,644,644,1460,0,0,1,29993369,29992725,644
32988701,644,644,644,1460,0,0,1,29994013,29993369,644
32990161,644,644,644,1460,0,0,1,29994657,29994013,644
32991621,644,644,644,1460,0,0,1,29995301,29994657,644
32993081,644,644,644,1460,0,0,1,29995945,29995301,644
32994541,644,644,644,1460,0,0,1,29996589,29995945,644
32996001,644,644,644,1460,0,0,1,29997233,29996589,644
32997461,644,644,644,1460,0,0,1,29997877,29997233,644
32998921,644,644,644,1460,0,0,1,29998521,29997877,644
33000381,644,644,644,1460,0,0,1,29999165,29998521,644
33001841,644,644,644,1460,0,0,1,29999809,29999165,644
33003301,644,644,644,1460,0,0,1,30000453,29999809,644
33004761,644,644,644,1460,0,0,1,30001097,30000453,644
33006221,644,644,644,1460,0,0,1,30001741,30001097,644
33007681,644,644,644,1460,0,0,1,30002385,30001741,644
33009141,644,644,644,1460,0,0,1,30003029,30002385,644
33010601,644,644,644,1460,0,0,1,30003673,30003029,644
33012061,644,644,644,1460,0,0,1,30004317,30003673,644
33013521,644,644,644,1460,0,0,1,30004961,30004317,644
33014981,644,644,644,1460,0,0,1,30005605,30004961,644
33016441,644,644,644,1460,0,0,1,30006249,30005605,644
33017901,644,644,644,1460,0,0,1,30006893,30006249,644
33019361,644,644,644,1460,0,0,1,30007537,30006893,644
33020821,644,644,644,1460,0,0,1,30008181,30007537,644
33022281,644,644,644,1460,0,0,1,30008825,30008181,644
33023741,644,644,644,1460,0,0,1,30009469,30008825,644
33025201,644,644,644,1460,0,0,1,30010113,30009469,644
33026661,644,644,644,1460,0,0,1,30010757,30010113,644
33028121,644,644,644,1460,0,0,1,30011401,30010757,644
33029581,644,644,644,1460,0,0,1,30012045,30011401,644
33031041,644,644,644,1460,0,0,1,30012689,30012045,644
33032501,644,644,644,1460,0,0,1,30013333,30012689,644
33033961,644,644,644,1460,0,0,1,30013977,30013333,644
33035421,644,644,644,1460,0,0,1,30014621,30013977,644
33036881,644,644,644,1460,0,0,1,30015265,30014621,644
33038341,644,644,644,1460,0,0,1,30015909,30015265,644
33039801,644,644,644,1460,0,0,1,30016553,30015909,644
33041261,644,644,644,1460,0,0,1,30017197,30016553,644
33042721,644,644,644,1460,0,0,1,30017841,30017197,644
33044181,644,644,644,1460,0,0,1,30018485,30017841,644
33045641,644,644,644,1460,0,0,1,30019129,30018485,644
33047101,644,644,644,1460,0,0,1,30019773,30019129,644
33048561,644,644,644,1460,0,0,1,30020417,30019773,644
33050021,644,644,644,1460,0,0,1,30021061,30020417,644
33051481,644,644,644,1460,0,0,1,30021705,30021061,644
33052941,644,644,644,1460,0,0,1,30022349,30021705,644
33054401,644,644,644,1460,0,0,1,30022993,30022349,644
33055861,644,644,644,1460,0,0,1,30023637,30022993,644
33057321,644,644,644,1460,0,0,1,30024281,30023637,644
33058781,644,644,644,1460,0,0,1,30024925,30024281,644
33060241,644,644,644,1460,0,0,1,30025569,30024925,644
33061701,644,644,644,1460,0,0,1,30026213,30025569,644
33063161,644,644,644,1460,0,0,1,30026857,30026213,644
33064621,644,644,644,1460,0,0,1,30027501,30026857,644
33066081,644,644,644,1460,0,0,1,30028145,30027501,644
33067541,644,644,644,1460,0,0,1,30028789,30028145,644
33069001,644,644,644,1460,0,0,1,30029433,30028789,644
33070461,644,644,644,1460,0,0,1,30030077,30029433,644
33071921,644,644,644,1460,0,0,1,30030721,30030077,644
33073381,644,644,644,1460,0,0,1,30031365,30030721,644
33074841,644,644,644,1460,0,0,1,30032009,30031365,644
33076301,644,644,644,1460,0,0,1,30032653,30032009,644
33077761,644,644,644,1460,0,0,1,30033297,30032653,644
33079221,644,644,644,1460,0,0,1,30033941,30033297,644
33080681,644,644,644,1460,0,0,1,30034585,30033941,644
33082141,644,644,644,1460,0,0,1,30035229,30034585,644
33083601,644,644,644,1460,0,0,1,30035873,30035229,644
33085061,644,644,644,1460,0,0,1,30036517,30035873,644
33086521,644,644,644,1460,0,0,1,30037161,30036517,644
33087981,644,644,644,1460,0,0,1,30037805,30037161,644
33089441,644,644,644,1460,0,0,1,30038449,30037805,644
33090901,644,644,644,1460,0,0,1,30039093,30038449,644
33092361,644,644,644,1460,0,0,1,30039737,30039093,644
33093821,644,644,644,1460,0,0,1,30040381,30039737,644
33095281,644,644,644,1460,0,0,1,30041025,30040381,644
33096741,644,644,644,1460,0,0,1,30041669,30041025,644
33098201,644,644,644,1460,0,0,1,30042313,30041669,644
33099661,644,644,644,1460,0,0,1,30042957,30042313,644
33101121,644,644,644,1460,0,0,1,30043601,30042957,644
33102581,644,644,644,1460,0,0,1,30044245,30043601,644
33104041,644,644,644,1460,0,0,1,30044889,30044245,644
33105501,644,644,644,1460,0,0,1,30045533,30044889,644
33106961,644,644,644,1460,0,0,1,30046177,30045533,644
33108421,644,644,644,1460,0,0,1,30046821,30046177,644
33109881,644,644,644,1460,0,0,1,30047465,30046821,644
33111341,644,644,644,1460,0,0,1,30048109,30047465,644
33112801,644,644,644,1460,0,0,1,30048753,30048109,644
33114261,644,644,644,1460,0,0,1,30049397,30048753,644
33115721,644,644,644,1460,0,0,1,30050041,30049397,644
33117181,644,644,644,1460,0,0,1,30050685,30050041,644
33118641,644,644,644,1460,0,0,1,30051329,30050685,644
33120101,644,644,644,1460,0,0,1,30051973,30051329,644
33121561,644,644,644,1460,0,0,1,30052617,30051973,644
33123021,644,644,644,1460,0,0,1,30053261,30052617,644
33124481,644,644,644,1460,0,0,1,30053905,30053261,644
33125941,644,644,644,1460,0,0,1,30054549,30053905,644
33127401,644,644,644,1460,0,0,1,30055193,30054549,644
33128861,644,644,644,1460,0,0,1,30055837,30055193,644
33130321,644,644,644,1460,0,0,1,30056481,30055837,644
33131781,644,644,644,1460,0,0,1,30057125,30056481,644
33133241,644,644,644,1460,0,0,1,30057769,30057125,644
33134701,644,644,644,1460,0,0,1,30058413,30057769,644
33136161,644,644,644,1460,0,0,1,30059057,30058413,644
33137621,644,644,644,1460,0,0,1,30059701,30059057,644
33139081,644,644,644,1460,0,0,1,30060345,30059701,644
33140541,644,644,644,1460,0,0,1,30060989,30060345,644
33142001,644,644,644,1460,0,0,1,30061633,30060989,644
33143461,644,644,644,1460,0,0,1,30062277,30061633,644
33144921,644,644,644,1460,0,0,1,30062921,30062277,644
33146381,644,644,644,1460,0,0,1,30063565,30062921,644
33147841,644,644,644,1460,0,0,1,30064209,30063565,644
33149301,644,644,644,1460,0,0,1,30064853,30064209,644
33150761,644,644,644,1460,0,0,1,30065497,30064853,644
33152221,644,644,644,1460,0,0,1,30066141,30065497,644
33153681,644,644,644,1460,0,0,1,30066785,30066141,644
33155141,644,644,644,1460,0,0,1,30067429,30066785,644
33156601,644,644,644,1460,0,0,1,30068073,30067429,644
33158061,644,644,644,1460,0,0,1,30068717,30068073,644
33159521,644,644,644,1460,0,0,1,30069361,30068717,644
33160981,644,644,644,1460,0,0,1,30070005,30069361,644
33162441,644,644,644,1460,0,0,1,30070649,30070005,644
33163901,644,644,644,1460,0,0,1,30071293,30070649,644
33165361,644,644,644,1460,0,0,1,30071937,30071293,644
33166821,644,644,644,1460,0,0,1,30072581,30071937,644
33168281,644,644,644,1460,0,0,1,30073225,30072581,644
33169741,644,644,644,1460,0,0,1,30073869,30073225,644
33171201,644,644,644,1460,0,0,1,30074513,30073869,644
33172661,644,644,644,1460,0,0,1,30075157,30074513,644
33174121,644,644,644,1460,0,0,1,30075801,30075157,644
33175581,644,644,644,1460,0,0,1,30076445,30075801,644
33177041,644,644,644,1460,0,0,1,30077089,30076445,644
33178501,644,644,644,1460,0,0,1,30077733,30077089,644
33179961,644,644,644,1460,0,0,1,30078377,30077733,644
33181421,644,644,644,1460,0,0,1,30079021,30078377,644
33182881,644,644,644,1460,0,0,1,30079665,30079021,644
33184341,644,644,644,1460,0,0,1,30080309,30079665,644
33185801,644,644,644,1460,0,0,1,30080953,30080309,644
33187261,644,644,644,1460,0,0,1,30081597,30080953,644
33188721,644,644,644,1460,0,0,1,30082241,30081597,644
33190181,644,644,644,1460,0,0,1,30082885,30082241,644
33191641,644,644,644,1460,0,0,1,30083529,30082885,644
33193101,644,644,644,1460,0,0,1,30084173,30083529,644
33194561,644,644,644,1460,0,0,1,30084817,30084173,644
33196021,644,644,644,1460,0,0,1,30085461,30084817,644
33197481,644,644,644,1460,0,0,1,30086105,30085461,644
33198941,644,644,644,1460,0,0,1,30086749,30086105,644
33200401,644,644,644,1460,0,0,1,30087393,30086749,644
33201861,644,644,644,1460,0,0,1,30088037,30087393,644
33203321,644,644,644,1460,0,0,1,30088681,30088037,644
33204781,644,644,644,1460,0,0,1,30089325,30088681,644
33206241,644,644,644,1460,0,0,1,30089969,30089325,644
33207701,644,644,644,1460,0,0,1,30090613,30089969,644
33209161,644,644,644,1460,0,0,1,30091257,30090613,644
33210621,644,644,644,1460,0,0,1,30091901,30091257,644
33212081,644,644,644,1460,0,0,1,30092545,30091901,644
33213541,644,644,644,1460,0,0,1,30093189,30092545,644
33215001,644,644,644,1460,0,0,1,30093833,30093189,644
33216461,644,644,644,1460,0,0,1,30094477,30093833,644
33217921,644,644,644,1460,0,0,1,30095121,30094477,644
33219381,644,644,644,1460,0,0,1,30095765,30095121,644
33220841,644,644,644,1460,0,0,1,30096409,30095765,644
33222301,644,644,644,1460,0,0,1,30097053,30096409,644
33223761,644,644,644,1460,0,0,1,30097697,30097053,644
33225221,644,644,644,1460,0,0,1,30098341,30097697,644
33226681,644,644,644,1460,0,0,1,30098985,30098341,644
33228141,644,644,644,1460,0,0,1,30099629,30098985,644
33229601,644,644,644,1460,0,0,1,30100273,30099629,644
33231061,644,644,644,1460,0,0,1,30100917,30100273,644
33232521,644,644,644,1460,0,0,1,30101561,30100917,644
33233981,644,644,644,1460,0,0,1,30102205,30101561,644
33235441,644,644,644,1460,0,0,1,30102849,30102205,644
33236901,644,644,644,1460,0,0,1,30103493,30102849,644
33238361,644,644,644,1460,0,0,1,30104137,30103493,644
33239821,644,644,644,1460,0,0,1,30104781,30104137,644
33241281,644,644,644,1460,0,0,1,30105425,30104781,644
33242741,644,644,644,1460,0,0,1,30106069,30105425,644
33244201,644,644,644,1460,0,0,1,30106713,30106069,644
33245661,644,644,644,1460,0,0,1,30107357,30106713,644
33247121,644,644,644,1460,0,0,1,30108001,30107357,644
33248581,644,644,644,1460,0,0,1,30108645,30108001,644
33250041,644,644,644,1460,0,0,1,30109289,30108645,644
33251501,644,644,644,1460,0,0,1,30109933,30109289,644
33252961,644,644,644,1460,0,0,1,30110577,30109933,644
33254421,644,644,644,1460,0,0,1,30111221,30110577,644
33255881,644,644,644,1460,0,0,1,30111865,30111221,644
33257341,644,644,644,1460,0,0,1,30112509,30111865,644
33258801,644,644,644,1460,0,0,1,30113153,30112509,644
33260261,644,644,644,1460,0,0,1,30113797,30113153,644
33261721,644,644,644,1460,0,0,1,30114441,30113797,644
33263181,644,644,644,1460,0,0,1,30115085,30114441,644
33264641,644,644,644,1460,0,0,1,30115729,30115085,644
33266101,644,644,644,1460,0,0,1,30116373,30115729,644
33267561,644,644,644,1460,0,0,1,30117017,30116373,644
33269021,644,644,644,1460,0,0,1,30117661,30117017,644
33270481,644,644,644,1460,0,0,1,30118305,30117661,644
33271941,644,644,644,1460,0,0,1,30118949,30118305,644
33273401,644,644,644,1460,0,0,1,30119593,30118949,644
33274861,644,644,644,1460,0,0,1,30120237,30119593,644
33276321,644,644,644,1460,0,0,1,30120881,30120237,644
33277781,644,644,644,1460,0,0,1,30121525,30120881,644
33279241,644,644,644,1460,0,0,1,30122169,30121525,644
33280701,644,644,644,1460,0,0,1,30122813,30122169,644
33282161,644,644,644,1460,0,0,1,30123457,30122813,644
33283621,644,644,644,1460,0,0,1,30124101,30123457,644
33285081,644,644,644,1460,0,0,1,30124745,30124101,644
33286541,644,644,644,1460,0,0,1,30125389,30124745,644
33288001,644,644,644,1460,0,0,1,30126033,30125389,644
33289461,644,644,644,1460,0,0,1,30126677,30126033,644
33290921,644,644,644,1460,0,0,1,30127321,30126677,644
33292381,644,644,644,1460,0,0,1,30127965,30127321,644
33293841,644,644,644,1460,0,0,1,30128609,30127965,644
33295301,644,644,644,1460,0,0,1,30129253,30128609,644
33296761,644,644,644,1460,0,0,1,30129897,30129253,644
33298221,644,644,644,1460,0,0,1,30130541,30129897,644
33299681,644,644,644,1460,0,0,1,30131185,30130541,644
33301141,644,644,644,1460,0,0,1,30131829,30131185,644
33302601,644,644,644,1460,0,0,1,30132473,30131829,644
33304061,644,644,644,1460,0,0,1,30133117,30132473,644
33305521,644,644,644,1460,0,0,1,30133761,30133117,644
33306981,644,644,644,1460,0,0,1,30134405,30133761,644
33308441,644,644,644,1460,0,0,1,30135049,30134405,644
33309901,644,644,644,1460,0,0,1,30135693,30135049,644
33311361,644,644,644,1460,0,0,1,30136337,30135693,644
33312821,644,644,644,1460,0,0,1,30136981,30136337,644
33314281,644,644,644,1460,0,0,1,30137625,30136981,644
33315741,644,644,644,1460,0,0,1,30138269,30137625,644
33317201,644,644,644,1460,0,0,1,30138913,30138269,644
33318661,644,644,644,1460,0,0,1,30139557,30138913,644
33320121,644,644,644,1460,0,0,1,30140201,30139557,644
33321581,644,644,644,1460,0,0,1,30140845,30140201,644
33323041,644,644,644,1460,0,0,1,30141489,30140845,644
33324501,644,644,644,1460,0,0,1,30142133,30141489,644
33325961,644,644,644,1460,0,0,1,30142777,30142133,644
33327421,644,644,644,1460,0,0,1,30143421,30142777,644
33328881,644,644,644,1460,0,0,1,30144065,30143421,644
33330341,644,644,644,1460,0,0,1,30144709,30144065,644
33331801,644,644,644,1460,0,0,1,30145353,30144709,644
33333261,644,644,644,1460,0,0,1,30145997,30145353,644
33334721,644,644,644,1460,0,0,1,30146641,30145997,644
33336181,644,644,644,1460,0,0,1,30147285,30146641,644
33337641,644,644,644,1460,0,0,1,30147929,30147285,644
33339101,644,644,644,1460,0,0,1,30148573,30147929,644
33340561,644,644,644,1460,0,0,1,30149217,30148573,644
33342021,644,644,644,1460,0,0,1,30149861,30149217,644
33343481,644,644,644,1460,0,0,1,30150505,30149861,644
33344941,644,644,644,1460,0,0,1,30151149,30150505,644
33346401,644,644,644,1460,0,0,1,30151793,30151149,644
33347861,644,644,644,1460,0,0,1,30152437,30151793,644
33349321,644,644,644,1460,0,0,1,30153081,30152437,644
33350781,644,644,644,1460,0,0,1,30153725,30153081,644
33352241,644,644,644,1460,0,0,1,30154369,30153725,644
33353701,644,644,644,1460,0,0,1,30155013,30154369,644
33355161,644,644,644,1460,0,0,1,30155657,30155013,644
33356621,644,644,644,1460,0,0,1,30156301,30155657,644
33358081,644,644,644,1460,0,0,1,30156945,30156301,644
33359541,644,644,644,1460,0,0,1,30157589,30156945,644
33361001,644,644,644,1460,0,0,1,30158233,30157589,644
33362461,644,644,644,1460,0,0,1,30158877,30158233,644
33363921,644,644,644,1460,0,0,1,30159521,30158877,644
33365381,644,644,644,1460,0,0,1,30160165,30159521,644
33366841,644,644,644,1460,0,0,1,30160809,30160165,644
33368301,644,644,644,1460,0,0,1,30161453,30160809,644
33369761,644,644,644,1460,0,0,1,30162097,30161453,644
33371221,644,644,644,1460,0,0,1,30162741,30162097,644
33372681,644,644,644,1460,0,0,1,30163385,30162741,644
33374141,644,644,644,1460,0,0,1,30164029,30163385,644
33375601,644,644,644,1460,0,0,1,30164673,30164029,644
33377061,644,644,644,1460,0,0,1,30165317,30164673,644
33378521,644,644,644,1460,0,0,1,30165961,30165317,644
33379981,644,644,644,1460,0,0,1,30166605,30165961,644
33381441,644,644,644,1460,0,0,1,30167249,30166605,644
33382901,644,644,644,1460,0,0,1,30167893,30167249,644
33384361,644,644,644,1460,0,0,1,30168537,30167893,644
33385821,644,644,644,1460,0,0,1,30169181,30168537,644
33387281,644,644,644,1460,0,0,1,30169825,30169181,644
33388741,644,644,644,1460,0,0,1,30170469,30169825,644
33390201,644,644,644,1460,0,0,1,30171113,30170469,644
33391661,644,644,644,1460,0,0,1,30171757,30171113,644
33393121,644,644,644,1460,0,0,1,30172401,30171757,644
33394581,644,644,644,1460,0,0,1,30173045,30172401,644
33396041,644,644,644,1460,0,0,1,30173689,30173045,644
33397501,644,644,644,1460,0,0,1,30174333,30173689,644
33398961,644,644,644,1460,0,0,1,30174977,30174333,644
33400421,644,644,644,1460,0,0,1,30175621,30174977,644
33401881,644,644,644,1460,0,0,1,30176265,30175621,644
33403341,644,644,644,1460,0,0,1,30176909,30176265,644
33404801,644,644,644,1460,0,0,1,30177553,30176909,644
33406261,644,644,644,1460,0,0,1,30178197,30177553,644
33407721,644,644,644,1460,0,0,1,30178841,30178197,644
33409181,644,644,644,1460,0,0,1,30179485,30178841,644
33410641,644,644,644,1460,0,0,1,30180129,30179485,644
33412101,644,644,644,1460,0,0,1,30180773,30180129,644
33413561,644,644,644,1460,0,0,1,30181417,30180773,644
33415021,644,644,644,1460,0,0,1,30182061,30181417,644
33416481,644,644,644,1460,0,0,1,30182705,30182061,644
33417941,644,644,644,1460,0,0,1,30183349,30182705,644
33419401,644,644,644,1460,0,0,1,30183993,30183349,644
33420861,644,644,644,1460,0,0,1,30184637,30183993,644
33422321,644,644,644,1460,0,0,1,30185281,30184637,644
33423781,644,644,644,1460,0,0,1,30185925,30185281,644
33425241,644,644,644,1460,0,0,1,30186569,30185925,644
33426701,644,644,644,1460,0,0,1,30187213,30186569,644
33428161,644,644,644,1460,0,0,1,30187857,30187213,644
33429621,644,644,644,1460,0,0,1,30188501,30187857,644
33431081,644,644,644,1460,0,0,1,30189145,30188501,644
33432541,644,644,644,1460,0,0,1,30189789,30189145,644
33434001,644,644,644,1460,0,0,1,30190433,30189789,644
33435461,644,644,644,1460,0,0,1,30191077,30190433,644
33436921,644,644,644,1460,0,0,1,30191721,30191077,644
33438381,644,644,644,1460,0,0,1,30192365,30191721,644
33439841,644,644,644,1460,0,0,1,30193009,30192365,644
33441301,644,644,644,1460,0,0,1,30193653,30193009,644
33442761,644,644,644,1460,0,0,1,30194297,30193653,644
33444221,644,644,644,1460,0,0,1,30194941,30194297,644
33445681,644,644,644,1460,0,0,1,30195585,30194941,644
33447141,644,644,644,1460,0,0,1,30196229,30195585,644
33448601,644,644,644,1460,0,0,1,30196873,30196229,644
33450061,644,644,644,1460,0,0,1,30197517,30196873,644
33451521,644,644,644,1460,0,0,1,30198161,30197517,644
33452981,644,644,644,1460,0,0,1,30198805,30198161,644
33454441,644,644,644,1460,0,0,1,30199449,30198805,644
33455901,644,644,644,1460,0,0,1,30200093,30199449,644
33457361,644,644,644,1460,0,0,1,30200737,30200093,644
33458821,644,644,644,1460,0,0,1,30201381,30200737,644
33460281,644,644,644,1460,0,0,1,30202025,30201381,644
33461741,644,644,644,1460,0,0,1,30202669,30202025,644
33463201,644,644,644,1460,0,0,1,30203313,30202669,644
33464661,644,644,644,1460,0,0,1,30203957,30203313,644
33466121,644,644,644,1460,0,0,1,30204601,30203957,644
33467581,644,644,644,1460,0,0,1,30205245,30204601,644
33469041,644,644,644,1460,0,0,1,30205889,30205245,644
33470501,644,644,644,1460,0,0,1,30206533,30205889,644
33471961,644,644,644,1460,0,0,1,30207177,30206533,644
33473421,644,644,644,1460,0,0,1,30207821,30207177,644
33474881,644,644,644,1460,0,0,1,30208465,30207821,644
33476341,644,644,644,1460,0,0,1,30209109,30208465,644
33477801,644,644,644,1460,0,0,1,30209753,30209109,644
33479261,644,644,644,1460,0,0,1,30210397,30209753,644
33480721,644,644,644,1460,0,0,1,30211041,30210397,644
33482181,644,644,644,1460,0,0,1,30211685,30211041,644
33483641,644,644,644,1460,0,0,1,30212329,30211685,644
33485101,644,644,644,1460,0,0,1,30212973,30212329,644
33486561,644,644,644,1460,0,0,1,30213617,30212973,644
33488021,644,644,644,1460,0,0,1,30214261,30213617,644
33489481,644,644,644,1460,0,0,1,30214905,30214261,644
33490941,644,644,644,1460,0,0,1,30215549,30214905,644
33492401,644,644,644,1460,0,0,1,30216193,30215549,644
33493861,644,644,644,1460,0,0,1,30216837,30216193,644
33495321,644,644,644,1460,0,0,1,30217481,30216837,644
33496781,644,644,644,1460,0,0,1,30218125,30217481,644
33498241,644,644,644,1460,0,0,1,30218769,30218125,644
33499701,644,644,644,1460,0,0,1,30219413,30218769,644
33501161,644,644,644,1460,0,0,1,30220057,30219413,644
33502621,644,644,644,1460,0,0,1,30220701,30220057,644
33504081,644,644,644,1460,0,0,1,30221345,30220701,644
33505541,644,644,644,1460,0,0,1,30221989,30221345,644
33507001,644,644,644,1460,0,0,1,30222633,30221989,644
33508461,644,644,644,1460,0,0,1,30223277,30222633,644
33509921,644,644,644,1460,0,0,1,30223921,30223277,644
33511381,644,644,644,1460,0,0,1,30224565,30223921,644
33512841,644,644,644,1460,0,0,1,30225209,30224565,644
33514301,644,644,644,1460,0,0,1,30225853,30225209,644
33515761,644,644,644,1460,0,0,1,30226497,30225853,644
33517221,644,644,644,1460,0,0,1,30227141,30226497,644
33518681,644,644,644,1460,0,0,1,30227785,30227141,644
33520141,644,644,644,1460,0,0,1,30228429,30227785,644
33521601,644,644,644,1460,0,0,1,30229073,30228429,644
33523061,644,644,644,1460,0,0,1,30229717,30229073,644
33524521,644,644,644,1460,0,0,1,30230361,30229717,644
33525981,644,644,644,1460,0,0,1,30231005,30230361,644
33527441,644,644,644,1460,0,0,1,30231649,30231005,644
33528901,644,644,644,1460,0,0,1,30232293,30231649,644
33530361,644,644,644,1460,0,0,1,30232937,30232293,644
33531821,644,644,644,1460,0,0,1,30233581,30232937,644
33533281,644,644,644,1460,0,0,1,30234225,30233581,644
33534741,644,644,644,1460,0,0,1,30234869,30234225,644
33536201,644,644,644,1460,0,0,1,30235513,30234869,644
33537661,644,644,644,1460,0,0,1,30236157,30235513,644
33539121,644,644,644,1460,0,0,1,30236801,30236157,644
33540581,644,644,644,1460,0,0,1,30237445,30236801,644
33542041,644,644,644,1460,0,0,1,30238089,30237445,644
33543501,644,644,644,1460,0,0,1,30238733,30238089,644
33544961,644,644,644,1460,0,0,1,30239377,30238733,644
33546421,644,644,644,1460,0,0,1,30240021,30239377,644
33547881,644,644,644,1460,0,0,1,30240665,30240021,644
33549341,644,644,644,1460,0,0,1,30241309,30240665,644
33550801,644,644,644,1460,0,0,1,30241953,30241309,644
33552261,644,644,644,1460,0,0,1,30242597,30241953,644
33553721,644,644,644,1460,0,0,1,30243241,30242597,644
33555181,644,644,644,1460,0,0,1,30243885,30243241,644
33556641,644,644,644,1460,0,0,1,30244529,30243885,644
33558101,644,644,644,1460,0,0,1,30245173,30244529,644
33559561,644,644,644,1460,0,0,1,30245817,30245173,644
33561021,644,644,644,1460,0,0,1,30246461,30245817,644
33562481,644,644,644,1460,0,0,1,30247105,30246461,644
33563941,644,644,644,1460,0,0,1,30247749,30247105,644
33565401,644,644,644,1460,0,0,1,30248393,30247749,644
33566861,644,644,644,1460,0,0,1,30249037,30248393,644
33568321,644,644,644,1460,0,0,1,30249681,30249037,644
33569781,644,644,644,1460,0,0,1,30250325,30249681,644
33571241,644,644,644,1460,0,0,1,30250969,30250325,644
33572701,644,644,644,1460,0,0,1,30251613,30250969,644
33574161,644,644,644,1460,0,0,1,30252257,30251613,644
33575621,644,644,644,1460,0,0,1,30252901,30252257,644
33577081,644,644,644,1460,0,0,1,30253545,30252901,644
33578541,644,644,644,1460,0,0,1,30254189,30253545,644
33580001,644,644,644,1460,0,0,1,30254833,30254189,644
33581461,644,644,644,1460,0,0,1,30255477,30254833,644
33582921,644,644,644,1460,0,0,1,30256121,30255477,644
33584381,644,644,644,1460,0,0,1,30256765,30256121,644
33585841,644,644,644,1460,0,0,1,30257409,30256765,644
33587301,644,644,644,1460,0,0,1,30258053,30257409,644
33588761,644,644,644,1460,0,0,1,30258697,30258053,644
33590221,644,644,644,1460,0,0,1,30259341,30258697,644
33591681,644,644,644,1460,0,0,1,30259985,30259341,644
33593141,644,644,644,1460,0,0,1,30260629,30259985,644
33594601,644,644,644,1460,0,0,1,30261273,30260629,644
33596061,644,644,644,1460,0,0,1,30261917,30261273,644
33597521,644,644,644,1460,0,0,1,30262561,30261917,644
33598981,644,644,644,1460,0,0,1,30263205,30262561,644
33600441,644,644,644,1460,0,0,1,30263849,30263205,644
33601901,644,644,644,1460,0,0,1,30264493,30263849,644
33603361,644,644,644,1460,0,0,1,30265137,30264493,644
33604821,644,644,644,1460,0,0,1,30265781,30265137,644
33606281,644,644,644,1460,0,0,1,30266425,30265781,644
33607741,644,644,644,1460,0,0,1,30267069,30266425,644
33609201,644,644,644,1460,0,0,1,30267713,30267069,644
33610661,644,644,644,1460,0,0,1,30268357,30267713,644
33612121,644,644,644,1460,0,0,1,30269001,30268357,644
33613581,644,644,644,1460,0,0,1,30269645,30269001,644
33615041,644,644,644,1460,0,0,1,30270289,30269645,644
33616501,644,644,644,1460,0,0,1,30270933,30270289,644
33617961,644,644,644,1460,0,0,1,30271577,30270933,644
33619421,644,644,644,1460,0,0,1,30272221,30271577,644
33620881,644,644,644,1460,0,0,1,30272865,30272221,644
33622341,644,644,644,1460,0,0,1,30273509,30272865,644
33623801,644,644,644,1460,0,0,1,30274153,30273509,644
33625261,644,644,644,1460,0,0,1,30274797,30274153,644
33626721,644,644,644,1460,0,0,1,30275441,30274797,644
33628181,644,644,644,1460,0,0,1,30276085,30275441,644
33629641,644,644,644,1460,0,0,1,30276729,30276085,644
33631101,644,644,644,1460,0,0,1,30277373,30276729,644
33632561,644,644,644,1460,0,0,1,30278017,30277373,644
33634021,644,644,644,1460,0,0,1,30278661,30278017,644
33635481,644,644,644,1460,0,0,1,30279305,30278661,644
33636941,644,644,644,1460,0,0,1,30279949,30279305,644
33638401,644,644,644,1460,0,0,1,30280593,30279949,644
33639861,644,644,644,1460,0,0,1,30281237,30280593,644
33641321,644,644,644,1460,0,0,1,30281881,30281237,644
33642781,644,644,644,1460,0,0,1,30282525,30281881,644
33644241,644,644,644,1460,0,0,1,30283169,30282525,644
33645701,644,644,644,1460,0,0,1,30283813,30283169,644
33647161,644,644,644,1460,0,0,1,30284457,30283813,644
33648621,644,644,644,1460,0,0,1,30285101,30284457,644
33650081,644,644,644,1460,0,0,1,30285745,30285101,644
33651541,644,644,644,1460,0,0,1,30286389,30285745,644
33653001,644,644,644,1460,0,0,1,30287033,30286389,644
33654461,644,644,644,1460,0,0,1,30287677,30287033,644
33655921,644,644,644,1460,0,0,1,30288321,30287677,644
33657381,644,644,644,1460,0,0,1,30288965,30288321,644
33658841,644,644,644,1460,0,0,1,30289609,30288965,644
33660301,644,644,644,1460,0,0,1,30290253,30289609,644
33661761,644,644,644,1460,0,0,1,30290897,30290253,644
33663221,644,644,644,1460,0,0,1,30291541,30290897,644
33664681,644,644,644,1460,0,0,1,30292185,30291541,644
33666141,644,644,644,1460,0,0,1,30292829,30292185,644
33667601,644,644,644,1460,0,0,1,30293473,30292829,644
33669061,644,644,644,1460,0,0,1,30294117,30293473,644
33670521,644,644,644,1460,0,0,1,30294761,30294117,644
33671981,644,644,644,1460,0,0,1,30295405,30294761,644
33673441,644,644,644,1460,0,0,1,30296049,30295405,644
33674901,644,644,644,1460,0,0,1,30296693,30296049,644
33676361,644,644,644,1460,0,0,1,30297337,30296693,644
33677821,644,644,644,1460,0,0,1,30297981,30297337,644
33679281,644,644,644,1460,0,0,1,30298625,30297981,644
33680741,644,644,644,1460,0,0,1,30299269,30298625,644
33682201,644,644,644,1460,0,0,1,30299913,30299269,644
33683661,644,644,644,1460,0,0,1,30300557,30299913,644
33685121,644,644,644,1460,0,0,1,30301201,30300557,644
33686581,644,644,644,1460,0,0,1,30301845,30301201,644
33688041,644,644,644,1460,0,0,1,30302489,30301845,644
33689501,644,644,644,1460,0,0,1,30303133,30302489,644
33690961,644,644,644,1460,0,0,1,30303777,30303133,644
33692421,644,644,644,1460,0,0,1,30304421,30303777,644
33693881,644,644,644,1460,0,0,1,30305065,30304421,644
33695341,644,644,644,1460,0,0,1,30305709,30305065,644
33696801,644,644,644,1460,0,0,1,30306353,30305709,644
33698261,644,644,644,1460,0,0,1,30306997,30306353,644
33699721,644,644,644,1460,0,0,1,30307641,30306997,644
33701181,644,644,644,1460,0,0,1,30308285,30307641,644
33702641,644,644,644,1460,0,0,1,30308929,30308285,644
33704101,644,644,644,1460,0,0,1,30309573,30308929,644
33705561,644,644,644,1460,0,0,1,30310217,30309573,644
33707021,644,644,644,1460,0,0,1,30310861,30310217,644
33708481,644,644,644,1460,0,0,1,30311505,30310861,644
33709941,644,644,644,1460,0,0,1,30312149,30311505,644
33711401,644,644,644,1460,0,0,1,30312793,30312149,644
33712861,644,644,644,1460,0,0,1,30313437,30312793,644
33714321,644,644,644,1460,0,0,1,30314081,30313437,644
33715781,644,644,644,1460,0,0,1,30314725,30314081,644
33717241,644,644,644,1460,0,0,1,30315369,30314725,644
33718701,644,644,644,1460,0,0,1,30316013,30315369,644
33720161,644,644,644,1460,0,0,1,30316657,30316013,644
33721621,644,644,644,1460,0,0,1,30317301,30316657,644
33723081,644,644,644,1460,0,0,1,30317945,30317301,644
33724541,644,644,644,1460,0,0,1,30318589,30317945,644
33726001,644,644,644,1460,0,0,1,30319233,30318589,644
33727461,644,644,644,1460,0,0,1,30319877,30319233,644
33728921,644,644,644,1460,0,0,1,30320521,30319877,644
33730381,644,644,644,1460,0,0,1,30321165,30320521,644
33731841,644,644,644,1460,0,0,1,30321809,30321165,644
33733301,644,644,644,1460,0,0,1,30322453,30321809,644
33734761,644,644,644,1460,0,0,1,30323097,30322453,644
33736221,644,644,644,1460,0,0,1,30323741,30323097,644
33737681,644,644,644,1460,0,0,1,30324385,30323741,644
33739141,644,644,644,1460,0,0,1,30325029,30324385,644
33740601,644,644,644,1460,0,0,1,30325673,30325029,644
33742061,644,644,644,1460,0,0,1,30326317,30325673,644
33743521,644,644,644,1460,0,0,1,30326961,30326317,644
33744981,644,644,644,1460,0,0,1,30327605,30326961,644
33746441,644,644,644,1460,0,0,1,30328249,30327605,644
33747901,644,644,644,1460,0,0,1,30328893,30328249,644
33749361,644,644,644,1460,0,0,1,30329537,30328893,644
33750821,644,644,644,1460,0,0,1,30330181,30329537,644
33752281,644,644,644,1460,0,0,1,30330825,30330181,644
33753741,644,644,644,1460,0,0,1,30331469,30330825,644
33755201,644,644,644,1460,0,0,1,30332113,30331469,644
33756661,644,644,644,1460,0,0,1,30332757,30332113,644
33758121,644,644,644,1460,0,0,1,30333401,30332757,644
33759581,644,644,644,1460,0,0,1,30334045,30333401,644
33761041,644,644,644,1460,0,0,1,30334689,30334045,644
33762501,644,644,644,1460,0,0,1,30335333,30334689,644
33763961,644,644,644,1460,0,0,1,30335977,30335333,644
33765421,644,644,644,1460,0,0,1,30336621,30335977,644
33766881,644,644,644,1460,0,0,1,30337265,30336621,644
33768341,644,644,644,1460,0,0,1,30337909,30337265,644
33769801,644,644,644,1460,0,0,1,30338553,30337909,644
33771261,644,644,644,1460,0,0,1,30339197,30338553,644
33772721,644,644,644,1460,0,0,1,30339841,30339197,644
33774181,644,644,644,1460,0,0,1,30340485,30339841,644
33775641,644,644,644,1460,0,0,1,30341129,30340485,644
33777101,644,644,644,1460,0,0,1,30341773,30341129,644
33778561,644,644,644,1460,0,0,1,30342417,30341773,644
33780021,644,644,644,1460,0,0,1,30343061,30342417,644
33781481,644,644,644,1460,0,0,1,30343705,30343061,644
33782941,644,644,644,1460,0,0,1,30344349,30343705,644
33784401,644,644,644,1460,0,0,1,30344993,30344349,644
33785861,644,644,644,1460,0,0,1,30345637,30344993,644
33787321,644,644,644,1460,0,0,1,30346281,30345637,644
33788781,644,644,644,1460,0,0,1,30346925,30346281,644
33790241,644,644,644,1460,0,0,1,30347569,30346925,644
33791701,644,644,644,1460,0,0,1,30348213,30347569,644
33793161,644,644,644,1460,0,0,1,30348857,30348213,644
33794621,644,644,644,1460,0,0,1,30349501,30348857,644
33796081,644,644,644,1460,0,0,1,30350145,30349501,644
33797541,644,644,644,1460,0,0,1,30350789,30350145,644
33799001,644,644,644,1460,0,0,1,30351433,30350789,644
33800461,644,644,644,1460,0,0,1,30352077,30351433,644
33801921,644,644,644,1460,0,0,1,30352721,30352077,644
33803381,644,644,644,1460,0,0,1,30353365,30352721,644
33804841,644,644,644,1460,0,0,1,30354009,30353365,644
33806301,644,644,644,1460,0,0,1,30354653,30354009,644
33807761,644,644,644,1460,0,0,1,30355297,30354653,644
33809221,644,644,644,1460,0,0,1,30355941,30355297,644
33810681,644,644,644,1460,0,0,1,30356585,30355941,644
33812141,644,644,644,1460,0,0,1,30357229,30356585,644
33813601,644,644,644,1460,0,0,1,30357873,30357229,644
33815061,644,644,644,1460,0,0,1,30358517,30357873,644
33816521,644,644,644,1460,0,0,1,30359161,30358517,644
33817981,644,644,644,1460,0,0,1,30359805,30359161,644
33819441,644,644,644,1460,0,0,1,30360449,30359805,644
33820901,644,644,644,1460,0,0,1,30361093,30360449,644
33822361,644,644,644,1460,0,0,1,30361737,30361093,644
33823821,644,644,644,1460,0,0,1,30362381,30361737,644
33825281,644,644,644,1460,0,0,1,30363025,30362381,644
33826741,644,644,644,1460,0,0,1,30363669,30363025,644
33828201,644,644,644,1460,0,0,1,30364313,30363669,644
33829661,644,644,644,1460,0,0,1,30364957,30364313,644
33831121,644,644,644,1460,0,0,1,30365601,30364957,644
33832581,644,644,644,1460,0,0,1,30366245,30365601,644
33834041,644,644,644,1460,0,0,1,30366889,30366245,644
33835501,644,644,644,1460,0,0,1,30367533,30366889,644
33836961,644,644,644,1460,0,0,1,30368177,30367533,644
33838421,644,644,644,1460,0,0,1,30368821,30368177,644
33839881,644,644,644,1460,0,0,1,30369465,30368821,644
33841341,644,644,644,1460,0,0,1,30370109,30369465,644
33842801,644,644,644,1460,0,0,1,30370753,30370109,644
33844261,644,644,644,1460,0,0,1,30371397,30370753,644
33845721,644,644,644,1460,0,0,1,30372041,30371397,644
33847181,644,644,644,1460,0,0,1,30372685,30372041,644
33848641,644,644,644,1460,0,0,1,30373329,30372685,644
33850101,644,644,644,1460,0,0,1,30373973,30373329,644
33851561,644,644,644,1460,0,0,1,30374617,30373973,644
33853021,644,644,644,1460,0,0,1,30375261,30374617,644
33854481,644,644,644,1460,0,0,1,30375905,30375261,644
33855941,644,644,644,1460,0,0,1,30376549,30375905,644
33857401,644,644,644,1460,0,0,1,30377193,30376549,644
33858861,644,644,644,1460,0,0,1,30377837,30377193,644
33860321,644,644,644,1460,0,0,1,30378481,30377837,644
33861781,644,644,644,1460,0,0,1,30379125,30378481,644
33863241,644,644,644,1460,0,0,1,30379769,30379125,644
33864701,644,644,644,1460,0,0,1,30380413,30379769,644
33866161,644,644,644,1460,0,0,1,30381057,30380413,644
33867621,644,644,644,1460,0,0,1,30381701,30381057,644
33869081,644,644,644,1460,0,0,1,30382345,30381701,644
33870541,644,644,644,1460,0,0,1,30382989,30382345,644
33872001,644,644,644,1460,0,0,1,30383633,30382989,644
33873461,644,644,644,1460,0,0,1,30384277,30383633,644
33874921,644,644,644,1460,0,0,1,30384921,30384277,644
33876381,644,644,644,1460,0,0,1,30385565,30384921,644
33877841,644,644,644,1460,0,0,1,30386209,30385565,644
33879301,644,644,644,1460,0,0,1,30386853,30386209,644
33880761,644,644,644,1460,0,0,1,30387497,30386853,644
33882221,644,644,644,1460,0,0,1,30388141,30387497,644
33883681,644,644,644,1460,0,0,1,30388785,30388141,644
33885141,644,644,644,1460,0,0,1,30389429,30388785,644
33886601,644,644,644,1460,0,0,1,30390073,30389429,644
33888061,644,644,644,1460,0,0,1,30390717,30390073,644
33889521,644,644,644,1460,0,0,1,30391361,30390717,644
33890981,644,644,644,1460,0,0,1,30392005,30391361,644
33892441,644,644,644,1460,0,0,1,30392649,30392005,644
33893901,644,644,644,1460,0,0,1,30393293,30392649,644
33895361,644,644,644,1460,0,0,1,30393937,30393293,644
33896821,644,644,644,1460,0,0,1,30394581,30393937,644
33898281,644,644,644,1460,0,0,1,30395225,30394581,644
33899741,644,644,644,1460,0,0,1,30395869,30395225,644
33901201,644,644,644,1460,0,0,1,30396513,30395869,644
33902661,644,644,644,1460,0,0,1,30397157,30396513,644
33904121,644,644,644,1460,0,0,1,30397801,30397157,644
33905581,644,644,644,1460,0,0,1,30398445,30397801,644
33907041,644,644,644,1460,0,0,1,30399089,30398445,644
33908501,644,644,644,1460,0,0,1,30399733,30399089,644
33909961,644,644,644,1460,0,0,1,30400377,30399733,644
33911421,644,644,644,1460,0,0,1,30401021,30400377,644
33912881,644,644,644,1460,0,0,1,30401665,30401021,644
33914341,644,644,644,1460,0,0,1,30402309,30401665,644
33915801,644,644,644,1460,0,0,1,30402953,30402309,644
33917261,644,644,644,1460,0,0,1,30403597,30402953,644
33918721,644,644,644,1460,0,0,1,30404241,30403597,644
33920181,644,644,644,1460,0,0,1,30404885,30404241,644
33921641,644,644,644,1460,0,0,1,30405529,30404885,644
33923101,644,644,644,1460,0,0,1,30406173,30405529,644
33924561,644,644,644,1460,0,0,1,30406817,30406173,644
33926021,644,644,644,1460,0,0,1,30407461,30406817,644
33927481,644,644,644,1460,0,0,1,30408105,30407461,644
33928941,644,644,644,1460,0,0,1,30408749,30408105,644
33930401,644,644,644,1460,0,0,1,30409393,30408749,644
33931861,644,644,644,1460,0,0,1,30410037,30409393,644
33933321,644,644,644,1460,0,0,1,30410681,30410037,644
33934781,644,644,644,1460,0,0,1,30411325,30410681,644
33936241,644,644,644,1460,0,0,1,30411969,30411325,644
33937701,644,644,644,1460,0,0,1,30412613,30411969,644
33939161,644,644,644,1460,0,0,1,30413257,30412613,644
33940621,644,644,644,1460,0,0,1,30413901,30413257,644
33942081,644,644,644,1460,0,0,1,30414545,30413901,644
33943541,644,644,644,1460,0,0,1,30415189,30414545,644
33945001,644,644,644,1460,0,0,1,30415833,30415189,644
33946461,644,644,644,1460,0,0,1,30416477,30415833,644
33947921,644,644,644,1460,0,0,1,30417121,30416477,644
33949381,644,644,644,1460,0,0,1,30417765,30417121,644
33950841,644,644,644,1460,0,0,1,30418409,30417765,644
33952301,644,644,644,1460,0,0,1,30419053,30418409,644
33953761,644,644,644,1460,0,0,1,30419697,30419053,644
33955221,644,644,644,1460,0,0,1,30420341,30419697,644
33956681,644,644,644,1460,0,0,1,30420985,30420341,644
33958141,644,644,644,1460,0,0,1,30421629,30420985,644
33959601,644,644,644,1460,0,0,1,30422273,30421629,644
33961061,644,644,644,1460,0,0,1,30422917,30422273,644
33962521,644,644,644,1460,0,0,1,30423561,30422917,644
33963981,644,644,644,1460,0,0,1,30424205,30423561,644
33965441,644,644,644,1460,0,0,1,30424849,30424205,644
33966901,644,644,644,1460,0,0,1,30425493,30424849,644
33968361,644,644,644,1460,0,0,1,30426137,30425493,644
33969821,644,644,644,1460,0,0,1,30426781,30426137,644
33971281,644,644,644,1460,0,0,1,30427425,30426781,644
33972741,644,644,644,1460,0,0,1,30428069,30427425,644
33974201,644,644,644,1460,0,0,1,30428713,30428069,644
33975661,644,644,644,1460,0,0,1,30429357,30428713,644
33977121,644,644,644,1460,0,0,1,30430001,30429357,644
33978581,644,644,644,1460,0,0,1,30430645,30430001,644
33980041,644,644,644,1460,0,0,1,30431289,30430645,644
33981501,644,644,644,1460,0,0,1,30431933,30431289,644
33982961,644,644,644,1460,0,0,1,30432577,30431933,644
33984421,644,644,644,1460,0,0,1,30433221,30432577,644
33985881,644,644,644,1460,0,0,1,30433865,30433221,644
33987341,644,644,644,1460,0,0,1,30434509,30433865,644
33988801,644,644,644,1460,0,0,1,30435153,30434509,644
33990261,644,644,644,1460,0,0,1,30435797,30435153,644
33991721,644,644,644,1460,0,0,1,30436441,30435797,644
33993181,644,644,644,1460,0,0,1,30437085,30436441,644
33994641,644,644,644,1460,0,0,1,30437729,30437085,644
33996101,644,644,644,1460,0,0,1,30438373,30437729,644
33997561,644,644,644,1460,0,0,1,30439017,30438373,644
33999021,644,644,644,1460,0,0,1,30439661,30439017,644
34000481,644,644,644,1460,0,0,1,30440305,30439661,644
34001941,644,644,644,1460,0,0,1,30440949,30440305,644
34003401,644,644,644,1460,0,0,1,30441593,30440949,644
34004861,644,644,644,1460,0,0,1,30442237,30441593,644
34006321,644,644,644,1460,0,0,1,30442881,30442237,644
34007781,644,644,644,1460,0,0,1,30443525,30442881,644
34009241,644,644,644,1460,0,0,1,30444169,30443525,644
34010701,644,644,644,1460,0,0,1,30444813,30444169,644
34012161,644,644,644,1460,0,0,1,30445457,30444813,644
34013621,644,644,644,1460,0,0,1,30446101,30445457,644
34015081,644,644,644,1460,0,0,1,30446745,30446101,644
34016541,644,644,644,1460,0,0,1,30447389,30446745,644
34018001,644,644,644,1460,0,0,1,30448033,30447389,644
34019461,644,644,644,1460,0,0,1,30448677,30448033,644
34020921,644,644,644,1460,0,0,1,30449321,30448677,644
34022381,644,644,644,1460,0,0,1,30449965,30449321,644
34023841,644,644,644,1460,0,0,1,30450609,30449965,644
34025301,644,644,644,1460,0,0,1,30451253,30450609,644
34026761,644,644,644,1460,0,0,1,30451897,30451253,644
34028221,644,644,644,1460,0,0,1,30452541,30451897,644
34029681,644,644,644,1460,0,0,1,30453185,30452541,644
34031141,644,644,644,1460,0,0,1,30453829,30453185,644
34032601,644,644,644,1460,0,0,1,30454473,30453829,644
34034061,644,644,644,1460,0,0,1,30455117,30454473,644
34035521,644,644,644,1460,0,0,1,30455761,30455117,644
34036981,644,644,644,1460,0,0,1,30456405,30455761,644
34038441,644,644,644,1460,0,0,1,30457049,30456405,644
34039901,644,644,644,1460,0,0,1,30457693,30457049,644
34041361,644,644,644,1460,0,0,1,30458337,30457693,644
34042821,644,644,644,1460,0,0,1,30458981,30458337,644
34044281,644,644,644,1460,0,0,1,30459625,30458981,644
34045741,644,644,644,1460,0,0,1,30460269,30459625,644
34047201,644,644,644,1460,0,0,1,30460913,30460269,644
34048661,644,644,644,1460,0,0,1,30461557,30460913,644
34050121,644,644,644,1460,0,0,1,30462201,30461557,644
34051581,644,644,644,1460,0,0,1,30462845,30462201,644
34053041,644,644,644,1460,0,0,1,30463489,30462845,644
34054501,644,644,644,1460,0,0,1,30464133,30463489,644
34055961,644,644,644,1460,0,0,1,30464777,30464133,644
34057421,644,644,644,1460,0,0,1,30465421,30464777,644
34058881,644,644,644,1460,0,0,1,30466065,30465421,644
34060341,644,644,644,1460,0,0,1,30466709,30466065,644
34061801,644,644,644,1460,0,0,1,30467353,30466709,644
34063261,644,644,644,1460,0,0,1,30467997,30467353,644
34064721,644,644,644,1460,0,0,1,30468641,30467997,644
34066181,644,644,644,1460,0,0,1,30469285,30468641,644
34067641,644,644,644,1460,0,0,1,30469929,30469285,644
34069101,644,644,644,1460,0,0,1,30470573,30469929,644
34070561,644,644,644,1460,0,0,1,30471217,30470573,644
34072021,644,644,644,1460,0,0,1,30471861,30471217,644
34073481,644,644,644,1460,0,0,1,30472505,30471861,644
34074941,644,644,644,1460,0,0,1,30473149,30472505,644
34076401,644,644,644,1460,0,0,1,30473793,30473149,644
34077861,644,644,644,1460,0,0,1,30474437,30473793,644
34079321,644,644,644,1460,0,0,1,30475081,30474437,644
34080781,644,644,644,1460,0,0,1,30475725,30475081,644
34082241,644,644,644,1460,0,0,1,30476369,30475725,644
34083701,644,644,644,1460,0,0,1,30477013,30476369,644
34085161,644,644,644,1460,0,0,1,30477657,30477013,644
34086621,644,644,644,1460,0,0,1,30478301,30477657,644
34088081,644,644,644,1460,0,0,1,30478945,30478301,644
34089541,644,644,644,1460,0,0,1,30479589,30478945,644
34091001,644,644,644,1460,0,0,1,30480233,30479589,644
34092461,644,644,644,1460,0,0,1,30480877,30480233,644
34093921,644,644,644,1460,0,0,1,30481521,30480877,644
34095381,644,644,644,1460,0,0,1,30482165,30481521,644
34096841,644,644,644,1460,0,0,1,30482809,30482165,644
34098301,644,644,644,1460,0,0,1,30483453,30482809,644
34099761,644,644,644,1460,0,0,1,30484097,30483453,644
34101221,644,644,644,1460,0,0,1,30484741,30484097,644
34102681,644,644,644,1460,0,0,1,30485385,30484741,644
34104141,644,644,644,1460,0,0,1,30486029,30485385,644
34105601,644,644,644,1460,0,0,1,30486673,30486029,644
34107061,644,644,644,1460,0,0,1,30487317,30486673,644
34108521,644,644,644,1460,0,0,1,30487961,30487317,644
34109981,644,644,644,1460,0,0,1,30488605,30487961,644
34111441,644,644,644,1460,0,0,1,30489249,30488605,644
34112901,644,644,644,1460,0,0,1,30489893,30489249,644
34114361,644,644,644,1460,0,0,1,30490537,30489893,644
34115821,644,644,644,1460,0,0,1,30491181,30490537,644
34117281,644,644,644,1460,0,0,1,30491825,30491181,644
34118741,644,644,644,1460,0,0,1,30492469,30491825,644
34120201,644,644,644,1460,0,0,1,30493113,30492469,644
34121661,644,644,644,1460,0,0,1,30493757,30493113,644
34123121,644,644,644,1460,0,0,1,30494401,30493757,644
34124581,644,644,644,1460,0,0,1,30495045,30494401,644
34126041,644,644,644,1460,0,0,1,30495689,30495045,644
34127501,644,644,644,1460,0,0,1,30496333,30495689,644
34128961,644,644,644,1460,0,0,1,30496977,30496333,644
34130421,644,644,644,1460,0,0,1,30497621,30496977,644
34131881,644,644,644,1460,0,0,1,30498265,30497621,644
34133341,644,644,644,1460,0,0,1,30498909,30498265,644
34134801,644,644,644,1460,0,0,1,30499553,30498909,644
34136261,644,644,644,1460,0,0,1,30500197,30499553,644
34137721,644,644,644,1460,0,0,1,30500841,30500197,644
34139181,644,644,644,1460,0,0,1,30501485,30500841,644
34140641,644,644,644,1460,0,0,1,30502129,30501485,644
34142101,644,644,644,1460,0,0,1,30502773,30502129,644
34143561,644,644,644,1460,0,0,1,30503417,30502773,644
34145021,644,644,644,1460,0,0,1,30504061,30503417,644
34146481,644,644,644,1460,0,0,1,30504705,30504061,644
34147941,644,644,644,1460,0,0,1,30505349,30504705,644
34149401,644,644,644,1460,0,0,1,30505993,30505349,644
34150861,644,644,644,1460,0,0,1,30506637,30505993,644
34152321,644,644,644,1460,0,0,1,30507281,30506637,644
34153781,644,644,644,1460,0,0,1,30507925,30507281,644
34155241,644,644,644,1460,0,0,1,30508569,30507925,644
34156701,644,644,644,1460,0,0,1,30509213,30508569,644
34158161,644,644,644,1460,0,0,1,30509857,30509213,644
34159621,644,644,644,1460,0,0,1,30510501,30509857,644
34161081,644,644,644,1460,0,0,1,30511145,30510501,644
34162541,644,644,644,1460,0,0,1,30511789,30511145,644
34164001,644,644,644,1460,0,0,1,30512433,30511789,644
34165461,644,644,644,1460,0,0,1,30513077,30512433,644
34166921,644,644,644,1460,0,0,1,30513721,30513077,644
34168381,644,644,644,1460,0,0,1,30514365,30513721,644
34169841,644,644,644,1460,0,0,1,30515009,30514365,644
34171301,644,644,644,1460,0,0,1,30515653,30515009,644
34172761,644,644,644,1460,0,0,1,30516297,30515653,644
34174221,644,644,644,1460,0,0,1,30516941,30516297,644
34175681,644,644,644,1460,0,0,1,30517585,30516941,644
34177141,644,644,644,1460,0,0,1,30518229,30517585,644
34178601,644,644,644,1460,0,0,1,30518873,30518229,644
34180061,644,644,644,1460,0,0,1,30519517,30518873,644
34181521,644,644,644,1460,0,0,1,30520161,30519517,644
34182981,644,644,644,1460,0,0,1,30520805,30520161,644
34184441,644,644,644,1460,0,0,1,30521449,30520805,644
34185901,644,644,644,1460,0,0,1,30522093,30521449,644
34187361,644,644,644,1460,0,0,1,30522737,30522093,644
34188821,644,644,644,1460,0,0,1,30523381,30522737,644
34190281,644,644,644,1460,0,0,1,30524025,30523381,644
34191741,644,644,644,1460,0,0,1,30524669,30524025,644
34193201,644,644,644,1460,0,0,1,30525313,30524669,644
34194661,644,644,644,1460,0,0,1,30525957,30525313,644
34196121,644,644,644,1460,0,0,1,30526601,30525957,644
34197581,644,644,644,1460,0,0,1,30527245,30526601,644
34199041,644,644,644,1460,0,0,1,30527889,30527245,644
34200501,644,644,644,1460,0,0,1,30528533,30527889,644
34201961,644,644,644,1460,0,0,1,30529177,30528533,644
34203421,644,644,644,1460,0,0,1,30529821,30529177,644
34204881,644,644,644,1460,0,0,1,30530465,30529821,644
34206341,644,644,644,1460,0,0,1,30531109,30530465,644
34207801,644,644,644,1460,0,0,1,30531753,30531109,644
34209261,644,644,644,1460,0,0,1,30532397,30531753,644
34210721,644,644,644,1460,0,0,1,30533041,30532397,644
34212181,644,644,644,1460,0,0,1,30533685,30533041,644
34213641,644,644,644,1460,0,0,1,30534329,30533685,644
34215101,644,644,644,1460,0,0,1,30534973,30534329,644
34216561,644,644,644,1460,0,0,1,30535617,30534973,644
34218021,644,644,644,1460,0,0,1,30536261,30535617,644
34219481,644,644,644,1460,0,0,1,30536905,30536261,644
34220941,644,644,644,1460,0,0,1,30537549,30536905,644
34222401,644,644,644,1460,0,0,1,30538193,30537549,644
34223861,644,644,644,1460,0,0,1,30538837,30538193,644
34225321,644,644,644,1460,0,0,1,30539481,30538837,644
34226781,644,644,644,1460,0,0,1,30540125,30539481,644
34228241,644,644,644,1460,0,0,1,30540769,30540125,644
34229701,644,644,644,1460,0,0,1,30541413,30540769,644
34231161,644,644,644,1460,0,0,1,30542057,30541413,644
34232621,644,644,644,1460,0,0,1,30542701,30542057,644
34234081,644,644,644,1460,0,0,1,30543345,30542701,644
34235541,644,644,644,1460,0,0,1,30543989,30543345,644
34237001,644,644,644,1460,0,0,1,30544633,30543989,644
34238461,644,644,644,1460,0,0,1,30545277,30544633,644
34239921,644,644,644,1460,0,0,1,30545921,30545277,644
34241381,644,644,644,1460,0,0,1,30546565,30545921,644
34242841,644,644,644,1460,0,0,1,30547209,30546565,644
34244301,644,644,644,1460,0,0,1,30547853,30547209,644
34245761,644,644,644,1460,0,0,1,30548497,30547853,644
34247221,644,644,644,1460,0,0,1,30549141,30548497,644
34248681,644,644,644,1460,0,0,1,30549785,30549141,644
34250141,644,644,644,1460,0,0,1,30550429,30549785,644
34251601,644,644,644,1460,0,0,1,30551073,30550429,644
34253061,644,644,644,1460,0,0,1,30551717,30551073,644
34254521,644,644,644,1460,0,0,1,30552361,30551717,644
34255981,644,644,644,1460,0,0,1,30553005,30552361,644
34257441,644,644,644,1460,0,0,1,30553649,30553005,644
34258901,644,644,644,1460,0,0,1,30554293,30553649,644
34260361,644,644,644,1460,0,0,1,30554937,30554293,644
34261821,644,644,644,1460,0,0,1,30555581,30554937,644
34263281,644,644,644,1460,0,0,1,30556225,30555581,644
34264741,644,644,644,1460,0,0,1,30556869,30556225,644
34266201,644,644,644,1460,0,0,1,30557513,30556869,644
34267661,644,644,644,1460,0,0,1,30558157,30557513,644
34269121,644,644,644,1460,0,0,1,30558801,30558157,644
34270581,644,644,644,1460,0,0,1,30559445,30558801,644
34272041,644,644,644,1460,0,0,1,30560089,30559445,644
34273501,644,644,644,1460,0,0,1,30560733,30560089,644
34274961,644,644,644,1460,0,0,1,30561377,30560733,644
34276421,644,644,644,1460,0,0,1,30562021,30561377,644
34277881,644,644,644,1460,0,0,1,30562665,30562021,644
34279341,644,644,644,1460,0,0,1,30563309,30562665,644
34280801,644,644,644,1460,0,0,1,30563953,30563309,644
34282261,644,644,644,1460,0,0,1,30564597,30563953,644
34283721,644,644,644,1460,0,0,1,30565241,30564597,644
34285181,644,644,644,1460,0,0,1,30565885,30565241,644
34286641,644,644,644,1460,0,0,1,30566529,30565885,644
34288101,644,644,644,1460,0,0,1,30567173,30566529,644
34289561,644,644,644,1460,0,0,1,30567817,30567173,644
34291021,644,644,644,1460,0,0,1,30568461,30567817,644
34292481,644,644,644,1460,0,0,1,30569105,30568461,644
34293941,644,644,644,1460,0,0,1,30569749,30569105,644
34295401,644,644,644,1460,0,0,1,30570393,30569749,644
34296861,644,644,644,1460,0,0,1,30571037,30570393,644
34298321,644,644,644,1460,0,0,1,30571681,30571037,644
34299781,644,644,644,1460,0,0,1,30572325,30571681,644
34301241,644,644,644,1460,0,0,1,30572969,30572325,644
34302701,644,644,644,1460,0,0,1,30573613,30572969,644
34304161,644,644,644,1460,0,0,1,30574257,30573613,644
34305621,644,644,644,1460,0,0,1,30574901,30574257,644
34307081,644,644,644,1460,0,0,1,30575545,30574901,644
34308541,644,644,644,1460,0,0,1,30576189,30575545,644
34310001,644,644,644,1460,0,0,1,30576833,30576189,644
34311461,644,644,644,1460,0,0,1,30577477,30576833,644
34312921,644,644,644,1460,0,0,1,30578121,30577477,644
34314381,644,644,644,1460,0,0,1,30578765,30578121,644
34315841,644,644,644,1460,0,0,1,30579409,30578765,644
34317301,644,644,644,1460,0,0,1,30580053,30579409,644
34318761,644,644,644,1460,0,0,1,30580697,30580053,644
34320221,644,644,644,1460,0,0,1,30581341,30580697,644
34321681,644,644,644,1460,0,0,1,30581985,30581341,644
34323141,644,644,644,1460,0,0,1,30582629,30581985,644
34324601,644,644,644,1460,0,0,1,30583273,30582629,644
34326061,644,644,644,1460,0,0,1,30583917,30583273,644
34327521,644,644,644,1460,0,0,1,30584561,30583917,644
34328981,644,644,644,1460,0,0,1,30585205,30584561,644
34330441,644,644,644,1460,0,0,1,30585849,30585205,644
34331901,644,644,644,1460,0,0,1,30586493,30585849,644
34333361,644,644,644,1460,0,0,1,30587137,30586493,644
34334821,644,644,644,1460,0,0,1,30587781,30587137,644
34336281,644,644,644,1460,0,0,1,30588425,30587781,644
34337741,644,644,644,1460,0,0,1,30589069,30588425,644
34339201,644,644,644,1460,0,0,1,30589713,30589069,644
34340661,644,644,644,1460,0,0,1,30590357,30589713,644
34342121,644,644,644,1460,0,0,1,30591001,30590357,644
34343581,644,644,644,1460,0,0,1,30591645,30591001,644
34345041,644,644,644,1460,0,0,1,30592289,30591645,644
34346501,644,644,644,1460,0,0,1,30592933,30592289,644
34347961,644,644,644,1460,0,0,1,30593577,30592933,644
34349421,644,644,644,1460,0,0,1,30594221,30593577,644
34350881,644,644,644,1460,0,0,1,30594865,30594221,644
34352341,644,644,644,1460,0,0,1,30595509,30594865,644
34353801,644,644,644,1460,0,0,1,30596153,30595509,644
34355261,644,644,644,1460,0,0,1,30596797,30596153,644
34356721,644,644,644,1460,0,0,1,30597441,30596797,644
34358181,644,644,644,1460,0,0,1,30598085,30597441,644
34359641,644,644,644,1460,0,0,1,30598729,30598085,644
34361101,644,644,644,1460,0,0,1,30599373,30598729,644
34362561,644,644,644,1460,0,0,1,30600017,30599373,644
34364021,644,644,644,1460,0,0,1,30600661,30600017,644
34365481,644,644,644,1460,0,0,1,30601305,30600661,644
34366941,644,644,644,1460,0,0,1,30601949,30601305,644
34368401,644,644,644,1460,0,0,1,30602593,30601949,644
34369861,644,644,644,1460,0,0,1,30603237,30602593,644
34371321,644,644,644,1460,0,0,1,30603881,30603237,644
34372781,644,644,644,1460,0,0,1,30604525,30603881,644
34374241,644,644,644,1460,0,0,1,30605169,30604525,644
34375701,644,644,644,1460,0,0,1,30605813,30605169,644
34377161,644,644,644,1460,0,0,1,30606457,30605813,644
34378621,644,644,644,1460,0,0,1,30607101,30606457,644
34380081,644,644,644,1460,0,0,1,30607745,30607101,644
34381541,644,644,644,1460,0,0,1,30608389,30607745,644
34383001,644,644,644,1460,0,0,1,30609033,30608389,644
34384461,644,644,644,1460,0,0,1,30609677,30609033,644
34385921,644,644,644,1460,0,0,1,30610321,30609677,644
34387381,644,644,644,1460,0,0,1,30610965,30610321,644
34388841,644,644,644,1460,0,0,1,30611609,30610965,644
34390301,644,644,644,1460,0,0,1,30612253,30611609,644
34391761,644,644,644,1460,0,0,1,30612897,30612253,644
34393221,644,644,644,1460,0,0,1,30613541,30612897,644
34394681,644,644,644,1460,0,0,1,30614185,30613541,644
34396141,644,644,644,1460,0,0,1,30614829,30614185,644
34397601,644,644,644,1460,0,0,1,30615473,30614829,644
34399061,644,644,644,1460,0,0,1,30616117,30615473,644
34400521,644,644,644,1460,0,0,1,30616761,30616117,644
34401981,644,644,644,1460,0,0,1,30617405,30616761,644
34403441,644,644,644,1460,0,0,1,30618049,30617405,644
34404901,644,644,644,1460,0,0,1,30618693,30618049,644
34406361,644,644,644,1460,0,0,1,30619337,30618693,644
34407821,644,644,644,1460,0,0,1,30619981,30619337,644
34409281,644,644,644,1460,0,0,1,30620625,30619981,644
34410741,644,644,644,1460,0,0,1,30621269,30620625,644
34412201,644,644,644,1460,0,0,1,30621913,30621269,644
34413661,644,644,644,1460,0,0,1,30622557,30621913,644
34415121,644,644,644,1460,0,0,1,30623201,30622557,644
34416581,644,644,644,1460,0,0,1,30623845,30623201,644
34418041,644,644,644,1460,0,0,1,30624489,30623845,644
34419501,644,644,644,1460,0,0,1,30625133,30624489,644
34420961,644,644,644,1460,0,0,1,30625777,30625133,644
34422421,644,644,644,1460,0,0,1,30626421,30625777,644
34423881,644,644,644,1460,0,0,1,30627065,30626421,644
34425341,644,644,644,1460,0,0,1,30627709,30627065,644
34426801,644,644,644,1460,0,0,1,30628353,30627709,644
34428261,644,644,644,1460,0,0,1,30628997,30628353,644
34429721,644,644,644,1460,0,0,1,30629641,30628997,644
34431181,644,644,644,1460,0,0,1,30630285,30629641,644
34432641,644,644,644,1460,0,0,1,30630929,30630285,644
34434101,644,644,644,1460,0,0,1,30631573,30630929,644
34435561,644,644,644,1460,0,0,1,30632217,30631573,644
34437021,644,644,644,1460,0,0,1,30632861,30632217,644
34438481,644,644,644,1460,0,0,1,30633505,30632861,644
34439941,644,644,644,1460,0,0,1,30634149,30633505,644
34441401,644,644,644,1460,0,0,1,30634793,30634149,644
34442861,644,644,644,1460,0,0,1,30635437,30634793,644
34444321,644,644,644,1460,0,0,1,30636081,30635437,644
34445781,644,644,644,1460,0,0,1,30636725,30636081,644
34447241,644,644,644,1460,0,0,1,30637369,30636725,644
34448701,644,644,644,1460,0,0,1,30638013,30637369,644
34450161,644,644,644,1460,0,0,1,30638657,30638013,644
34451621,644,644,644,1460,0,0,1,30639301,30638657,644
34453081,644,644,644,1460,0,0,1,30639945,30639301,644
34454541,644,644,644,1460,0,0,1,30640589,30639945,644
34456001,644,644,644,1460,0,0,1,30641233,30640589,644
34457461,644,644,644,1460,0,0,1,30641877,30641233,644
34458921,644,644,644,1460,0,0,1,30642521,30641877,644
34460381,644,644,644,1460,0,0,1,30643165,30642521,644
34461841,644,644,644,1460,0,0,1,30643809,30643165,644
34463301,644,644,644,1460,0,0,1,30644453,30643809,644
34464761,644,644,644,1460,0,0,1,30645097,30644453,644
34466221,644,644,644,1460,0,0,1,30645741,30645097,644
34467681,644,644,644,1460,0,0,1,30646385,30645741,644
34469141,644,644,644,1460,0,0,1,30647029,30646385,644
34470601,644,644,644,1460,0,0,1,30647673,30647029,644
34472061,644,644,644,1460,0,0,1,30648317,30647673,644
34473521,644,644,644,1460,0,0,1,30648961,30648317,644
34474981,644,644,644,1460,0,0,1,30649605,30648961,644
34476441,644,644,644,1460,0,0,1,30650249,30649605,644
34477901,644,644,644,1460,0,0,1,30650893,30650249,644
34479361,644,644,644,1460,0,0,1,30651537,30650893,644
34480821,644,644,644,1460,0,0,1,30652181,30651537,644
34482281,644,644,644,1460,0,0,1,30652825,30652181,644
34483741,644,644,644,1460,0,0,1,30653469,30652825,644
34485201,644,644,644,1460,0,0,1,30654113,30653469,644
34486661,644,644,644,1460,0,0,1,30654757,30654113,644
34488121,644,644,644,1460,0,0,1,30655401,30654757,644
34489581,644,644,644,1460,0,0,1,30656045,30655401,644
34491041,644,644,644,1460,0,0,1,30656689,30656045,644
34492501,644,644,644,1460,0,0,1,30657333,30656689,644
34493961,644,644,644,1460,0,0,1,30657977,30657333,644
34495421,644,644,644,1460,0,0,1,30658621,30657977,644
34496881,644,644,644,1460,0,0,1,30659265,30658621,644
34498341,644,644,644,1460,0,0,1,30659909,30659265,644
34499801,644,644,644,1460,0,0,1,30660553,30659909,644
34501261,644,644,644,1460,0,0,1,30661197,30660553,644
34502721,644,644,644,1460,0,0,1,30661841,30661197,644
34504181,644,644,644,1460,0,0,1,30662485,30661841,644
34505641,644,644,644,1460,0,0,1,30663129,30662485,644
34507101,644,644,644,1460,0,0,1,30663773,30663129,644
34508561,644,644,644,1460,0,0,1,30664417,30663773,644
34510021,644,644,644,1460,0,0,1,30665061,30664417,644
34511481,644,644,644,1460,0,0,1,30665705,30665061,644
34512941,644,644,644,1460,0,0,1,30666349,30665705,644
34514401,644,644,644,1460,0,0,1,30666993,30666349,644
34515861,644,644,644,1460,0,0,1,30667637,30666993,644
34517321,644,644,644,1460,0,0,1,30668281,30667637,644
34518781,644,644,644,1460,0,0,1,30668925,30668281,644
34520241,644,644,644,1460,0,0,1,30669569,30668925,644
34521701,644,644,644,1460,0,0,1,30670213,30669569,644
34523161,644,644,644,1460,0,0,1,30670857,30670213,644
34524621,644,644,644,1460,0,0,1,30671501,30670857,644
34526081,644,644,644,1460,0,0,1,30672145,30671501,644
34527541,644,644,644,1460,0,0,1,30672789,30672145,644
34529001,644,644,644,1460,0,0,1,30673433,30672789,644
34530461,644,644,644,1460,0,0,1,30674077,30673433,644
34531921,644,644,644,1460,0,0,1,30674721,30674077,644
34533381,644,644,644,1460,0,0,1,30675365,30674721,644
34534841,644,644,644,1460,0,0,1,30676009,30675365,644
34536301,644,644,644,1460,0,0,1,30676653,30676009,644
34537761,644,644,644,1460,0,0,1,30677297,30676653,644
34539221,644,644,644,1460,0,0,1,30677941,30677297,644
34540681,644,644,644,1460,0,0,1,30678585,30677941,644
34542141,644,644,644,1460,0,0,1,30679229,30678585,644
34543601,644,644,644,1460,0,0,1,30679873,30679229,644
34545061,644,644,644,1460,0,0,1,30680517,30679873,644
34546521,644,644,644,1460,0,0,1,30681161,30680517,644
34547981,644,644,644,1460,0,0,1,30681805,30681161,644
34549441,644,644,644,1460,0,0,1,30682449,30681805,644
34550901,644,644,644,1460,0,0,1,30683093,30682449,644
34552361,644,644,644,1460,0,0,1,30683737,30683093,644
34553821,644,644,644,1460,0,0,1,30684381,30683737,644
34555281,644,644,644,1460,0,0,1,30685025,30684381,644
34556741,644,644,644,1460,0,0,1,30685669,30685025,644
34558201,644,644,644,1460,0,0,1,30686313,30685669,644
34559661,644,644,644,1460,0,0,1,30686957,30686313,644
34561121,644,644,644,1460,0,0,1,30687601,30686957,644
34562581,644,644,644,1460,0,0,1,30688245,30687601,644
34564041,644,644,644,1460,0,0,1,30688889,30688245,644
34565501,644,644,644,1460,0,0,1,30689533,30688889,644
34566961,644,644,644,1460,0,0,1,30690177,30689533,644
34568421,644,644,644,1460,0,0,1,30690821,30690177,644
34569881,644,644,644,1460,0,0,1,30691465,30690821,644
34571341,644,644,644,1460,0,0,1,30692109,30691465,644
34572801,644,644,644,1460,0,0,1,30692753,30692109,644
34574261,644,644,644,1460,0,0,1,30693397,30692753,644
34575721,644,644,644,1460,0,0,1,30694041,30693397,644
34577181,644,644,644,1460,0,0,1,30694685,30694041,644
34578641,644,644,644,1460,0,0,1,30695329,30694685,644
34580101,644,644,644,1460,0,0,1,30695973,30695329,644
34581561,644,644,644,1460,0,0,1,30696617,30695973,644
34583021,644,644,644,1460,0,0,1,30697261,30696617,644
34584481,644,644,644,1460,0,0,1,30697905,30697261,644
34585941,644,644,644,1460,0,0,1,30698549,30697905,644
34587401,644,644,644,1460,0,0,1,30699193,30698549,644
34588861,644,644,644,1460,0,0,1,30699837,30699193,644
34590321,644,644,644,1460,0,0,1,30700481,30699837,644
34591781,644,644,644,1460,0,0,1,30701125,30700481,644
34593241,644,644,644,1460,0,0,1,30701769,30701125,644
34594701,644,644,644,1460,0,0,1,30702413,30701769,644
34596161,644,644,644,1460,0,0,1,30703057,30702413,644
34597621,644,644,644,1460,0,0,1,30703701,30703057,644
34599081,644,644,644,1460,0,0,1,30704345,30703701,644
34600541,644,644,644,1460,0,0,1,30704989,30704345,644
34602001,644,644,644,1460,0,0,1,30705633,30704989,644
34603461,644,644,644,1460,0,0,1,30706277,30705633,644
34604921,644,644,644,1460,0,0,1,30706921,30706277,644
34606381,644,644,644,1460,0,0,1,30707565,30706921,644
34607841,644,644,644,1460,0,0,1,30708209,30707565,644
34609301,644,644,644,1460,0,0,1,30708853,30708209,644
34610761,644,644,644,1460,0,0,1,30709497,30708853,644
34612221,644,644,644,1460,0,0,1,30710141,30709497,644
34613681,644,644,644,1460,0,0,1,30710785,30710141,644
34615141,644,644,644,1460,0,0,1,30711429,30710785,644
34616601,644,644,644,1460,0,0,1,30712073,30711429,644
34618061,644,644,644,1460,0,0,1,30712717,30712073,644
34619521,644,644,644,1460,0,0,1,30713361,30712717,644
34620981,644,644,644,1460,0,0,1,30714005,30713361,644
34622441,644,644,644,1460,0,0,1,30714649,30714005,644
34623901,644,644,644,1460,0,0,1,30715293,30714649,644
34625361,644,644,644,1460,0,0,1,30715937,30715293,644
34626821,644,644,644,1460,0,0,1,30716581,30715937,644
34628281,644,644,644,1460,0,0,1,30717225,30716581,644
34629741,644,644,644,1460,0,0,1,30717869,30717225,644
34631201,644,644,644,1460,0,0,1,30718513,30717869,644
34632661,644,644,644,1460,0,0,1,30719157,30718513,644
34634121,644,644,644,1460,0,0,1,30719801,30719157,644
34635581,644,644,644,1460,0,0,1,30720445,30719801,644
34637041,644,644,644,1460,0,0,1,30721089,30720445,644
34638501,644,644,644,1460,0,0,1,30721733,30721089,644
34639961,644,644,644,1460,0,0,1,30722377,30721733,644
34641421,644,644,644,1460,0,0,1,30723021,30722377,644
34642881,644,644,644,1460,0,0,1,30723665,30723021,644
34644341,644,644,644,1460,0,0,1,30724309,30723665,644
34645801,644,644,644,1460,0,0,1,30724953,30724309,644
34647261,644,644,644,1460,0,0,1,30725597,30724953,644
34648721,644,644,644,1460,0,0,1,30726241,30725597,644
34650181,644,644,644,1460,0,0,1,30726885,30726241,644
34651641,644,644,644,1460,0,0,1,30727529,30726885,644
34653101,644,644,644,1460,0,0,1,30728173,30727529,644
34654561,644,644,644,1460,0,0,1,30728817,30728173,644
34656021,644,644,644,1460,0,0,1,30729461,30728817,644
34657481,644,644,644,1460,0,0,1,30730105,30729461,644
34658941,644,644,644,1460,0,0,1,30730749,30730105,644
34660401,644,644,644,1460,0,0,1,30731393,30730749,644
34661861,644,644,644,1460,0,0,1,30732037,30731393,644
34663321,644,644,644,1460,0,0,1,30732681,30732037,644
34664781,644,644,644,1460,0,0,1,30733325,30732681,644
34666241,644,644,644,1460,0,0,1,30733969,30733325,644
34667701,644,644,644,1460,0,0,1,30734613,30733969,644
34669161,644,644,644,1460,0,0,1,30735257,30734613,644
34670621,644,644,644,1460,0,0,1,30735901,30735257,644
34672081,644,644,644,1460,0,0,1,30736545,30735901,644
34673541,644,644,644,1460,0,0,1,30737189,30736545,644
34675001,644,644,644,1460,0,0,1,30737833,30737189,644
34676461,644,644,644,1460,0,0,1,30738477,30737833,644
34677921,644,644,644,1460,0,0,1,30739121,30738477,644
34679381,644,644,644,1460,0,0,1,30739765,30739121,644
34680841,644,644,644,1460,0,0,1,30740409,30739765,644
34682301,644,644,644,1460,0,0,1,30741053,30740409,644
34683761,644,644,644,1460,0,0,1,30741697,30741053,644
34685221,644,644,644,1460,0,0,1,30742341,30741697,644
34686681,644,644,644,1460,0,0,1,30742985,30742341,644
34688141,644,644,644,1460,0,0,1,30743629,30742985,644
34689601,644,644,644,1460,0,0,1,30744273,30743629,644
34691061,644,644,644,1460,0,0,1,30744917,30744273,644
34692521,644,644,644,1460,0,0,1,30745561,30744917,644
34693981,644,644,644,1460,0,0,1,30746205,30745561,644
34695441,644,644,644,1460,0,0,1,30746849,30746205,644
34696901,644,644,644,1460,0,0,1,30747493,30746849,644
34698361,644,644,644,1460,0,0,1,30748137,30747493,644
34699821,644,644,644,1460,0,0,1,30748781,30748137,644
34701281,644,644,644,1460,0,0,1,30749425,30748781,644
34702741,644,644,644,1460,0,0,1,30750069,30749425,644
34704201,644,644,644,1460,0,0,1,30750713,30750069,644
34705661,644,644,644,1460,0,0,1,30751357,30750713,644
34707121,644,644,644,1460,0,0,1,30752001,30751357,644
34708581,644,644,644,1460,0,0,1,30752645,30752001,644
34710041,644,644,644,1460,0,0,1,30753289,30752645,644
34711501,644,644,644,1460,0,0,1,30753933,30753289,644
34712961,644,644,644,1460,0,0,1,30754577,30753933,644
34714421,644,644,644,1460,0,0,1,30755221,30754577,644
34715881,644,644,644,1460,0,0,1,30755865,30755221,644
34717341,644,644,644,1460,0,0,1,30756509,30755865,644
34718801,644,644,644,1460,0,0,1,30757153,30756509,644
34720261,644,644,644,1460,0,0,1,30757797,30757153,644
34721721,644,644,644,1460,0,0,1,30758441,30757797,644
34723181,644,644,644,1460,0,0,1,30759085,30758441,644
34724641,644,644,644,1460,0,0,1,30759729,30759085,644
34726101,644,644,644,1460,0,0,1,30760373,30759729,644
34727561,644,644,644,1460,0,0,1,30761017,30760373,644
34729021,644,644,644,1460,0,0,1,30761661,30761017,644
34730481,644,644,644,1460,0,0,1,30762305,30761661,644
34731941,644,644,644,1460,0,0,1,30762949,30762305,644
34733401,644,644,644,1460,0,0,1,30763593,30762949,644
34734861,644,644,644,1460,0,0,1,30764237,30763593,644
34736321,644,644,644,1460,0,0,1,30764881,30764237,644
34737781,644,644,644,1460,0,0,1,30765525,30764881,644
34739241,644,644,644,1460,0,0,1,30766169,30765525,644
34740701,644,644,644,1460,0,0,1,30766813,30766169,644
34742161,644,644,644,1460,0,0,1,30767457,30766813,644
34743621,644,644,644,1460,0,0,1,30768101,30767457,644
34745081,644,644,644,1460,0,0,1,30768745,30768101,644
34746541,644,644,644,1460,0,0,1,30769389,30768745,644
34748001,644,644,644,1460,0,0,1,30770033,30769389,644
34749461,644,644,644,1460,0,0,1,30770677,30770033,644
34750921,644,644,644,1460,0,0,1,30771321,30770677,644
34752381,644,644,644,1460,0,0,1,30771965,30771321,644
34753841,644,644,644,1460,0,0,1,30772609,30771965,644
34755301,644,644,644,1460,0,0,1,30773253,30772609,644
34756761,644,644,644,1460,0,0,1,30773897,30773253,644
34758221,644,644,644,1460,0,0,1,30774541,30773897,644
34759681,644,644,644,1460,0,0,1,30775185,30774541,644
34761141,644,644,644,1460,0,0,1,30775829,30775185,644
34762601,644,644,644,1460,0,0,1,30776473,30775829,644
34764061,644,644,644,1460,0,0,1,30777117,30776473,644
34765521,644,644,644,1460,0,0,1,30777761,30777117,644
34766981,644,644,644,1460,0,0,1,30778405,30777761,644
34768441,644,644,644,1460,0,0,1,30779049,30778405,644
34769901,644,644,644,1460,0,0,1,30779693,30779049,644
34771361,644,644,644,1460,0,0,1,30780337,30779693,644
34772821,644,644,644,1460,0,0,1,30780981,30780337,644
34774281,644,644,644,1460,0,0,1,30781625,30780981,644
34775741,644,644,644,1460,0,0,1,30782269,30781625,644
34777201,644,644,644,1460,0,0,1,30782913,30782269,644
34778661,644,644,644,1460,0,0,1,30783557,30782913,644
34780121,644,644,644,1460,0,0,1,30784201,30783557,644
34781581,644,644,644,1460,0,0,1,30784845,30784201,644
34783041,644,644,644,1460,0,0,1,30785489,30784845,644
34784501,644,644,644,1460,0,0,1,30786133,30785489,644
34785961,644,644,644,1460,0,0,1,30786777,30786133,644
34787421,644,644,644,1460,0,0,1,30787421,30786777,644
34788881,644,644,644,1460,0,0,1,30788065,30787421,644
34790341,644,644,644,1460,0,0,1,30788709,30788065,644
34791801,644,644,644,1460,0,0,1,30789353,30788709,644
34793261,644,644,644,1460,0,0,1,30789997,30789353,644
34794721,644,644,644,1460,0,0,1,30790641,30789997,644
34796181,644,644,644,1460,0,0,1,30791285,30790641,644
34797641,644,644,644,1460,0,0,1,30791929,30791285,644
34799101,644,644,644,1460,0,0,1,30792573,30791929,644
34800561,644,644,644,1460,0,0,1,30793217,30792573,644
34802021,644,644,644,1460,0,0,1,30793861,30793217,644
34803481,644,644,644,1460,0,0,1,30794505,30793861,644
34804941,644,644,644,1460,0,0,1,30795149,30794505,644
34806401,644,644,644,1460,0,0,1,30795793,30795149,644
34807861,644,644,644,1460,0,0,1,30796437,30795793,644
34809321,644,644,644,1460,0,0,1,30797081,30796437,644
34810781,644,644,644,1460,0,0,1,30797725,30797081,644
34812241,644,644,644,1460,0,0,1,30798369,30797725,644
34813701,644,644,644,1460,0,0,1,30799013,30798369,644
34815161,644,644,644,1460,0,0,1,30799657,30799013,644
34816621,644,644,644,1460,0,0,1,30800301,30799657,644
34818081,644,644,644,1460,0,0,1,30800945,30800301,644
34819541,644,644,644,1460,0,0,1,30801589,30800945,644
34821001,644,644,644,1460,0,0,1,30802233,30801589,644
34822461,644,644,644,1460,0,0,1,30802877,30802233,644
34823921,644,644,644,1460,0,0,1,30803521,30802877,644
34825381,644,644,644,1460,0,0,1,30804165,30803521,644
34826841,644,644,644,1460,0,0,1,30804809,30804165,644
34828301,644,644,644,1460,0,0,1,30805453,30804809,644
34829761,644,644,644,1460,0,0,1,30806097,30805453,644
34831221,644,644,644,1460,0,0,1,30806741,30806097,644
34832681,644,644,644,1460,0,0,1,30807385,30806741,644
34834141,644,644,644,1460,0,0,1,30808029,30807385,644
34835601,644,644,644,1460,0,0,1,30808673,30808029,644
34837061,644,644,644,1460,0,0,1,30809317,30808673,644
34838521,644,644,644,1460,0,0,1,30809961,30809317,644
34839981,644,644,644,1460,0,0,1,30810605,30809961,644
34841441,644,644,644,1460,0,0,1,30811249,30810605,644
34842901,644,644,644,1460,0,0,1,30811893,30811249,644
34844361,644,644,644,1460,0,0,1,30812537,30811893,644
34845821,644,644,644,1460,0,0,1,30813181,30812537,644
34847281,644,644,644,1460,0,0,1,30813825,30813181,644
34848741,644,644,644,1460,0,0,1,30814469,30813825,644
34850201,644,644,644,1460,0,0,1,30815113,30814469,644
34851661,644,644,644,1460,0,0,1,30815757,30815113,644
34853121,644,644,644,1460,0,0,1,30816401,30815757,644
34854581,644,644,644,1460,0,0,1,30817045,30816401,644
34856041,644,644,644,1460,0,0,1,30817689,30817045,644
34857501,644,644,644,1460,0,0,1,30818333,30817689,644
34858961,644,644,644,1460,0,0,1,30818977,30818333,644
34860421,644,644,644,1460,0,0,1,30819621,30818977,644
34861881,644,644,644,1460,0,0,1,30820265,30819621,644
34863341,644,644,644,1460,0,0,1,30820909,30820265,644
34864801,644,644,644,1460,0,0,1,30821553,30820909,644
34866261,644,644,644,1460,0,0,1,30822197,30821553,644
34867721,644,644,644,1460,0,0,1,30822841,30822197,644
34869181,644,644,644,1460,0,0,1,30823485,30822841,644
34870641,644,644,644,1460,0,0,1,30824129,30823485,644
34872101,644,644,644,1460,0,0,1,30824773,30824129,644
34873561,644,644,644,1460,0,0,1,30825417,30824773,644
34875021,644,644,644,1460,0,0,1,30826061,30825417,644
34876481,644,644,644,1460,0,0,1,30826705,30826061,644
34877941,644,644,644,1460,0,0,1,30827349,30826705,644
34879401,644,644,644,1460,0,0,1,30827993,30827349,644
34880861,644,644,644,1460,0,0,1,30828637,30827993,644
34882321,644,644,644,1460,0,0,1,30829281,30828637,644
34883781,644,644,644,1460,0,0,1,30829925,30829281,644
34885241,644,644,644,1460,0,0,1,30830569,30829925,644
34886701,644,644,644,1460,0,0,1,30831213,30830569,644
34888161,644,644,644,1460,0,0,1,30831857,30831213,644
34889621,644,644,644,1460,0,0,1,30832501,30831857,644
34891081,644,644,644,1460,0,0,1,30833145,30832501,644
34892541,644,644,644,1460,0,0,1,30833789,30833145,644
34894001,644,644,644,1460,0,0,1,30834433,30833789,644
34895461,644,644,644,1460,0,0,1,30835077,30834433,644
34896921,644,644,644,1460,0,0,1,30835721,30835077,644
34898381,644,644,644,1460,0,0,1,30836365,30835721,644
34899841,644,644,644,1460,0,0,1,30837009,30836365,644
34901301,644,644,644,1460,0,0,1,30837653,30837009,644
34902761,644,644,644,1460,0,0,1,30838297,30837653,644
34904221,644,644,644,1460,0,0,1,30838941,30838297,644
34905681,644,644,644,1460,0,0,1,30839585,30838941,644
34907141,644,644,644,1460,0,0,1,30840229,30839585,644
34908601,644,644,644,1460,0,0,1,30840873,30840229,644
34910061,644,644,644,1460,0,0,1,30841517,30840873,644
34911521,644,644,644,1460,0,0,1,30842161,30841517,644
34912981,644,644,644,1460,0,0,1,30842805,30842161,644
34914441,644,644,644,1460,0,0,1,30843449,30842805,644
34915901,644,644,644,1460,0,0,1,30844093,30843449,644
34917361,644,644,644,1460,0,0,1,30844737,30844093,644
34918821,644,644,644,1460,0,0,1,30845381,30844737,644
34920281,644,644,644,1460,0,0,1,30846025,30845381,644
34921741,644,644,644,1460,0,0,1,30846669,30846025,644
34923201,644,644,644,1460,0,0,1,30847313,30846669,644
34924661,644,644,644,1460,0,0,1,30847957,30847313,644
34926121,644,644,644,1460,0,0,1,30848601,30847957,644
34927581,644,644,644,1460,0,0,1,30849245,30848601,644
34929041,644,644,644,1460,0,0,1,30849889,30849245,644
34930501,644,644,644,1460,0,0,1,30850533,30849889,644
34931961,644,644,644,1460,0,0,1,30851177,30850533,644
34933421,644,644,644,1460,0,0,1,30851821,30851177,644
34934881,644,644,644,1460,0,0,1,30852465,30851821,644
34936341,644,644,644,1460,0,0,1,30853109,30852465,644
34937801,644,644,644,1460,0,0,1,30853753,30853109,644
34939261,644,644,644,1460,0,0,1,30854397,30853753,644
34940721,644,644,644,1460,0,0,1,30855041,30854397,644
34942181,644,644,644,1460,0,0,1,30855685,30855041,644
34943641,644,644,644,1460,0,0,1,30856329,30855685,644
34945101,644,644,644,1460,0,0,1,30856973,30856329,644
34946561,644,644,644,1460,0,0,1,30857617,30856973,644
34948021,644,644,644,1460,0,0,1,30858261,30857617,644
34949481,644,644,644,1460,0,0,1,30858905,30858261,644
34950941,644,644,644,1460,0,0,1,30859549,30858905,644
34952401,644,644,644,1460,0,0,1,30860193,30859549,644
34953861,644,644,644,1460,0,0,1,30860837,30860193,644
34955321,644,644,644,1460,0,0,1,30861481,30860837,644
34956781,644,644,644,1460,0,0,1,30862125,30861481,644
34958241,644,644,644,1460,0,0,1,30862769,30862125,644
34959701,644,644,644,1460,0,0,1,30863413,30862769,644
34961161,644,644,644,1460,0,0,1,30864057,30863413,644
34962621,644,644,644,1460,0,0,1,30864701,30864057,644
34964081,644,644,644,1460,0,0,1,30865345,30864701,644
34965541,644,644,644,1460,0,0,1,30865989,30865345,644
34967001,644,644,644,1460,0,0,1,30866633,30865989,644
34968461,644,644,644,1460,0,0,1,30867277,30866633,644
34969921,644,644,644,1460,0,0,1,30867921,30867277,644
34971381,644,644,644,1460,0,0,1,30868565,30867921,644
34972841,644,644,644,1460,0,0,1,30869209,30868565,644
34974301,644,644,644,1460,0,0,1,30869853,30869209,644
34975761,644,644,644,1460,0,0,1,30870497,30869853,644
34977221,644,644,644,1460,0,0,1,30871141,30870497,644
34978681,644,644,644,1460,0,0,1,30871785,30871141,644
34980141,644,644,644,1460,0,0,1,30872429,30871785,644
34981601,644,644,644,1460,0,0,1,30873073,30872429,644
34983061,644,644,644,1460,0,0,1,30873717,30873073,644
34984521,644,644,644,1460,0,0,1,30874361,30873717,644
34985981,644,644,644,1460,0,0,1,30875005,30874361,644
34987441,644,644,644,1460,0,0,1,30875649,30875005,644
34988901,644,644,644,1460,0,0,1,30876293,30875649,644
34990361,644,644,644,1460,0,0,1,30876937,30876293,644
34991821,644,644,644,1460,0,0,1,30877581,30876937,644
34993281,644,644,644,1460,0,0,1,30878225,30877581,644
34994741,644,644,644,1460,0,0,1,30878869,30878225,644
34996201,644,644,644,1460,0,0,1,30879513,30878869,644
34997661,644,644,644,1460,0,0,1,30880157,30879513,644
34999121,644,644,644,1460,0,0,1,30880801,30880157,644
35000581,644,644,644,1460,0,0,1,30881445,30880801,644
35002041,644,644,644,1460,0,0,1,30882089,30881445,644
35003501,644,644,644,1460,0,0,1,30882733,30882089,644
35004961,644,644,644,1460,0,0,1,30883377,30882733,644
35006421,644,644,644,1460,0,0,1,30884021,30883377,644
35007881,644,644,644,1460,0,0,1,30884665,30884021,644
35009341,644,644,644,1460,0,0,1,30885309,30884665,644
35010801,644,644,644,1460,0,0,1,30885953,30885309,644
35012261,644,644,644,1460,0,0,1,30886597,30885953,644
35013721,644,644,644,1460,0,0,1,30887241,30886597,644
35015181,644,644,644,1460,0,0,1,30887885,30887241,644
35016641,644,644,644,1460,0,0,1,30888529,30887885,644
35018101,644,644,644,1460,0,0,1,30889173,30888529,644
35019561,644,644,644,1460,0,0,1,30889817,30889173,644
35021021,644,644,644,1460,0,0,1,30890461,30889817,644
35022481,644,644,644,1460,0,0,1,30891105,30890461,644
35023941,644,644,644,1460,0,0,1,30891749,30891105,644
35025401,644,644,644,1460,0,0,1,30892393,30891749,644
35026861,644,644,644,1460,0,0,1,30893037,30892393,644
35028321,644,644,644,1460,0,0,1,30893681,30893037,644
35029781,644,644,644,1460,0,0,1,30894325,30893681,644
35031241,644,644,644,1460,0,0,1,30894969,30894325,644
35032701,644,644,644,1460,0,0,1,30895613,30894969,644
35034161,644,644,644,1460,0,0,1,30896257,30895613,644
35035621,644,644,644,1460,0,0,1,30896901,30896257,644
35037081,644,644,644,1460,0,0,1,30897545,30896901,644
35038541,644,644,644,1460,0,0,1,30898189,30897545,644
35040001,644,644,644,1460,0,0,1,30898833,30898189,644
35041461,644,644,644,1460,0,0,1,30899477,30898833,644
35042921,644,644,644,1460,0,0,1,30900121,30899477,644
35044381,644,644,644,1460,0,0,1,30900765,30900121,644
35045841,644,644,644,1460,0,0,1,30901409,30900765,644
35047301,644,644,644,1460,0,0,1,30902053,30901409,644
35048761,644,644,644,1460,0,0,1,30902697,30902053,644
35050221,644,644,644,1460,0,0,1,30903341,30902697,644
35051681,644,644,644,1460,0,0,1,30903985,30903341,644
35053141,644,644,644,1460,0,0,1,30904629,30903985,644
35054601,644,644,644,1460,0,0,1,30905273,30904629,644
35056061,644,644,644,1460,0,0,1,30905917,30905273,644
35057521,644,644,644,1460,0,0,1,30906561,30905917,644
35058981,644,644,644,1460,0,0,1,30907205,30906561,644
35060441,644,644,644,1460,0,0,1,30907849,30907205,644
35061901,644,644,644,1460,0,0,1,30908493,30907849,644
35063361,644,644,644,1460,0,0,1,30909137,30908493,644
35064821,644,644,644,1460,0,0,1,30909781,30909137,644
35066281,644,644,644,1460,0,0,1,30910425,30909781,644
35067741,644,644,644,1460,0,0,1,30911069,30910425,644
35069201,644,644,644,1460,0,0,1,30911713,30911069,644
35070661,644,644,644,1460,0,0,1,30912357,30911713,644
35072121,644,644,644,1460,0,0,1,30913001,30912357,644
35073581,644,644,644,1460,0,0,1,30913645,30913001,644
35075041,644,644,644,1460,0,0,1,30914289,30913645,644
35076501,644,644,644,1460,0,0,1,30914933,30914289,644
35077961,644,644,644,1460,0,0,1,30915577,30914933,644
35079421,644,644,644,1460,0,0,1,30916221,30915577,644
35080881,644,644,644,1460,0,0,1,30916865,30916221,644
35082341,644,644,644,1460,0,0,1,30917509,30916865,644
35083801,644,644,644,1460,0,0,1,30918153,30917509,644
35085261,644,644,644,1460,0,0,1,30918797,30918153,644
35086721,644,644,644,1460,0,0,1,30919441,30918797,644
35088181,644,644,644,1460,0,0,1,30920085,30919441,644
35089641,644,644,644,1460,0,0,1,30920729,30920085,644
35091101,644,644,644,1460,0,0,1,30921373,30920729,644
35092561,644,644,644,1460,0,0,1,30922017,30921373,644
35094021,644,644,644,1460,0,0,1,30922661,30922017,644
35095481,644,644,644,1460,0,0,1,30923305,30922661,644
35096941,644,644,644,1460,0,0,1,30923949,30923305,644
35098401,644,644,644,1460,0,0,1,30924593,30923949,644
35099861,644,644,644,1460,0,0,1,30925237,30924593,644
35101321,644,644,644,1460,0,0,1,30925881,30925237,644
35102781,644,644,644,1460,0,0,1,30926525,30925881,644
35104241,644,644,644,1460,0,0,1,30927169,30926525,644
35105701,644,644,644,1460,0,0,1,30927813,30927169,644
35107161,644,644,644,1460,0,0,1,30928457,30927813,644
35108621,644,644,644,1460,0,0,1,30929101,30928457,644
35110081,644,644,644,1460,0,0,1,30929745,30929101,644
35111541,644,644,644,1460,0,0,1,30930389,30929745,644
35113001,644,644,644,1460,0,0,1,30931033,30930389,644
35114461,644,644,644,1460,0,0,1,30931677,30931033,644
35115921,644,644,644,1460,0,0,1,30932321,30931677,644
35117381,644,644,644,1460,0,0,1,30932965,30932321,644
35118841,644,644,644,1460,0,0,1,30933609,30932965,644
35120301,644,644,644,1460,0,0,1,30934253,30933609,644
35121761,644,644,644,1460,0,0,1,30934897,30934253,644
35123221,644,644,644,1460,0,0,1,30935541,30934897,644
35124681,644,644,644,1460,0,0,1,30936185,30935541,644
35126141,644,644,644,1460,0,0,1,30936829,30936185,644
35127601,644,644,644,1460,0,0,1,30937473,30936829,644
35129061,644,644,644,1460,0,0,1,30938117,30937473,644
35130521,644,644,644,1460,0,0,1,30938761,30938117,644
35131981,644,644,644,1460,0,0,1,30939405,30938761,644
35133441,644,644,644,1460,0,0,1,30940049,30939405,644
35134901,644,644,644,1460,0,0,1,30940693,30940049,644
35136361,644,644,644,1460,0,0,1,30941337,30940693,644
35137821,644,644,644,1460,0,0,1,30941981,30941337,644
35139281,644,644,644,1460,0,0,1,30942625,30941981,644
35140741,644,644,644,1460,0,0,1,30943269,30942625,644
35142201,644,644,644,1460,0,0,1,30943913,30943269,644
35143661,644,644,644,1460,0,0,1,30944557,30943913,644
35145121,644,644,644,1460,0,0,1,30945201,30944557,644
35146581,644,644,644,1460,0,0,1,30945845,30945201,644
35148041,644,644,644,1460,0,0,1,30946489,30945845,644
35149501,644,644,644,1460,0,0,1,30947133,30946489,644
35150961,644,644,644,1460,0,0,1,30947777,30947133,644
35152421,644,644,644,1460,0,0,1,30948421,30947777,644
35153881,644,644,644,1460,0,0,1,30949065,30948421,644
35155341,644,644,644,1460,0,0,1,30949709,30949065,644
35156801,644,644,644,1460,0,0,1,30950353,30949709,644
35158261,644,644,644,1460,0,0,1,30950997,30950353,644
35159721,644,644,644,1460,0,0,1,30951641,30950997,644
35161181,644,644,644,1460,0,0,1,30952285,30951641,644
35162641,644,644,644,1460,0,0,1,30952929,30952285,644
35164101,644,644,644,1460,0,0,1,30953573,30952929,644
35165561,644,644,644,1460,0,0,1,30954217,30953573,644
35167021,644,644,644,1460,0,0,1,30954861,30954217,644
35168481,644,644,644,1460,0,0,1,30955505,30954861,644
35169941,644,644,644,1460,0,0,1,30956149,30955505,644
35171401,644,644,644,1460,0,0,1,30956793,30956149,644
35172861,644,644,644,1460,0,0,1,30957437,30956793,644
35174321,644,644,644,1460,0,0,1,30958081,30957437,644
35175781,644,644,644,1460,0,0,1,30958725,30958081,644
35177241,644,644,644,1460,0,0,1,30959369,30958725,644
35178701,644,644,644,1460,0,0,1,30960013,30959369,644
35180161,644,644,644,1460,0,0,1,30960657,30960013,644
35181621,644,644,644,1460,0,0,1,30961301,30960657,644
35183081,644,644,644,1460,0,0,1,30961945,30961301,644
35184541,644,644,644,1460,0,0,1,30962589,30961945,644
35186001,644,644,644,1460,0,0,1,30963233,30962589,644
35187461,644,644,644,1460,0,0,1,30963877,30963233,644
35188921,644,644,644,1460,0,0,1,30964521,30963877,644
35190381,644,644,644,1460,0,0,1,30965165,30964521,644
35191841,644,644,644,1460,0,0,1,30965809,30965165,644
35193301,644,644,644,1460,0,0,1,30966453,30965809,644
35194761,644,644,644,1460,0,0,1,30967097,30966453,644
35196221,644,644,644,1460,0,0,1,30967741,30967097,644
35197681,644,644,644,1460,0,0,1,30968385,30967741,644
35199141,644,644,644,1460,0,0,1,30969029,30968385,644
35200601,644,644,644,1460,0,0,1,30969673,30969029,644
35202061,644,644,644,1460,0,0,1,30970317,30969673,644
35203521,644,644,644,1460,0,0,1,30970961,30970317,644
35204981,644,644,644,1460,0,0,1,30971605,30970961,644
35206441,644,644,644,1460,0,0,1,30972249,30971605,644
35207901,644,644,644,1460,0,0,1,30972893,30972249,644
35209361,644,644,644,1460,0,0,1,30973537,30972893,644
35210821,644,644,644,1460,0,0,1,30974181,30973537,644
35212281,644,644,644,1460,0,0,1,30974825,30974181,644
35213741,644,644,644,1460,0,0,1,30975469,30974825,644
35215201,644,644,644,1460,0,0,1,30976113,30975469,644
35216661,644,644,644,1460,0,0,1,30976757,30976113,644
35218121,644,644,644,1460,0,0,1,30977401,30976757,644
35219581,644,644,644,1460,0,0,1,30978045,30977401,644
35221041,644,644,644,1460,0,0,1,30978689,30978045,644
35222501,644,644,644,1460,0,0,1,30979333,30978689,644
35223961,644,644,644,1460,0,0,1,30979977,30979333,644
35225421,644,644,644,1460,0,0,1,30980621,30979977,644
35226881,644,644,644,1460,0,0,1,30981265,30980621,644
35228341,644,644,644,1460,0,0,1,30981909,30981265,644
35229801,644,644,644,1460,0,0,1,30982553,30981909,644
35231261,644,644,644,1460,0,0,1,30983197,30982553,644
35232721,644,644,644,1460,0,0,1,30983841,30983197,644
35234181,644,644,644,1460,0,0,1,30984485,30983841,644
35235641,644,644,644,1460,0,0,1,30985129,30984485,644
35237101,644,644,644,1460,0,0,1,30985773,30985129,644
35238561,644,644,644,1460,0,0,1,30986417,30985773,644
35240021,644,644,644,1460,0,0,1,30987061,30986417,644
35241481,644,644,644,1460,0,0,1,30987705,30987061,644
35242941,644,644,644,1460,0,0,1,30988349,30987705,644
35244401,644,644,644,1460,0,0,1,30988993,30988349,644
35245861,644,644,644,1460,0,0,1,30989637,30988993,644
35247321,644,644,644,1460,0,0,1,30990281,30989637,644
35248781,644,644,644,1460,0,0,1,30990925,30990281,644
35250241,644,644,644,1460,0,0,1,30991569,30990925,644
35251701,644,644,644,1460,0,0,1,30992213,30991569,644
35253161,644,644,644,1460,0,0,1,30992857,30992213,644
35254621,644,644,644,1460,0,0,1,30993501,30992857,644
35256081,644,644,644,1460,0,0,1,30994145,30993501,644
35257541,644,644,644,1460,0,0,1,30994789,30994145,644
35259001,644,644,644,1460,0,0,1,30995433,30994789,644
35260461,644,644,644,1460,0,0,1,30996077,30995433,644
35261921,644,644,644,1460,0,0,1,30996721,30996077,644
35263381,644,644,644,1460,0,0,1,30997365,30996721,644
35264841,644,644,644,1460,0,0,1,30998009,30997365,644
35266301,644,644,644,1460,0,0,1,30998653,30998009,644
35267761,644,644,644,1460,0,0,1,30999297,30998653,644
35269221,644,644,644,1460,0,0,1,30999941,30999297,644
35270681,644,644,644,1460,0,0,1,31000585,30999941,644
35272141,644,644,644,1460,0,0,1,31001229,31000585,644
35273601,644,644,644,1460,0,0,1,31001873,31001229,644
35275061,644,644,644,1460,0,0,1,31002517,31001873,644
35276521,644,644,644,1460,0,0,1,31003161,31002517,644
35277981,644,644,644,1460,0,0,1,31003805,31003161,644
35279441,644,644,644,1460,0,0,1,31004449,31003805,644
35280901,644,644,644,1460,0,0,1,31005093,31004449,644
35282361,644,644,644,1460,0,0,1,31005737,31005093,644
35283821,644,644,644,1460,0,0,1,31006381,31005737,644
35285281,644,644,644,1460,0,0,1,31007025,31006381,644
35286741,644,644,644,1460,0,0,1,31007669,31007025,644
35288201,644,644,644,1460,0,0,1,31008313,31007669,644
35289661,644,644,644,1460,0,0,1,31008957,31008313,644
35291121,644,644,644,1460,0,0,1,31009601,31008957,644
35292581,644,644,644,1460,0,0,1,31010245,31009601,644
35294041,644,644,644,1460,0,0,1,31010889,31010245,644
35295501,644,644,644,1460,0,0,1,31011533,31010889,644
35296961,644,644,644,1460,0,0,1,31012177,31011533,644
35298421,644,644,644,1460,0,0,1,31012821,31012177,644
35299881,644,644,644,1460,0,0,1,31013465,31012821,644
35301341,644,644,644,1460,0,0,1,31014109,31013465,644
35302801,644,644,644,1460,0,0,1,31014753,31014109,644
35304261,644,644,644,1460,0,0,1,31015397,31014753,644
35305721,644,644,644,1460,0,0,1,31016041,31015397,644
35307181,644,644,644,1460,0,0,1,31016685,31016041,644
35308641,644,644,644,1460,0,0,1,31017329,31016685,644
35310101,644,644,644,1460,0,0,1,31017973,31017329,644
35311561,644,644,644,1460,0,0,1,31018617,31017973,644
35313021,644,644,644,1460,0,0,1,31019261,31018617,644
35314481,644,644,644,1460,0,0,1,31019905,31019261,644
35315941,644,644,644,1460,0,0,1,31020549,31019905,644
35317401,644,644,644,1460,0,0,1,31021193,31020549,644
35318861,644,644,644,1460,0,0,1,31021837,31021193,644
35320321,644,644,644,1460,0,0,1,31022481,31021837,644
35321781,644,644,644,1460,0,0,1,31023125,31022481,644
35323241,644,644,644,1460,0,0,1,31023769,31023125,644
35324701,644,644,644,1460,0,0,1,31024413,31023769,644
35326161,644,644,644,1460,0,0,1,31025057,31024413,644
35327621,644,644,644,1460,0,0,1,31025701,31025057,644
35329081,644,644,644,1460,0,0,1,31026345,31025701,644
35330541,644,644,644,1460,0,0,1,31026989,31026345,644
35332001,644,644,644,1460,0,0,1,31027633,31026989,644
35333461,644,644,644,1460,0,0,1,31028277,31027633,644
35334921,644,644,644,1460,0,0,1,31028921,31028277,644
35336381,644,644,644,1460,0,0,1,31029565,31028921,644
35337841,644,644,644,1460,0,0,1,31030209,31029565,644
35339301,644,644,644,1460,0,0,1,31030853,31030209,644
35340761,644,644,644,1460,0,0,1,31031497,31030853,644
35342221,644,644,644,1460,0,0,1,31032141,31031497,644
35343681,644,644,644,1460,0,0,1,31032785,31032141,644
35345141,644,644,644,1460,0,0,1,31033429,31032785,644
35346601,644,644,644,1460,0,0,1,31034073,31033429,644
35348061,644,644,644,1460,0,0,1,31034717,31034073,644
35349521,644,644,644,1460,0,0,1,31035361,31034717,644
35350981,644,644,644,1460,0,0,1,31036005,31035361,644
35352441,644,644,644,1460,0,0,1,31036649,31036005,644
35353901,644,644,644,1460,0,0,1,31037293,31036649,644
35355361,644,644,644,1460,0,0,1,31037937,31037293,644
35356821,644,644,644,1460,0,0,1,31038581,31037937,644
35358281,644,644,644,1460,0,0,1,31039225,31038581,644
35359741,644,644,644,1460,0,0,1,31039869,31039225,644
35361201,644,644,644,1460,0,0,1,31040513,31039869,644
35362661,644,644,644,1460,0,0,1,31041157,31040513,644
35364121,644,644,644,1460,0,0,1,31041801,31041157,644
35365581,644,644,644,1460,0,0,1,31042445,31041801,644
35367041,644,644,644,1460,0,0,1,31043089,31042445,644
35368501,644,644,644,1460,0,0,1,31043733,31043089,644
35369961,644,644,644,1460,0,0,1,31044377,31043733,644
35371421,644,644,644,1460,0,0,1,31045021,31044377,644
35372881,644,644,644,1460,0,0,1,31045665,31045021,644
35374341,644,644,644,1460,0,0,1,31046309,31045665,644
35375801,644,644,644,1460,0,0,1,31046953,31046309,644
35377261,644,644,644,1460,0,0,1,31047597,31046953,644
35378721,644,644,644,1460,0,0,1,31048241,31047597,644
35380181,644,644,644,1460,0,0,1,31048885,31048241,644
35381641,644,644,644,1460,0,0,1,31049529,31048885,644
35383101,644,644,644,1460,0,0,1,31050173,31049529,644
35384561,644,644,644,1460,0,0,1,31050817,31050173,644
35386021,644,644,644,1460,0,0,1,31051461,31050817,644
35387481,644,644,644,1460,0,0,1,31052105,31051461,644
35388941,644,644,644,1460,0,0,1,31052749,31052105,644
35390401,644,644,644,1460,0,0,1,31053393,31052749,644
35391861,644,644,644,1460,0,0,1,31054037,31053393,644
35393321,644,644,644,1460,0,0,1,31054681,31054037,644
35394781,644,644,644,1460,0,0,1,31055325,31054681,644
35396241,644,644,644,1460,0,0,1,31055969,31055325,644
35397701,644,644,644,1460,0,0,1,31056613,31055969,644
35399161,644,644,644,1460,0,0,1,31057257,31056613,644
35400621,644,644,644,1460,0,0,1,31057901,31057257,644
35402081,644,644,644,1460,0,0,1,31058545,31057901,644
35403541,644,644,644,1460,0,0,1,31059189,31058545,644
35405001,644,644,644,1460,0,0,1,31059833,31059189,644
35406461,644,644,644,1460,0,0,1,31060477,31059833,644
35407921,644,644,644,1460,0,0,1,31061121,31060477,644
35409381,644,644,644,1460,0,0,1,31061765,31061121,644
35410841,644,644,644,1460,0,0,1,31062409,31061765,644
35412301,644,644,644,1460,0,0,1,31063053,31062409,644
35413761,644,644,644,1460,0,0,1,31063697,31063053,644
35415221,644,644,644,1460,0,0,1,31064341,31063697,644
35416681,644,644,644,1460,0,0,1,31064985,31064341,644
35418141,644,644,644,1460,0,0,1,31065629,31064985,644
35419601,644,644,644,1460,0,0,1,31066273,31065629,644
35421061,644,644,644,1460,0,0,1,31066917,31066273,644
35422521,644,644,644,1460,0,0,1,31067561,31066917,644
35423981,644,644,644,1460,0,0,1,31068205,31067561,644
35425441,644,644,644,1460,0,0,1,31068849,31068205,644
35426901,644,644,644,1460,0,0,1,31069493,31068849,644
35428361,644,644,644,1460,0,0,1,31070137,31069493,644
35429821,644,644,644,1460,0,0,1,31070781,31070137,644
35431281,644,644,644,1460,0,0,1,31071425,31070781,644
35432741,644,644,644,1460,0,0,1,31072069,31071425,644
35434201,644,644,644,1460,0,0,1,31072713,31072069,644
35435661,644,644,644,1460,0,0,1,31073357,31072713,644
35437121,644,644,644,1460,0,0,1,31074001,31073357,644
35438581,644,644,644,1460,0,0,1,31074645,31074001,644
35440041,644,644,644,1460,0,0,1,31075289,31074645,644
35441501,644,644,644,1460,0,0,1,31075933,31075289,644
35442961,644,644,644,1460,0,0,1,31076577,31075933,644
35444421,644,644,644,1460,0,0,1,31077221,31076577,644
35445881,644,644,644,1460,0,0,1,31077865,31077221,644
35447341,644,644,644,1460,0,0,1,31078509,31077865,644
35448801,644,644,644,1460,0,0,1,31079153,31078509,644
35450261,644,644,644,1460,0,0,1,31079797,31079153,644
35451721,644,644,644,1460,0,0,1,31080441,31079797,644
35453181,644,644,644,1460,0,0,1,31081085,31080441,644
35454641,644,644,644,1460,0,0,1,31081729,31081085,644
35456101,644,644,644,1460,0,0,1,31082373,31081729,644
35457561,644,644,644,1460,0,0,1,31083017,31082373,644
35459021,644,644,644,1460,0,0,1,31083661,31083017,644
35460481,644,644,644,1460,0,0,1,31084305,31083661,644
35461941,644,644,644,1460,0,0,1,31084949,31084305,644
35463401,644,644,644,1460,0,0,1,31085593,31084949,644
35464861,644,644,644,1460,0,0,1,31086237,31085593,644
35466321,644,644,644,1460,0,0,1,31086881,31086237,644
35467781,644,644,644,1460,0,0,1,31087525,31086881,644
35469241,644,644,644,1460,0,0,1,31088169,31087525,644
35470701,644,644,644,1460,0,0,1,31088813,31088169,644
35472161,644,644,644,1460,0,0,1,31089457,31088813,644
35473621,644,644,644,1460,0,0,1,31090101,31089457,644
35475081,644,644,644,1460,0,0,1,31090745,31090101,644
35476541,644,644,644,1460,0,0,1,31091389,31090745,644
35478001,644,644,644,1460,0,0,1,31092033,31091389,644
35479461,644,644,644,1460,0,0,1,31092677,31092033,644
35480921,644,644,644,1460,0,0,1,31093321,31092677,644
35482381,644,644,644,1460,0,0,1,31093965,31093321,644
35483841,644,644,644,1460,0,0,1,31094609,31093965,644
35485301,644,644,644,1460,0,0,1,31095253,31094609,644
35486761,644,644,644,1460,0,0,1,31095897,31095253,644
35488221,644,644,644,1460,0,0,1,31096541,31095897,644
35489681,644,644,644,1460,0,0,1,31097185,31096541,644
35491141,644,644,644,1460,0,0,1,31097829,31097185,644
35492601,644,644,644,1460,0,0,1,31098473,31097829,644
35494061,644,644,644,1460,0,0,1,31099117,31098473,644
35495521,644,644,644,1460,0,0,1,31099761,31099117,644
35496981,644,644,644,1460,0,0,1,31100405,31099761,644
35498441,644,644,644,1460,0,0,1,31101049,31100405,644
35499901,644,644,644,1460,0,0,1,31101693,31101049,644
35501361,644,644,644,1460,0,0,1,31102337,31101693,644
35502821,644,644,644,1460,0,0,1,31102981,31102337,644
35504281,644,644,644,1460,0,0,1,31103625,31102981,644
35505741,644,644,644,1460,0,0,1,31104269,31103625,644
35507201,644,644,644,1460,0,0,1,31104913,31104269,644
35508661,644,644,644,1460,0,0,1,31105557,31104913,644
35510121,644,644,644,1460,0,0,1,31106201,31105557,644
35511581,644,644,644,1460,0,0,1,31106845,31106201,644
35513041,644,644,644,1460,0,0,1,31107489,31106845,644
35514501,644,644,644,1460,0,0,1,31108133,31107489,644
35515961,644,644,644,1460,0,0,1,31108777,31108133,644
35517421,644,644,644,1460,0,0,1,31109421,31108777,644
35518881,644,644,644,1460,0,0,1,31110065,31109421,644
35520341,644,644,644,1460,0,0,1,31110709,31110065,644
35521801,644,644,644,1460,0,0,1,31111353,31110709,644
35523261,644,644,644,1460,0,0,1,31111997,31111353,644
35524721,644,644,644,1460,0,0,1,31112641,31111997,644
35526181,644,644,644,1460,0,0,1,31113285,31112641,644
35527641,644,644,644,1460,0,0,1,31113929,31113285,644
35529101,644,644,644,1460,0,0,1,31114573,31113929,644
35530561,644,644,644,1460,0,0,1,31115217,31114573,644
35532021,644,644,644,1460,0,0,1,31115861,31115217,644
35533481,644,644,644,1460,0,0,1,31116505,31115861,644
35534941,644,644,644,1460,0,0,1,31117149,31116505,644
35536401,644,644,644,1460,0,0,1,31117793,31117149,644
35537861,644,644,644,1460,0,0,1,31118437,31117793,644
35539321,644,644,644,1460,0,0,1,31119081,31118437,644
35540781,644,644,644,1460,0,0,1,31119725,31119081,644
35542241,644,644,644,1460,0,0,1,31120369,31119725,644
35543701,644,644,644,1460,0,0,1,31121013,31120369,644
35545161,644,644,644,1460,0,0,1,31121657,31121013,644
35546621,644,644,644,1460,0,0,1,31122301,31121657,644
35548081,644,644,644,1460,0,0,1,31122945,31122301,644
35549541,644,644,644,1460,0,0,1,31123589,31122945,644
35551001,644,644,644,1460,0,0,1,31124233,31123589,644
35552461,644,644,644,1460,0,0,1,31124877,31124233,644
35553921,644,644,644,1460,0,0,1,31125521,31124877,644
35555381,644,644,644,1460,0,0,1,31126165,31125521,644
35556841,644,644,644,1460,0,0,1,31126809,31126165,644
35558301,644,644,644,1460,0,0,1,31127453,31126809,644
35559761,644,644,644,1460,0,0,1,31128097,31127453,644
35561221,644,644,644,1460,0,0,1,31128741,31128097,644
35562681,644,644,644,1460,0,0,1,31129385,31128741,644
35564141,644,644,644,1460,0,0,1,31130029,31129385,644
35565601,644,644,644,1460,0,0,1,31130673,31130029,644
35567061,644,644,644,1460,0,0,1,31131317,31130673,644
35568521,644,644,644,1460,0,0,1,31131961,31131317,644
35569981,644,644,644,1460,0,0,1,31132605,31131961,644
35571441,644,644,644,1460,0,0,1,31133249,31132605,644
35572901,644,644,644,1460,0,0,1,31133893,31133249,644
35574361,644,644,644,1460,0,0,1,31134537,31133893,644
35575821,644,644,644,1460,0,0,1,31135181,31134537,644
35577281,644,644,644,1460,0,0,1,31135825,31135181,644
35578741,644,644,644,1460,0,0,1,31136469,31135825,644
35580201,644,644,644,1460,0,0,1,31137113,31136469,644
35581661,644,644,644,1460,0,0,1,31137757,31137113,644
35583121,644,644,644,1460,0,0,1,31138401,31137757,644
35584581,644,644,644,1460,0,0,1,31139045,31138401,644
35586041,644,644,644,1460,0,0,1,31139689,31139045,644
35587501,644,644,644,1460,0,0,1,31140333,31139689,644
35588961,644,644,644,1460,0,0,1,31140977,31140333,644
35590421,644,644,644,1460,0,0,1,31141621,31140977,644
35591881,644,644,644,1460,0,0,1,31142265,31141621,644
35593341,644,644,644,1460,0,0,1,31142909,31142265,644
35594801,644,644,644,1460,0,0,1,31143553,31142909,644
35596261,644,644,644,1460,0,0,1,31144197,31143553,644
35597721,644,644,644,1460,0,0,1,31144841,31144197,644
35599181,644,644,644,1460,0,0,1,31145485,31144841,644
35600641,644,644,644,1460,0,0,1,31146129,31145485,644
35602101,644,644,644,1460,0,0,1,31146773,31146129,644
35603561,644,644,644,1460,0,0,1,31147417,31146773,644
35605021,644,644,644,1460,0,0,1,31148061,31147417,644
35606481,644,644,644,1460,0,0,1,31148705,31148061,644
35607941,644,644,644,1460,0,0,1,31149349,31148705,644
35609401,644,644,644,1460,0,0,1,31149993,31149349,644
35610861,644,644,644,1460,0,0,1,31150637,31149993,644
35612321,644,644,644,1460,0,0,1,31151281,31150637,644
35613781,644,644,644,1460,0,0,1,31151925,31151281,644
35615241,644,644,644,1460,0,0,1,31152569,31151925,644
35616701,644,644,644,1460,0,0,1,31153213,31152569,644
35618161,644,644,644,1460,0,0,1,31153857,31153213,644
35619621,644,644,644,1460,0,0,1,31154501,31153857,644
35621081,644,644,644,1460,0,0,1,31155145,31154501,644
35622541,644,644,644,1460,0,0,1,31155789,31155145,644
35624001,644,644,644,1460,0,0,1,31156433,31155789,644
35625461,644,644,644,1460,0,0,1,31157077,31156433,644
35626921,644,644,644,1460,0,0,1,31157721,31157077,644
35628381,644,644,644,1460,0,0,1,31158365,31157721,644
35629841,644,644,644,1460,0,0,1,31159009,31158365,644
35631301,644,644,644,1460,0,0,1,31159653,31159009,644
35632761,644,644,644,1460,0,0,1,31160297,31159653,644
35634221,644,644,644,1460,0,0,1,31160941,31160297,644
35635681,644,644,644,1460,0,0,1,31161585,31160941,644
35637141,644,644,644,1460,0,0,1,31162229,31161585,644
35638601,644,644,644,1460,0,0,1,31162873,31162229,644
35640061,644,644,644,1460,0,0,1,31163517,31162873,644
35641521,644,644,644,1460,0,0,1,31164161,31163517,644
35642981,644,644,644,1460,0,0,1,31164805,31164161,644
35644441,644,644,644,1460,0,0,1,31165449,31164805,644
35645901,644,644,644,1460,0,0,1,31166093,31165449,644
35647361,644,644,644,1460,0,0,1,31166737,31166093,644
35648821,644,644,644,1460,0,0,1,31167381,31166737,644
35650281,644,644,644,1460,0,0,1,31168025,31167381,644
35651741,644,644,644,1460,0,0,1,31168669,31168025,644
35653201,644,644,644,1460,0,0,1,31169313,31168669,644
35654661,644,644,644,1460,0,0,1,31169957,31169313,644
35656121,644,644,644,1460,0,0,1,31170601,31169957,644
35657581,644,644,644,1460,0,0,1,31171245,31170601,644
35659041,644,644,644,1460,0,0,1,31171889,31171245,644
35660501,644,644,644,1460,0,0,1,31172533,31171889,644
35661961,644,644,644,1460,0,0,1,31173177,31172533,644
35663421,644,644,644,1460,0,0,1,31173821,31173177,644
35664881,644,644,644,1460,0,0,1,31174465,31173821,644
35666341,644,644,644,1460,0,0,1,31175109,31174465,644
35667801,644,644,644,1460,0,0,1,31175753,31175109,644
35669261,644,644,644,1460,0,0,1,31176397,31175753,644
35670721,644,644,644,1460,0,0,1,31177041,31176397,644
35672181,644,644,644,1460,0,0,1,31177685,31177041,644
35673641,644,644,644,1460,0,0,1,31178329,31177685,644
35675101,644,644,644,1460,0,0,1,31178973,31178329,644
35676561,644,644,644,1460,0,0,1,31179617,31178973,644
35678021,644,644,644,1460,0,0,1,31180261,31179617,644
35679481,644,644,644,1460,0,0,1,31180905,31180261,644
35680941,644,644,644,1460,0,0,1,31181549,31180905,644
35682401,644,644,644,1460,0,0,1,31182193,31181549,644
35683861,644,644,644,1460,0,0,1,31182837,31182193,644
35685321,644,644,644,1460,0,0,1,31183481,31182837,644
35686781,644,644,644,1460,0,0,1,31184125,31183481,644
35688241,644,644,644,1460,0,0,1,31184769,31184125,644
35689701,644,644,644,1460,0,0,1,31185413,31184769,644
35691161,644,644,644,1460,0,0,1,31186057,31185413,644
35692621,644,644,644,1460,0,0,1,31186701,31186057,644
35694081,644,644,644,1460,0,0,1,31187345,31186701,644
35695541,644,644,644,1460,0,0,1,31187989,31187345,644
35697001,644,644,644,1460,0,0,1,31188633,31187989,644
35698461,644,644,644,1460,0,0,1,31189277,31188633,644
35699921,644,644,644,1460,0,0,1,31189921,31189277,644
35701381,644,644,644,1460,0,0,1,31190565,31189921,644
35702841,644,644,644,1460,0,0,1,31191209,31190565,644
35704301,644,644,644,1460,0,0,1,31191853,31191209,644
35705761,644,644,644,1460,0,0,1,31192497,31191853,644
35707221,644,644,644,1460,0,0,1,31193141,31192497,644
35708681,644,644,644,1460,0,0,1,31193785,31193141,644
35710141,644,644,644,1460,0,0,1,31194429,31193785,644
35711601,644,644,644,1460,0,0,1,31195073,31194429,644
35713061,644,644,644,1460,0,0,1,31195717,31195073,644
35714521,644,644,644,1460,0,0,1,31196361,31195717,644
35715981,644,644,644,1460,0,0,1,31197005,31196361,644
35717441,644,644,644,1460,0,0,1,31197649,31197005,644
35718901,644,644,644,1460,0,0,1,31198293,31197649,644
35720361,644,644,644,1460,0,0,1,31198937,31198293,644
35721821,644,644,644,1460,0,0,1,31199581,31198937,644
35723281,644,644,644,1460,0,0,1,31200225,31199581,644
35724741,644,644,644,1460,0,0,1,31200869,31200225,644
35726201,644,644,644,1460,0,0,1,31201513,31200869,644
35727661,644,644,644,1460,0,0,1,31202157,31201513,644
35729121,644,644,644,1460,0,0,1,31202801,31202157,644
35730581,644,644,644,1460,0,0,1,31203445,31202801,644
35732041,644,644,644,1460,0,0,1,31204089,31203445,644
35733501,644,644,644,1460,0,0,1,31204733,31204089,644
35734961,644,644,644,1460,0,0,1,31205377,31204733,644
35736421,644,644,644,1460,0,0,1,31206021,31205377,644
35737881,644,644,644,1460,0,0,1,31206665,31206021,644
35739341,644,644,644,1460,0,0,1,31207309,31206665,644
35740801,644,644,644,1460,0,0,1,31207953,31207309,644
35742261,644,644,644,1460,0,0,1,31208597,31207953,644
35743721,644,644,644,1460,0,0,1,31209241,31208597,644
35745181,644,644,644,1460,0,0,1,31209885,31209241,644
35746641,644,644,644,1460,0,0,1,31210529,31209885,644
35748101,644,644,644,1460,0,0,1,31211173,31210529,644
35749561,644,644,644,1460,0,0,1,31211817,31211173,644
35751021,644,644,644,1460,0,0,1,31212461,31211817,644
35752481,644,644,644,1460,0,0,1,31213105,31212461,644
35753941,644,644,644,1460,0,0,1,31213749,31213105,644
35755401,644,644,644,1460,0,0,1,31214393,31213749,644
35756861,644,644,644,1460,0,0,1,31215037,31214393,644
35758321,644,644,644,1460,0,0,1,31215681,31215037,644
35759781,644,644,644,1460,0,0,1,31216325,31215681,644
35761241,644,644,644,1460,0,0,1,31216969,31216325,644
35762701,644,644,644,1460,0,0,1,31217613,31216969,644
35764161,644,644,644,1460,0,0,1,31218257,31217613,644
35765621,644,644,644,1460,0,0,1,31218901,31218257,644
35767081,644,644,644,1460,0,0,1,31219545,31218901,644
35768541,644,644,644,1460,0,0,1,31220189,31219545,644
35770001,644,644,644,1460,0,0,1,31220833,31220189,644
35771461,644,644,644,1460,0,0,1,31221477,31220833,644
35772921,644,644,644,1460,0,0,1,31222121,31221477,644
35774381,644,644,644,1460,0,0,1,31222765,31222121,644
35775841,644,644,644,1460,0,0,1,31223409,31222765,644
35777301,644,644,644,1460,0,0,1,31224053,31223409,644
35778761,644,644,644,1460,0,0,1,31224697,31224053,644
35780221,644,644,644,1460,0,0,1,31225341,31224697,644
35781681,644,644,644,1460,0,0,1,31225985,31225341,644
35783141,644,644,644,1460,0,0,1,31226629,31225985,644
35784601,644,644,644,1460,0,0,1,31227273,31226629,644
35786061,644,644,644,1460,0,0,1,31227917,31227273,644
35787521,644,644,644,1460,0,0,1,31228561,31227917,644
35788981,644,644,644,1460,0,0,1,31229205,31228561,644
35790441,644,644,644,1460,0,0,1,31229849,31229205,644
35791901,644,644,644,1460,0,0,1,31230493,31229849,644
35793361,644,644,644,1460,0,0,1,31231137,31230493,644
35794821,644,644,644,1460,0,0,1,31231781,31231137,644
35796281,644,644,644,1460,0,0,1,31232425,31231781,644
35797741,644,644,644,1460,0,0,1,31233069,31232425,644
35799201,644,644,644,1460,0,0,1,31233713,31233069,644
35800661,644,644,644,1460,0,0,1,31234357,31233713,644
35802121,644,644,644,1460,0,0,1,31235001,31234357,644
35803581,644,644,644,1460,0,0,1,31235645,31235001,644
35805041,644,644,644,1460,0,0,1,31236289,31235645,644
35806501,644,644,644,1460,0,0,1,31236933,31236289,644
35807961,644,644,644,1460,0,0,1,31237577,31236933,644
35809421,644,644,644,1460,0,0,1,31238221,31237577,644
35810881,644,644,644,1460,0,0,1,31238865,31238221,644
35812341,644,644,644,1460,0,0,1,31239509,31238865,644
35813801,644,644,644,1460,0,0,1,31240153,31239509,644
35815261,644,644,644,1460,0,0,1,31240797,31240153,644
35816721,644,644,644,1460,0,0,1,31241441,31240797,644
35818181,644,644,644,1460,0,0,1,31242085,31241441,644
35819641,644,644,644,1460,0,0,1,31242729,31242085,644
35821101,644,644,644,1460,0,0,1,31243373,31242729,644
35822561,644,644,644,1460,0,0,1,31244017,31243373,644
35824021,644,644,644,1460,0,0,1,31244661,31244017,644
35825481,644,644,644,1460,0,0,1,31245305,31244661,644
35826941,644,644,644,1460,0,0,1,31245949,31245305,644
35828401,644,644,644,1460,0,0,1,31246593,31245949,644
35829861,644,644,644,1460,0,0,1,31247237,31246593,644
35831321,644,644,644,1460,0,0,1,31247881,31247237,644
35832781,644,644,644,1460,0,0,1,31248525,31247881,644
35834241,644,644,644,1460,0,0,1,31249169,31248525,644
35835701,644,644,644,1460,0,0,1,31249813,31249169,644
35837161,644,644,644,1460,0,0,1,31250457,31249813,644
35838621,644,644,644,1460,0,0,1,31251101,31250457,644
35840081,644,644,644,1460,0,0,1,31251745,31251101,644
35841541,644,644,644,1460,0,0,1,31252389,31251745,644
35843001,644,644,644,1460,0,0,1,31253033,31252389,644
35844461,644,644,644,1460,0,0,1,31253677,31253033,644
35845921,644,644,644,1460,0,0,1,31254321,31253677,644
35847381,644,644,644,1460,0,0,1,31254965,31254321,644
35848841,644,644,644,1460,0,0,1,31255609,31254965,644
35850301,644,644,644,1460,0,0,1,31256253,31255609,644
35851761,644,644,644,1460,0,0,1,31256897,31256253,644
35853221,644,644,644,1460,0,0,1,31257541,31256897,644
35854681,644,644,644,1460,0,0,1,31258185,31257541,644
35856141,644,644,644,1460,0,0,1,31258829,31258185,644
35857601,644,644,644,1460,0,0,1,31259473,31258829,644
35859061,644,644,644,1460,0,0,1,31260117,31259473,644
35860521,644,644,644,1460,0,0,1,31260761,31260117,644
35861981,644,644,644,1460,0,0,1,31261405,31260761,644
35863441,644,644,644,1460,0,0,1,31262049,31261405,644
35864901,644,644,644,1460,0,0,1,31262693,31262049,644
35866361,644,644,644,1460,0,0,1,31263337,31262693,644
35867821,644,644,644,1460,0,0,1,31263981,31263337,644
35869281,644,644,644,1460,0,0,1,31264625,31263981,644
35870741,644,644,644,1460,0,0,1,31265269,31264625,644
35872201,644,644,644,1460,0,0,1,31265913,31265269,644
35873661,644,644,644,1460,0,0,1,31266557,31265913,644
35875121,644,644,644,1460,0,0,1,31267201,31266557,644
35876581,644,644,644,1460,0,0,1,31267845,31267201,644
35878041,644,644,644,1460,0,0,1,31268489,31267845,644
35879501,644,644,644,1460,0,0,1,31269133,31268489,644
35880961,644,644,644,1460,0,0,1,31269777,31269133,644
35882421,644,644,644,1460,0,0,1,31270421,31269777,644
35883881,644,644,644,1460,0,0,1,31271065,31270421,644
35885341,644,644,644,1460,0,0,1,31271709,31271065,644
35886801,644,644,644,1460,0,0,1,31272353,31271709,644
35888261,644,644,644,1460,0,0,1,31272997,31272353,644
35889721,644,644,644,1460,0,0,1,31273641,31272997,644
35891181,644,644,644,1460,0,0,1,31274285,31273641,644
35892641,644,644,644,1460,0,0,1,31274929,31274285,644
35894101,644,644,644,1460,0,0,1,31275573,31274929,644
35895561,644,644,644,1460,0,0,1,31276217,31275573,644
35897021,644,644,644,1460,0,0,1,31276861,31276217,644
35898481,644,644,644,1460,0,0,1,31277505,31276861,644
35899941,644,644,644,1460,0,0,1,31278149,31277505,644
35901401,644,644,644,1460,0,0,1,31278793,31278149,644
35902861,644,644,644,1460,0,0,1,31279437,31278793,644
35904321,644,644,644,1460,0,0,1,31280081,31279437,644
35905781,644,644,644,1460,0,0,1,31280725,31280081,644
35907241,644,644,644,1460,0,0,1,31281369,31280725,644
35908701,644,644,644,1460,0,0,1,31282013,31281369,644
35910161,644,644,644,1460,0,0,1,31282657,31282013,644
35911621,644,644,644,1460,0,0,1,31283301,31282657,644
35913081,644,644,644,1460,0,0,1,31283945,31283301,644
35914541,644,644,644,1460,0,0,1,31284589,31283945,644
35916001,644,644,644,1460,0,0,1,31285233,31284589,644
35917461,644,644,644,1460,0,0,1,31285877,31285233,644
35918921,644,644,644,1460,0,0,1,31286521,31285877,644
35920381,644,644,644,1460,0,0,1,31287165,31286521,644
35921841,644,644,644,1460,0,0,1,31287809,31287165,644
35923301,644,644,644,1460,0,0,1,31288453,31287809,644
35924761,644,644,644,1460,0,0,1,31289097,31288453,644
35926221,644,644,644,1460,0,0,1,31289741,31289097,644
35927681,644,644,644,1460,0,0,1,31290385,31289741,644
35929141,644,644,644,1460,0,0,1,31291029,31290385,644
35930601,644,644,644,1460,0,0,1,31291673,31291029,644
35932061,644,644,644,1460,0,0,1,31292317,31291673,644
35933521,644,644,644,1460,0,0,1,31292961,31292317,644
35934981,644,644,644,1460,0,0,1,31293605,31292961,644
35936441,644,644,644,1460,0,0,1,31294249,31293605,644
35937901,644,644,644,1460,0,0,1,31294893,31294249,644
35939361,644,644,644,1460,0,0,1,31295537,31294893,644
35940821,644,644,644,1460,0,0,1,31296181,31295537,644
35942281,644,644,644,1460,0,0,1,31296825,31296181,644
35943741,644,644,644,1460,0,0,1,31297469,31296825,644
35945201,644,644,644,1460,0,0,1,31298113,31297469,644
35946661,644,644,644,1460,0,0,1,31298757,31298113,644
35948121,644,644,644,1460,0,0,1,31299401,31298757,644
35949581,644,644,644,1460,0,0,1,31300045,31299401,644
35951041,644,644,644,1460,0,0,1,31300689,31300045,644
35952501,644,644,644,1460,0,0,1,31301333,31300689,644
35953961,644,644,644,1460,0,0,1,31301977,31301333,644
35955421,644,644,644,1460,0,0,1,31302621,31301977,644
35956881,644,644,644,1460,0,0,1,31303265,31302621,644
35958341,644,644,644,1460,0,0,1,31303909,31303265,644
35959801,644,644,644,1460,0,0,1,31304553,31303909,644
35961261,644,644,644,1460,0,0,1,31305197,31304553,644
35962721,644,644,644,1460,0,0,1,31305841,31305197,644
35964181,644,644,644,1460,0,0,1,31306485,31305841,644
35965641,644,644,644,1460,0,0,1,31307129,31306485,644
35967101,644,644,644,1460,0,0,1,31307773,31307129,644
35968561,644,644,644,1460,0,0,1,31308417,31307773,644
35970021,644,644,644,1460,0,0,1,31309061,31308417,644
35971481,644,644,644,1460,0,0,1,31309705,31309061,644
35972941,644,644,644,1460,0,0,1,31310349,31309705,644
35974401,644,644,644,1460,0,0,1,31310993,31310349,644
35975861,644,644,644,1460,0,0,1,31311637,31310993,644
35977321,644,644,644,1460,0,0,1,31312281,31311637,644
35978781,644,644,644,1460,0,0,1,31312925,31312281,644
35980241,644,644,644,1460,0,0,1,31313569,31312925,644
35981701,644,644,644,1460,0,0,1,31314213,31313569,644
35983161,644,644,644,1460,0,0,1,31314857,31314213,644
35984621,644,644,644,1460,0,0,1,31315501,31314857,644
35986081,644,644,644,1460,0,0,1,31316145,31315501,644
35987541,644,644,644,1460,0,0,1,31316789,31316145,644
35989001,644,644,644,1460,0,0,1,31317433,31316789,644
35990461,644,644,644,1460,0,0,1,31318077,31317433,644
35991921,644,644,644,1460,0,0,1,31318721,31318077,644
35993381,644,644,644,1460,0,0,1,31319365,31318721,644
35994841,644,644,644,1460,0,0,1,31320009,31319365,644
35996301,644,644,644,1460,0,0,1,31320653,31320009,644
35997761,644,644,644,1460,0,0,1,31321297,31320653,644
35999221,644,644,644,1460,0,0,1,31321941,31321297,644
36000681,644,644,644,1460,0,0,1,31322585,31321941,644
36002141,644,644,644,1460,0,0,1,31323229,31322585,644
36003601,644,644,644,1460,0,0,1,31323873,31323229,644
36005061,644,644,644,1460,0,0,1,31324517,31323873,644
36006521,644,644,644,1460,0,0,1,31325161,31324517,644
36007981,644,644,644,1460,0,0,1,31325805,31325161,644
36009441,644,644,644,1460,0,0,1,31326449,31325805,644
36010901,644,644,644,1460,0,0,1,31327093,31326449,644
36012361,644,644,644,1460,0,0,1,31327737,31327093,644
36013821,644,644,644,1460,0,0,1,31328381,31327737,644
36015281,644,644,644,1460,0,0,1,31329025,31328381,644
36016741,644,644,644,1460,0,0,1,31329669,31329025,644
36018201,644,644,644,1460,0,0,1,31330313,31329669,644
36019661,644,644,644,1460,0,0,1,31330957,31330313,644
36021121,644,644,644,1460,0,0,1,31331601,31330957,644
36022581,644,644,644,1460,0,0,1,31332245,31331601,644
36024041,644,644,644,1460,0,0,1,31332889,31332245,644
36025501,644,644,644,1460,0,0,1,31333533,31332889,644
36026961,644,644,644,1460,0,0,1,31334177,31333533,644
36028421,644,644,644,1460,0,0,1,31334821,31334177,644
36029881,644,644,644,1460,0,0,1,31335465,31334821,644
36031341,644,644,644,1460,0,0,1,31336109,31335465,644
36032801,644,644,644,1460,0,0,1,31336753,31336109,644
36034261,644,644,644,1460,0,0,1,31337397,31336753,644
36035721,644,644,644,1460,0,0,1,31338041,31337397,644
36037181,644,644,644,1460,0,0,1,31338685,31338041,644
36038641,644,644,644,1460,0,0,1,31339329,31338685,644
36040101,644,644,644,1460,0,0,1,31339973,31339329,644
36041561,644,644,644,1460,0,0,1,31340617,31339973,644
36043021,644,644,644,1460,0,0,1,31341261,31340617,644
36044481,644,644,644,1460,0,0,1,31341905,31341261,644
36045941,644,644,644,1460,0,0,1,31342549,31341905,644
36047401,644,644,644,1460,0,0,1,31343193,31342549,644
36048861,644,644,644,1460,0,0,1,31343837,31343193,644
36050321,644,644,644,1460,0,0,1,31344481,31343837,644
36051781,644,644,644,1460,0,0,1,31345125,31344481,644
36053241,644,644,644,1460,0,0,1,31345769,31345125,644
36054701,644,644,644,1460,0,0,1,31346413,31345769,644
36056161,644,644,644,1460,0,0,1,31347057,31346413,644
36057621,644,644,644,1460,0,0,1,31347701,31347057,644
36059081,644,644,644,1460,0,0,1,31348345,31347701,644
36060541,644,644,644,1460,0,0,1,31348989,31348345,644
36062001,644,644,644,1460,0,0,1,31349633,31348989,644
36063461,644,644,644,1460,0,0,1,31350277,31349633,644
36064921,644,644,644,1460,0,0,1,31350921,31350277,644
36066381,644,644,644,1460,0,0,1,31351565,31350921,644
36067841,644,644,644,1460,0,0,1,31352209,31351565,644
36069301,644,644,644,1460,0,0,1,31352853,31352209,644
36070761,644,644,644,1460,0,0,1,31353497,31352853,644
36072221,644,644,644,1460,0,0,1,31354141,31353497,644
36073681,644,644,644,1460,0,0,1,31354785,31354141,644
36075141,644,644,644,1460,0,0,1,31355429,31354785,644
36076601,644,644,644,1460,0,0,1,31356073,31355429,644
36078061,644,644,644,1460,0,0,1,31356717,31356073,644
36079521,644,644,644,1460,0,0,1,31357361,31356717,644
36080981,644,644,644,1460,0,0,1,31358005,31357361,644
36082441,644,644,644,1460,0,0,1,31358649,31358005,644
36083901,644,644,644,1460,0,0,1,31359293,31358649,644
36085361,644,644,644,1460,0,0,1,31359937,31359293,644
36086821,644,644,644,1460,0,0,1,31360581,31359937,644
36088281,644,644,644,1460,0,0,1,31361225,31360581,644
36089741,644,644,644,1460,0,0,1,31361869,31361225,644
36091201,644,644,644,1460,0,0,1,31362513,31361869,644
36092661,644,644,644,1460,0,0,1,31363157,31362513,644
36094121,644,644,644,1460,0,0,1,31363801,31363157,644
36095581,644,644,644,1460,0,0,1,31364445,31363801,644
36097041,644,644,644,1460,0,0,1,31365089,31364445,644
36098501,644,644,644,1460,0,0,1,31365733,31365089,644
36099961,644,644,644,1460,0,0,1,31366377,31365733,644
36101421,644,644,644,1460,0,0,1,31367021,31366377,644
36102881,644,644,644,1460,0,0,1,31367665,31367021,644
36104341,644,644,644,1460,0,0,1,31368309,31367665,644
36105801,644,644,644,1460,0,0,1,31368953,31368309,644
36107261,644,644,644,1460,0,0,1,31369597,31368953,644
36108721,644,644,644,1460,0,0,1,31370241,31369597,644
36110181,644,644,644,1460,0,0,1,31370885,31370241,644
36111641,644,644,644,1460,0,0,1,31371529,31370885,644
36113101,644,644,644,1460,0,0,1,31372173,31371529,644
36114561,644,644,644,1460,0,0,1,31372817,31372173,644
36116021,644,644,644,1460,0,0,1,31373461,31372817,644
36117481,644,644,644,1460,0,0,1,31374105,31373461,644
36118941,644,644,644,1460,0,0,1,31374749,31374105,644
36120401,644,644,644,1460,0,0,1,31375393,31374749,644
36121861,644,644,644,1460,0,0,1,31376037,31375393,644
36123321,644,644,644,1460,0,0,1,31376681,31376037,644
36124781,644,644,644,1460,0,0,1,31377325,31376681,644
36126241,644,644,644,1460,0,0,1,31377969,31377325,644
36127701,644,644,644,1460,0,0,1,31378613,31377969,644
36129161,644,644,644,1460,0,0,1,31379257,31378613,644
36130621,644,644,644,1460,0,0,1,31379901,31379257,644
36132081,644,644,644,1460,0,0,1,31380545,31379901,644
36133541,644,644,644,1460,0,0,1,31381189,31380545,644
36135001,644,644,644,1460,0,0,1,31381833,31381189,644
36136461,644,644,644,1460,0,0,1,31382477,31381833,644
36137921,644,644,644,1460,0,0,1,31383121,31382477,644
36139381,644,644,644,1460,0,0,1,31383765,31383121,644
36140841,644,644,644,1460,0,0,1,31384409,31383765,644
36142301,644,644,644,1460,0,0,1,31385053,31384409,644
36143761,644,644,644,1460,0,0,1,31385697,31385053,644
36145221,644,644,644,1460,0,0,1,31386341,31385697,644
36146681,644,644,644,1460,0,0,1,31386985,31386341,644
36148141,644,644,644,1460,0,0,1,31387629,31386985,644
36149601,644,644,644,1460,0,0,1,31388273,31387629,644
36151061,644,644,644,1460,0,0,1,31388917,31388273,644
36152521,644,644,644,1460,0,0,1,31389561,31388917,644
36153981,644,644,644,1460,0,0,1,31390205,31389561,644
36155441,644,644,644,1460,0,0,1,31390849,31390205,644
36156901,644,644,644,1460,0,0,1,31391493,31390849,644
36158361,644,644,644,1460,0,0,1,31392137,31391493,644
36159821,644,644,644,1460,0,0,1,31392781,31392137,644
36161281,644,644,644,1460,0,0,1,31393425,31392781,644
36162741,644,644,644,1460,0,0,1,31394069,31393425,644
36164201,644,644,644,1460,0,0,1,31394713,31394069,644
36165661,644,644,644,1460,0,0,1,31395357,31394713,644
36167121,644,644,644,1460,0,0,1,31396001,31395357,644
36168581,644,644,644,1460,0,0,1,31396645,31396001,644
36170041,644,644,644,1460,0,0,1,31397289,31396645,644
36171501,644,644,644,1460,0,0,1,31397933,31397289,644
36172961,644,644,644,1460,0,0,1,31398577,31397933,644
36174421,644,644,644,1460,0,0,1,31399221,31398577,644
36175881,644,644,644,1460,0,0,1,31399865,31399221,644
36177341,644,644,644,1460,0,0,1,31400509,31399865,644
36178801,644,644,644,1460,0,0,1,31401153,31400509,644
36180261,644,644,644,1460,0,0,1,31401797,31401153,644
36181721,644,644,644,1460,0,0,1,31402441,31401797,644
36183181,644,644,644,1460,0,0,1,31403085,31402441,644
36184641,644,644,644,1460,0,0,1,31403729,31403085,644
36186101,644,644,644,1460,0,0,1,31404373,31403729,644
36187561,644,644,644,1460,0,0,1,31405017,31404373,644
36189021,644,644,644,1460,0,0,1,31405661,31405017,644
36190481,644,644,644,1460,0,0,1,31406305,31405661,644
36191941,644,644,644,1460,0,0,1,31406949,31406305,644
36193401,644,644,644,1460,0,0,1,31407593,31406949,644
36194861,644,644,644,1460,0,0,1,31408237,31407593,644
36196321,644,644,644,1460,0,0,1,31408881,31408237,644
36197781,644,644,644,1460,0,0,1,31409525,31408881,644
36199241,644,644,644,1460,0,0,1,31410169,31409525,644
36200701,644,644,644,1460,0,0,1,31410813,31410169,644
36202161,644,644,644,1460,0,0,1,31411457,31410813,644
36203621,644,644,644,1460,0,0,1,31412101,31411457,644
36205081,644,644,644,1460,0,0,1,31412745,31412101,644
36206541,644,644,644,1460,0,0,1,31413389,31412745,644
36208001,644,644,644,1460,0,0,1,31414033,31413389,644
36209461,644,644,644,1460,0,0,1,31414677,31414033,644
36210921,644,644,644,1460,0,0,1,31415321,31414677,644
36212381,644,644,644,1460,0,0,1,31415965,31415321,644
36213841,644,644,644,1460,0,0,1,31416609,31415965,644
36215301,644,644,644,1460,0,0,1,31417253,31416609,644
36216761,644,644,644,1460,0,0,1,31417897,31417253,644
36218221,644,644,644,1460,0,0,1,31418541,31417897,644
36219681,644,644,644,1460,0,0,1,31419185,31418541,644
36221141,644,644,644,1460,0,0,1,31419829,31419185,644
36222601,644,644,644,1460,0,0,1,31420473,31419829,644
36224061,644,644,644,1460,0,0,1,31421117,31420473,644
36225521,644,644,644,1460,0,0,1,31421761,31421117,644
36226981,644,644,644,1460,0,0,1,31422405,31421761,644
36228441,644,644,644,1460,0,0,1,31423049,31422405,644
36229901,644,644,644,1460,0,0,1,31423693,31423049,644
36231361,644,644,644,1460,0,0,1,31424337,31423693,644
36232821,644,644,644,1460,0,0,1,31424981,31424337,644
36234281,644,644,644,1460,0,0,1,31425625,31424981,644
36235741,644,644,644,1460,0,0,1,31426269,31425625,644
36237201,644,644,644,1460,0,0,1,31426913,31426269,644
36238661,644,644,644,1460,0,0,1,31427557,31426913,644
36240121,644,644,644,1460,0,0,1,31428201,31427557,644
36241581,644,644,644,1460,0,0,1,31428845,31428201,644
36243041,644,644,644,1460,0,0,1,31429489,31428845,644
36244501,644,644,644,1460,0,0,1,31430133,31429489,644
36245961,644,644,644,1460,0,0,1,31430777,31430133,644
36247421,644,644,644,1460,0,0,1,31431421,31430777,644
36248881,644,644,644,1460,0,0,1,31432065,31431421,644
36250341,644,644,644,1460,0,0,1,31432709,31432065,644
36251801,644,644,644,1460,0,0,1,31433353,31432709,644
36253261,644,644,644,1460,0,0,1,31433997,31433353,644
36254721,644,644,644,1460,0,0,1,31434641,31433997,644
36256181,644,644,644,1460,0,0,1,31435285,31434641,644
36257641,644,644,644,1460,0,0,1,31435929,31435285,644
36259101,644,644,644,1460,0,0,1,31436573,31435929,644
36260561,644,644,644,1460,0,0,1,31437217,31436573,644
36262021,644,644,644,1460,0,0,1,31437861,31437217,644
36263481,644,644,644,1460,0,0,1,31438505,31437861,644
36264941,644,644,644,1460,0,0,1,31439149,31438505,644
36266401,644,644,644,1460,0,0,1,31439793,31439149,644
36267861,644,644,644,1460,0,0,1,31440437,31439793,644
36269321,644,644,644,1460,0,0,1,31441081,31440437,644
36270781,644,644,644,1460,0,0,1,31441725,31441081,644
36272241,644,644,644,1460,0,0,1,31442369,31441725,644
36273701,644,644,644,1460,0,0,1,31443013,31442369,644
36275161,644,644,644,1460,0,0,1,31443657,31443013,644
36276621,644,644,644,1460,0,0,1,31444301,31443657,644
36278081,644,644,644,1460,0,0,1,31444945,31444301,644
36279541,644,644,644,1460,0,0,1,31445589,31444945,644
36281001,644,644,644,1460,0,0,1,31446233,31445589,644
36282461,644,644,644,1460,0,0,1,31446877,31446233,644
36283921,644,644,644,1460,0,0,1,31447521,31446877,644
36285381,644,644,644,1460,0,0,1,31448165,31447521,644
36286841,644,644,644,1460,0,0,1,31448809,31448165,644
36288301,644,644,644,1460,0,0,1,31449453,31448809,644
36289761,644,644,644,1460,0,0,1,31450097,31449453,644
36291221,644,644,644,1460,0,0,1,31450741,31450097,644
36292681,644,644,644,1460,0,0,1,31451385,31450741,644
36294141,644,644,644,1460,0,0,1,31452029,31451385,644
36295601,644,644,644,1460,0,0,1,31452673,31452029,644
36297061,644,644,644,1460,0,0,1,31453317,31452673,644
36298521,644,644,644,1460,0,0,1,31453961,31453317,644
36299981,644,644,644,1460,0,0,1,31454605,31453961,644
36301441,644,644,644,1460,0,0,1,31455249,31454605,644
36302901,644,644,644,1460,0,0,1,31455893,31455249,644
36304361,644,644,644,1460,0,0,1,31456537,31455893,644
36305821,644,644,644,1460,0,0,1,31457181,31456537,644
36307281,644,644,644,1460,0,0,1,31457825,31457181,644
36308741,644,644,644,1460,0,0,1,31458469,31457825,644
36310201,644,644,644,1460,0,0,1,31459113,31458469,644
36311661,644,644,644,1460,0,0,1,31459757,31459113,644
36313121,644,644,644,1460,0,0,1,31460401,31459757,644
36314581,644,644,644,1460,0,0,1,31461045,31460401,644
36316041,644,644,644,1460,0,0,1,31461689,31461045,644
36317501,644,644,644,1460,0,0,1,31462333,31461689,644
36318961,644,644,644,1460,0,0,1,31462977,31462333,644
36320421,644,644,644,1460,0,0,1,31463621,31462977,644
36321881,644,644,644,1460,0,0,1,31464265,31463621,644
36323341,644,644,644,1460,0,0,1,31464909,31464265,644
36324801,644,644,644,1460,0,0,1,31465553,31464909,644
36326261,644,644,644,1460,0,0,1,31466197,31465553,644
36327721,644,644,644,1460,0,0,1,31466841,31466197,644
36329181,644,644,644,1460,0,0,1,31467485,31466841,644
36330641,644,644,644,1460,0,0,1,31468129,31467485,644
36332101,644,644,644,1460,0,0,1,31468773,31468129,644
36333561,644,644,644,1460,0,0,1,31469417,31468773,644
36335021,644,644,644,1460,0,0,1,31470061,31469417,644
36336481,644,644,644,1460,0,0,1,31470705,31470061,644
36337941,644,644,644,1460,0,0,1,31471349,31470705,644
36339401,644,644,644,1460,0,0,1,31471993,31471349,644
36340861,644,644,644,1460,0,0,1,31472637,31471993,644
36342321,644,644,644,1460,0,0,1,31473281,31472637,644
36343781,644,644,644,1460,0,0,1,31473925,31473281,644
36345241,644,644,644,1460,0,0,1,31474569,31473925,644
36346701,644,644,644,1460,0,0,1,31475213,31474569,644
36348161,644,644,644,1460,0,0,1,31475857,31475213,644
36349621,644,644,644,1460,0,0,1,31476501,31475857,644
36351081,644,644,644,1460,0,0,1,31477145,31476501,644
36352541,644,644,644,1460,0,0,1,31477789,31477145,644
36354001,644,644,644,1460,0,0,1,31478433,31477789,644
36355461,644,644,644,1460,0,0,1,31479077,31478433,644
36356921,644,644,644,1460,0,0,1,31479721,31479077,644
36358381,644,644,644,1460,0,0,1,31480365,31479721,644
36359841,644,644,644,1460,0,0,1,31481009,31480365,644
36361301,644,644,644,1460,0,0,1,31481653,31481009,644
36362761,644,644,644,1460,0,0,1,31482297,31481653,644
36364221,644,644,644,1460,0,0,1,31482941,31482297,644
36365681,644,644,644,1460,0,0,1,31483585,31482941,644
36367141,644,644,644,1460,0,0,1,31484229,31483585,644
36368601,644,644,644,1460,0,0,1,31484873,31484229,644
36370061,644,644,644,1460,0,0,1,31485517,31484873,644
36371521,644,644,644,1460,0,0,1,31486161,31485517,644
36372981,644,644,644,1460,0,0,1,31486805,31486161,644
36374441,644,644,644,1460,0,0,1,31487449,31486805,644
36375901,644,644,644,1460,0,0,1,31488093,31487449,644
36377361,644,644,644,1460,0,0,1,31488737,31488093,644
36378821,644,644,644,1460,0,0,1,31489381,31488737,644
36380281,644,644,644,1460,0,0,1,31490025,31489381,644
36381741,644,644,644,1460,0,0,1,31490669,31490025,644
36383201,644,644,644,1460,0,0,1,31491313,31490669,644
36384661,644,644,644,1460,0,0,1,31491957,31491313,644
36386121,644,644,644,1460,0,0,1,31492601,31491957,644
36387581,644,644,644,1460,0,0,1,31493245,31492601,644
36389041,644,644,644,1460,0,0,1,31493889,31493245,644
36390501,644,644,644,1460,0,0,1,31494533,31493889,644
36391961,644,644,644,1460,0,0,1,31495177,31494533,644
36393421,644,644,644,1460,0,0,1,31495821,31495177,644
36394881,644,644,644,1460,0,0,1,31496465,31495821,644
36396341,644,644,644,1460,0,0,1,31497109,31496465,644
36397801,644,644,644,1460,0,0,1,31497753,31497109,644
36399261,644,644,644,1460,0,0,1,31498397,31497753,644
36400721,644,644,644,1460,0,0,1,31499041,31498397,644
36402181,644,644,644,1460,0,0,1,31499685,31499041,644
36403641,644,644,644,1460,0,0,1,31500329,31499685,644
36405101,644,644,644,1460,0,0,1,31500973,31500329,644
36406561,644,644,644,1460,0,0,1,31501617,31500973,644
36408021,644,644,644,1460,0,0,1,31502261,31501617,644
36409481,644,644,644,1460,0,0,1,31502905,31502261,644
36410941,644,644,644,1460,0,0,1,31503549,31502905,644
36412401,644,644,644,1460,0,0,1,31504193,31503549,644
36413861,644,644,644,1460,0,0,1,31504837,31504193,644
36415321,644,644,644,1460,0,0,1,31505481,31504837,644
36416781,644,644,644,1460,0,0,1,31506125,31505481,644
36418241,644,644,644,1460,0,0,1,31506769,31506125,644
36419701,644,644,644,1460,0,0,1,31507413,31506769,644
36421161,644,644,644,1460,0,0,1,31508057,31507413,644
36422621,644,644,644,1460,0,0,1,31508701,31508057,644
36424081,644,644,644,1460,0,0,1,31509345,31508701,644
36425541,644,644,644,1460,0,0,1,31509989,31509345,644
36427001,644,644,644,1460,0,0,1,31510633,31509989,644
36428461,644,644,644,1460,0,0,1,31511277,31510633,644
36429921,644,644,644,1460,0,0,1,31511921,31511277,644
36431381,644,644,644,1460,0,0,1,31512565,31511921,644
36432841,644,644,644,1460,0,0,1,31513209,31512565,644
36434301,644,644,644,1460,0,0,1,31513853,31513209,644
36435761,644,644,644,1460,0,0,1,31514497,31513853,644
36437221,644,644,644,1460,0,0,1,31515141,31514497,644
36438681,644,644,644,1460,0,0,1,31515785,31515141,644
36440141,644,644,644,1460,0,0,1,31516429,31515785,644
36441601,644,644,644,1460,0,0,1,31517073,31516429,644
36443061,644,644,644,1460,0,0,1,31517717,31517073,644
36444521,644,644,644,1460,0,0,1,31518361,31517717,644
36445981,644,644,644,1460,0,0,1,31519005,31518361,644
36447441,644,644,644,1460,0,0,1,31519649,31519005,644
36448901,644,644,644,1460,0,0,1,31520293,31519649,644
36450361,644,644,644,1460,0,0,1,31520937,31520293,644
36451821,644,644,644,1460,0,0,1,31521581,31520937,644
36453281,644,644,644,1460,0,0,1,31522225,31521581,644
36454741,644,644,644,1460,0,0,1,31522869,31522225,644
36456201,644,644,644,1460,0,0,1,31523513,31522869,644
36457661,644,644,644,1460,0,0,1,31524157,31523513,644
36459121,644,644,644,1460,0,0,1,31524801,31524157,644
36460581,644,644,644,1460,0,0,1,31525445,31524801,644
36462041,644,644,644,1460,0,0,1,31526089,31525445,644
36463501,644,644,644,1460,0,0,1,31526733,31526089,644
36464961,644,644,644,1460,0,0,1,31527377,31526733,644
36466421,644,644,644,1460,0,0,1,31528021,31527377,644
36467881,644,644,644,1460,0,0,1,31528665,31528021,644
36469341,644,644,644,1460,0,0,1,31529309,31528665,644
36470801,644,644,644,1460,0,0,1,31529953,31529309,644
36472261,644,644,644,1460,0,0,1,31530597,31529953,644
36473721,644,644,644,1460,0,0,1,31531241,31530597,644
36475181,644,644,644,1460,0,0,1,31531885,31531241,644
36476641,644,644,644,1460,0,0,1,31532529,31531885,644
36478101,644,644,644,1460,0,0,1,31533173,31532529,644
36479561,644,644,644,1460,0,0,1,31533817,31533173,644
36481021,644,644,644,1460,0,0,1,31534461,31533817,644
36482481,644,644,644,1460,0,0,1,31535105,31534461,644
36483941,644,644,644,1460,0,0,1,31535749,31535105,644
36485401,644,644,644,1460,0,0,1,31536393,31535749,644
36486861,644,644,644,1460,0,0,1,31537037,31536393,644
36488321,644,644,644,1460,0,0,1,31537681,31537037,644
36489781,644,644,644,1460,0,0,1,31538325,31537681,644
36491241,644,644,644,1460,0,0,1,31538969,31538325,644
36492701,644,644,644,1460,0,0,1,31539613,31538969,644
36494161,644,644,644,1460,0,0,1,31540257,31539613,644
36495621,644,644,644,1460,0,0,1,31540901,31540257,644
36497081,644,644,644,1460,0,0,1,31541545,31540901,644
36498541,644,644,644,1460,0,0,1,31542189,31541545,644
36500001,644,644,644,1460,0,0,1,31542833,31542189,644
36501461,644,644,644,1460,0,0,1,31543477,31542833,644
36502921,644,644,644,1460,0,0,1,31544121,31543477,644
36504381,644,644,644,1460,0,0,1,31544765,31544121,644
36505841,644,644,644,1460,0,0,1,31545409,31544765,644
36507301,644,644,644,1460,0,0,1,31546053,31545409,644
36508761,644,644,644,1460,0,0,1,31546697,31546053,644
36510221,644,644,644,1460,0,0,1,31547341,31546697,644
36511681,644,644,644,1460,0,0,1,31547985,31547341,644
36513141,644,644,644,1460,0,0,1,31548629,31547985,644
36514601,644,644,644,1460,0,0,1,31549273,31548629,644
36516061,644,644,644,1460,0,0,1,31549917,31549273,644
36517521,644,644,644,1460,0,0,1,31550561,31549917,644
36518981,644,644,644,1460,0,0,1,31551205,31550561,644
36520441,644,644,644,1460,0,0,1,31551849,31551205,644
36521901,644,644,644,1460,0,0,1,31552493,31551849,644
36523361,644,644,644,1460,0,0,1,31553137,31552493,644
36524821,644,644,644,1460,0,0,1,31553781,31553137,644
36526281,644,644,644,1460,0,0,1,31554425,31553781,644
36527741,644,644,644,1460,0,0,1,31555069,31554425,644
36529201,644,644,644,1460,0,0,1,31555713,31555069,644
36530661,644,644,644,1460,0,0,1,31556357,31555713,644
36532121,644,644,644,1460,0,0,1,31557001,31556357,644
36533581,644,644,644,1460,0,0,1,31557645,31557001,644
36535041,644,644,644,1460,0,0,1,31558289,31557645,644
36536501,644,644,644,1460,0,0,1,31558933,31558289,644
36537961,644,644,644,1460,0,0,1,31559577,31558933,644
36539421,644,644,644,1460,0,0,1,31560221,31559577,644
36540881,644,644,644,1460,0,0,1,31560865,31560221,644
36542341,644,644,644,1460,0,0,1,31561509,31560865,644
36543801,644,644,644,1460,0,0,1,31562153,31561509,644
36545261,644,644,644,1460,0,0,1,31562797,31562153,644
36546721,644,644,644,1460,0,0,1,31563441,31562797,644
36548181,644,644,644,1460,0,0,1,31564085,31563441,644
36549641,644,644,644,1460,0,0,1,31564729,31564085,644
36551101,644,644,644,1460,0,0,1,31565373,31564729,644
36552561,644,644,644,1460,0,0,1,31566017,31565373,644
36554021,644,644,644,1460,0,0,1,31566661,31566017,644
36555481,644,644,644,1460,0,0,1,31567305,31566661,644
36556941,644,644,644,1460,0,0,1,31567949,31567305,644
36558401,644,644,644,1460,0,0,1,31568593,31567949,644
36559861,644,644,644,1460,0,0,1,31569237,31568593,644
36561321,644,644,644,1460,0,0,1,31569881,31569237,644
36562781,644,644,644,1460,0,0,1,31570525,31569881,644
36564241,644,644,644,1460,0,0,1,31571169,31570525,644
36565701,644,644,644,1460,0,0,1,31571813,31571169,644
36567161,644,644,644,1460,0,0,1,31572457,31571813,644
36568621,644,644,644,1460,0,0,1,31573101,31572457,644
36570081,644,644,644,1460,0,0,1,31573745,31573101,644
36571541,644,644,644,1460,0,0,1,31574389,31573745,644
36573001,644,644,644,1460,0,0,1,31575033,31574389,644
36574461,644,644,644,1460,0,0,1,31575677,31575033,644
36575921,644,644,644,1460,0,0,1,31576321,31575677,644
36577381,644,644,644,1460,0,0,1,31576965,31576321,644
36578841,644,644,644,1460,0,0,1,31577609,31576965,644
36580301,644,644,644,1460,0,0,1,31578253,31577609,644
36581761,644,644,644,1460,0,0,1,31578897,31578253,644
36583221,644,644,644,1460,0,0,1,31579541,31578897,644
36584681,644,644,644,1460,0,0,1,31580185,31579541,644
36586141,644,644,644,1460,0,0,1,31580829,31580185,644
36587601,644,644,644,1460,0,0,1,31581473,31580829,644
36589061,644,644,644,1460,0,0,1,31582117,31581473,644
36590521,644,644,644,1460,0,0,1,31582761,31582117,644
36591981,644,644,644,1460,0,0,1,31583405,31582761,644
36593441,644,644,644,1460,0,0,1,31584049,31583405,644
36594901,644,644,644,1460,0,0,1,31584693,31584049,644
36596361,644,644,644,1460,0,0,1,31585337,31584693,644
36597821,644,644,644,1460,0,0,1,31585981,31585337,644
36599281,644,644,644,1460,0,0,1,31586625,31585981,644
36600741,644,644,644,1460,0,0,1,31587269,31586625,644
36602201,644,644,644,1460,0,0,1,31587913,31587269,644
36603661,644,644,644,1460,0,0,1,31588557,31587913,644
36605121,644,644,644,1460,0,0,1,31589201,31588557,644
36606581,644,644,644,1460,0,0,1,31589845,31589201,644
36608041,644,644,644,1460,0,0,1,31590489,31589845,644
36609501,644,644,644,1460,0,0,1,31591133,31590489,644
36610961,644,644,644,1460,0,0,1,31591777,31591133,644
36612421,644,644,644,1460,0,0,1,31592421,31591777,644
36613881,644,644,644,1460,0,0,1,31593065,31592421,644
36615341,644,644,644,1460,0,0,1,31593709,31593065,644
36616801,644,644,644,1460,0,0,1,31594353,31593709,644
36618261,644,644,644,1460,0,0,1,31594997,31594353,644
36619721,644,644,644,1460,0,0,1,31595641,31594997,644
36621181,644,644,644,1460,0,0,1,31596285,31595641,644
36622641,644,644,644,1460,0,0,1,31596929,31596285,644
36624101,644,644,644,1460,0,0,1,31597573,31596929,644
36625561,644,644,644,1460,0,0,1,31598217,31597573,644
36627021,644,644,644,1460,0,0,1,31598861,31598217,644
36628481,644,644,644,1460,0,0,1,31599505,31598861,644
36629941,644,644,644,1460,0,0,1,31600149,31599505,644
36631401,644,644,644,1460,0,0,1,31600793,31600149,644
36632861,644,644,644,1460,0,0,1,31601437,31600793,644
36634321,644,644,644,1460,0,0,1,31602081,31601437,644
36635781,644,644,644,1460,0,0,1,31602725,31602081,644
36637241,644,644,644,1460,0,0,1,31603369,31602725,644
36638701,644,644,644,1460,0,0,1,31604013,31603369,644
36640161,644,644,644,1460,0,0,1,31604657,31604013,644
36641621,644,644,644,1460,0,0,1,31605301,31604657,644
36643081,644,644,644,1460,0,0,1,31605945,31605301,644
36644541,644,644,644,1460,0,0,1,31606589,31605945,644
36646001,644,644,644,1460,0,0,1,31607233,31606589,644
36647461,644,644,644,1460,0,0,1,31607877,31607233,644
36648921,644,644,644,1460,0,0,1,31608521,31607877,644
36650381,644,644,644,1460,0,0,1,31609165,31608521,644
36651841,644,644,644,1460,0,0,1,31609809,31609165,644
36653301,644,644,644,1460,0,0,1,31610453,31609809,644
36654761,644,644,644,1460,0,0,1,31611097,31610453,644
36656221,644,644,644,1460,0,0,1,31611741,31611097,644
36657681,644,644,644,1460,0,0,1,31612385,31611741,644
36659141,644,644,644,1460,0,0,1,31613029,31612385,644
36660601,644,644,644,1460,0,0,1,31613673,31613029,644
36662061,644,644,644,1460,0,0,1,31614317,31613673,644
36663521,644,644,644,1460,0,0,1,31614961,31614317,644
36664981,644,644,644,1460,0,0,1,31615605,31614961,644
36666441,644,644,644,1460,0,0,1,31616249,31615605,644
36667901,644,644,644,1460,0,0,1,31616893,31616249,644
36669361,644,644,644,1460,0,0,1,31617537,31616893,644
36670821,644,644,644,1460,0,0,1,31618181,31617537,644
36672281,644,644,644,1460,0,0,1,31618825,31618181,644
36673741,644,644,644,1460,0,0,1,31619469,31618825,644
36675201,644,644,644,1460,0,0,1,31620113,31619469,644
36676661,644,644,644,1460,0,0,1,31620757,31620113,644
36678121,644,644,644,1460,0,0,1,31621401,31620757,644
36679581,644,644,644,1460,0,0,1,31622045,31621401,644
36681041,644,644,644,1460,0,0,1,31622689,31622045,644
36682501,644,644,644,1460,0,0,1,31623333,31622689,644
36683961,644,644,644,1460,0,0,1,31623977,31623333,644
36685421,644,644,644,1460,0,0,1,31624621,31623977,644
36686881,644,644,644,1460,0,0,1,31625265,31624621,644
36688341,644,644,644,1460,0,0,1,31625909,31625265,644
36689801,644,644,644,1460,0,0,1,31626553,31625909,644
36691261,644,644,644,1460,0,0,1,31627197,31626553,644
36692721,644,644,644,1460,0,0,1,31627841,31627197,644
36694181,644,644,644,1460,0,0,1,31628485,31627841,644
36695641,644,644,644,1460,0,0,1,31629129,31628485,644
36697101,644,644,644,1460,0,0,1,31629773,31629129,644
36698561,644,644,644,1460,0,0,1,31630417,31629773,644
36700021,644,644,644,1460,0,0,1,31631061,31630417,644
36701481,644,644,644,1460,0,0,1,31631705,31631061,644
36702941,644,644,644,1460,0,0,1,31632349,31631705,644
36704401,644,644,644,1460,0,0,1,31632993,31632349,644
36705861,644,644,644,1460,0,0,1,31633637,31632993,644
36707321,644,644,644,1460,0,0,1,31634281,31633637,644
36708781,644,644,644,1460,0,0,1,31634925,31634281,644
36710241,644,644,644,1460,0,0,1,31635569,31634925,644
36711701,644,644,644,1460,0,0,1,31636213,31635569,644
36713161,644,644,644,1460,0,0,1,31636857,31636213,644
36714621,644,644,644,1460,0,0,1,31637501,31636857,644
36716081,644,644,644,1460,0,0,1,31638145,31637501,644
36717541,644,644,644,1460,0,0,1,31638789,31638145,644
36719001,644,644,644,1460,0,0,1,31639433,31638789,644
36720461,644,644,644,1460,0,0,1,31640077,31639433,644
36721921,644,644,644,1460,0,0,1,31640721,31640077,644
36723381,644,644,644,1460,0,0,1,31641365,31640721,644
36724841,644,644,644,1460,0,0,1,31642009,31641365,644
36726301,644,644,644,1460,0,0,1,31642653,31642009,644
36727761,644,644,644,1460,0,0,1,31643297,31642653,644
36729221,644,644,644,1460,0,0,1,31643941,31643297,644
36730681,644,644,644,1460,0,0,1,31644585,31643941,644
36732141,644,644,644,1460,0,0,1,31645229,31644585,644
36733601,644,644,644,1460,0,0,1,31645873,31645229,644
36735061,644,644,644,1460,0,0,1,31646517,31645873,644
36736521,644,644,644,1460,0,0,1,31647161,31646517,644
36737981,644,644,644,1460,0,0,1,31647805,31647161,644
36739441,644,644,644,1460,0,0,1,31648449,31647805,644
36740901,644,644,644,1460,0,0,1,31649093,31648449,644
36742361,644,644,644,1460,0,0,1,31649737,31649093,644
36743821,644,644,644,1460,0,0,1,31650381,31649737,644
36745281,644,644,644,1460,0,0,1,31651025,31650381,644
36746741,644,644,644,1460,0,0,1,31651669,31651025,644
36748201,644,644,644,1460,0,0,1,31652313,31651669,644
36749661,644,644,644,1460,0,0,1,31652957,31652313,644
36751121,644,644,644,1460,0,0,1,31653601,31652957,644
36752581,644,644,644,1460,0,0,1,31654245,31653601,644
36754041,644,644,644,1460,0,0,1,31654889,31654245,644
36755501,644,644,644,1460,0,0,1,31655533,31654889,644
36756961,644,644,644,1460,0,0,1,31656177,31655533,644
36758421,644,644,644,1460,0,0,1,31656821,31656177,644
36759881,644,644,644,1460,0,0,1,31657465,31656821,644
36761341,644,644,644,1460,0,0,1,31658109,31657465,644
36762801,644,644,644,1460,0,0,1,31658753,31658109,644
36764261,644,644,644,1460,0,0,1,31659397,31658753,644
36765721,644,644,644,1460,0,0,1,31660041,31659397,644
36767181,644,644,644,1460,0,0,1,31660685,31660041,644
36768641,644,644,644,1460,0,0,1,31661329,31660685,644
36770101,644,644,644,1460,0,0,1,31661973,31661329,644
36771561,644,644,644,1460,0,0,1,31662617,31661973,644
36773021,644,644,644,1460,0,0,1,31663261,31662617,644
36774481,644,644,644,1460,0,0,1,31663905,31663261,644
36775941,644,644,644,1460,0,0,1,31664549,31663905,644
36777401,644,644,644,1460,0,0,1,31665193,31664549,644
36778861,644,644,644,1460,0,0,1,31665837,31665193,644
36780321,644,644,644,1460,0,0,1,31666481,31665837,644
36781781,644,644,644,1460,0,0,1,31667125,31666481,644
36783241,644,644,644,1460,0,0,1,31667769,31667125,644
36784701,644,644,644,1460,0,0,1,31668413,31667769,644
36786161,644,644,644,1460,0,0,1,31669057,31668413,644
36787621,644,644,644,1460,0,0,1,31669701,31669057,644
36789081,644,644,644,1460,0,0,1,31670345,31669701,644
36790541,644,644,644,1460,0,0,1,31670989,31670345,644
36792001,644,644,644,1460,0,0,1,31671633,31670989,644
36793461,644,644,644,1460,0,0,1,31672277,31671633,644
36794921,644,644,644,1460,0,0,1,31672921,31672277,644
36796381,644,644,644,1460,0,0,1,31673565,31672921,644
36797841,644,644,644,1460,0,0,1,31674209,31673565,644
36799301,644,644,644,1460,0,0,1,31674853,31674209,644
36800761,644,644,644,1460,0,0,1,31675497,31674853,644
36802221,644,644,644,1460,0,0,1,31676141,31675497,644
36803681,644,644,644,1460,0,0,1,31676785,31676141,644
36805141,644,644,644,1460,0,0,1,31677429,31676785,644
36806601,644,644,644,1460,0,0,1,31678073,31677429,644
36808061,644,644,644,1460,0,0,1,31678717,31678073,644
36809521,644,644,644,1460,0,0,1,31679361,31678717,644
36810981,644,644,644,1460,0,0,1,31680005,31679361,644
36812441,644,644,644,1460,0,0,1,31680649,31680005,644
36813901,644,644,644,1460,0,0,1,31681293,31680649,644
36815361,644,644,644,1460,0,0,1,31681937,31681293,644
36816821,644,644,644,1460,0,0,1,31682581,31681937,644
36818281,644,644,644,1460,0,0,1,31683225,31682581,644
36819741,644,644,644,1460,0,0,1,31683869,31683225,644
36821201,644,644,644,1460,0,0,1,31684513,31683869,644
36822661,644,644,644,1460,0,0,1,31685157,31684513,644
36824121,644,644,644,1460,0,0,1,31685801,31685157,644
36825581,644,644,644,1460,0,0,1,31686445,31685801,644
36827041,644,644,644,1460,0,0,1,31687089,31686445,644
36828501,644,644,644,1460,0,0,1,31687733,31687089,644
36829961,644,644,644,1460,0,0,1,31688377,31687733,644
36831421,644,644,644,1460,0,0,1,31689021,31688377,644
36832881,644,644,644,1460,0,0,1,31689665,31689021,644
36834341,644,644,644,1460,0,0,1,31690309,31689665,644
36835801,644,644,644,1460,0,0,1,31690953,31690309,644
36837261,644,644,644,1460,0,0,1,31691597,31690953,644
36838721,644,644,644,1460,0,0,1,31692241,31691597,644
36840181,644,644,644,1460,0,0,1,31692885,31692241,644
36841641,644,644,644,1460,0,0,1,31693529,31692885,644
36843101,644,644,644,1460,0,0,1,31694173,31693529,644
36844561,644,644,644,1460,0,0,1,31694817,31694173,644
36846021,644,644,644,1460,0,0,1,31695461,31694817,644
36847481,644,644,644,1460,0,0,1,31696105,31695461,644
36848941,644,644,644,1460,0,0,1,31696749,31696105,644
36850401,644,644,644,1460,0,0,1,31697393,31696749,644
36851861,644,644,644,1460,0,0,1,31698037,31697393,644
36853321,644,644,644,1460,0,0,1,31698681,31698037,644
36854781,644,644,644,1460,0,0,1,31699325,31698681,644
36856241,644,644,644,1460,0,0,1,31699969,31699325,644
36857701,644,644,644,1460,0,0,1,31700613,31699969,644
36859161,644,644,644,1460,0,0,1,31701257,31700613,644
36860621,644,644,644,1460,0,0,1,31701901,31701257,644
36862081,644,644,644,1460,0,0,1,31702545,31701901,644
36863541,644,644,644,1460,0,0,1,31703189,31702545,644
36865001,644,644,644,1460,0,0,1,31703833,31703189,644
36866461,644,644,644,1460,0,0,1,31704477,31703833,644
36867921,644,644,644,1460,0,0,1,31705121,31704477,644
36869381,644,644,644,1460,0,0,1,31705765,31705121,644
36870841,644,644,644,1460,0,0,1,31706409,31705765,644
36872301,644,644,644,1460,0,0,1,31707053,31706409,644
36873761,644,644,644,1460,0,0,1,31707697,31707053,644
36875221,644,644,644,1460,0,0,1,31708341,31707697,644
36876681,644,644,644,1460,0,0,1,31708985,31708341,644
36878141,644,644,644,1460,0,0,1,31709629,31708985,644
36879601,644,644,644,1460,0,0,1,31710273,31709629,644
36881061,644,644,644,1460,0,0,1,31710917,31710273,644
36882521,644,644,644,1460,0,0,1,31711561,31710917,644
36883981,644,644,644,1460,0,0,1,31712205,31711561,644
36885441,644,644,644,1460,0,0,1,31712849,31712205,644
36886901,644,644,644,1460,0,0,1,31713493,31712849,644
36888361,644,644,644,1460,0,0,1,31714137,31713493,644
36889821,644,644,644,1460,0,0,1,31714781,31714137,644
36891281,644,644,644,1460,0,0,1,31715425,31714781,644
36892741,644,644,644,1460,0,0,1,31716069,31715425,644
36894201,644,644,644,1460,0,0,1,31716713,31716069,644
36895661,644,644,644,1460,0,0,1,31717357,31716713,644
36897121,644,644,644,1460,0,0,1,31718001,31717357,644
36898581,644,644,644,1460,0,0,1,31718645,31718001,644
36900041,644,644,644,1460,0,0,1,31719289,31718645,644
36901501,644,644,644,1460,0,0,1,31719933,31719289,644
36902961,644,644,644,1460,0,0,1,31720577,31719933,644
36904421,644,644,644,1460,0,0,1,31721221,31720577,644
36905881,644,644,644,1460,0,0,1,31721865,31721221,644
36907341,644,644,644,1460,0,0,1,31722509,31721865,644
36908801,644,644,644,1460,0,0,1,31723153,31722509,644
36910261,644,644,644,1460,0,0,1,31723797,31723153,644
36911721,644,644,644,1460,0,0,1,31724441,31723797,644
36913181,644,644,644,1460,0,0,1,31725085,31724441,644
36914641,644,644,644,1460,0,0,1,31725729,31725085,644
36916101,644,644,644,1460,0,0,1,31726373,31725729,644
36917561,644,644,644,1460,0,0,1,31727017,31726373,644
36919021,644,644,644,1460,0,0,1,31727661,31727017,644
36920481,644,644,644,1460,0,0,1,31728305,31727661,644
36921941,644,644,644,1460,0,0,1,31728949,31728305,644
36923401,644,644,644,1460,0,0,1,31729593,31728949,644
36924861,644,644,644,1460,0,0,1,31730237,31729593,644
36926321,644,644,644,1460,0,0,1,31730881,31730237,644
36927781,644,644,644,1460,0,0,1,31731525,31730881,644
36929241,644,644,644,1460,0,0,1,31732169,31731525,644
36930701,644,644,644,1460,0,0,1,31732813,31732169,644
36932161,644,644,644,1460,0,0,1,31733457,31732813,644
36933621,644,644,644,1460,0,0,1,31734101,31733457,644
36935081,644,644,644,1460,0,0,1,31734745,31734101,644
36936541,644,644,644,1460,0,0,1,31735389,31734745,644
36938001,644,644,644,1460,0,0,1,31736033,31735389,644
36939461,644,644,644,1460,0,0,1,31736677,31736033,644
36940921,644,644,644,1460,0,0,1,31737321,31736677,644
36942381,644,644,644,1460,0,0,1,31737965,31737321,644
36943841,644,644,644,1460,0,0,1,31738609,31737965,644
36945301,644,644,644,1460,0,0,1,31739253,31738609,644
36946761,644,644,644,1460,0,0,1,31739897,31739253,644
36948221,644,644,644,1460,0,0,1,31740541,31739897,644
36949681,644,644,644,1460,0,0,1,31741185,31740541,644
36951141,644,644,644,1460,0,0,1,31741829,31741185,644
36952601,644,644,644,1460,0,0,1,31742473,31741829,644
36954061,644,644,644,1460,0,0,1,31743117,31742473,644
36955521,644,644,644,1460,0,0,1,31743761,31743117,644
36956981,644,644,644,1460,0,0,1,31744405,31743761,644
36958441,644,644,644,1460,0,0,1,31745049,31744405,644
36959901,644,644,644,1460,0,0,1,31745693,31745049,644
36961361,644,644,644,1460,0,0,1,31746337,31745693,644
36962821,644,644,644,1460,0,0,1,31746981,31746337,644
36964281,644,644,644,1460,0,0,1,31747625,31746981,644
36965741,644,644,644,1460,0,0,1,31748269,31747625,644
36967201,644,644,644,1460,0,0,1,31748913,31748269,644
36968661,644,644,644,1460,0,0,1,31749557,31748913,644
36970121,644,644,644,1460,0,0,1,31750201,31749557,644
36971581,644,644,644,1460,0,0,1,31750845,31750201,644
36973041,644,644,644,1460,0,0,1,31751489,31750845,644
36974501,644,644,644,1460,0,0,1,31752133,31751489,644
36975961,644,644,644,1460,0,0,1,31752777,31752133,644
36977421,644,644,644,1460,0,0,1,31753421,31752777,644
36978881,644,644,644,1460,0,0,1,31754065,31753421,644
36980341,644,644,644,1460,0,0,1,31754709,31754065,644
36981801,644,644,644,1460,0,0,1,31755353,31754709,644
36983261,644,644,644,1460,0,0,1,31755997,31755353,644
36984721,644,644,644,1460,0,0,1,31756641,31755997,644
36986181,644,644,644,1460,0,0,1,31757285,31756641,644
36987641,644,644,644,1460,0,0,1,31757929,31757285,644
36989101,644,644,644,1460,0,0,1,31758573,31757929,644
36990561,644,644,644,1460,0,0,1,31759217,31758573,644
36992021,644,644,644,1460,0,0,1,31759861,31759217,644
36993481,644,644,644,1460,0,0,1,31760505,31759861,644
36994941,644,644,644,1460,0,0,1,31761149,31760505,644
36996401,644,644,644,1460,0,0,1,31761793,31761149,644
36997861,644,644,644,1460,0,0,1,31762437,31761793,644
36999321,644,644,644,1460,0,0,1,31763081,31762437,644
37000781,644,644,644,1460,0,0,1,31763725,31763081,644
37002241,644,644,644,1460,0,0,1,31764369,31763725,644
37003701,644,644,644,1460,0,0,1,31765013,31764369,644
37005161,644,644,644,1460,0,0,1,31765657,31765013,644
37006621,644,644,644,1460,0,0,1,31766301,31765657,644
37008081,644,644,644,1460,0,0,1,31766945,31766301,644
37009541,644,644,644,1460,0,0,1,31767589,31766945,644
37011001,644,644,644,1460,0,0,1,31768233,31767589,644
37012461,644,644,644,1460,0,0,1,31768877,31768233,644
37013921,644,644,644,1460,0,0,1,31769521,31768877,644
37015381,644,644,644,1460,0,0,1,31770165,31769521,644
37016841,644,644,644,1460,0,0,1,31770809,31770165,644
37018301,644,644,644,1460,0,0,1,31771453,31770809,644
37019761,644,644,644,1460,0,0,1,31772097,31771453,644
37021221,644,644,644,1460,0,0,1,31772741,31772097,644
37022681,644,644,644,1460,0,0,1,31773385,31772741,644
37024141,644,644,644,1460,0,0,1,31774029,31773385,644
37025601,644,644,644,1460,0,0,1,31774673,31774029,644
37027061,644,644,644,1460,0,0,1,31775317,31774673,644
37028521,644,644,644,1460,0,0,1,31775961,31775317,644
37029981,644,644,644,1460,0,0,1,31776605,31775961,644
37031441,644,644,644,1460,0,0,1,31777249,31776605,644
37032901,644,644,644,1460,0,0,1,31777893,31777249,644
37034361,644,644,644,1460,0,0,1,31778537,31777893,644
37035821,644,644,644,1460,0,0,1,31779181,31778537,644
37037281,644,644,644,1460,0,0,1,31779825,31779181,644
37038741,644,644,644,1460,0,0,1,31780469,31779825,644
37040201,644,644,644,1460,0,0,1,31781113,31780469,644
37041661,644,644,644,1460,0,0,1,31781757,31781113,644
37043121,644,644,644,1460,0,0,1,31782401,31781757,644
37044581,644,644,644,1460,0,0,1,31783045,31782401,644
37046041,644,644,644,1460,0,0,1,31783689,31783045,644
37047501,644,644,644,1460,0,0,1,31784333,31783689,644
37048961,644,644,644,1460,0,0,1,31784977,31784333,644
37050421,644,644,644,1460,0,0,1,31785621,31784977,644
37051881,644,644,644,1460,0,0,1,31786265,31785621,644
37053341,644,644,644,1460,0,0,1,31786909,31786265,644
37054801,644,644,644,1460,0,0,1,31787553,31786909,644
37056261,644,644,644,1460,0,0,1,31788197,31787553,644
37057721,644,644,644,1460,0,0,1,31788841,31788197,644
37059181,644,644,644,1460,0,0,1,31789485,31788841,644
37060641,644,644,644,1460,0,0,1,31790129,31789485,644
37062101,644,644,644,1460,0,0,1,31790773,31790129,644
37063561,644,644,644,1460,0,0,1,31791417,31790773,644
37065021,644,644,644,1460,0,0,1,31792061,31791417,644
37066481,644,644,644,1460,0,0,1,31792705,31792061,644
37067941,644,644,644,1460,0,0,1,31793349,31792705,644
37069401,644,644,644,1460,0,0,1,31793993,31793349,644
37070861,644,644,644,1460,0,0,1,31794637,31793993,644
37072321,644,644,644,1460,0,0,1,31795281,31794637,644
37073781,644,644,644,1460,0,0,1,31795925,31795281,644
37075241,644,644,644,1460,0,0,1,31796569,31795925,644
37076701,644,644,644,1460,0,0,1,31797213,31796569,644
37078161,644,644,644,1460,0,0,1,31797857,31797213,644
37079621,644,644,644,1460,0,0,1,31798501,31797857,644
37081081,644,644,644,1460,0,0,1,31799145,31798501,644
37082541,644,644,644,1460,0,0,1,31799789,31799145,644
37084001,644,644,644,1460,0,0,1,31800433,31799789,644
37085461,644,644,644,1460,0,0,1,31801077,31800433,644
37086921,644,644,644,1460,0,0,1,31801721,31801077,644
37088381,644,644,644,1460,0,0,1,31802365,31801721,644
37089841,644,644,644,1460,0,0,1,31803009,31802365,644
37091301,644,644,644,1460,0,0,1,31803653,31803009,644
37092761,644,644,644,1460,0,0,1,31804297,31803653,644
37094221,644,644,644,1460,0,0,1,31804941,31804297,644
37095681,644,644,644,1460,0,0,1,31805585,31804941,644
37097141,644,644,644,1460,0,0,1,31806229,31805585,644
37098601,644,644,644,1460,0,0,1,31806873,31806229,644
37100061,644,644,644,1460,0,0,1,31807517,31806873,644
37101521,644,644,644,1460,0,0,1,31808161,31807517,644
37102981,644,644,644,1460,0,0,1,31808805,31808161,644
37104441,644,644,644,1460,0,0,1,31809449,31808805,644
37105901,644,644,644,1460,0,0,1,31810093,31809449,644
37107361,644,644,644,1460,0,0,1,31810737,31810093,644
37108821,644,644,644,1460,0,0,1,31811381,31810737,644
37110281,644,644,644,1460,0,0,1,31812025,31811381,644
37111741,644,644,644,1460,0,0,1,31812669,31812025,644
37113201,644,644,644,1460,0,0,1,31813313,31812669,644
37114661,644,644,644,1460,0,0,1,31813957,31813313,644
37116121,644,644,644,1460,0,0,1,31814601,31813957,644
37117581,644,644,644,1460,0,0,1,31815245,31814601,644
37119041,644,644,644,1460,0,0,1,31815889,31815245,644
37120501,644,644,644,1460,0,0,1,31816533,31815889,644
37121961,644,644,644,1460,0,0,1,31817177,31816533,644
37123421,644,644,644,1460,0,0,1,31817821,31817177,644
37124881,644,644,644,1460,0,0,1,31818465,31817821,644
37126341,644,644,644,1460,0,0,1,31819109,31818465,644
37127801,644,644,644,1460,0,0,1,31819753,31819109,644
37129261,644,644,644,1460,0,0,1,31820397,31819753,644
37130721,644,644,644,1460,0,0,1,31821041,31820397,644
37132181,644,644,644,1460,0,0,1,31821685,31821041,644
37133641,644,644,644,1460,0,0,1,31822329,31821685,644
37135101,644,644,644,1460,0,0,1,31822973,31822329,644
37136561,644,644,644,1460,0,0,1,31823617,31822973,644
37138021,644,644,644,1460,0,0,1,31824261,31823617,644
37139481,644,644,644,1460,0,0,1,31824905,31824261,644
37140941,644,644,644,1460,0,0,1,31825549,31824905,644
37142401,644,644,644,1460,0,0,1,31826193,31825549,644
37143861,644,644,644,1460,0,0,1,31826837,31826193,644
37145321,644,644,644,1460,0,0,1,31827481,31826837,644
37146781,644,644,644,1460,0,0,1,31828125,31827481,644
37148241,644,644,644,1460,0,0,1,31828769,31828125,644
37149701,644,644,644,1460,0,0,1,31829413,31828769,644
37151161,644,644,644,1460,0,0,1,31830057,31829413,644
37152621,644,644,644,1460,0,0,1,31830701,31830057,644
37154081,644,644,644,1460,0,0,1,31831345,31830701,644
37155541,644,644,644,1460,0,0,1,31831989,31831345,644
37157001,644,644,644,1460,0,0,1,31832633,31831989,644
37158461,644,644,644,1460,0,0,1,31833277,31832633,644
37159921,644,644,644,1460,0,0,1,31833921,31833277,644
37161381,644,644,644,1460,0,0,1,31834565,31833921,644
37162841,644,644,644,1460,0,0,1,31835209,31834565,644
37164301,644,644,644,1460,0,0,1,31835853,31835209,644
37165761,644,644,644,1460,0,0,1,31836497,31835853,644
37167221,644,644,644,1460,0,0,1,31837141,31836497,644
37168681,644,644,644,1460,0,0,1,31837785,31837141,644
37170141,644,644,644,1460,0,0,1,31838429,31837785,644
37171601,644,644,644,1460,0,0,1,31839073,31838429,644
37173061,644,644,644,1460,0,0,1,31839717,31839073,644
37174521,644,644,644,1460,0,0,1,31840361,31839717,644
37175981,644,644,644,1460,0,0,1,31841005,31840361,644
37177441,644,644,644,1460,0,0,1,31841649,31841005,644
37178901,644,644,644,1460,0,0,1,31842293,31841649,644
37180361,644,644,644,1460,0,0,1,31842937,31842293,644
37181821,644,644,644,1460,0,0,1,31843581,31842937,644
37183281,644,644,644,1460,0,0,1,31844225,31843581,644
37184741,644,644,644,1460,0,0,1,31844869,31844225,644
37186201,644,644,644,1460,0,0,1,31845513,31844869,644
37187661,644,644,644,1460,0,0,1,31846157,31845513,644
37189121,644,644,644,1460,0,0,1,31846801,31846157,644
37190581,644,644,644,1460,0,0,1,31847445,31846801,644
37192041,644,644,644,1460,0,0,1,31848089,31847445,644
37193501,644,644,644,1460,0,0,1,31848733,31848089,644
37194961,644,644,644,1460,0,0,1,31849377,31848733,644
37196421,644,644,644,1460,0,0,1,31850021,31849377,644
37197881,644,644,644,1460,0,0,1,31850665,31850021,644
37199341,644,644,644,1460,0,0,1,31851309,31850665,644
37200801,644,644,644,1460,0,0,1,31851953,31851309,644
37202261,644,644,644,1460,0,0,1,31852597,31851953,644
37203721,644,644,644,1460,0,0,1,31853241,31852597,644
37205181,644,644,644,1460,0,0,1,31853885,31853241,644
37206641,644,644,644,1460,0,0,1,31854529,31853885,644
37208101,644,644,644,1460,0,0,1,31855173,31854529,644
37209561,644,644,644,1460,0,0,1,31855817,31855173,644
37211021,644,644,644,1460,0,0,1,31856461,31855817,644
37212481,644,644,644,1460,0,0,1,31857105,31856461,644
37213941,644,644,644,1460,0,0,1,31857749,31857105,644
37215401,644,644,644,1460,0,0,1,31858393,31857749,644
37216861,644,644,644,1460,0,0,1,31859037,31858393,644
37218321,644,644,644,1460,0,0,1,31859681,31859037,644
37219781,644,644,644,1460,0,0,1,31860325,31859681,644
37221241,644,644,644,1460,0,0,1,31860969,31860325,644
37222701,644,644,644,1460,0,0,1,31861613,31860969,644
37224161,644,644,644,1460,0,0,1,31862257,31861613,644
37225621,644,644,644,1460,0,0,1,31862901,31862257,644
37227081,644,644,644,1460,0,0,1,31863545,31862901,644
37228541,644,644,644,1460,0,0,1,31864189,31863545,644
37230001,644,644,644,1460,0,0,1,31864833,31864189,644
37231461,644,644,644,1460,0,0,1,31865477,31864833,644
37232921,644,644,644,1460,0,0,1,31866121,31865477,644
37234381,644,644,644,1460,0,0,1,31866765,31866121,644
37235841,644,644,644,1460,0,0,1,31867409,31866765,644
37237301,644,644,644,1460,0,0,1,31868053,31867409,644
37238761,644,644,644,1460,0,0,1,31868697,31868053,644
37240221,644,644,644,1460,0,0,1,31869341,31868697,644
37241681,644,644,644,1460,0,0,1,31869985,31869341,644
37243141,644,644,644,1460,0,0,1,31870629,31869985,644
37244601,644,644,644,1460,0,0,1,31871273,31870629,644
37246061,644,644,644,1460,0,0,1,31871917,31871273,644
37247521,644,644,644,1460,0,0,1,31872561,31871917,644
37248981,644,644,644,1460,0,0,1,31873205,31872561,644
37250441,644,644,644,1460,0,0,1,31873849,31873205,644
37251901,644,644,644,1460,0,0,1,31874493,31873849,644
37253361,644,644,644,1460,0,0,1,31875137,31874493,644
37254821,644,644,644,1460,0,0,1,31875781,31875137,644
37256281,644,644,644,1460,0,0,1,31876425,31875781,644
37257741,644,644,644,1460,0,0,1,31877069,31876425,644
37259201,644,644,644,1460,0,0,1,31877713,31877069,644
37260661,644,644,644,1460,0,0,1,31878357,31877713,644
37262121,644,644,644,1460,0,0,1,31879001,31878357,644
37263581,644,644,644,1460,0,0,1,31879645,31879001,644
37265041,644,644,644,1460,0,0,1,31880289,31879645,644
37266501,644,644,644,1460,0,0,1,31880933,31880289,644
37267961,644,644,644,1460,0,0,1,31881577,31880933,644
37269421,644,644,644,1460,0,0,1,31882221,31881577,644
37270881,644,644,644,1460,0,0,1,31882865,31882221,644
37272341,644,644,644,1460,0,0,1,31883509,31882865,644
37273801,644,644,644,1460,0,0,1,31884153,31883509,644
37275261,644,644,644,1460,0,0,1,31884797,31884153,644
37276721,644,644,644,1460,0,0,1,31885441,31884797,644
37278181,644,644,644,1460,0,0,1,31886085,31885441,644
37279641,644,644,644,1460,0,0,1,31886729,31886085,644
37281101,644,644,644,1460,0,0,1,31887373,31886729,644
37282561,644,644,644,1460,0,0,1,31888017,31887373,644
37284021,644,644,644,1460,0,0,1,31888661,31888017,644
37285481,644,644,644,1460,0,0,1,31889305,31888661,644
37286941,644,644,644,1460,0,0,1,31889949,31889305,644
37288401,644,644,644,1460,0,0,1,31890593,31889949,644
37289861,644,644,644,1460,0,0,1,31891237,31890593,644
37291321,644,644,644,1460,0,0,1,31891881,31891237,644
37292781,644,644,644,1460,0,0,1,31892525,31891881,644
37294241,644,644,644,1460,0,0,1,31893169,31892525,644
37295701,644,644,644,1460,0,0,1,31893813,31893169,644
37297161,644,644,644,1460,0,0,1,31894457,31893813,644
37298621,644,644,644,1460,0,0,1,31895101,31894457,644
37300081,644,644,644,1460,0,0,1,31895745,31895101,644
37301541,644,644,644,1460,0,0,1,31896389,31895745,644
37303001,644,644,644,1460,0,0,1,31897033,31896389,644
37304461,644,644,644,1460,0,0,1,31897677,31897033,644
37305921,644,644,644,1460,0,0,1,31898321,31897677,644
37307381,644,644,644,1460,0,0,1,31898965,31898321,644
37308841,644,644,644,1460,0,0,1,31899609,31898965,644
37310301,644,644,644,1460,0,0,1,31900253,31899609,644
37311761,644,644,644,1460,0,0,1,31900897,31900253,644
37313221,644,644,644,1460,0,0,1,31901541,31900897,644
37314681,644,644,644,1460,0,0,1,31902185,31901541,644
37316141,644,644,644,1460,0,0,1,31902829,31902185,644
37317601,644,644,644,1460,0,0,1,31903473,31902829,644
37319061,644,644,644,1460,0,0,1,31904117,31903473,644
37320521,644,644,644,1460,0,0,1,31904761,31904117,644
37321981,644,644,644,1460,0,0,1,31905405,31904761,644
37323441,644,644,644,1460,0,0,1,31906049,31905405,644
37324901,644,644,644,1460,0,0,1,31906693,31906049,644
37326361,644,644,644,1460,0,0,1,31907337,31906693,644
37327821,644,644,644,1460,0,0,1,31907981,31907337,644
37329281,644,644,644,1460,0,0,1,31908625,31907981,644
37330741,644,644,644,1460,0,0,1,31909269,31908625,644
37332201,644,644,644,1460,0,0,1,31909913,31909269,644
37333661,644,644,644,1460,0,0,1,31910557,31909913,644
37335121,644,644,644,1460,0,0,1,31911201,31910557,644
37336581,644,644,644,1460,0,0,1,31911845,31911201,644
37338041,644,644,644,1460,0,0,1,31912489,31911845,644
37339501,644,644,644,1460,0,0,1,31913133,31912489,644
37340961,644,644,644,1460,0,0,1,31913777,31913133,644
37342421,644,644,644,1460,0,0,1,31914421,31913777,644
37343881,644,644,644,1460,0,0,1,31915065,31914421,644
37345341,644,644,644,1460,0,0,1,31915709,31915065,644
37346801,644,644,644,1460,0,0,1,31916353,31915709,644
37348261,644,644,644,1460,0,0,1,31916997,31916353,644
37349721,644,644,644,1460,0,0,1,31917641,31916997,644
37351181,644,644,644,1460,0,0,1,31918285,31917641,644
37352641,644,644,644,1460,0,0,1,31918929,31918285,644
37354101,644,644,644,1460,0,0,1,31919573,31918929,644
37355561,644,644,644,1460,0,0,1,31920217,31919573,644
37357021,644,644,644,1460,0,0,1,31920861,31920217,644
37358481,644,644,644,1460,0,0,1,31921505,31920861,644
37359941,644,644,644,1460,0,0,1,31922149,31921505,644
37361401,644,644,644,1460,0,0,1,31922793,31922149,644
37362861,644,644,644,1460,0,0,1,31923437,31922793,644
37364321,644,644,644,1460,0,0,1,31924081,31923437,644
37365781,644,644,644,1460,0,0,1,31924725,31924081,644
37367241,644,644,644,1460,0,0,1,31925369,31924725,644
37368701,644,644,644,1460,0,0,1,31926013,31925369,644
37370161,644,644,644,1460,0,0,1,31926657,31926013,644
37371621,644,644,644,1460,0,0,1,31927301,31926657,644
37373081,644,644,644,1460,0,0,1,31927945,31927301,644
37374541,644,644,644,1460,0,0,1,31928589,31927945,644
37376001,644,644,644,1460,0,0,1,31929233,31928589,644
37377461,644,644,644,1460,0,0,1,31929877,31929233,644
37378921,644,644,644,1460,0,0,1,31930521,31929877,644
37380381,644,644,644,1460,0,0,1,31931165,31930521,644
37381841,644,644,644,1460,0,0,1,31931809,31931165,644
37383301,644,644,644,1460,0,0,1,31932453,31931809,644
37384761,644,644,644,1460,0,0,1,31933097,31932453,644
37386221,644,644,644,1460,0,0,1,31933741,31933097,644
37387681,644,644,644,1460,0,0,1,31934385,31933741,644
37389141,644,644,644,1460,0,0,1,31935029,31934385,644
37390601,644,644,644,1460,0,0,1,31935673,31935029,644
37392061,644,644,644,1460,0,0,1,31936317,31935673,644
37393521,644,644,644,1460,0,0,1,31936961,31936317,644
37394981,644,644,644,1460,0,0,1,31937605,31936961,644
37396441,644,644,644,1460,0,0,1,31938249,31937605,644
37397901,644,644,644,1460,0,0,1,31938893,31938249,644
37399361,644,644,644,1460,0,0,1,31939537,31938893,644
37400821,644,644,644,1460,0,0,1,31940181,31939537,644
37402281,644,644,644,1460,0,0,1,31940825,31940181,644
37403741,644,644,644,1460,0,0,1,31941469,31940825,644
37405201,644,644,644,1460,0,0,1,31942113,31941469,644
37406661,644,644,644,1460,0,0,1,31942757,31942113,644
37408121,644,644,644,1460,0,0,1,31943401,31942757,644
37409581,644,644,644,1460,0,0,1,31944045,31943401,644
37411041,644,644,644,1460,0,0,1,31944689,31944045,644
37412501,644,644,644,1460,0,0,1,31945333,31944689,644
37413961,644,644,644,1460,0,0,1,31945977,31945333,644
37415421,644,644,644,1460,0,0,1,31946621,31945977,644
37416881,644,644,644,1460,0,0,1,31947265,31946621,644
37418341,644,644,644,1460,0,0,1,31947909,31947265,644
37419801,644,644,644,1460,0,0,1,31948553,31947909,644
37421261,644,644,644,1460,0,0,1,31949197,31948553,644
37422721,644,644,644,1460,0,0,1,31949841,31949197,644
37424181,644,644,644,1460,0,0,1,31950485,31949841,644
37425641,644,644,644,1460,0,0,1,31951129,31950485,644
37427101,644,644,644,1460,0,0,1,31951773,31951129,644
37428561,644,644,644,1460,0,0,1,31952417,31951773,644
37430021,644,644,644,1460,0,0,1,31953061,31952417,644
37431481,644,644,644,1460,0,0,1,31953705,31953061,644
37432941,644,644,644,1460,0,0,1,31954349,31953705,644
37434401,644,644,644,1460,0,0,1,31954993,31954349,644
37435861,644,644,644,1460,0,0,1,31955637,31954993,644
37437321,644,644,644,1460,0,0,1,31956281,31955637,644
37438781,644,644,644,1460,0,0,1,31956925,31956281,644
37440241,644,644,644,1460,0,0,1,31957569,31956925,644
37441701,644,644,644,1460,0,0,1,31958213,31957569,644
37443161,644,644,644,1460,0,0,1,31958857,31958213,644
37444621,644,644,644,1460,0,0,1,31959501,31958857,644
37446081,644,644,644,1460,0,0,1,31960145,31959501,644
37447541,644,644,644,1460,0,0,1,31960789,31960145,644
37449001,644,644,644,1460,0,0,1,31961433,31960789,644
37450461,644,644,644,1460,0,0,1,31962077,31961433,644
37451921,644,644,644,1460,0,0,1,31962721,31962077,644
37453381,644,644,644,1460,0,0,1,31963365,31962721,644
37454841,644,644,644,1460,0,0,1,31964009,31963365,644
37456301,644,644,644,1460,0,0,1,31964653,31964009,644
37457761,644,644,644,1460,0,0,1,31965297,31964653,644
37459221,644,644,644,1460,0,0,1,31965941,31965297,644
37460681,644,644,644,1460,0,0,1,31966585,31965941,644
37462141,644,644,644,1460,0,0,1,31967229,31966585,644
37463601,644,644,644,1460,0,0,1,31967873,31967229,644
37465061,644,644,644,1460,0,0,1,31968517,31967873,644
37466521,644,644,644,1460,0,0,1,31969161,31968517,644
37467981,644,644,644,1460,0,0,1,31969805,31969161,644
37469441,644,644,644,1460,0,0,1,31970449,31969805,644
37470901,644,644,644,1460,0,0,1,31971093,31970449,644
37472361,644,644,644,1460,0,0,1,31971737,31971093,644
37473821,644,644,644,1460,0,0,1,31972381,31971737,644
37475281,644,644,644,1460,0,0,1,31973025,31972381,644
37476741,644,644,644,1460,0,0,1,31973669,31973025,644
37478201,644,644,644,1460,0,0,1,31974313,31973669,644
37479661,644,644,644,1460,0,0,1,31974957,31974313,644
37481121,644,644,644,1460,0,0,1,31975601,31974957,644
37482581,644,644,644,1460,0,0,1,31976245,31975601,644
37484041,644,644,644,1460,0,0,1,31976889,31976245,644
37485501,644,644,644,1460,0,0,1,31977533,31976889,644
37486961,644,644,644,1460,0,0,1,31978177,31977533,644
37488421,644,644,644,1460,0,0,1,31978821,31978177,644
37489881,644,644,644,1460,0,0,1,31979465,31978821,644
37491341,644,644,644,1460,0,0,1,31980109,31979465,644
37492801,644,644,644,1460,0,0,1,31980753,31980109,644
37494261,644,644,644,1460,0,0,1,31981397,31980753,644
37495721,644,644,644,1460,0,0,1,31982041,31981397,644
37497181,644,644,644,1460,0,0,1,31982685,31982041,644
37498641,644,644,644,1460,0,0,1,31983329,31982685,644
37500101,644,644,644,1460,0,0,1,31983973,31983329,644
37501561,644,644,644,1460,0,0,1,31984617,31983973,644
37503021,644,644,644,1460,0,0,1,31985261,31984617,644
37504481,644,644,644,1460,0,0,1,31985905,31985261,644
37505941,644,644,644,1460,0,0,1,31986549,31985905,644
37507401,644,644,644,1460,0,0,1,31987193,31986549,644
37508861,644,644,644,1460,0,0,1,31987837,31987193,644
37510321,644,644,644,1460,0,0,1,31988481,31987837,644
37511781,644,644,644,1460,0,0,1,31989125,31988481,644
37513241,644,644,644,1460,0,0,1,31989769,31989125,644
37514701,644,644,644,1460,0,0,1,31990413,31989769,644
37516161,644,644,644,1460,0,0,1,31991057,31990413,644
37517621,644,644,644,1460,0,0,1,31991701,31991057,644
37519081,644,644,644,1460,0,0,1,31992345,31991701,644
37520541,644,644,644,1460,0,0,1,31992989,31992345,644
37522001,644,644,644,1460,0,0,1,31993633,31992989,644
37523461,644,644,644,1460,0,0,1,31994277,31993633,644
37524921,644,644,644,1460,0,0,1,31994921,31994277,644
37526381,644,644,644,1460,0,0,1,31995565,31994921,644
37527841,644,644,644,1460,0,0,1,31996209,31995565,644
37529301,644,644,644,1460,0,0,1,31996853,31996209,644
37530761,644,644,644,1460,0,0,1,31997497,31996853,644
37532221,644,644,644,1460,0,0,1,31998141,31997497,644
37533681,644,644,644,1460,0,0,1,31998785,31998141,644
37535141,644,644,644,1460,0,0,1,31999429,31998785,644
37536601,644,644,644,1460,0,0,1,32000073,31999429,644
37538061,644,644,644,1460,0,0,1,32000717,32000073,644
37539521,644,644,644,1460,0,0,1,32001361,32000717,644
37540981,644,644,644,1460,0,0,1,32002005,32001361,644
37542441,644,644,644,1460,0,0,1,32002649,32002005,644
37543901,644,644,644,1460,0,0,1,32003293,32002649,644
37545361,644,644,644,1460,0,0,1,32003937,32003293,644
37546821,644,644,644,1460,0,0,1,32004581,32003937,644
37548281,644,644,644,1460,0,0,1,32005225,32004581,644
37549741,644,644,644,1460,0,0,1,32005869,32005225,644
37551201,644,644,644,1460,0,0,1,32006513,32005869,644
37552661,644,644,644,1460,0,0,1,32007157,32006513,644
37554121,644,644,644,1460,0,0,1,32007801,32007157,644
37555581,644,644,644,1460,0,0,1,32008445,32007801,644
37557041,644,644,644,1460,0,0,1,32009089,32008445,644
37558501,644,644,644,1460,0,0,1,32009733,32009089,644
37559961,644,644,644,1460,0,0,1,32010377,32009733,644
37561421,644,644,644,1460,0,0,1,32011021,32010377,644
37562881,644,644,644,1460,0,0,1,32011665,32011021,644
37564341,644,644,644,1460,0,0,1,32012309,32011665,644
37565801,644,644,644,1460,0,0,1,32012953,32012309,644
37567261,644,644,644,1460,0,0,1,32013597,32012953,644
37568721,644,644,644,1460,0,0,1,32014241,32013597,644
37570181,644,644,644,1460,0,0,1,32014885,32014241,644
37571641,644,644,644,1460,0,0,1,32015529,32014885,644
37573101,644,644,644,1460,0,0,1,32016173,32015529,644
37574561,644,644,644,1460,0,0,1,32016817,32016173,644
37576021,644,644,644,1460,0,0,1,32017461,32016817,644
37577481,644,644,644,1460,0,0,1,32018105,32017461,644
37578941,644,644,644,1460,0,0,1,32018749,32018105,644
37580401,644,644,644,1460,0,0,1,32019393,32018749,644
37581861,644,644,644,1460,0,0,1,32020037,32019393,644
37583321,644,644,644,1460,0,0,1,32020681,32020037,644
37584781,644,644,644,1460,0,0,1,32021325,32020681,644
37586241,644,644,644,1460,0,0,1,32021969,32021325,644
37587701,644,644,644,1460,0,0,1,32022613,32021969,644
37589161,644,644,644,1460,0,0,1,32023257,32022613,644
37590621,644,644,644,1460,0,0,1,32023901,32023257,644
37592081,644,644,644,1460,0,0,1,32024545,32023901,644
37593541,644,644,644,1460,0,0,1,32025189,32024545,644
37595001,644,644,644,1460,0,0,1,32025833,32025189,644
37596461,644,644,644,1460,0,0,1,32026477,32025833,644
37597921,644,644,644,1460,0,0,1,32027121,32026477,644
37599381,644,644,644,1460,0,0,1,32027765,32027121,644
37600841,644,644,644,1460,0,0,1,32028409,32027765,644
37602301,644,644,644,1460,0,0,1,32029053,32028409,644
37603761,644,644,644,1460,0,0,1,32029697,32029053,644
37605221,644,644,644,1460,0,0,1,32030341,32029697,644
37606681,644,644,644,1460,0,0,1,32030985,32030341,644
37608141,644,644,644,1460,0,0,1,32031629,32030985,644
37609601,644,644,644,1460,0,0,1,32032273,32031629,644
37611061,644,644,644,1460,0,0,1,32032917,32032273,644
37612521,644,644,644,1460,0,0,1,32033561,32032917,644
37613981,644,644,644,1460,0,0,1,32034205,32033561,644
37615441,644,644,644,1460,0,0,1,32034849,32034205,644
37616901,644,644,644,1460,0,0,1,32035493,32034849,644
37618361,644,644,644,1460,0,0,1,32036137,32035493,644
37619821,644,644,644,1460,0,0,1,32036781,32036137,644
37621281,644,644,644,1460,0,0,1,32037425,32036781,644
37622741,644,644,644,1460,0,0,1,32038069,32037425,644
37624201,644,644,644,1460,0,0,1,32038713,32038069,644
37625661,644,644,644,1460,0,0,1,32039357,32038713,644
37627121,644,644,644,1460,0,0,1,32040001,32039357,644
37628581,644,644,644,1460,0,0,1,32040645,32040001,644
37630041,644,644,644,1460,0,0,1,32041289,32040645,644
37631501,644,644,644,1460,0,0,1,32041933,32041289,644
37632961,644,644,644,1460,0,0,1,32042577,32041933,644
37634421,644,644,644,1460,0,0,1,32043221,32042577,644
37635881,644,644,644,1460,0,0,1,32043865,32043221,644
37637341,644,644,644,1460,0,0,1,32044509,32043865,644
37638801,644,644,644,1460,0,0,1,32045153,32044509,644
37640261,644,644,644,1460,0,0,1,32045797,32045153,644
37641721,644,644,644,1460,0,0,1,32046441,32045797,644
37643181,644,644,644,1460,0,0,1,32047085,32046441,644
37644641,644,644,644,1460,0,0,1,32047729,32047085,644
37646101,644,644,644,1460,0,0,1,32048373,32047729,644
37647561,644,644,644,1460,0,0,1,32049017,32048373,644
37649021,644,644,644,1460,0,0,1,32049661,32049017,644
37650481,644,644,644,1460,0,0,1,32050305,32049661,644
37651941,644,644,644,1460,0,0,1,32050949,32050305,644
37653401,644,644,644,1460,0,0,1,32051593,32050949,644
37654861,644,644,644,1460,0,0,1,32052237,32051593,644
37656321,644,644,644,1460,0,0,1,32052881,32052237,644
37657781,644,644,644,1460,0,0,1,32053525,32052881,644
37659241,644,644,644,1460,0,0,1,32054169,32053525,644
37660701,644,644,644,1460,0,0,1,32054813,32054169,644
37662161,644,644,644,1460,0,0,1,32055457,32054813,644
37663621,644,644,644,1460,0,0,1,32056101,32055457,644
37665081,644,644,644,1460,0,0,1,32056745,32056101,644
37666541,644,644,644,1460,0,0,1,32057389,32056745,644
37668001,644,644,644,1460,0,0,1,32058033,32057389,644
37669461,644,644,644,1460,0,0,1,32058677,32058033,644
37670921,644,644,644,1460,0,0,1,32059321,32058677,644
37672381,644,644,644,1460,0,0,1,32059965,32059321,644
37673841,644,644,644,1460,0,0,1,32060609,32059965,644
37675301,644,644,644,1460,0,0,1,32061253,32060609,644
37676761,644,644,644,1460,0,0,1,32061897,32061253,644
37678221,644,644,644,1460,0,0,1,32062541,32061897,644
37679681,644,644,644,1460,0,0,1,32063185,32062541,644
37681141,644,644,644,1460,0,0,1,32063829,32063185,644
37682601,644,644,644,1460,0,0,1,32064473,32063829,644
37684061,644,644,644,1460,0,0,1,32065117,32064473,644
37685521,644,644,644,1460,0,0,1,32065761,32065117,644
37686981,644,644,644,1460,0,0,1,32066405,32065761,644
37688441,644,644,644,1460,0,0,1,32067049,32066405,644
37689901,644,644,644,1460,0,0,1,32067693,32067049,644
37691361,644,644,644,1460,0,0,1,32068337,32067693,644
37692821,644,644,644,1460,0,0,1,32068981,32068337,644
37694281,644,644,644,1460,0,0,1,32069625,32068981,644
37695741,644,644,644,1460,0,0,1,32070269,32069625,644
37697201,644,644,644,1460,0,0,1,32070913,32070269,644
37698661,644,644,644,1460,0,0,1,32071557,32070913,644
37700121,644,644,644,1460,0,0,1,32072201,32071557,644
37701581,644,644,644,1460,0,0,1,32072845,32072201,644
37703041,644,644,644,1460,0,0,1,32073489,32072845,644
37704501,644,644,644,1460,0,0,1,32074133,32073489,644
37705961,644,644,644,1460,0,0,1,32074777,32074133,644
37707421,644,644,644,1460,0,0,1,32075421,32074777,644
37708881,644,644,644,1460,0,0,1,32076065,32075421,644
37710341,644,644,644,1460,0,0,1,32076709,32076065,644
37711801,644,644,644,1460,0,0,1,32077353,32076709,644
37713261,644,644,644,1460,0,0,1,32077997,32077353,644
37714721,644,644,644,1460,0,0,1,32078641,32077997,644
37716181,644,644,644,1460,0,0,1,32079285,32078641,644
37717641,644,644,644,1460,0,0,1,32079929,32079285,644
37719101,644,644,644,1460,0,0,1,32080573,32079929,644
37720561,644,644,644,1460,0,0,1,32081217,32080573,644
37722021,644,644,644,1460,0,0,1,32081861,32081217,644
37723481,644,644,644,1460,0,0,1,32082505,32081861,644
37724941,644,644,644,1460,0,0,1,32083149,32082505,644
37726401,644,644,644,1460,0,0,1,32083793,32083149,644
37727861,644,644,644,1460,0,0,1,32084437,32083793,644
37729321,644,644,644,1460,0,0,1,32085081,32084437,644
37730781,644,644,644,1460,0,0,1,32085725,32085081,644
37732241,644,644,644,1460,0,0,1,32086369,32085725,644
37733701,644,644,644,1460,0,0,1,32087013,32086369,644
37735161,644,644,644,1460,0,0,1,32087657,32087013,644
37736621,644,644,644,1460,0,0,1,32088301,32087657,644
37738081,644,644,644,1460,0,0,1,32088945,32088301,644
37739541,644,644,644,1460,0,0,1,32089589,32088945,644
37741001,644,644,644,1460,0,0,1,32090233,32089589,644
37742461,644,644,644,1460,0,0,1,32090877,32090233,644
37743921,644,644,644,1460,0,0,1,32091521,32090877,644
37745381,644,644,644,1460,0,0,1,32092165,32091521,644
37746841,644,644,644,1460,0,0,1,32092809,32092165,644
37748301,644,644,644,1460,0,0,1,32093453,32092809,644
37749761,644,644,644,1460,0,0,1,32094097,32093453,644
37751221,644,644,644,1460,0,0,1,32094741,32094097,644
37752681,644,644,644,1460,0,0,1,32095385,32094741,644
37754141,644,644,644,1460,0,0,1,32096029,32095385,644
37755601,644,644,644,1460,0,0,1,32096673,32096029,644
37757061,644,644,644,1460,0,0,1,32097317,32096673,644
37758521,644,644,644,1460,0,0,1,32097961,32097317,644
37759981,644,644,644,1460,0,0,1,32098605,32097961,644
37761441,644,644,644,1460,0,0,1,32099249,32098605,644
37762901,644,644,644,1460,0,0,1,32099893,32099249,644
37764361,644,644,644,1460,0,0,1,32100537,32099893,644
37765821,644,644,644,1460,0,0,1,32101181,32100537,644
37767281,644,644,644,1460,0,0,1,32101825,32101181,644
37768741,644,644,644,1460,0,0,1,32102469,32101825,644
37770201,644,644,644,1460,0,0,1,32103113,32102469,644
37771661,644,644,644,1460,0,0,1,32103757,32103113,644
37773121,644,644,644,1460,0,0,1,32104401,32103757,644
37774581,644,644,644,1460,0,0,1,32105045,32104401,644
37776041,644,644,644,1460,0,0,1,32105689,32105045,644
37777501,644,644,644,1460,0,0,1,32106333,32105689,644
37778961,644,644,644,1460,0,0,1,32106977,32106333,644
37780421,644,644,644,1460,0,0,1,32107621,32106977,644
37781881,644,644,644,1460,0,0,1,32108265,32107621,644
37783341,644,644,644,1460,0,0,1,32108909,32108265,644
37784801,644,644,644,1460,0,0,1,32109553,32108909,644
37786261,644,644,644,1460,0,0,1,32110197,32109553,644
37787721,644,644,644,1460,0,0,1,32110841,32110197,644
37789181,644,644,644,1460,0,0,1,32111485,32110841,644
37790641,644,644,644,1460,0,0,1,32112129,32111485,644
37792101,644,644,644,1460,0,0,1,32112773,32112129,644
37793561,644,644,644,1460,0,0,1,32113417,32112773,644
37795021,644,644,644,1460,0,0,1,32114061,32113417,644
37796481,644,644,644,1460,0,0,1,32114705,32114061,644
37797941,644,644,644,1460,0,0,1,32115349,32114705,644
37799401,644,644,644,1460,0,0,1,32115993,32115349,644
37800861,644,644,644,1460,0,0,1,32116637,32115993,644
37802321,644,644,644,1460,0,0,1,32117281,32116637,644
37803781,644,644,644,1460,0,0,1,32117925,32117281,644
37805241,644,644,644,1460,0,0,1,32118569,32117925,644
37806701,644,644,644,1460,0,0,1,32119213,32118569,644
37808161,644,644,644,1460,0,0,1,32119857,32119213,644
37809621,644,644,644,1460,0,0,1,32120501,32119857,644
37811081,644,644,644,1460,0,0,1,32121145,32120501,644
37812541,644,644,644,1460,0,0,1,32121789,32121145,644
37814001,644,644,644,1460,0,0,1,32122433,32121789,644
37815461,644,644,644,1460,0,0,1,32123077,32122433,644
37816921,644,644,644,1460,0,0,1,32123721,32123077,644
37818381,644,644,644,1460,0,0,1,32124365,32123721,644
37819841,644,644,644,1460,0,0,1,32125009,32124365,644
37821301,644,644,644,1460,0,0,1,32125653,32125009,644
37822761,644,644,644,1460,0,0,1,32126297,32125653,644
37824221,644,644,644,1460,0,0,1,32126941,32126297,644
37825681,644,644,644,1460,0,0,1,32127585,32126941,644
37827141,644,644,644,1460,0,0,1,32128229,32127585,644
37828601,644,644,644,1460,0,0,1,32128873,32128229,644
37830061,644,644,644,1460,0,0,1,32129517,32128873,644
37831521,644,644,644,1460,0,0,1,32130161,32129517,644
37832981,644,644,644,1460,0,0,1,32130805,32130161,644
37834441,644,644,644,1460,0,0,1,32131449,32130805,644
37835901,644,644,644,1460,0,0,1,32132093,32131449,644
37837361,644,644,644,1460,0,0,1,32132737,32132093,644
37838821,644,644,644,1460,0,0,1,32133381,32132737,644
37840281,644,644,644,1460,0,0,1,32134025,32133381,644
37841741,644,644,644,1460,0,0,1,32134669,32134025,644
37843201,644,644,644,1460,0,0,1,32135313,32134669,644
37844661,644,644,644,1460,0,0,1,32135957,32135313,644
37846121,644,644,644,1460,0,0,1,32136601,32135957,644
37847581,644,644,644,1460,0,0,1,32137245,32136601,644
37849041,644,644,644,1460,0,0,1,32137889,32137245,644
37850501,644,644,644,1460,0,0,1,32138533,32137889,644
37851961,644,644,644,1460,0,0,1,32139177,32138533,644
37853421,644,644,644,1460,0,0,1,32139821,32139177,644
37854881,644,644,644,1460,0,0,1,32140465,32139821,644
37856341,644,644,644,1460,0,0,1,32141109,32140465,644
37857801,644,644,644,1460,0,0,1,32141753,32141109,644
37859261,644,644,644,1460,0,0,1,32142397,32141753,644
37860721,644,644,644,1460,0,0,1,32143041,32142397,644
37862181,644,644,644,1460,0,0,1,32143685,32143041,644
37863641,644,644,644,1460,0,0,1,32144329,32143685,644
37865101,644,644,644,1460,0,0,1,32144973,32144329,644
37866561,644,644,644,1460,0,0,1,32145617,32144973,644
37868021,644,644,644,1460,0,0,1,32146261,32145617,644
37869481,644,644,644,1460,0,0,1,32146905,32146261,644
37870941,644,644,644,1460,0,0,1,32147549,32146905,644
37872401,644,644,644,1460,0,0,1,32148193,32147549,644
37873861,644,644,644,1460,0,0,1,32148837,32148193,644
37875321,644,644,644,1460,0,0,1,32149481,32148837,644
37876781,644,644,644,1460,0,0,1,32150125,32149481,644
37878241,644,644,644,1460,0,0,1,32150769,32150125,644
37879701,644,644,644,1460,0,0,1,32151413,32150769,644
37881161,644,644,644,1460,0,0,1,32152057,32151413,644
37882621,644,644,644,1460,0,0,1,32152701,32152057,644
37884081,644,644,644,1460,0,0,1,32153345,32152701,644
37885541,644,644,644,1460,0,0,1,32153989,32153345,644
37887001,644,644,644,1460,0,0,1,32154633,32153989,644
37888461,644,644,644,1460,0,0,1,32155277,32154633,644
37889921,644,644,644,1460,0,0,1,32155921,32155277,644
37891381,644,644,644,1460,0,0,1,32156565,32155921,644
37892841,644,644,644,1460,0,0,1,32157209,32156565,644
37894301,644,644,644,1460,0,0,1,32157853,32157209,644
37895761,644,644,644,1460,0,0,1,32158497,32157853,644
37897221,644,644,644,1460,0,0,1,32159141,32158497,644
37898681,644,644,644,1460,0,0,1,32159785,32159141,644
37900141,644,644,644,1460,0,0,1,32160429,32159785,644
37901601,644,644,644,1460,0,0,1,32161073,32160429,644
37903061,644,644,644,1460,0,0,1,32161717,32161073,644
37904521,644,644,644,1460,0,0,1,32162361,32161717,644
37905981,644,644,644,1460,0,0,1,32163005,32162361,644
37907441,644,644,644,1460,0,0,1,32163649,32163005,644
37908901,644,644,644,1460,0,0,1,32164293,32163649,644
37910361,644,644,644,1460,0,0,1,32164937,32164293,644
37911821,644,644,644,1460,0,0,1,32165581,32164937,644
37913281,644,644,644,1460,0,0,1,32166225,32165581,644
37914741,644,644,644,1460,0,0,1,32166869,32166225,644
37916201,644,644,644,1460,0,0,1,32167513,32166869,644
37917661,644,644,644,1460,0,0,1,32168157,32167513,644
37919121,644,644,644,1460,0,0,1,32168801,32168157,644
37920581,644,644,644,1460,0,0,1,32169445,32168801,644
37922041,644,644,644,1460,0,0,1,32170089,32169445,644
37923501,644,644,644,1460,0,0,1,32170733,32170089,644
37924961,644,644,644,1460,0,0,1,32171377,32170733,644
37926421,644,644,644,1460,0,0,1,32172021,32171377,644
37927881,644,644,644,1460,0,0,1,32172665,32172021,644
37929341,644,644,644,1460,0,0,1,32173309,32172665,644
37930801,644,644,644,1460,0,0,1,32173953,32173309,644
37932261,644,644,644,1460,0,0,1,32174597,32173953,644
37933721,644,644,644,1460,0,0,1,32175241,32174597,644
37935181,644,644,644,1460,0,0,1,32175885,32175241,644
37936641,644,644,644,1460,0,0,1,32176529,32175885,644
37938101,644,644,644,1460,0,0,1,32177173,32176529,644
37939561,644,644,644,1460,0,0,1,32177817,32177173,644
37941021,644,644,644,1460,0,0,1,32178461,32177817,644
37942481,644,644,644,1460,0,0,1,32179105,32178461,644
37943941,644,644,644,1460,0,0,1,32179749,32179105,644
37945401,644,644,644,1460,0,0,1,32180393,32179749,644
37946861,644,644,644,1460,0,0,1,32181037,32180393,644
37948321,644,644,644,1460,0,0,1,32181681,32181037,644
37949781,644,644,644,1460,0,0,1,32182325,32181681,644
37951241,644,644,644,1460,0,0,1,32182969,32182325,644
37952701,644,644,644,1460,0,0,1,32183613,32182969,644
37954161,644,644,644,1460,0,0,1,32184257,32183613,644
37955621,644,644,644,1460,0,0,1,32184901,32184257,644
37957081,644,644,644,1460,0,0,1,32185545,32184901,644
37958541,644,644,644,1460,0,0,1,32186189,32185545,644
37960001,644,644,644,1460,0,0,1,32186833,32186189,644
37961461,644,644,644,1460,0,0,1,32187477,32186833,644
37962921,644,644,644,1460,0,0,1,32188121,32187477,644
37964381,644,644,644,1460,0,0,1,32188765,32188121,644
37965841,644,644,644,1460,0,0,1,32189409,32188765,644
37967301,644,644,644,1460,0,0,1,32190053,32189409,644
37968761,644,644,644,1460,0,0,1,32190697,32190053,644
37970221,644,644,644,1460,0,0,1,32191341,32190697,644
37971681,644,644,644,1460,0,0,1,32191985,32191341,644
37973141,644,644,644,1460,0,0,1,32192629,32191985,644
37974601,644,644,644,1460,0,0,1,32193273,32192629,644
37976061,644,644,644,1460,0,0,1,32193917,32193273,644
37977521,644,644,644,1460,0,0,1,32194561,32193917,644
37978981,644,644,644,1460,0,0,1,32195205,32194561,644
37980441,644,644,644,1460,0,0,1,32195849,32195205,644
37981901,644,644,644,1460,0,0,1,32196493,32195849,644
37983361,644,644,644,1460,0,0,1,32197137,32196493,644
37984821,644,644,644,1460,0,0,1,32197781,32197137,644
37986281,644,644,644,1460,0,0,1,32198425,32197781,644
37987741,644,644,644,1460,0,0,1,32199069,32198425,644
37989201,644,644,644,1460,0,0,1,32199713,32199069,644
37990661,644,644,644,1460,0,0,1,32200357,32199713,644
37992121,644,644,644,1460,0,0,1,32201001,32200357,644
37993581,644,644,644,1460,0,0,1,32201645,32201001,644
37995041,644,644,644,1460,0,0,1,32202289,32201645,644
37996501,644,644,644,1460,0,0,1,32202933,32202289,644
37997961,644,644,644,1460,0,0,1,32203577,32202933,644
37999421,644,644,644,1460,0,0,1,32204221,32203577,644
38000881,644,644,644,1460,0,0,1,32204865,32204221,644
38002341,644,644,644,1460,0,0,1,32205509,32204865,644
38003801,644,644,644,1460,0,0,1,32206153,32205509,644
38005261,644,644,644,1460,0,0,1,32206797,32206153,644
38006721,644,644,644,1460,0,0,1,32207441,32206797,644
38008181,644,644,644,1460,0,0,1,32208085,32207441,644
38009641,644,644,644,1460,0,0,1,32208729,32208085,644
38011101,644,644,644,1460,0,0,1,32209373,32208729,644
38012561,644,644,644,1460,0,0,1,32210017,32209373,644
38014021,644,644,644,1460,0,0,1,32210661,32210017,644
38015481,644,644,644,1460,0,0,1,32211305,32210661,644
38016941,644,644,644,1460,0,0,1,32211949,32211305,644
38018401,644,644,644,1460,0,0,1,32212593,32211949,644
38019861,644,644,644,1460,0,0,1,32213237,32212593,644
38021321,644,644,644,1460,0,0,1,32213881,32213237,644
38022781,644,644,644,1460,0,0,1,32214525,32213881,644
38024241,644,644,644,1460,0,0,1,32215169,32214525,644
38025701,644,644,644,1460,0,0,1,32215813,32215169,644
38027161,644,644,644,1460,0,0,1,32216457,32215813,644
38028621,644,644,644,1460,0,0,1,32217101,32216457,644
38030081,644,644,644,1460,0,0,1,32217745,32217101,644
38031541,644,644,644,1460,0,0,1,32218389,32217745,644
38033001,644,644,644,1460,0,0,1,32219033,32218389,644
38034461,644,644,644,1460,0,0,1,32219677,32219033,644
38035921,644,644,644,1460,0,0,1,32220321,32219677,644
38037381,644,644,644,1460,0,0,1,32220965,32220321,644
38038841,644,644,644,1460,0,0,1,32221609,32220965,644
38040301,644,644,644,1460,0,0,1,32222253,32221609,644
38041761,644,644,644,1460,0,0,1,32222897,32222253,644
38043221,644,644,644,1460,0,0,1,32223541,32222897,644
38044681,644,644,644,1460,0,0,1,32224185,32223541,644
38046141,644,644,644,1460,0,0,1,32224829,32224185,644
38047601,644,644,644,1460,0,0,1,32225473,32224829,644
38049061,644,644,644,1460,0,0,1,32226117,32225473,644
38050521,644,644,644,1460,0,0,1,32226761,32226117,644
38051981,644,644,644,1460,0,0,1,32227405,32226761,644
38053441,644,644,644,1460,0,0,1,32228049,32227405,644
38054901,644,644,644,1460,0,0,1,32228693,32228049,644
38056361,644,644,644,1460,0,0,1,32229337,32228693,644
38057821,644,644,644,1460,0,0,1,32229981,32229337,644
38059281,644,644,644,1460,0,0,1,32230625,32229981,644
38060741,644,644,644,1460,0,0,1,32231269,32230625,644
38062201,644,644,644,1460,0,0,1,32231913,32231269,644
38063661,644,644,644,1460,0,0,1,32232557,32231913,644
38065121,644,644,644,1460,0,0,1,32233201,32232557,644
38066581,644,644,644,1460,0,0,1,32233845,32233201,644
38068041,644,644,644,1460,0,0,1,32234489,32233845,644
38069501,644,644,644,1460,0,0,1,32235133,32234489,644
38070961,644,644,644,1460,0,0,1,32235777,32235133,644
38072421,644,644,644,1460,0,0,1,32236421,32235777,644
38073881,644,644,644,1460,0,0,1,32237065,32236421,644
38075341,644,644,644,1460,0,0,1,32237709,32237065,644
38076801,644,644,644,1460,0,0,1,32238353,32237709,644
38078261,644,644,644,1460,0,0,1,32238997,32238353,644
38079721,644,644,644,1460,0,0,1,32239641,32238997,644
38081181,644,644,644,1460,0,0,1,32240285,32239641,644
38082641,644,644,644,1460,0,0,1,32240929,32240285,644
38084101,644,644,644,1460,0,0,1,32241573,32240929,644
38085561,644,644,644,1460,0,0,1,32242217,32241573,644
38087021,644,644,644,1460,0,0,1,32242861,32242217,644
38088481,644,644,644,1460,0,0,1,32243505,32242861,644
38089941,644,644,644,1460,0,0,1,32244149,32243505,644
38091401,644,644,644,1460,0,0,1,32244793,32244149,644
38092861,644,644,644,1460,0,0,1,32245437,32244793,644
38094321,644,644,644,1460,0,0,1,32246081,32245437,644
38095781,644,644,644,1460,0,0,1,32246725,32246081,644
38097241,644,644,644,1460,0,0,1,32247369,32246725,644
38098701,644,644,644,1460,0,0,1,32248013,32247369,644
38100161,644,644,644,1460,0,0,1,32248657,32248013,644
38101621,644,644,644,1460,0,0,1,32249301,32248657,644
38103081,644,644,644,1460,0,0,1,32249945,32249301,644
38104541,644,644,644,1460,0,0,1,32250589,32249945,644
38106001,644,644,644,1460,0,0,1,32251233,32250589,644
38107461,644,644,644,1460,0,0,1,32251877,32251233,644
38108921,644,644,644,1460,0,0,1,32252521,32251877,644
38110381,644,644,644,1460,0,0,1,32253165,32252521,644
38111841,644,644,644,1460,0,0,1,32253809,32253165,644
38113301,644,644,644,1460,0,0,1,32254453,32253809,644
38114761,644,644,644,1460,0,0,1,32255097,32254453,644
38116221,644,644,644,1460,0,0,1,32255741,32255097,644
38117681,644,644,644,1460,0,0,1,32256385,32255741,644
38119141,644,644,644,1460,0,0,1,32257029,32256385,644
38120601,644,644,644,1460,0,0,1,32257673,32257029,644
38122061,644,644,644,1460,0,0,1,32258317,32257673,644
38123521,644,644,644,1460,0,0,1,32258961,32258317,644
38124981,644,644,644,1460,0,0,1,32259605,32258961,644
38126441,644,644,644,1460,0,0,1,32260249,32259605,644
38127901,644,644,644,1460,0,0,1,32260893,32260249,644
38129361,644,644,644,1460,0,0,1,32261537,32260893,644
38130821,644,644,644,1460,0,0,1,32262181,32261537,644
38132281,644,644,644,1460,0,0,1,32262825,32262181,644
38133741,644,644,644,1460,0,0,1,32263469,32262825,644
38135201,644,644,644,1460,0,0,1,32264113,32263469,644
38136661,644,644,644,1460,0,0,1,32264757,32264113,644
38138121,644,644,644,1460,0,0,1,32265401,32264757,644
38139581,644,644,644,1460,0,0,1,32266045,32265401,644
38141041,644,644,644,1460,0,0,1,32266689,32266045,644
38142501,644,644,644,1460,0,0,1,32267333,32266689,644
38143961,644,644,644,1460,0,0,1,32267977,32267333,644
38145421,644,644,644,1460,0,0,1,32268621,32267977,644
38146881,644,644,644,1460,0,0,1,32269265,32268621,644
38148341,644,644,644,1460,0,0,1,32269909,32269265,644
38149801,644,644,644,1460,0,0,1,32270553,32269909,644
38151261,644,644,644,1460,0,0,1,32271197,32270553,644
38152721,644,644,644,1460,0,0,1,32271841,32271197,644
38154181,644,644,644,1460,0,0,1,32272485,32271841,644
38155641,644,644,644,1460,0,0,1,32273129,32272485,644
38157101,644,644,644,1460,0,0,1,32273773,32273129,644
38158561,644,644,644,1460,0,0,1,32274417,32273773,644
38160021,644,644,644,1460,0,0,1,32275061,32274417,644
38161481,644,644,644,1460,0,0,1,32275705,32275061,644
38162941,644,644,644,1460,0,0,1,32276349,32275705,644
38164401,644,644,644,1460,0,0,1,32276993,32276349,644
38165861,644,644,644,1460,0,0,1,32277637,32276993,644
38167321,644,644,644,1460,0,0,1,32278281,32277637,644
38168781,644,644,644,1460,0,0,1,32278925,32278281,644
38170241,644,644,644,1460,0,0,1,32279569,32278925,644
38171701,644,644,644,1460,0,0,1,32280213,32279569,644
38173161,644,644,644,1460,0,0,1,32280857,32280213,644
38174621,644,644,644,1460,0,0,1,32281501,32280857,644
38176081,644,644,644,1460,0,0,1,32282145,32281501,644
38177541,644,644,644,1460,0,0,1,32282789,32282145,644
38179001,644,644,644,1460,0,0,1,32283433,32282789,644
38180461,644,644,644,1460,0,0,1,32284077,32283433,644
38181921,644,644,644,1460,0,0,1,32284721,32284077,644
38183381,644,644,644,1460,0,0,1,32285365,32284721,644
38184841,644,644,644,1460,0,0,1,32286009,32285365,644
38186301,644,644,644,1460,0,0,1,32286653,32286009,644
38187761,644,644,644,1460,0,0,1,32287297,32286653,644
38189221,644,644,644,1460,0,0,1,32287941,32287297,644
38190681,644,644,644,1460,0,0,1,32288585,32287941,644
38192141,644,644,644,1460,0,0,1,32289229,32288585,644
38193601,644,644,644,1460,0,0,1,32289873,32289229,644
38195061,644,644,644,1460,0,0,1,32290517,32289873,644
38196521,644,644,644,1460,0,0,1,32291161,32290517,644
38197981,644,644,644,1460,0,0,1,32291805,32291161,644
38199441,644,644,644,1460,0,0,1,32292449,32291805,644
38200901,644,644,644,1460,0,0,1,32293093,32292449,644
38202361,644,644,644,1460,0,0,1,32293737,32293093,644
38203821,644,644,644,1460,0,0,1,32294381,32293737,644
38205281,644,644,644,1460,0,0,1,32295025,32294381,644
38206741,644,644,644,1460,0,0,1,32295669,32295025,644
38208201,644,644,644,1460,0,0,1,32296313,32295669,644
38209661,644,644,644,1460,0,0,1,32296957,32296313,644
38211121,644,644,644,1460,0,0,1,32297601,32296957,644
38212581,644,644,644,1460,0,0,1,32298245,32297601,644
38214041,644,644,644,1460,0,0,1,32298889,32298245,644
38215501,644,644,644,1460,0,0,1,32299533,32298889,644
38216961,644,644,644,1460,0,0,1,32300177,32299533,644
38218421,644,644,644,1460,0,0,1,32300821,32300177,644
38219881,644,644,644,1460,0,0,1,32301465,32300821,644
38221341,644,644,644,1460,0,0,1,32302109,32301465,644
38222801,644,644,644,1460,0,0,1,32302753,32302109,644
38224261,644,644,644,1460,0,0,1,32303397,32302753,644
38225721,644,644,644,1460,0,0,1,32304041,32303397,644
38227181,644,644,644,1460,0,0,1,32304685,32304041,644
38228641,644,644,644,1460,0,0,1,32305329,32304685,644
38230101,644,644,644,1460,0,0,1,32305973,32305329,644
38231561,644,644,644,1460,0,0,1,32306617,32305973,644
38233021,644,644,644,1460,0,0,1,32307261,32306617,644
38234481,644,644,644,1460,0,0,1,32307905,32307261,644
38235941,644,644,644,1460,0,0,1,32308549,32307905,644
38237401,644,644,644,1460,0,0,1,32309193,32308549,644
38238861,644,644,644,1460,0,0,1,32309837,32309193,644
38240321,644,644,644,1460,0,0,1,32310481,32309837,644
38241781,644,644,644,1460,0,0,1,32311125,32310481,644
38243241,644,644,644,1460,0,0,1,32311769,32311125,644
38244701,644,644,644,1460,0,0,1,32312413,32311769,644
38246161,644,644,644,1460,0,0,1,32313057,32312413,644
38247621,644,644,644,1460,0,0,1,32313701,32313057,644
38249081,644,644,644,1460,0,0,1,32314345,32313701,644
38250541,644,644,644,1460,0,0,1,32314989,32314345,644
38252001,644,644,644,1460,0,0,1,32315633,32314989,644
38253461,644,644,644,1460,0,0,1,32316277,32315633,644
38254921,644,644,644,1460,0,0,1,32316921,32316277,644
38256381,644,644,644,1460,0,0,1,32317565,32316921,644
38257841,644,644,644,1460,0,0,1,32318209,32317565,644
38259301,644,644,644,1460,0,0,1,32318853,32318209,644
38260761,644,644,644,1460,0,0,1,32319497,32318853,644
38262221,644,644,644,1460,0,0,1,32320141,32319497,644
38263681,644,644,644,1460,0,0,1,32320785,32320141,644
38265141,644,644,644,1460,0,0,1,32321429,32320785,644
38266601,644,644,644,1460,0,0,1,32322073,32321429,644
38268061,644,644,644,1460,0,0,1,32322717,32322073,644
38269521,644,644,644,1460,0,0,1,32323361,32322717,644
38270981,644,644,644,1460,0,0,1,32324005,32323361,644
38272441,644,644,644,1460,0,0,1,32324649,32324005,644
38273901,644,644,644,1460,0,0,1,32325293,32324649,644
38275361,644,644,644,1460,0,0,1,32325937,32325293,644
38276821,644,644,644,1460,0,0,1,32326581,32325937,644
38278281,644,644,644,1460,0,0,1,32327225,32326581,644
38279741,644,644,644,1460,0,0,1,32327869,32327225,644
38281201,644,644,644,1460,0,0,1,32328513,32327869,644
38282661,644,644,644,1460,0,0,1,32329157,32328513,644
38284121,644,644,644,1460,0,0,1,32329801,32329157,644
38285581,644,644,644,1460,0,0,1,32330445,32329801,644
38287041,644,644,644,1460,0,0,1,32331089,32330445,644
38288501,644,644,644,1460,0,0,1,32331733,32331089,644
38289961,644,644,644,1460,0,0,1,32332377,32331733,644
38291421,644,644,644,1460,0,0,1,32333021,32332377,644
38292881,644,644,644,1460,0,0,1,32333665,32333021,644
38294341,644,644,644,1460,0,0,1,32334309,32333665,644
38295801,644,644,644,1460,0,0,1,32334953,32334309,644
38297261,644,644,644,1460,0,0,1,32335597,32334953,644
38298721,644,644,644,1460,0,0,1,32336241,32335597,644
38300181,644,644,644,1460,0,0,1,32336885,32336241,644
38301641,644,644,644,1460,0,0,1,32337529,32336885,644
38303101,644,644,644,1460,0,0,1,32338173,32337529,644
38304561,644,644,644,1460,0,0,1,32338817,32338173,644
38306021,644,644,644,1460,0,0,1,32339461,32338817,644
38307481,644,644,644,1460,0,0,1,32340105,32339461,644
38308941,644,644,644,1460,0,0,1,32340749,32340105,644
38310401,644,644,644,1460,0,0,1,32341393,32340749,644
38311861,644,644,644,1460,0,0,1,32342037,32341393,644
38313321,644,644,644,1460,0,0,1,32342681,32342037,644
38314781,644,644,644,1460,0,0,1,32343325,32342681,644
38316241,644,644,644,1460,0,0,1,32343969,32343325,644
38317701,644,644,644,1460,0,0,1,32344613,32343969,644
38319161,644,644,644,1460,0,0,1,32345257,32344613,644
38320621,644,644,644,1460,0,0,1,32345901,32345257,644
38322081,644,644,644,1460,0,0,1,32346545,32345901,644
38323541,644,644,644,1460,0,0,1,32347189,32346545,644
38325001,644,644,644,1460,0,0,1,32347833,32347189,644
38326461,644,644,644,1460,0,0,1,32348477,32347833,644
38327921,644,644,644,1460,0,0,1,32349121,32348477,644
38329381,644,644,644,1460,0,0,1,32349765,32349121,644
38330841,644,644,644,1460,0,0,1,32350409,32349765,644
38332301,644,644,644,1460,0,0,1,32351053,32350409,644
38333761,644,644,644,1460,0,0,1,32351697,32351053,644
38335221,644,644,644,1460,0,0,1,32352341,32351697,644
38336681,644,644,644,1460,0,0,1,32352985,32352341,644
38338141,644,644,644,1460,0,0,1,32353629,32352985,644
38339601,644,644,644,1460,0,0,1,32354273,32353629,644
38341061,644,644,644,1460,0,0,1,32354917,32354273,644
38342521,644,644,644,1460,0,0,1,32355561,32354917,644
38343981,644,644,644,1460,0,0,1,32356205,32355561,644
38345441,644,644,644,1460,0,0,1,32356849,32356205,644
38346901,644,644,644,1460,0,0,1,32357493,32356849,644
38348361,644,644,644,1460,0,0,1,32358137,32357493,644
38349821,644,644,644,1460,0,0,1,32358781,32358137,644
38351281,644,644,644,1460,0,0,1,32359425,32358781,644
38352741,644,644,644,1460,0,0,1,32360069,32359425,644
38354201,644,644,644,1460,0,0,1,32360713,32360069,644
38355661,644,644,644,1460,0,0,1,32361357,32360713,644
38357121,644,644,644,1460,0,0,1,32362001,32361357,644
38358581,644,644,644,1460,0,0,1,32362645,32362001,644
38360041,644,644,644,1460,0,0,1,32363289,32362645,644
38361501,644,644,644,1460,0,0,1,32363933,32363289,644
38362961,644,644,644,1460,0,0,1,32364577,32363933,644
38364421,644,644,644,1460,0,0,1,32365221,32364577,644
38365881,644,644,644,1460,0,0,1,32365865,32365221,644
38367341,644,644,644,1460,0,0,1,32366509,32365865,644
38368801,644,644,644,1460,0,0,1,32367153,32366509,644
38370261,644,644,644,1460,0,0,1,32367797,32367153,644
38371721,644,644,644,1460,0,0,1,32368441,32367797,644
38373181,644,644,644,1460,0,0,1,32369085,32368441,644
38374641,644,644,644,1460,0,0,1,32369729,32369085,644
38376101,644,644,644,1460,0,0,1,32370373,32369729,644
38377561,644,644,644,1460,0,0,1,32371017,32370373,644
38379021,644,644,644,1460,0,0,1,32371661,32371017,644
38380481,644,644,644,1460,0,0,1,32372305,32371661,644
38381941,644,644,644,1460,0,0,1,32372949,32372305,644
38383401,644,644,644,1460,0,0,1,32373593,32372949,644
38384861,644,644,644,1460,0,0,1,32374237,32373593,644
38386321,644,644,644,1460,0,0,1,32374881,32374237,644
38387781,644,644,644,1460,0,0,1,32375525,32374881,644
38389241,644,644,644,1460,0,0,1,32376169,32375525,644
38390701,644,644,644,1460,0,0,1,32376813,32376169,644
38392161,644,644,644,1460,0,0,1,32377457,32376813,644
38393621,644,644,644,1460,0,0,1,32378101,32377457,644
38395081,644,644,644,1460,0,0,1,32378745,32378101,644
38396541,644,644,644,1460,0,0,1,32379389,32378745,644
38398001,644,644,644,1460,0,0,1,32380033,32379389,644
38399461,644,644,644,1460,0,0,1,32380677,32380033,644
38400921,644,644,644,1460,0,0,1,32381321,32380677,644
38402381,644,644,644,1460,0,0,1,32381965,32381321,644
38403841,644,644,644,1460,0,0,1,32382609,32381965,644
38405301,644,644,644,1460,0,0,1,32383253,32382609,644
38406761,644,644,644,1460,0,0,1,32383897,32383253,644
38408221,644,644,644,1460,0,0,1,32384541,32383897,644
38409681,644,644,644,1460,0,0,1,32385185,32384541,644
38411141,644,644,644,1460,0,0,1,32385829,32385185,644
38412601,644,644,644,1460,0,0,1,32386473,32385829,644
38414061,644,644,644,1460,0,0,1,32387117,32386473,644
38415521,644,644,644,1460,0,0,1,32387761,32387117,644
38416981,644,644,644,1460,0,0,1,32388405,32387761,644
38418441,644,644,644,1460,0,0,1,32389049,32388405,644
38419901,644,644,644,1460,0,0,1,32389693,32389049,644
38421361,644,644,644,1460,0,0,1,32390337,32389693,644
38422821,644,644,644,1460,0,0,1,32390981,32390337,644
38424281,644,644,644,1460,0,0,1,32391625,32390981,644
38425741,644,644,644,1460,0,0,1,32392269,32391625,644
38427201,644,644,644,1460,0,0,1,32392913,32392269,644
38428661,644,644,644,1460,0,0,1,32393557,32392913,644
38430121,644,644,644,1460,0,0,1,32394201,32393557,644
38431581,644,644,644,1460,0,0,1,32394845,32394201,644
38433041,644,644,644,1460,0,0,1,32395489,32394845,644
38434501,644,644,644,1460,0,0,1,32396133,32395489,644
38435961,644,644,644,1460,0,0,1,32396777,32396133,644
38437421,644,644,644,1460,0,0,1,32397421,32396777,644
38438881,644,644,644,1460,0,0,1,32398065,32397421,644
38440341,644,644,644,1460,0,0,1,32398709,32398065,644
38441801,644,644,644,1460,0,0,1,32399353,32398709,644
38443261,644,644,644,1460,0,0,1,32399997,32399353,644
38444721,644,644,644,1460,0,0,1,32400641,32399997,644
38446181,644,644,644,1460,0,0,1,32401285,32400641,644
38447641,644,644,644,1460,0,0,1,32401929,32401285,644
38449101,644,644,644,1460,0,0,1,32402573,32401929,644
38450561,644,644,644,1460,0,0,1,32403217,32402573,644
38452021,644,644,644,1460,0,0,1,32403861,32403217,644
38453481,644,644,644,1460,0,0,1,32404505,32403861,644
38454941,644,644,644,1460,0,0,1,32405149,32404505,644
38456401,644,644,644,1460,0,0,1,32405793,32405149,644
38457861,644,644,644,1460,0,0,1,32406437,32405793,644
38459321,644,644,644,1460,0,0,1,32407081,32406437,644
38460781,644,644,644,1460,0,0,1,32407725,32407081,644
38462241,644,644,644,1460,0,0,1,32408369,32407725,644
38463701,644,644,644,1460,0,0,1,32409013,32408369,644
38465161,644,644,644,1460,0,0,1,32409657,32409013,644
38466621,644,644,644,1460,0,0,1,32410301,32409657,644
38468081,644,644,644,1460,0,0,1,32410945,32410301,644
38469541,644,644,644,1460,0,0,1,32411589,32410945,644
38471001,644,644,644,1460,0,0,1,32412233,32411589,644
38472461,644,644,644,1460,0,0,1,32412877,32412233,644
38473921,644,644,644,1460,0,0,1,32413521,32412877,644
38475381,644,644,644,1460,0,0,1,32414165,32413521,644
38476841,644,644,644,1460,0,0,1,32414809,32414165,644
38478301,644,644,644,1460,0,0,1,32415453,32414809,644
38479761,644,644,644,1460,0,0,1,32416097,32415453,644
38481221,644,644,644,1460,0,0,1,32416741,32416097,644
38482681,644,644,644,1460,0,0,1,32417385,32416741,644
38484141,644,644,644,1460,0,0,1,32418029,32417385,644
38485601,644,644,644,1460,0,0,1,32418673,32418029,644
38487061,644,644,644,1460,0,0,1,32419317,32418673,644
38488521,644,644,644,1460,0,0,1,32419961,32419317,644
38489981,644,644,644,1460,0,0,1,32420605,32419961,644
38491441,644,644,644,1460,0,0,1,32421249,32420605,644
38492901,644,644,644,1460,0,0,1,32421893,32421249,644
38494361,644,644,644,1460,0,0,1,32422537,32421893,644
38495821,644,644,644,1460,0,0,1,32423181,32422537,644
38497281,644,644,644,1460,0,0,1,32423825,32423181,644
38498741,644,644,644,1460,0,0,1,32424469,32423825,644
38500201,644,644,644,1460,0,0,1,32425113,32424469,644
38501661,644,644,644,1460,0,0,1,32425757,32425113,644
38503121,644,644,644,1460,0,0,1,32426401,32425757,644
38504581,644,644,644,1460,0,0,1,32427045,32426401,644
38506041,644,644,644,1460,0,0,1,32427689,32427045,644
38507501,644,644,644,1460,0,0,1,32428333,32427689,644
38508961,644,644,644,1460,0,0,1,32428977,32428333,644
38510421,644,644,644,1460,0,0,1,32429621,32428977,644
38511881,644,644,644,1460,0,0,1,32430265,32429621,644
38513341,644,644,644,1460,0,0,1,32430909,32430265,644
38514801,644,644,644,1460,0,0,1,32431553,32430909,644
38516261,644,644,644,1460,0,0,1,32432197,32431553,644
38517721,644,644,644,1460,0,0,1,32432841,32432197,644
38519181,644,644,644,1460,0,0,1,32433485,32432841,644
38520641,644,644,644,1460,0,0,1,32434129,32433485,644
38522101,644,644,644,1460,0,0,1,32434773,32434129,644
38523561,644,644,644,1460,0,0,1,32435417,32434773,644
38525021,644,644,644,1460,0,0,1,32436061,32435417,644
38526481,644,644,644,1460,0,0,1,32436705,32436061,644
38527941,644,644,644,1460,0,0,1,32437349,32436705,644
38529401,644,644,644,1460,0,0,1,32437993,32437349,644
38530861,644,644,644,1460,0,0,1,32438637,32437993,644
38532321,644,644,644,1460,0,0,1,32439281,32438637,644
38533781,644,644,644,1460,0,0,1,32439925,32439281,644
38535241,644,644,644,1460,0,0,1,32440569,32439925,644
38536701,644,644,644,1460,0,0,1,32441213,32440569,644
38538161,644,644,644,1460,0,0,1,32441857,32441213,644
38539621,644,644,644,1460,0,0,1,32442501,32441857,644
38541081,644,644,644,1460,0,0,1,32443145,32442501,644
38542541,644,644,644,1460,0,0,1,32443789,32443145,644
38544001,644,644,644,1460,0,0,1,32444433,32443789,644
38545461,644,644,644,1460,0,0,1,32445077,32444433,644
38546921,644,644,644,1460,0,0,1,32445721,32445077,644
38548381,644,644,644,1460,0,0,1,32446365,32445721,644
38549841,644,644,644,1460,0,0,1,32447009,32446365,644
38551301,644,644,644,1460,0,0,1,32447653,32447009,644
38552761,644,644,644,1460,0,0,1,32448297,32447653,644
38554221,644,644,644,1460,0,0,1,32448941,32448297,644
38555681,644,644,644,1460,0,0,1,32449585,32448941,644
38557141,644,644,644,1460,0,0,1,32450229,32449585,644
38558601,644,644,644,1460,0,0,1,32450873,32450229,644
38560061,644,644,644,1460,0,0,1,32451517,32450873,644
38561521,644,644,644,1460,0,0,1,32452161,32451517,644
38562981,644,644,644,1460,0,0,1,32452805,32452161,644
38564441,644,644,644,1460,0,0,1,32453449,32452805,644
38565901,644,644,644,1460,0,0,1,32454093,32453449,644
38567361,644,644,644,1460,0,0,1,32454737,32454093,644
38568821,644,644,644,1460,0,0,1,32455381,32454737,644
38570281,644,644,644,1460,0,0,1,32456025,32455381,644
38571741,644,644,644,1460,0,0,1,32456669,32456025,644
38573201,644,644,644,1460,0,0,1,32457313,32456669,644
38574661,644,644,644,1460,0,0,1,32457957,32457313,644
38576121,644,644,644,1460,0,0,1,32458601,32457957,644
38577581,644,644,644,1460,0,0,1,32459245,32458601,644
38579041,644,644,644,1460,0,0,1,32459889,32459245,644
38580501,644,644,644,1460,0,0,1,32460533,32459889,644
38581961,644,644,644,1460,0,0,1,32461177,32460533,644
38583421,644,644,644,1460,0,0,1,32461821,32461177,644
38584881,644,644,644,1460,0,0,1,32462465,32461821,644
38586341,644,644,644,1460,0,0,1,32463109,32462465,644
38587801,644,644,644,1460,0,0,1,32463753,32463109,644
38589261,644,644,644,1460,0,0,1,32464397,32463753,644
38590721,644,644,644,1460,0,0,1,32465041,32464397,644
38592181,644,644,644,1460,0,0,1,32465685,32465041,644
38593641,644,644,644,1460,0,0,1,32466329,32465685,644
38595101,644,644,644,1460,0,0,1,32466973,32466329,644
38596561,644,644,644,1460,0,0,1,32467617,32466973,644
38598021,644,644,644,1460,0,0,1,32468261,32467617,644
38599481,644,644,644,1460,0,0,1,32468905,32468261,644
38600941,644,644,644,1460,0,0,1,32469549,32468905,644
38602401,644,644,644,1460,0,0,1,32470193,32469549,644
38603861,644,644,644,1460,0,0,1,32470837,32470193,644
38605321,644,644,644,1460,0,0,1,32471481,32470837,644
38606781,644,644,644,1460,0,0,1,32472125,32471481,644
38608241,644,644,644,1460,0,0,1,32472769,32472125,644
38609701,644,644,644,1460,0,0,1,32473413,32472769,644
38611161,644,644,644,1460,0,0,1,32474057,32473413,644
38612621,644,644,644,1460,0,0,1,32474701,32474057,644
38614081,644,644,644,1460,0,0,1,32475345,32474701,644
38615541,644,644,644,1460,0,0,1,32475989,32475345,644
38617001,644,644,644,1460,0,0,1,32476633,32475989,644
38618461,644,644,644,1460,0,0,1,32477277,32476633,644
38619921,644,644,644,1460,0,0,1,32477921,32477277,644
38621381,644,644,644,1460,0,0,1,32478565,32477921,644
38622841,644,644,644,1460,0,0,1,32479209,32478565,644
38624301,644,644,644,1460,0,0,1,32479853,32479209,644
38625761,644,644,644,1460,0,0,1,32480497,32479853,644
38627221,644,644,644,1460,0,0,1,32481141,32480497,644
38628681,644,644,644,1460,0,0,1,32481785,32481141,644
38630141,644,644,644,1460,0,0,1,32482429,32481785,644
38631601,644,644,644,1460,0,0,1,32483073,32482429,644
38633061,644,644,644,1460,0,0,1,32483717,32483073,644
38634521,644,644,644,1460,0,0,1,32484361,32483717,644
38635981,644,644,644,1460,0,0,1,32485005,32484361,644
38637441,644,644,644,1460,0,0,1,32485649,32485005,644
38638901,644,644,644,1460,0,0,1,32486293,32485649,644
38640361,644,644,644,1460,0,0,1,32486937,32486293,644
38641821,644,644,644,1460,0,0,1,32487581,32486937,644
38643281,644,644,644,1460,0,0,1,32488225,32487581,644
38644741,644,644,644,1460,0,0,1,32488869,32488225,644
38646201,644,644,644,1460,0,0,1,32489513,32488869,644
38647661,644,644,644,1460,0,0,1,32490157,32489513,644
38649121,644,644,644,1460,0,0,1,32490801,32490157,644
38650581,644,644,644,1460,0,0,1,32491445,32490801,644
38652041,644,644,644,1460,0,0,1,32492089,32491445,644
38653501,644,644,644,1460,0,0,1,32492733,32492089,644
38654961,644,644,644,1460,0,0,1,32493377,32492733,644
38656421,644,644,644,1460,0,0,1,32494021,32493377,644
38657881,644,644,644,1460,0,0,1,32494665,32494021,644
38659341,644,644,644,1460,0,0,1,32495309,32494665,644
38660801,644,644,644,1460,0,0,1,32495953,32495309,644
38662261,644,644,644,1460,0,0,1,32496597,32495953,644
38663721,644,644,644,1460,0,0,1,32497241,32496597,644
38665181,644,644,644,1460,0,0,1,32497885,32497241,644
38666641,644,644,644,1460,0,0,1,32498529,32497885,644
38668101,644,644,644,1460,0,0,1,32499173,32498529,644
38669561,644,644,644,1460,0,0,1,32499817,32499173,644
38671021,644,644,644,1460,0,0,1,32500461,32499817,644
38672481,644,644,644,1460,0,0,1,32501105,32500461,644
38673941,644,644,644,1460,0,0,1,32501749,32501105,644
38675401,644,644,644,1460,0,0,1,32502393,32501749,644
38676861,644,644,644,1460,0,0,1,32503037,32502393,644
38678321,644,644,644,1460,0,0,1,32503681,32503037,644
38679781,644,644,644,1460,0,0,1,32504325,32503681,644
38681241,644,644,644,1460,0,0,1,32504969,32504325,644
38682701,644,644,644,1460,0,0,1,32505613,32504969,644
38684161,644,644,644,1460,0,0,1,32506257,32505613,644
38685621,644,644,644,1460,0,0,1,32506901,32506257,644
38687081,644,644,644,1460,0,0,1,32507545,32506901,644
38688541,644,644,644,1460,0,0,1,32508189,32507545,644
38690001,644,644,644,1460,0,0,1,32508833,32508189,644
38691461,644,644,644,1460,0,0,1,32509477,32508833,644
38692921,644,644,644,1460,0,0,1,32510121,32509477,644
38694381,644,644,644,1460,0,0,1,32510765,32510121,644
38695841,644,644,644,1460,0,0,1,32511409,32510765,644
38697301,644,644,644,1460,0,0,1,32512053,32511409,644
38698761,644,644,644,1460,0,0,1,32512697,32512053,644
38700221,644,644,644,1460,0,0,1,32513341,32512697,644
38701681,644,644,644,1460,0,0,1,32513985,32513341,644
38703141,644,644,644,1460,0,0,1,32514629,32513985,644
38704601,644,644,644,1460,0,0,1,32515273,32514629,644
38706061,644,644,644,1460,0,0,1,32515917,32515273,644
38707521,644,644,644,1460,0,0,1,32516561,32515917,644
38708981,644,644,644,1460,0,0,1,32517205,32516561,644
38710441,644,644,644,1460,0,0,1,32517849,32517205,644
38711901,644,644,644,1460,0,0,1,32518493,32517849,644
38713361,644,644,644,1460,0,0,1,32519137,32518493,644
38714821,644,644,644,1460,0,0,1,32519781,32519137,644
38716281,644,644,644,1460,0,0,1,32520425,32519781,644
38717741,644,644,644,1460,0,0,1,32521069,32520425,644
38719201,644,644,644,1460,0,0,1,32521713,32521069,644
38720661,644,644,644,1460,0,0,1,32522357,32521713,644
38722121,644,644,644,1460,0,0,1,32523001,32522357,644
38723581,644,644,644,1460,0,0,1,32523645,32523001,644
38725041,644,644,644,1460,0,0,1,32524289,32523645,644
38726501,644,644,644,1460,0,0,1,32524933,32524289,644
38727961,644,644,644,1460,0,0,1,32525577,32524933,644
38729421,644,644,644,1460,0,0,1,32526221,32525577,644
38730881,644,644,644,1460,0,0,1,32526865,32526221,644
38732341,644,644,644,1460,0,0,1,32527509,32526865,644
38733801,644,644,644,1460,0,0,1,32528153,32527509,644
38735261,644,644,644,1460,0,0,1,32528797,32528153,644
38736721,644,644,644,1460,0,0,1,32529441,32528797,644
38738181,644,644,644,1460,0,0,1,32530085,32529441,644
38739641,644,644,644,1460,0,0,1,32530729,32530085,644
38741101,644,644,644,1460,0,0,1,32531373,32530729,644
38742561,644,644,644,1460,0,0,1,32532017,32531373,644
38744021,644,644,644,1460,0,0,1,32532661,32532017,644
38745481,644,644,644,1460,0,0,1,32533305,32532661,644
38746941,644,644,644,1460,0,0,1,32533949,32533305,644
38748401,644,644,644,1460,0,0,1,32534593,32533949,644
38749861,644,644,644,1460,0,0,1,32535237,32534593,644
38751321,644,644,644,1460,0,0,1,32535881,32535237,644
38752781,644,644,644,1460,0,0,1,32536525,32535881,644
38754241,644,644,644,1460,0,0,1,32537169,32536525,644
38755701,644,644,644,1460,0,0,1,32537813,32537169,644
38757161,644,644,644,1460,0,0,1,32538457,32537813,644
38758621,644,644,644,1460,0,0,1,32539101,32538457,644
38760081,644,644,644,1460,0,0,1,32539745,32539101,644
38761541,644,644,644,1460,0,0,1,32540389,32539745,644
38763001,644,644,644,1460,0,0,1,32541033,32540389,644
38764461,644,644,644,1460,0,0,1,32541677,32541033,644
38765921,644,644,644,1460,0,0,1,32542321,32541677,644
38767381,644,644,644,1460,0,0,1,32542965,32542321,644
38768841,644,644,644,1460,0,0,1,32543609,32542965,644
38770301,644,644,644,1460,0,0,1,32544253,32543609,644
38771761,644,644,644,1460,0,0,1,32544897,32544253,644
38773221,644,644,644,1460,0,0,1,32545541,32544897,644
38774681,644,644,644,1460,0,0,1,32546185,32545541,644
38776141,644,644,644,1460,0,0,1,32546829,32546185,644
38777601,644,644,644,1460,0,0,1,32547473,32546829,644
38779061,644,644,644,1460,0,0,1,32548117,32547473,644
38780521,644,644,644,1460,0,0,1,32548761,32548117,644
38781981,644,644,644,1460,0,0,1,32549405,32548761,644
38783441,644,644,644,1460,0,0,1,32550049,32549405,644
38784901,644,644,644,1460,0,0,1,32550693,32550049,644
38786361,644,644,644,1460,0,0,1,32551337,32550693,644
38787821,644,644,644,1460,0,0,1,32551981,32551337,644
38789281,644,644,644,1460,0,0,1,32552625,32551981,644
38790741,644,644,644,1460,0,0,1,32553269,32552625,644
38792201,644,644,644,1460,0,0,1,32553913,32553269,644
38793661,644,644,644,1460,0,0,1,32554557,32553913,644
38795121,644,644,644,1460,0,0,1,32555201,32554557,644
38796581,644,644,644,1460,0,0,1,32555845,32555201,644
38798041,644,644,644,1460,0,0,1,32556489,32555845,644
38799501,644,644,644,1460,0,0,1,32557133,32556489,644
38800961,644,644,644,1460,0,0,1,32557777,32557133,644
38802421,644,644,644,1460,0,0,1,32558421,32557777,644
38803881,644,644,644,1460,0,0,1,32559065,32558421,644
38805341,644,644,644,1460,0,0,1,32559709,32559065,644
38806801,644,644,644,1460,0,0,1,32560353,32559709,644
38808261,644,644,644,1460,0,0,1,32560997,32560353,644
38809721,644,644,644,1460,0,0,1,32561641,32560997,644
38811181,644,644,644,1460,0,0,1,32562285,32561641,644
38812641,644,644,644,1460,0,0,1,32562929,32562285,644
38814101,644,644,644,1460,0,0,1,32563573,32562929,644
38815561,644,644,644,1460,0,0,1,32564217,32563573,644
38817021,644,644,644,1460,0,0,1,32564861,32564217,644
38818481,644,644,644,1460,0,0,1,32565505,32564861,644
38819941,644,644,644,1460,0,0,1,32566149,32565505,644
38821401,644,644,644,1460,0,0,1,32566793,32566149,644
38822861,644,644,644,1460,0,0,1,32567437,32566793,644
38824321,644,644,644,1460,0,0,1,32568081,32567437,644
38825781,644,644,644,1460,0,0,1,32568725,32568081,644
38827241,644,644,644,1460,0,0,1,32569369,32568725,644
38828701,644,644,644,1460,0,0,1,32570013,32569369,644
38830161,644,644,644,1460,0,0,1,32570657,32570013,644
38831621,644,644,644,1460,0,0,1,32571301,32570657,644
38833081,644,644,644,1460,0,0,1,32571945,32571301,644
38834541,644,644,644,1460,0,0,1,32572589,32571945,644
38836001,644,644,644,1460,0,0,1,32573233,32572589,644
38837461,644,644,644,1460,0,0,1,32573877,32573233,644
38838921,644,644,644,1460,0,0,1,32574521,32573877,644
38840381,644,644,644,1460,0,0,1,32575165,32574521,644
38841841,644,644,644,1460,0,0,1,32575809,32575165,644
38843301,644,644,644,1460,0,0,1,32576453,32575809,644
38844761,644,644,644,1460,0,0,1,32577097,32576453,644
38846221,644,644,644,1460,0,0,1,32577741,32577097,644
38847681,644,644,644,1460,0,0,1,32578385,32577741,644
38849141,644,644,644,1460,0,0,1,32579029,32578385,644
38850601,644,644,644,1460,0,0,1,32579673,32579029,644
38852061,644,644,644,1460,0,0,1,32580317,32579673,644
38853521,644,644,644,1460,0,0,1,32580961,32580317,644
38854981,644,644,644,1460,0,0,1,32581605,32580961,644
38856441,644,644,644,1460,0,0,1,32582249,32581605,644
38857901,644,644,644,1460,0,0,1,32582893,32582249,644
38859361,644,644,644,1460,0,0,1,32583537,32582893,644
38860821,644,644,644,1460,0,0,1,32584181,32583537,644
38862281,644,644,644,1460,0,0,1,32584825,32584181,644
38863741,644,644,644,1460,0,0,1,32585469,32584825,644
38865201,644,644,644,1460,0,0,1,32586113,32585469,644
38866661,644,644,644,1460,0,0,1,32586757,32586113,644
38868121,644,644,644,1460,0,0,1,32587401,32586757,644
38869581,644,644,644,1460,0,0,1,32588045,32587401,644
38871041,644,644,644,1460,0,0,1,32588689,32588045,644
38872501,644,644,644,1460,0,0,1,32589333,32588689,644
38873961,644,644,644,1460,0,0,1,32589977,32589333,644
38875421,644,644,644,1460,0,0,1,32590621,32589977,644
38876881,644,644,644,1460,0,0,1,32591265,32590621,644
38878341,644,644,644,1460,0,0,1,32591909,32591265,644
38879801,644,644,644,1460,0,0,1,32592553,32591909,644
38881261,644,644,644,1460,0,0,1,32593197,32592553,644
38882721,644,644,644,1460,0,0,1,32593841,32593197,644
38884181,644,644,644,1460,0,0,1,32594485,32593841,644
38885641,644,644,644,1460,0,0,1,32595129,32594485,644
38887101,644,644,644,1460,0,0,1,32595773,32595129,644
38888561,644,644,644,1460,0,0,1,32596417,32595773,644
38890021,644,644,644,1460,0,0,1,32597061,32596417,644
38891481,644,644,644,1460,0,0,1,32597705,32597061,644
38892941,644,644,644,1460,0,0,1,32598349,32597705,644
38894401,644,644,644,1460,0,0,1,32598993,32598349,644
38895861,644,644,644,1460,0,0,1,32599637,32598993,644
38897321,644,644,644,1460,0,0,1,32600281,32599637,644
38898781,644,644,644,1460,0,0,1,32600925,32600281,644
38900241,644,644,644,1460,0,0,1,32601569,32600925,644
38901701,644,644,644,1460,0,0,1,32602213,32601569,644
38903161,644,644,644,1460,0,0,1,32602857,32602213,644
38904621,644,644,644,1460,0,0,1,32603501,32602857,644
38906081,644,644,644,1460,0,0,1,32604145,32603501,644
38907541,644,644,644,1460,0,0,1,32604789,32604145,644
38909001,644,644,644,1460,0,0,1,32605433,32604789,644
38910461,644,644,644,1460,0,0,1,32606077,32605433,644
38911921,644,644,644,1460,0,0,1,32606721,32606077,644
38913381,644,644,644,1460,0,0,1,32607365,32606721,644
38914841,644,644,644,1460,0,0,1,32608009,32607365,644
38916301,644,644,644,1460,0,0,1,32608653,32608009,644
38917761,644,644,644,1460,0,0,1,32609297,32608653,644
38919221,644,644,644,1460,0,0,1,32609941,32609297,644
38920681,644,644,644,1460,0,0,1,32610585,32609941,644
38922141,644,644,644,1460,0,0,1,32611229,32610585,644
38923601,644,644,644,1460,0,0,1,32611873,32611229,644
38925061,644,644,644,1460,0,0,1,32612517,32611873,644
38926521,644,644,644,1460,0,0,1,32613161,32612517,644
38927981,644,644,644,1460,0,0,1,32613805,32613161,644
38929441,644,644,644,1460,0,0,1,32614449,32613805,644
38930901,644,644,644,1460,0,0,1,32615093,32614449,644
38932361,644,644,644,1460,0,0,1,32615737,32615093,644
38933821,644,644,644,1460,0,0,1,32616381,32615737,644
38935281,644,644,644,1460,0,0,1,32617025,32616381,644
38936741,644,644,644,1460,0,0,1,32617669,32617025,644
38938201,644,644,644,1460,0,0,1,32618313,32617669,644
38939661,644,644,644,1460,0,0,1,32618957,32618313,644
38941121,644,644,644,1460,0,0,1,32619601,32618957,644
38942581,644,644,644,1460,0,0,1,32620245,32619601,644
38944041,644,644,644,1460,0,0,1,32620889,32620245,644
38945501,644,644,644,1460,0,0,1,32621533,32620889,644
38946961,644,644,644,1460,0,0,1,32622177,32621533,644
38948421,644,644,644,1460,0,0,1,32622821,32622177,644
38949881,644,644,644,1460,0,0,1,32623465,32622821,644
38951341,644,644,644,1460,0,0,1,32624109,32623465,644
38952801,644,644,644,1460,0,0,1,32624753,32624109,644
38954261,644,644,644,1460,0,0,1,32625397,32624753,644
38955721,644,644,644,1460,0,0,1,32626041,32625397,644
38957181,644,644,644,1460,0,0,1,32626685,32626041,644
38958641,644,644,644,1460,0,0,1,32627329,32626685,644
38960101,644,644,644,1460,0,0,1,32627973,32627329,644
38961561,644,644,644,1460,0,0,1,32628617,32627973,644
38963021,644,644,644,1460,0,0,1,32629261,32628617,644
38964481,644,644,644,1460,0,0,1,32629905,32629261,644
38965941,644,644,644,1460,0,0,1,32630549,32629905,644
38967401,644,644,644,1460,0,0,1,32631193,32630549,644
38968861,644,644,644,1460,0,0,1,32631837,32631193,644
38970321,644,644,644,1460,0,0,1,32632481,32631837,644
38971781,644,644,644,1460,0,0,1,32633125,32632481,644
38973241,644,644,644,1460,0,0,1,32633769,32633125,644
38974701,644,644,644,1460,0,0,1,32634413,32633769,644
38976161,644,644,644,1460,0,0,1,32635057,32634413,644
38977621,644,644,644,1460,0,0,1,32635701,32635057,644
38979081,644,644,644,1460,0,0,1,32636345,32635701,644
38980541,644,644,644,1460,0,0,1,32636989,32636345,644
38982001,644,644,644,1460,0,0,1,32637633,32636989,644
38983461,644,644,644,1460,0,0,1,32638277,32637633,644
38984921,644,644,644,1460,0,0,1,32638921,32638277,644
38986381,644,644,644,1460,0,0,1,32639565,32638921,644
38987841,644,644,644,1460,0,0,1,32640209,32639565,644
38989301,644,644,644,1460,0,0,1,32640853,32640209,644
38990761,644,644,644,1460,0,0,1,32641497,32640853,644
38992221,644,644,644,1460,0,0,1,32642141,32641497,644
38993681,644,644,644,1460,0,0,1,32642785,32642141,644
38995141,644,644,644,1460,0,0,1,32643429,32642785,644
38996601,644,644,644,1460,0,0,1,32644073,32643429,644
38998061,644,644,644,1460,0,0,1,32644717,32644073,644
38999521,644,644,644,1460,0,0,1,32645361,32644717,644
39000981,644,644,644,1460,0,0,1,32646005,32645361,644
39002441,644,644,644,1460,0,0,1,32646649,32646005,644
39003901,644,644,644,1460,0,0,1,32647293,32646649,644
39005361,644,644,644,1460,0,0,1,32647937,32647293,644
39006821,644,644,644,1460,0,0,1,32648581,32647937,644
39008281,644,644,644,1460,0,0,1,32649225,32648581,644
39009741,644,644,644,1460,0,0,1,32649869,32649225,644
39011201,644,644,644,1460,0,0,1,32650513,32649869,644
39012661,644,644,644,1460,0,0,1,32651157,32650513,644
39014121,644,644,644,1460,0,0,1,32651801,32651157,644
39015581,644,644,644,1460,0,0,1,32652445,32651801,644
39017041,644,644,644,1460,0,0,1,32653089,32652445,644
39018501,644,644,644,1460,0,0,1,32653733,32653089,644
39019961,644,644,644,1460,0,0,1,32654377,32653733,644
39021421,644,644,644,1460,0,0,1,32655021,32654377,644
39022881,644,644,644,1460,0,0,1,32655665,32655021,644
39024341,644,644,644,1460,0,0,1,32656309,32655665,644
39025801,644,644,644,1460,0,0,1,32656953,32656309,644
39027261,644,644,644,1460,0,0,1,32657597,32656953,644
39028721,644,644,644,1460,0,0,1,32658241,32657597,644
39030181,644,644,644,1460,0,0,1,32658885,32658241,644
39031641,644,644,644,1460,0,0,1,32659529,32658885,644
39033101,644,644,644,1460,0,0,1,32660173,32659529,644
39034561,644,644,644,1460,0,0,1,32660817,32660173,644
39036021,644,644,644,1460,0,0,1,32661461,32660817,644
39037481,644,644,644,1460,0,0,1,32662105,32661461,644
39038941,644,644,644,1460,0,0,1,32662749,32662105,644
39040401,644,644,644,1460,0,0,1,32663393,32662749,644
39041861,644,644,644,1460,0,0,1,32664037,32663393,644
39043321,644,644,644,1460,0,0,1,32664681,32664037,644
39044781,644,644,644,1460,0,0,1,32665325,32664681,644
39046241,644,644,644,1460,0,0,1,32665969,32665325,644
39047701,644,644,644,1460,0,0,1,32666613,32665969,644
39049161,644,644,644,1460,0,0,1,32667257,32666613,644
39050621,644,644,644,1460,0,0,1,32667901,32667257,644
39052081,644,644,644,1460,0,0,1,32668545,32667901,644
39053541,644,644,644,1460,0,0,1,32669189,32668545,644
39055001,644,644,644,1460,0,0,1,32669833,32669189,644
39056461,644,644,644,1460,0,0,1,32670477,32669833,644
39057921,644,644,644,1460,0,0,1,32671121,32670477,644
39059381,644,644,644,1460,0,0,1,32671765,32671121,644
39060841,644,644,644,1460,0,0,1,32672409,32671765,644
39062301,644,644,644,1460,0,0,1,32673053,32672409,644
39063761,644,644,644,1460,0,0,1,32673697,32673053,644
39065221,644,644,644,1460,0,0,1,32674341,32673697,644
39066681,644,644,644,1460,0,0,1,32674985,32674341,644
39068141,644,644,644,1460,0,0,1,32675629,32674985,644
39069601,644,644,644,1460,0,0,1,32676273,32675629,644
39071061,644,644,644,1460,0,0,1,32676917,32676273,644
39072521,644,644,644,1460,0,0,1,32677561,32676917,644
39073981,644,644,644,1460,0,0,1,32678205,32677561,644
39075441,644,644,644,1460,0,0,1,32678849,32678205,644
39076901,644,644,644,1460,0,0,1,32679493,32678849,644
39078361,644,644,644,1460,0,0,1,32680137,32679493,644
39079821,644,644,644,1460,0,0,1,32680781,32680137,644
39081281,644,644,644,1460,0,0,1,32681425,32680781,644
39082741,644,644,644,1460,0,0,1,32682069,32681425,644
39084201,644,644,644,1460,0,0,1,32682713,32682069,644
39085661,644,644,644,1460,0,0,1,32683357,32682713,644
39087121,644,644,644,1460,0,0,1,32684001,32683357,644
39088581,644,644,644,1460,0,0,1,32684645,32684001,644
39090041,644,644,644,1460,0,0,1,32685289,32684645,644
39091501,644,644,644,1460,0,0,1,32685933,32685289,644
39092961,644,644,644,1460,0,0,1,32686577,32685933,644
39094421,644,644,644,1460,0,0,1,32687221,32686577,644
39095881,644,644,644,1460,0,0,1,32687865,32687221,644
39097341,644,644,644,1460,0,0,1,32688509,32687865,644
39098801,644,644,644,1460,0,0,1,32689153,32688509,644
39100261,644,644,644,1460,0,0,1,32689797,32689153,644
39101721,644,644,644,1460,0,0,1,32690441,32689797,644
39103181,644,644,644,1460,0,0,1,32691085,32690441,644
39104641,644,644,644,1460,0,0,1,32691729,32691085,644
39106101,644,644,644,1460,0,0,1,32692373,32691729,644
39107561,644,644,644,1460,0,0,1,32693017,32692373,644
39109021,644,644,644,1460,0,0,1,32693661,32693017,644
39110481,644,644,644,1460,0,0,1,32694305,32693661,644
39111941,644,644,644,1460,0,0,1,32694949,32694305,644
39113401,644,644,644,1460,0,0,1,32695593,32694949,644
39114861,644,644,644,1460,0,0,1,32696237,32695593,644
39116321,644,644,644,1460,0,0,1,32696881,32696237,644
39117781,644,644,644,1460,0,0,1,32697525,32696881,644
39119241,644,644,644,1460,0,0,1,32698169,32697525,644
39120701,644,644,644,1460,0,0,1,32698813,32698169,644
39122161,644,644,644,1460,0,0,1,32699457,32698813,644
39123621,644,644,644,1460,0,0,1,32700101,32699457,644
39125081,644,644,644,1460,0,0,1,32700745,32700101,644
39126541,644,644,644,1460,0,0,1,32701389,32700745,644
39128001,644,644,644,1460,0,0,1,32702033,32701389,644
39129461,644,644,644,1460,0,0,1,32702677,32702033,644
39130921,644,644,644,1460,0,0,1,32703321,32702677,644
39132381,644,644,644,1460,0,0,1,32703965,32703321,644
39133841,644,644,644,1460,0,0,1,32704609,32703965,644
39135301,644,644,644,1460,0,0,1,32705253,32704609,644
39136761,644,644,644,1460,0,0,1,32705897,32705253,644
39138221,644,644,644,1460,0,0,1,32706541,32705897,644
39139681,644,644,644,1460,0,0,1,32707185,32706541,644
39141141,644,644,644,1460,0,0,1,32707829,32707185,644
39142601,644,644,644,1460,0,0,1,32708473,32707829,644
39144061,644,644,644,1460,0,0,1,32709117,32708473,644
39145521,644,644,644,1460,0,0,1,32709761,32709117,644
39146981,644,644,644,1460,0,0,1,32710405,32709761,644
39148441,644,644,644,1460,0,0,1,32711049,32710405,644
39149901,644,644,644,1460,0,0,1,32711693,32711049,644
39151361,644,644,644,1460,0,0,1,32712337,32711693,644
39152821,644,644,644,1460,0,0,1,32712981,32712337,644
39154281,644,644,644,1460,0,0,1,32713625,32712981,644
39155741,644,644,644,1460,0,0,1,32714269,32713625,644
39157201,644,644,644,1460,0,0,1,32714913,32714269,644
39158661,644,644,644,1460,0,0,1,32715557,32714913,644
39160121,644,644,644,1460,0,0,1,32716201,32715557,644
39161581,644,644,644,1460,0,0,1,32716845,32716201,644
39163041,644,644,644,1460,0,0,1,32717489,32716845,644
39164501,644,644,644,1460,0,0,1,32718133,32717489,644
39165961,644,644,644,1460,0,0,1,32718777,32718133,644
39167421,644,644,644,1460,0,0,1,32719421,32718777,644
39168881,644,644,644,1460,0,0,1,32720065,32719421,644
39170341,644,644,644,1460,0,0,1,32720709,32720065,644
39171801,644,644,644,1460,0,0,1,32721353,32720709,644
39173261,644,644,644,1460,0,0,1,32721997,32721353,644
39174721,644,644,644,1460,0,0,1,32722641,32721997,644
39176181,644,644,644,1460,0,0,1,32723285,32722641,644
39177641,644,644,644,1460,0,0,1,32723929,32723285,644
39179101,644,644,644,1460,0,0,1,32724573,32723929,644
39180561,644,644,644,1460,0,0,1,32725217,32724573,644
39182021,644,644,644,1460,0,0,1,32725861,32725217,644
39183481,644,644,644,1460,0,0,1,32726505,32725861,644
39184941,644,644,644,1460,0,0,1,32727149,32726505,644
39186401,644,644,644,1460,0,0,1,32727793,32727149,644
39187861,644,644,644,1460,0,0,1,32728437,32727793,644
39189321,644,644,644,1460,0,0,1,32729081,32728437,644
39190781,644,644,644,1460,0,0,1,32729725,32729081,644
39192241,644,644,644,1460,0,0,1,32730369,32729725,644
39193701,644,644,644,1460,0,0,1,32731013,32730369,644
39195161,644,644,644,1460,0,0,1,32731657,32731013,644
39196621,644,644,644,1460,0,0,1,32732301,32731657,644
39198081,644,644,644,1460,0,0,1,32732945,32732301,644
39199541,644,644,644,1460,0,0,1,32733589,32732945,644
39201001,644,644,644,1460,0,0,1,32734233,32733589,644
39202461,644,644,644,1460,0,0,1,32734877,32734233,644
39203921,644,644,644,1460,0,0,1,32735521,32734877,644
39205381,644,644,644,1460,0,0,1,32736165,32735521,644
39206841,644,644,644,1460,0,0,1,32736809,32736165,644
39208301,644,644,644,1460,0,0,1,32737453,32736809,644
39209761,644,644,644,1460,0,0,1,32738097,32737453,644
39211221,644,644,644,1460,0,0,1,32738741,32738097,644
39212681,644,644,644,1460,0,0,1,32739385,32738741,644
39214141,644,644,644,1460,0,0,1,32740029,32739385,644
39215601,644,644,644,1460,0,0,1,32740673,32740029,644
39217061,644,644,644,1460,0,0,1,32741317,32740673,644
39218521,644,644,644,1460,0,0,1,32741961,32741317,644
39219981,644,644,644,1460,0,0,1,32742605,32741961,644
39221441,644,644,644,1460,0,0,1,32743249,32742605,644
39222901,644,644,644,1460,0,0,1,32743893,32743249,644
39224361,644,644,644,1460,0,0,1,32744537,32743893,644
39225821,644,644,644,1460,0,0,1,32745181,32744537,644
39227281,644,644,644,1460,0,0,1,32745825,32745181,644
39228741,644,644,644,1460,0,0,1,32746469,32745825,644
39230201,644,644,644,1460,0,0,1,32747113,32746469,644
39231661,644,644,644,1460,0,0,1,32747757,32747113,644
39233121,644,644,644,1460,0,0,1,32748401,32747757,644
39234581,644,644,644,1460,0,0,1,32749045,32748401,644
39236041,644,644,644,1460,0,0,1,32749689,32749045,644
39237501,644,644,644,1460,0,0,1,32750333,32749689,644
39238961,644,644,644,1460,0,0,1,32750977,32750333,644
39240421,644,644,644,1460,0,0,1,32751621,32750977,644
39241881,644,644,644,1460,0,0,1,32752265,32751621,644
39243341,644,644,644,1460,0,0,1,32752909,32752265,644
39244801,644,644,644,1460,0,0,1,32753553,32752909,644
39246261,644,644,644,1460,0,0,1,32754197,32753553,644
39247721,644,644,644,1460,0,0,1,32754841,32754197,644
39249181,644,644,644,1460,0,0,1,32755485,32754841,644
39250641,644,644,644,1460,0,0,1,32756129,32755485,644
39252101,644,644,644,1460,0,0,1,32756773,32756129,644
39253561,644,644,644,1460,0,0,1,32757417,32756773,644
39255021,644,644,644,1460,0,0,1,32758061,32757417,644
39256481,644,644,644,1460,0,0,1,32758705,32758061,644
39257941,644,644,644,1460,0,0,1,32759349,32758705,644
39259401,644,644,644,1460,0,0,1,32759993,32759349,644
39260861,644,644,644,1460,0,0,1,32760637,32759993,644
39262321,644,644,644,1460,0,0,1,32761281,32760637,644
39263781,644,644,644,1460,0,0,1,32761925,32761281,644
39265241,644,644,644,1460,0,0,1,32762569,32761925,644
39266701,644,644,644,1460,0,0,1,32763213,32762569,644
39268161,644,644,644,1460,0,0,1,32763857,32763213,644
39269621,644,644,644,1460,0,0,1,32764501,32763857,644
39271081,644,644,644,1460,0,0,1,32765145,32764501,644
39272541,644,644,644,1460,0,0,1,32765789,32765145,644
39274001,644,644,644,1460,0,0,1,32766433,32765789,644
39275461,644,644,644,1460,0,0,1,32767077,32766433,644
39276921,644,644,644,1460,0,0,1,32767721,32767077,644
39278381,644,644,644,1460,0,0,1,32768365,32767721,644
39279841,644,644,644,1460,0,0,1,32769009,32768365,644
39281301,644,644,644,1460,0,0,1,32769653,32769009,644
39282761,644,644,644,1460,0,0,1,32770297,32769653,644
39284221,644,644,644,1460,0,0,1,32770941,32770297,644
39285681,644,644,644,1460,0,0,1,32771585,32770941,644
39287141,644,644,644,1460,0,0,1,32772229,32771585,644
39288601,644,644,644,1460,0,0,1,32772873,32772229,644
39290061,644,644,644,1460,0,0,1,32773517,32772873,644
39291521,644,644,644,1460,0,0,1,32774161,32773517,644
39292981,644,644,644,1460,0,0,1,32774805,32774161,644
39294441,644,644,644,1460,0,0,1,32775449,32774805,644
39295901,644,644,644,1460,0,0,1,32776093,32775449,644
39297361,644,644,644,1460,0,0,1,32776737,32776093,644
39298821,644,644,644,1460,0,0,1,32777381,32776737,644
39300281,644,644,644,1460,0,0,1,32778025,32777381,644
39301741,644,644,644,1460,0,0,1,32778669,32778025,644
39303201,644,644,644,1460,0,0,1,32779313,32778669,644
39304661,644,644,644,1460,0,0,1,32779957,32779313,644
39306121,644,644,644,1460,0,0,1,32780601,32779957,644
39307581,644,644,644,1460,0,0,1,32781245,32780601,644
39309041,644,644,644,1460,0,0,1,32781889,32781245,644
39310501,644,644,644,1460,0,0,1,32782533,32781889,644
39311961,644,644,644,1460,0,0,1,32783177,32782533,644
39313421,644,644,644,1460,0,0,1,32783821,32783177,644
39314881,644,644,644,1460,0,0,1,32784465,32783821,644
39316341,644,644,644,1460,0,0,1,32785109,32784465,644
39317801,644,644,644,1460,0,0,1,32785753,32785109,644
39319261,644,644,644,1460,0,0,1,32786397,32785753,644
39320721,644,644,644,1460,0,0,1,32787041,32786397,644
39322181,644,644,644,1460,0,0,1,32787685,32787041,644
39323641,644,644,644,1460,0,0,1,32788329,32787685,644
39325101,644,644,644,1460,0,0,1,32788973,32788329,644
39326561,644,644,644,1460,0,0,1,32789617,32788973,644
39328021,644,644,644,1460,0,0,1,32790261,32789617,644
39329481,644,644,644,1460,0,0,1,32790905,32790261,644
39330941,644,644,644,1460,0,0,1,32791549,32790905,644
39332401,644,644,644,1460,0,0,1,32792193,32791549,644
39333861,644,644,644,1460,0,0,1,32792837,32792193,644
39335321,644,644,644,1460,0,0,1,32793481,32792837,644
39336781,644,644,644,1460,0,0,1,32794125,32793481,644
39338241,644,644,644,1460,0,0,1,32794769,32794125,644
39339701,644,644,644,1460,0,0,1,32795413,32794769,644
39341161,644,644,644,1460,0,0,1,32796057,32795413,644
39342621,644,644,644,1460,0,0,1,32796701,32796057,644
39344081,644,644,644,1460,0,0,1,32797345,32796701,644
39345541,644,644,644,1460,0,0,1,32797989,32797345,644
39347001,644,644,644,1460,0,0,1,32798633,32797989,644
39348461,644,644,644,1460,0,0,1,32799277,32798633,644
39349921,644,644,644,1460,0,0,1,32799921,32799277,644
39351381,644,644,644,1460,0,0,1,32800565,32799921,644
39352841,644,644,644,1460,0,0,1,32801209,32800565,644
39354301,644,644,644,1460,0,0,1,32801853,32801209,644
39355761,644,644,644,1460,0,0,1,32802497,32801853,644
39357221,644,644,644,1460,0,0,1,32803141,32802497,644
39358681,644,644,644,1460,0,0,1,32803785,32803141,644
39360141,644,644,644,1460,0,0,1,32804429,32803785,644
39361601,644,644,644,1460,0,0,1,32805073,32804429,644
39363061,644,644,644,1460,0,0,1,32805717,32805073,644
39364521,644,644,644,1460,0,0,1,32806361,32805717,644
39365981,644,644,644,1460,0,0,1,32807005,32806361,644
39367441,644,644,644,1460,0,0,1,32807649,32807005,644
39368901,644,644,644,1460,0,0,1,32808293,32807649,644
39370361,644,644,644,1460,0,0,1,32808937,32808293,644
39371821,644,644,644,1460,0,0,1,32809581,32808937,644
39373281,644,644,644,1460,0,0,1,32810225,32809581,644
39374741,644,644,644,1460,0,0,1,32810869,32810225,644
39376201,644,644,644,1460,0,0,1,32811513,32810869,644
39377661,644,644,644,1460,0,0,1,32812157,32811513,644
39379121,644,644,644,1460,0,0,1,32812801,32812157,644
39380581,644,644,644,1460,0,0,1,32813445,32812801,644
39382041,644,644,644,1460,0,0,1,32814089,32813445,644
39383501,644,644,644,1460,0,0,1,32814733,32814089,644
39384961,644,644,644,1460,0,0,1,32815377,32814733,644
39386421,644,644,644,1460,0,0,1,32816021,32815377,644
39387881,644,644,644,1460,0,0,1,32816665,32816021,644
39389341,644,644,644,1460,0,0,1,32817309,32816665,644
39390801,644,644,644,1460,0,0,1,32817953,32817309,644
39392261,644,644,644,1460,0,0,1,32818597,32817953,644
39393721,644,644,644,1460,0,0,1,32819241,32818597,644
39395181,644,644,644,1460,0,0,1,32819885,32819241,644
39396641,644,644,644,1460,0,0,1,32820529,32819885,644
39398101,644,644,644,1460,0,0,1,32821173,32820529,644
39399561,644,644,644,1460,0,0,1,32821817,32821173,644
39401021,644,644,644,1460,0,0,1,32822461,32821817,644
39402481,644,644,644,1460,0,0,1,32823105,32822461,644
39403941,644,644,644,1460,0,0,1,32823749,32823105,644
39405401,644,644,644,1460,0,0,1,32824393,32823749,644
39406861,644,644,644,1460,0,0,1,32825037,32824393,644
39408321,644,644,644,1460,0,0,1,32825681,32825037,644
39409781,644,644,644,1460,0,0,1,32826325,32825681,644
39411241,644,644,644,1460,0,0,1,32826969,32826325,644
39412701,644,644,644,1460,0,0,1,32827613,32826969,644
39414161,644,644,644,1460,0,0,1,32828257,32827613,644
39415621,644,644,644,1460,0,0,1,32828901,32828257,644
39417081,644,644,644,1460,0,0,1,32829545,32828901,644
39418541,644,644,644,1460,0,0,1,32830189,32829545,644
39420001,644,644,644,1460,0,0,1,32830833,32830189,644
39421461,644,644,644,1460,0,0,1,32831477,32830833,644
39422921,644,644,644,1460,0,0,1,32832121,32831477,644
39424381,644,644,644,1460,0,0,1,32832765,32832121,644
39425841,644,644,644,1460,0,0,1,32833409,32832765,644
39427301,644,644,644,1460,0,0,1,32834053,32833409,644
39428761,644,644,644,1460,0,0,1,32834697,32834053,644
39430221,644,644,644,1460,0,0,1,32835341,32834697,644
39431681,644,644,644,1460,0,0,1,32835985,32835341,644
39433141,644,644,644,1460,0,0,1,32836629,32835985,644
39434601,644,644,644,1460,0,0,1,32837273,32836629,644
39436061,644,644,644,1460,0,0,1,32837917,32837273,644
39437521,644,644,644,1460,0,0,1,32838561,32837917,644
39438981,644,644,644,1460,0,0,1,32839205,32838561,644
39440441,644,644,644,1460,0,0,1,32839849,32839205,644
39441901,644,644,644,1460,0,0,1,32840493,32839849,644
39443361,644,644,644,1460,0,0,1,32841137,32840493,644
39444821,644,644,644,1460,0,0,1,32841781,32841137,644
39446281,644,644,644,1460,0,0,1,32842425,32841781,644
39447741,644,644,644,1460,0,0,1,32843069,32842425,644
39449201,644,644,644,1460,0,0,1,32843713,32843069,644
39450661,644,644,644,1460,0,0,1,32844357,32843713,644
39452121,644,644,644,1460,0,0,1,32845001,32844357,644
39453581,644,644,644,1460,0,0,1,32845645,32845001,644
39455041,644,644,644,1460,0,0,1,32846289,32845645,644
39456501,644,644,644,1460,0,0,1,32846933,32846289,644
39457961,644,644,644,1460,0,0,1,32847577,32846933,644
39459421,644,644,644,1460,0,0,1,32848221,32847577,644
39460881,644,644,644,1460,0,0,1,32848865,32848221,644
39462341,644,644,644,1460,0,0,1,32849509,32848865,644
39463801,644,644,644,1460,0,0,1,32850153,32849509,644
39465261,644,644,644,1460,0,0,1,32850797,32850153,644
39466721,644,644,644,1460,0,0,1,32851441,32850797,644
39468181,644,644,644,1460,0,0,1,32852085,32851441,644
39469641,644,644,644,1460,0,0,1,32852729,32852085,644
39471101,644,644,644,1460,0,0,1,32853373,32852729,644
39472561,644,644,644,1460,0,0,1,32854017,32853373,644
39474021,644,644,644,1460,0,0,1,32854661,32854017,644
39475481,644,644,644,1460,0,0,1,32855305,32854661,644
39476941,644,644,644,1460,0,0,1,32855949,32855305,644
39478401,644,644,644,1460,0,0,1,32856593,32855949,644
39479861,644,644,644,1460,0,0,1,32857237,32856593,644
39481321,644,644,644,1460,0,0,1,32857881,32857237,644
39482781,644,644,644,1460,0,0,1,32858525,32857881,644
39484241,644,644,644,1460,0,0,1,32859169,32858525,644
39485701,644,644,644,1460,0,0,1,32859813,32859169,644
39487161,644,644,644,1460,0,0,1,32860457,32859813,644
39488621,644,644,644,1460,0,0,1,32861101,32860457,644
39490081,644,644,644,1460,0,0,1,32861745,32861101,644
39491541,644,644,644,1460,0,0,1,32862389,32861745,644
39493001,644,644,644,1460,0,0,1,32863033,32862389,644
39494461,644,644,644,1460,0,0,1,32863677,32863033,644
39495921,644,644,644,1460,0,0,1,32864321,32863677,644
39497381,644,644,644,1460,0,0,1,32864965,32864321,644
39498841,644,644,644,1460,0,0,1,32865609,32864965,644
39500301,644,644,644,1460,0,0,1,32866253,32865609,644
39501761,644,644,644,1460,0,0,1,32866897,32866253,644
39503221,644,644,644,1460,0,0,1,32867541,32866897,644
39504681,644,644,644,1460,0,0,1,32868185,32867541,644
39506141,644,644,644,1460,0,0,1,32868829,32868185,644
39507601,644,644,644,1460,0,0,1,32869473,32868829,644
39509061,644,644,644,1460,0,0,1,32870117,32869473,644
39510521,644,644,644,1460,0,0,1,32870761,32870117,644
39511981,644,644,644,1460,0,0,1,32871405,32870761,644
39513441,644,644,644,1460,0,0,1,32872049,32871405,644
39514901,644,644,644,1460,0,0,1,32872693,32872049,644
39516361,644,644,644,1460,0,0,1,32873337,32872693,644
39517821,644,644,644,1460,0,0,1,32873981,32873337,644
39519281,644,644,644,1460,0,0,1,32874625,32873981,644
39520741,644,644,644,1460,0,0,1,32875269,32874625,644
39522201,644,644,644,1460,0,0,1,32875913,32875269,644
39523661,644,644,644,1460,0,0,1,32876557,32875913,644
39525121,644,644,644,1460,0,0,1,32877201,32876557,644
39526581,644,644,644,1460,0,0,1,32877845,32877201,644
39528041,644,644,644,1460,0,0,1,32878489,32877845,644
39529501,644,644,644,1460,0,0,1,32879133,32878489,644
39530961,644,644,644,1460,0,0,1,32879777,32879133,644
39532421,644,644,644,1460,0,0,1,32880421,32879777,644
39533881,644,644,644,1460,0,0,1,32881065,32880421,644
39535341,644,644,644,1460,0,0,1,32881709,32881065,644
39536801,644,644,644,1460,0,0,1,32882353,32881709,644
39538261,644,644,644,1460,0,0,1,32882997,32882353,644
39539721,644,644,644,1460,0,0,1,32883641,32882997,644
39541181,644,644,644,1460,0,0,1,32884285,32883641,644
39542641,644,644,644,1460,0,0,1,32884929,32884285,644
39544101,644,644,644,1460,0,0,1,32885573,32884929,644
39545561,644,644,644,1460,0,0,1,32886217,32885573,644
39547021,644,644,644,1460,0,0,1,32886861,32886217,644
39548481,644,644,644,1460,0,0,1,32887505,32886861,644
39549941,644,644,644,1460,0,0,1,32888149,32887505,644
39551401,644,644,644,1460,0,0,1,32888793,32888149,644
39552861,644,644,644,1460,0,0,1,32889437,32888793,644
39554321,644,644,644,1460,0,0,1,32890081,32889437,644
39555781,644,644,644,1460,0,0,1,32890725,32890081,644
39557241,644,644,644,1460,0,0,1,32891369,32890725,644
39558701,644,644,644,1460,0,0,1,32892013,32891369,644
39560161,644,644,644,1460,0,0,1,32892657,32892013,644
39561621,644,644,644,1460,0,0,1,32893301,32892657,644
39563081,644,644,644,1460,0,0,1,32893945,32893301,644
39564541,644,644,644,1460,0,0,1,32894589,32893945,644
39566001,644,644,644,1460,0,0,1,32895233,32894589,644
39567461,644,644,644,1460,0,0,1,32895877,32895233,644
39568921,644,644,644,1460,0,0,1,32896521,32895877,644
39570381,644,644,644,1460,0,0,1,32897165,32896521,644
39571841,644,644,644,1460,0,0,1,32897809,32897165,644
39573301,644,644,644,1460,0,0,1,32898453,32897809,644
39574761,644,644,644,1460,0,0,1,32899097,32898453,644
39576221,644,644,644,1460,0,0,1,32899741,32899097,644
39577681,644,644,644,1460,0,0,1,32900385,32899741,644
39579141,644,644,644,1460,0,0,1,32901029,32900385,644
39580601,644,644,644,1460,0,0,1,32901673,32901029,644
39582061,644,644,644,1460,0,0,1,32902317,32901673,644
39583521,644,644,644,1460,0,0,1,32902961,32902317,644
39584981,644,644,644,1460,0,0,1,32903605,32902961,644
39586441,644,644,644,1460,0,0,1,32904249,32903605,644
39587901,644,644,644,1460,0,0,1,32904893,32904249,644
39589361,644,644,644,1460,0,0,1,32905537,32904893,644
39590821,644,644,644,1460,0,0,1,32906181,32905537,644
39592281,644,644,644,1460,0,0,1,32906825,32906181,644
39593741,644,644,644,1460,0,0,1,32907469,32906825,644
39595201,644,644,644,1460,0,0,1,32908113,32907469,644
39596661,644,644,644,1460,0,0,1,32908757,32908113,644
39598121,644,644,644,1460,0,0,1,32909401,32908757,644
39599581,644,644,644,1460,0,0,1,32910045,32909401,644
39601041,644,644,644,1460,0,0,1,32910689,32910045,644
39602501,644,644,644,1460,0,0,1,32911333,32910689,644
39603961,644,644,644,1460,0,0,1,32911977,32911333,644
39605421,644,644,644,1460,0,0,1,32912621,32911977,644
39606881,644,644,644,1460,0,0,1,32913265,32912621,644
39608341,644,644,644,1460,0,0,1,32913909,32913265,644
39609801,644,644,644,1460,0,0,1,32914553,32913909,644
39611261,644,644,644,1460,0,0,1,32915197,32914553,644
39612721,644,644,644,1460,0,0,1,32915841,32915197,644
39614181,644,644,644,1460,0,0,1,32916485,32915841,644
39615641,644,644,644,1460,0,0,1,32917129,32916485,644
39617101,644,644,644,1460,0,0,1,32917773,32917129,644
39618561,644,644,644,1460,0,0,1,32918417,32917773,644
39620021,644,644,644,1460,0,0,1,32919061,32918417,644
39621481,644,644,644,1460,0,0,1,32919705,32919061,644
39622941,644,644,644,1460,0,0,1,32920349,32919705,644
39624401,644,644,644,1460,0,0,1,32920993,32920349,644
39625861,644,644,644,1460,0,0,1,32921637,32920993,644
39627321,644,644,644,1460,0,0,1,32922281,32921637,644
39628781,644,644,644,1460,0,0,1,32922925,32922281,644
39630241,644,644,644,1460,0,0,1,32923569,32922925,644
39631701,644,644,644,1460,0,0,1,32924213,32923569,644
39633161,644,644,644,1460,0,0,1,32924857,32924213,644
39634621,644,644,644,1460,0,0,1,32925501,32924857,644
39636081,644,644,644,1460,0,0,1,32926145,32925501,644
39637541,644,644,644,1460,0,0,1,32926789,32926145,644
39639001,644,644,644,1460,0,0,1,32927433,32926789,644
39640461,644,644,644,1460,0,0,1,32928077,32927433,644
39641921,644,644,644,1460,0,0,1,32928721,32928077,644
39643381,644,644,644,1460,0,0,1,32929365,32928721,644
39644841,644,644,644,1460,0,0,1,32930009,32929365,644
39646301,644,644,644,1460,0,0,1,32930653,32930009,644
39647761,644,644,644,1460,0,0,1,32931297,32930653,644
39649221,644,644,644,1460,0,0,1,32931941,32931297,644
39650681,644,644,644,1460,0,0,1,32932585,32931941,644
39652141,644,644,644,1460,0,0,1,32933229,32932585,644
39653601,644,644,644,1460,0,0,1,32933873,32933229,644
39655061,644,644,644,1460,0,0,1,32934517,32933873,644
39656521,644,644,644,1460,0,0,1,32935161,32934517,644
39657981,644,644,644,1460,0,0,1,32935805,32935161,644
39659441,644,644,644,1460,0,0,1,32936449,32935805,644
39660901,644,644,644,1460,0,0,1,32937093,32936449,644
39662361,644,644,644,1460,0,0,1,32937737,32937093,644
39663821,644,644,644,1460,0,0,1,32938381,32937737,644
39665281,644,644,644,1460,0,0,1,32939025,32938381,644
39666741,644,644,644,1460,0,0,1,32939669,32939025,644
39668201,644,644,644,1460,0,0,1,32940313,32939669,644
39669661,644,644,644,1460,0,0,1,32940957,32940313,644
39671121,644,644,644,1460,0,0,1,32941601,32940957,644
39672581,644,644,644,1460,0,0,1,32942245,32941601,644
39674041,644,644,644,1460,0,0,1,32942889,32942245,644
39675501,644,644,644,1460,0,0,1,32943533,32942889,644
39676961,644,644,644,1460,0,0,1,32944177,32943533,644
39678421,644,644,644,1460,0,0,1,32944821,32944177,644
39679881,644,644,644,1460,0,0,1,32945465,32944821,644
39681341,644,644,644,1460,0,0,1,32946109,32945465,644
39682801,644,644,644,1460,0,0,1,32946753,32946109,644
39684261,644,644,644,1460,0,0,1,32947397,32946753,644
39685721,644,644,644,1460,0,0,1,32948041,32947397,644
39687181,644,644,644,1460,0,0,1,32948685,32948041,644
39688641,644,644,644,1460,0,0,1,32949329,32948685,644
39690101,644,644,644,1460,0,0,1,32949973,32949329,644
39691561,644,644,644,1460,0,0,1,32950617,32949973,644
39693021,644,644,644,1460,0,0,1,32951261,32950617,644
39694481,644,644,644,1460,0,0,1,32951905,32951261,644
39695941,644,644,644,1460,0,0,1,32952549,32951905,644
39697401,644,644,644,1460,0,0,1,32953193,32952549,644
39698861,644,644,644,1460,0,0,1,32953837,32953193,644
39700321,644,644,644,1460,0,0,1,32954481,32953837,644
39701781,644,644,644,1460,0,0,1,32955125,32954481,644
39703241,644,644,644,1460,0,0,1,32955769,32955125,644
39704701,644,644,644,1460,0,0,1,32956413,32955769,644
39706161,644,644,644,1460,0,0,1,32957057,32956413,644
39707621,644,644,644,1460,0,0,1,32957701,32957057,644
39709081,644,644,644,1460,0,0,1,32958345,32957701,644
39710541,644,644,644,1460,0,0,1,32958989,32958345,644
39712001,644,644,644,1460,0,0,1,32959633,32958989,644
39713461,644,644,644,1460,0,0,1,32960277,32959633,644
39714921,644,644,644,1460,0,0,1,32960921,32960277,644
39716381,644,644,644,1460,0,0,1,32961565,32960921,644
39717841,644,644,644,1460,0,0,1,32962209,32961565,644
39719301,644,644,644,1460,0,0,1,32962853,32962209,644
39720761,644,644,644,1460,0,0,1,32963497,32962853,644
39722221,644,644,644,1460,0,0,1,32964141,32963497,644
39723681,644,644,644,1460,0,0,1,32964785,32964141,644
39725141,644,644,644,1460,0,0,1,32965429,32964785,644
39726601,644,644,644,1460,0,0,1,32966073,32965429,644
39728061,644,644,644,1460,0,0,1,32966717,32966073,644
39729521,644,644,644,1460,0,0,1,32967361,32966717,644
39730981,644,644,644,1460,0,0,1,32968005,32967361,644
39732441,644,644,644,1460,0,0,1,32968649,32968005,644
39733901,644,644,644,1460,0,0,1,32969293,32968649,644
39735361,644,644,644,1460,0,0,1,32969937,32969293,644
39736821,644,644,644,1460,0,0,1,32970581,32969937,644
39738281,644,644,644,1460,0,0,1,32971225,32970581,644
39739741,644,644,644,1460,0,0,1,32971869,32971225,644
39741201,644,644,644,1460,0,0,1,32972513,32971869,644
39742661,644,644,644,1460,0,0,1,32973157,32972513,644
39744121,644,644,644,1460,0,0,1,32973801,32973157,644
39745581,644,644,644,1460,0,0,1,32974445,32973801,644
39747041,644,644,644,1460,0,0,1,32975089,32974445,644
39748501,644,644,644,1460,0,0,1,32975733,32975089,644
39749961,644,644,644,1460,0,0,1,32976377,32975733,644
39751421,644,644,644,1460,0,0,1,32977021,32976377,644
39752881,644,644,644,1460,0,0,1,32977665,32977021,644
39754341,644,644,644,1460,0,0,1,32978309,32977665,644
39755801,644,644,644,1460,0,0,1,32978953,32978309,644
39757261,644,644,644,1460,0,0,1,32979597,32978953,644
39758721,644,644,644,1460,0,0,1,32980241,32979597,644
39760181,644,644,644,1460,0,0,1,32980885,32980241,644
39761641,644,644,644,1460,0,0,1,32981529,32980885,644
39763101,644,644,644,1460,0,0,1,32982173,32981529,644
39764561,644,644,644,1460,0,0,1,32982817,32982173,644
39766021,644,644,644,1460,0,0,1,32983461,32982817,644
39767481,644,644,644,1460,0,0,1,32984105,32983461,644
39768941,644,644,644,1460,0,0,1,32984749,32984105,644
39770401,644,644,644,1460,0,0,1,32985393,32984749,644
39771861,644,644,644,1460,0,0,1,32986037,32985393,644
39773321,644,644,644,1460,0,0,1,32986681,32986037,644
39774781,644,644,644,1460,0,0,1,32987325,32986681,644
39776241,644,644,644,1460,0,0,1,32987969,32987325,644
39777701,644,644,644,1460,0,0,1,32988613,32987969,644
39779161,644,644,644,1460,0,0,1,32989257,32988613,644
39780621,644,644,644,1460,0,0,1,32989901,32989257,644
39782081,644,644,644,1460,0,0,1,32990545,32989901,644
39783541,644,644,644,1460,0,0,1,32991189,32990545,644
39785001,644,644,644,1460,0,0,1,32991833,32991189,644
39786461,644,644,644,1460,0,0,1,32992477,32991833,644
39787921,644,644,644,1460,0,0,1,32993121,32992477,644
39789381,644,644,644,1460,0,0,1,32993765,32993121,644
39790841,644,644,644,1460,0,0,1,32994409,32993765,644
39792301,644,644,644,1460,0,0,1,32995053,32994409,644
39793761,644,644,644,1460,0,0,1,32995697,32995053,644
39795221,644,644,644,1460,0,0,1,32996341,32995697,644
39796681,644,644,644,1460,0,0,1,32996985,32996341,644
39798141,644,644,644,1460,0,0,1,32997629,32996985,644
39799601,644,644,644,1460,0,0,1,32998273,32997629,644
39801061,644,644,644,1460,0,0,1,32998917,32998273,644
39802521,644,644,644,1460,0,0,1,32999561,32998917,644
39803981,644,644,644,1460,0,0,1,33000205,32999561,644
39805441,644,644,644,1460,0,0,1,33000849,33000205,644
39806901,644,644,644,1460,0,0,1,33001493,33000849,644
39808361,644,644,644,1460,0,0,1,33002137,33001493,644
39809821,644,644,644,1460,0,0,1,33002781,33002137,644
39811281,644,644,644,1460,0,0,1,33003425,33002781,644
39812741,644,644,644,1460,0,0,1,33004069,33003425,644
39814201,644,644,644,1460,0,0,1,33004713,33004069,644
39815661,644,644,644,1460,0,0,1,33005357,33004713,644
39817121,644,644,644,1460,0,0,1,33006001,33005357,644
39818581,644,644,644,1460,0,0,1,33006645,33006001,644
39820041,644,644,644,1460,0,0,1,33007289,33006645,644
39821501,644,644,644,1460,0,0,1,33007933,33007289,644
39822961,644,644,644,1460,0,0,1,33008577,33007933,644
39824421,644,644,644,1460,0,0,1,33009221,33008577,644
39825881,644,644,644,1460,0,0,1,33009865,33009221,644
39827341,644,644,644,1460,0,0,1,33010509,33009865,644
39828801,644,644,644,1460,0,0,1,33011153,33010509,644
39830261,644,644,644,1460,0,0,1,33011797,33011153,644
39831721,644,644,644,1460,0,0,1,33012441,33011797,644
39833181,644,644,644,1460,0,0,1,33013085,33012441,644
39834641,644,644,644,1460,0,0,1,33013729,33013085,644
39836101,644,644,644,1460,0,0,1,33014373,33013729,644
39837561,644,644,644,1460,0,0,1,33015017,33014373,644
39839021,644,644,644,1460,0,0,1,33015661,33015017,644
39840481,644,644,644,1460,0,0,1,33016305,33015661,644
39841941,644,644,644,1460,0,0,1,33016949,33016305,644
39843401,644,644,644,1460,0,0,1,33017593,33016949,644
39844861,644,644,644,1460,0,0,1,33018237,33017593,644
39846321,644,644,644,1460,0,0,1,33018881,33018237,644
39847781,644,644,644,1460,0,0,1,33019525,33018881,644
39849241,644,644,644,1460,0,0,1,33020169,33019525,644
39850701,644,644,644,1460,0,0,1,33020813,33020169,644
39852161,644,644,644,1460,0,0,1,33021457,33020813,644
39853621,644,644,644,1460,0,0,1,33022101,33021457,644
39855081,644,644,644,1460,0,0,1,33022745,33022101,644
39856541,644,644,644,1460,0,0,1,33023389,33022745,644
39858001,644,644,644,1460,0,0,1,33024033,33023389,644
39859461,644,644,644,1460,0,0,1,33024677,33024033,644
39860921,644,644,644,1460,0,0,1,33025321,33024677,644
39862381,644,644,644,1460,0,0,1,33025965,33025321,644
39863841,644,644,644,1460,0,0,1,33026609,33025965,644
39865301,644,644,644,1460,0,0,1,33027253,33026609,644
39866761,644,644,644,1460,0,0,1,33027897,33027253,644
39868221,644,644,644,1460,0,0,1,33028541,33027897,644
39869681,644,644,644,1460,0,0,1,33029185,33028541,644
39871141,644,644,644,1460,0,0,1,33029829,33029185,644
39872601,644,644,644,1460,0,0,1,33030473,33029829,644
39874061,644,644,644,1460,0,0,1,33031117,33030473,644
39875521,644,644,644,1460,0,0,1,33031761,33031117,644
39876981,644,644,644,1460,0,0,1,33032405,33031761,644
39878441,644,644,644,1460,0,0,1,33033049,33032405,644
39879901,644,644,644,1460,0,0,1,33033693,33033049,644
39881361,644,644,644,1460,0,0,1,33034337,33033693,644
39882821,644,644,644,1460,0,0,1,33034981,33034337,644
39884281,644,644,644,1460,0,0,1,33035625,33034981,644
39885741,644,644,644,1460,0,0,1,33036269,33035625,644
39887201,644,644,644,1460,0,0,1,33036913,33036269,644
39888661,644,644,644,1460,0,0,1,33037557,33036913,644
39890121,644,644,644,1460,0,0,1,33038201,33037557,644
39891581,644,644,644,1460,0,0,1,33038845,33038201,644
39893041,644,644,644,1460,0,0,1,33039489,33038845,644
39894501,644,644,644,1460,0,0,1,33040133,33039489,644
39895961,644,644,644,1460,0,0,1,33040777,33040133,644
39897421,644,644,644,1460,0,0,1,33041421,33040777,644
39898881,644,644,644,1460,0,0,1,33042065,33041421,644
39900341,644,644,644,1460,0,0,1,33042709,33042065,644
39901801,644,644,644,1460,0,0,1,33043353,33042709,644
39903261,644,644,644,1460,0,0,1,33043997,33043353,644
39904721,644,644,644,1460,0,0,1,33044641,33043997,644
39906181,644,644,644,1460,0,0,1,33045285,33044641,644
39907641,644,644,644,1460,0,0,1,33045929,33045285,644
39909101,644,644,644,1460,0,0,1,33046573,33045929,644
39910561,644,644,644,1460,0,0,1,33047217,33046573,644
39912021,644,644,644,1460,0,0,1,33047861,33047217,644
39913481,644,644,644,1460,0,0,1,33048505,33047861,644
39914941,644,644,644,1460,0,0,1,33049149,33048505,644
39916401,644,644,644,1460,0,0,1,33049793,33049149,644
39917861,644,644,644,1460,0,0,1,33050437,33049793,644
39919321,644,644,644,1460,0,0,1,33051081,33050437,644
39920781,644,644,644,1460,0,0,1,33051725,33051081,644
39922241,644,644,644,1460,0,0,1,33052369,33051725,644
39923701,644,644,644,1460,0,0,1,33053013,33052369,644
39925161,644,644,644,1460,0,0,1,33053657,33053013,644
39926621,644,644,644,1460,0,0,1,33054301,33053657,644
39928081,644,644,644,1460,0,0,1,33054945,33054301,644
39929541,644,644,644,1460,0,0,1,33055589,33054945,644
39931001,644,644,644,1460,0,0,1,33056233,33055589,644
39932461,644,644,644,1460,0,0,1,33056877,33056233,644
39932882,437.85,644,427,1460,0,0,1,33057304,33056877,427
