#Ack,ack_ewma(ms),send_ewma(ms),rtt_ratio,cwnd (Bytes),Last Router Ocupation Ack Arriaval(Packets),Last Router Ocupation Packet Sent(Packets),Network Situation,AckArrival(ms),TSInsideAck(ms),RTTAck(ms)
4381,2,0,427,16060,0.07,0.05,1,110849,110422,427
7301,2,0,429,17520,0.07,0.05,1,110851,110422,429
10221,2,0,431,18980,0.07,0.05,1,110853,110422,431
13141,2,0,433,20440,0.07,0.05,1,110855,110422,433
14601,161.2,0,634,21900,0.022,0.07,1,111056,110422,634
17521,205.04,340,425,23360,0.0124,0.07,1,111272,110847,425
20441,42.608,69.6,425,24820,0.01048,0.07,1,111274,110849,425
23361,10.1216,13.92,427,26280,0.042096,0.07,1,111276,110849,427
26281,3.62432,4.384,427,27740,0.0484192,0.07,1,111278,110851,427
29201,2.32486,2.4768,427,29200,0.0176838,0.07,1,111280,110853,427
32121,2.06497,0.49536,429,30660,0.0115368,0.07,1,111282,110853,429
35041,2.01299,1.69907,429,32120,0.0263074,0.01,1,111284,110855,429
37961,157.203,161.14,424,33580,0.0292615,0.01,1,111480,111056,424
40881,202.641,205.028,422,35040,0.109852,0.01,1,111694,111272,422
43801,42.1281,41.0056,424,36500,0.15797,0.01,1,111696,111272,424
46721,10.0256,9.80112,424,37960,0.135594,0.05,1,111698,111274,424
49641,3.60512,3.56022,424,39420,0.131119,0.05,1,111700,111276,424
52561,2.32102,0.712045,426,40880,0.130224,0.05,1,111702,111276,426
55481,2.0642,1.74241,426,42340,0.130045,0.01,1,111704,111278,426
58401,2.01284,1.94848,426,43800,0.146009,0.01,1,111706,111280,426
61321,2.00257,0.389696,428,45260,0.165202,0.01,1,111708,111280,428
64241,2.00051,1.67794,428,46720,0.18504,0.03,1,111710,111282,428
67161,2.0001,1.93559,428,48180,0.205008,0.03,1,111712,111284,428
70081,152.4,0.387118,618,49640,0.0490016,0.03,1,111902,111284,618
73001,32.88,156.877,425,51100,0.0178003,0.13,1,111905,111480,425
75921,180.176,202.575,428,52560,0.12356,0.13,1,112122,111694,428
78841,37.6352,40.5151,430,54020,0.144712,0.17,1,112124,111694,430
81761,9.12704,9.70302,430,55480,0.116942,0.13,1,112126,111696,430
84681,3.42541,3.5406,430,56940,0.111388,0.13,1,112128,111698,430
87601,2.28508,0.708121,432,58400,0.110278,0.13,1,112130,111698,432
90521,2.05702,1.74162,432,59860,0.110056,0.13,1,112132,111700,432
93441,2.0114,1.94832,432,61320,0.126011,0.13,1,112134,111702,432
96361,2.00228,0.389665,434,62780,0.145202,0.13,1,112136,111702,434
99281,2.00046,1.67793,434,64240,0.16504,0.15,1,112138,111704,434
102201,2.00009,1.93559,434,65700,0.185008,0.15,1,112140,111706,434
105121,2.00002,0.387117,436,67160,0.205002,0.17,1,112142,111706,436
108041,2,1.67742,436,68620,0.225,0.19,1,112144,111708,436
110961,2,1.93548,436,70080,0.245,0.19,1,112146,111710,436
113881,2,0.387097,438,71540,0.265,0.21,1,112148,111710,438
116801,2,1.67742,438,73000,0.285,0.01,1,112150,111712,438
119721,141.2,152.335,424,74460,0.081,0.01,1,112326,111902,424
122641,29.84,30.4671,426,75920,0.0162,0.01,1,112328,111902,426
125561,7.568,8.49342,425,77380,0.01124,0.15,1,112330,111905,425
128481,176.714,175.299,427,78840,0.090248,0.15,1,112549,112122,427
131401,36.9427,35.0597,429,80300,0.10605,0.15,1,112551,112122,429
134321,8.98854,8.61195,429,81760,0.10921,0.11,1,112553,112124,429
137241,3.39771,3.32239,429,83220,0.109842,0.11,1,112555,112126,429
140161,2.27954,0.664478,431,84680,0.109968,0.11,1,112557,112126,431
143081,2.05591,1.7329,431,86140,0.109994,0.11,1,112559,112128,431
146001,2.01118,1.94658,431,87600,0.125999,0.11,1,112561,112130,431
148921,2.00224,0.389316,433,89060,0.1452,0.11,1,112563,112130,433
151841,2.00045,1.67786,433,90520,0.16504,0.13,1,112565,112132,433
154761,2.00009,1.93557,433,91980,0.185008,0.13,1,112567,112134,433
157681,2.00002,0.387115,435,93440,0.205002,0.15,1,112569,112134,435
160601,2,1.67742,435,94900,0.225,0.17,1,112571,112136,435
163521,2,1.93548,435,96360,0.245,0.17,1,112573,112138,435
166441,2,0.387097,437,97820,0.265,0.19,1,112575,112138,437
169361,2,1.67742,437,99280,0.285,0.21,1,112577,112140,437
172281,2,1.93548,437,100740,0.305,0.21,1,112579,112142,437
175201,2,0.387097,439,102200,0.325,0.23,1,112581,112142,439
178121,2,1.67742,439,103660,0.345,0.25,1,112583,112144,439
181041,2,1.93548,439,105120,0.365,0.25,1,112585,112146,439
183961,2,0.387097,441,106580,0.385,0.27,1,112587,112146,441
186881,2,1.67742,441,108040,0.405,0.29,1,112589,112148,441
189801,2,1.93548,441,109500,0.425,0.29,1,112591,112150,441
192721,125.2,0.387097,597,110960,0.525,0.03,1,112747,112150,597
195641,26.64,140.877,423,112420,0.545,0,1,112749,112326,423
198561,6.928,29.7755,423,113880,0.549,0,1,112751,112328,423
201481,2.9856,5.9551,425,115340,0.5178,0.01,1,112753,112328,425
204401,2.19712,2.79102,425,116800,0.47956,0.11,1,112755,112330,425
207321,177.239,175.758,427,118260,0.519912,0.11,1,112976,112549,427
210241,37.0479,35.1516,429,119720,0.527982,0.11,1,112978,112549,429
213161,9.00958,8.63033,429,121180,0.561597,0.11,1,112980,112551,429
216081,3.40192,3.32607,429,122640,0.568319,0.11,1,112982,112553,429
219001,2.28038,0.665213,431,124100,0.569664,0.11,1,112984,112553,431
221921,2.05608,1.73304,431,125560,0.537933,0.11,1,112986,112555,431
224841,2.01122,1.94661,431,127020,0.547587,0.11,1,112988,112557,431
227761,2.00224,0.389322,433,128480,0.565517,0.11,1,112990,112557,433
230681,2.00045,1.67786,433,129940,0.577103,0.13,1,112992,112559,433
233601,2.00009,1.93557,433,131400,0.547421,0.13,1,112994,112561,433
236521,2.00002,0.387115,435,132860,0.509484,0.15,1,112996,112561,435
239441,2,1.67742,435,134320,0.469897,0.17,1,112998,112563,435
242361,2,1.93548,435,135780,0.429979,0.17,1,113000,112565,435
245281,2,0.387097,437,137240,0.389996,0.19,1,113002,112565,437
248201,2,1.67742,437,138700,0.613999,0.21,1,113004,112567,437
251121,2,1.93548,437,140160,0.6268,0.21,1,113006,112569,437
254041,2,0.387097,439,141620,0.59736,0.23,1,113008,112569,439
256961,2,1.67742,439,143080,0.647472,0.25,1,113010,112571,439
259881,2,1.93548,439,144540,0.625494,0.25,1,113012,112573,439
262801,2,0.387097,441,146000,0.589099,0.27,1,113014,112573,441
265721,2,1.67742,441,147460,0.54982,0.29,1,113016,112575,441
268641,2,1.93548,441,148920,0.509964,0.29,1,113018,112577,441
271561,2,0.387097,443,150380,0.669993,0.31,1,113020,112577,443
274481,2,1.67742,443,151840,0.677999,0.33,1,113022,112579,443
277401,2.8,1.93548,444,153300,0.6316,0.33,1,113025,112581,444
280321,2.16,0.387097,446,154760,0.59032,0.35,1,113027,112581,446
283241,2.032,1.67742,446,156220,0.550064,0.37,1,113029,112583,446
286161,2.0064,1.93548,446,157680,0.662013,0.37,1,113031,112585,446
289081,2.00128,0.387097,448,159140,0.652403,0.39,1,113033,112585,448
292001,2.00026,1.67742,448,160600,0.618481,0.41,1,113035,112587,448
294921,2.00005,1.93548,448,162060,0.667696,0.41,1,113037,112589,448
297841,2.00001,0.387097,450,163520,0.637539,0.43,1,113039,112589,450
300761,2,1.67742,450,164980,0.599508,0.55,1,113041,112591,450
303681,121.2,125.135,445,166440,0.703902,0.55,1,113192,112747,445
306601,25.84,25.0271,447,167900,0.72478,0.55,1,113194,112747,447
309521,6.768,6.60542,447,169360,0.728956,0.55,1,113196,112749,447
312441,2.9536,2.92108,447,170820,0.729791,0.55,1,113198,112751,447
315361,2.19072,0.584217,449,172280,0.729958,0.51,1,113200,112751,449
318281,2.03814,1.71684,449,173740,0.729992,0.47,1,113202,112753,449
320321,2.00763,1.94337,449,175200,0.697998,0.49,1,113204,112755,449
321781,161.202,1.18867,649,176660,0.8036,0.53,2,113405,112756,649
324701,47.4403,176.238,448,178120,0.82472,0.53,2,113424,112976,448
327621,11.0881,35.2475,450,179580,0.860944,0.53,2,113426,112976,450
330541,3.81761,8.64951,450,181040,0.844189,0.57,2,113428,112978,450
333461,2.36352,3.3299,450,182500,0.840838,0.57,2,113430,112980,450
336341,2.0727,0.66598,452,183960,0.840168,0.58,2,113432,112980,452
339261,2.01454,9.7332,442,185420,0.840034,0.58,2,113434,112992,442
342181,2.00291,1.94664,444,186880,0.808007,0.58,2,113436,112992,444
345101,2.00058,0.389328,446,188340,0.769601,0.58,2,113438,112992,446
348021,2.00012,0.0778656,448,189800,0.72992,0.58,1,113440,112992,448
350941,2.00002,0.0155731,450,191260,0.777984,0.58,2,113442,112992,450
353861,2,0.00311462,452,192720,0.755597,0.58,2,113444,112992,452
356781,2,0.000622924,454,194180,0.823119,0.58,2,113446,112992,454
358801,1.2,0.000124585,455,195640,0.820624,0.46,2,113447,112992,455
361721,1.84,4.80003,451,197100,0.788125,0.46,2,113449,112998,451
364641,1.968,0.960005,453,198560,0.749625,0.46,1,113451,112998,453
367121,1.9936,0.192001,455,200020,0.709925,0.68,1,113453,112998,455
370041,1.99872,8.8384,446,201480,0.669985,0.68,1,113455,113009,446
372961,1.99974,1.76768,448,202940,0.781997,0.68,2,113457,113009,448
375881,1.99995,0.353536,450,204400,0.772399,0.68,2,113459,113009,450
378801,1.99999,0.0707072,452,205860,0.73848,0.68,1,113461,113009,452
381721,2,0.0141414,454,207320,0.699696,0.68,1,113463,113009,454
384641,2,0.00282829,456,208780,0.659939,0.68,1,113465,113009,456
386261,1.2,0.000565657,457,210240,0.635988,0.73,1,113466,113009,457
389181,1.84,8.00011,449,211700,0.767198,0.73,2,113468,113019,449
392101,1.968,1.60002,451,213160,0.76144,0.73,2,113470,113019,451
395021,1.9936,0.320004,453,214620,0.736288,0.73,1,113472,113019,453
397941,1.99872,0.0640009,455,216080,0.699258,0.73,1,113474,113019,455
400821,1.99974,0.0128002,457,217540,0.659852,0.6,1,113476,113019,457
403741,1.99995,5.60256,452,219000,0.77197,0.6,2,113478,113026,452
406661,1.99999,1.12051,454,220460,0.762394,0.6,2,113480,113026,454
409141,2,0.224102,456,221920,0.728479,0.63,1,113482,113026,456
412061,2,6.44482,450,223380,0.697696,0.63,1,113484,113034,450
414981,2,1.28896,452,224840,0.659539,0.63,1,113486,113034,452
417901,2,0.257793,454,226300,0.619908,0.63,1,113488,113034,454
420581,6.8,0.0515586,462,227760,0.795982,0.63,2,113496,113034,462
423501,3.76,10.4103,452,229220,0.783196,0.63,2,113499,113047,452
426421,2.352,2.08206,454,230680,0.756639,0.63,2,113501,113047,454
429341,2.0704,0.416412,456,232140,0.751328,0.63,2,113503,113047,456
431601,2.01408,0.0832825,458,233600,0.782266,0.75,2,113505,113047,458
434521,116.403,120.017,453,235060,0.900453,0.75,2,113650,113197,453
437441,24.8806,24.0033,455,236520,0.924091,0.75,2,113652,113197,455
439921,6.57611,4.80067,457,237980,0.928818,0.7,2,113654,113197,457
442841,6.11522,10.5601,451,239440,0.897764,0.7,2,113660,113209,451
445761,2.82304,2.11203,453,240900,0.859553,0.7,2,113662,113209,453
448681,2.16461,0.422405,455,242360,0.819911,0.7,2,113664,113209,455
451361,2.03292,0.0844811,457,243820,0.811982,0.85,2,113666,113209,457
468021,2,0,462,252580,0.95,0.82,2,113897,113435,462
470081,2,0,464,254040,0.918,0.86,2,113899,113435,464
473001,2,8,456,255500,0.8796,0.86,2,113901,113445,456
475921,2,1.6,458,256960,0.83992,0.86,2,113903,113445,458
478841,2,0.32,460,258420,0.799984,0.86,2,113905,113445,460
481761,2,0.064,462,259880,0.911997,0.86,2,113907,113445,462
484641,2,0.0128,464,261340,0.902399,0.81,2,113909,113445,464
487561,2,9.60256,454,262800,0.86848,0.81,2,113911,113457,454
490481,2,1.92051,456,264260,0.829696,0.81,2,113913,113457,456
493401,2,0.384102,458,265720,0.909939,0.81,2,113915,113457,458
496321,2,0.0768205,460,267180,0.893988,0.81,2,113917,113457,460
499241,2,0.0153641,462,268640,0.858798,0.81,2,113919,113457,462
501701,2,0.00307282,464,270100,0.81976,0.63,2,113921,113457,464
504621,2,7.20061,457,271560,0.899952,0.63,2,113923,113466,457
507541,2,1.44012,459,273020,0.88399,0.63,2,113925,113466,459
510461,2,0.288025,461,274480,0.848798,0.63,2,113927,113466,461
513381,2,0.0576049,463,275940,0.80976,0.63,2,113929,113466,463
516261,2,0.011521,465,277400,0.873952,0.8,2,113931,113466,465
519181,2,9.6023,455,278860,0.85479,0.8,2,113933,113478,455
522101,2,1.92046,457,280320,0.818958,0.8,2,113935,113478,457
525021,2,0.384092,459,281780,0.899792,0.8,2,113937,113478,459
527941,2,0.0768184,461,283240,0.883958,0.8,2,113939,113478,461
530861,2,0.0153637,463,284700,0.848792,0.8,2,113941,113478,463
532901,2,0.00307274,465,286160,0.809758,0.67,2,113943,113478,465
535821,2,5.60061,460,287620,0.769952,0.67,2,113945,113485,460
538741,2,1.12012,462,289080,0.72999,0.67,1,113947,113485,462
541661,2,0.224025,464,290540,0.841998,0.67,2,113949,113485,464
544341,6.8,0.0448049,472,292000,0.8484,0.84,2,113957,113485,472
547261,2.96,8.80896,463,293460,0.81768,0.84,2,113959,113496,463
549541,8.592,1.76179,473,294920,0.835536,0.79,2,113969,113496,473
552461,3.3184,12.3524,460,296380,0.807107,0.79,2,113971,113511,460
555381,2.26368,2.47047,462,297840,0.801421,0.79,2,113973,113511,462
558301,2.05274,0.494094,464,299300,0.800284,0.79,2,113975,113511,464
561221,2.01055,0.0988188,466,300760,0.808057,0.79,2,113977,113511,466
564101,114.002,0.0197638,608,302220,0.889611,0.89,2,114119,113511,608
567021,24.4004,119.204,461,303680,0.905922,0.89,2,114121,113660,461
569941,6.48008,23.8408,463,305140,0.909185,0.89,2,114123,113660,463
572421,4.49602,4.76816,467,306600,0.909837,0.81,2,114127,113660,467
575341,2.4992,7.35363,461,308060,0.909967,0.81,2,114129,113668,461
578261,2.09984,1.47073,463,309520,0.877993,0.81,2,114131,113668,463
581181,2.01997,0.294145,465,310980,0.839599,0.81,2,114133,113668,465
582401,161.204,0.058829,666,312440,0.91192,0.97,2,114334,113668,666
585321,49.8408,182.412,460,312440,0.942384,0.97,2,114356,113896,460
617761,2,0,466,329960,0.94,0.85,2,114378,113912,466
620681,2,5.6,461,331420,0.908,0.85,2,114380,113919,461
623601,2,1.12,463,332880,0.8696,0.85,2,114382,113919,463
626521,2,0.224,465,334340,0.94992,0.85,2,114384,113919,465
628581,2,0.0448,467,335800,0.933984,0.86,2,114386,113919,467
631501,2,5.60896,462,337260,0.970797,0.86,2,114388,113926,462
634421,2,1.12179,464,338720,0.946159,0.86,2,114390,113926,464
637341,2,0.224358,466,340180,0.925232,0.86,2,114392,113926,466
640021,2,0.0448717,468,341640,0.889046,0.92,2,114394,113926,468
642941,2,8.80897,459,343100,0.849809,0.92,2,114396,113937,459
645861,2,1.76179,461,344560,0.809962,0.92,2,114398,113937,461
648781,2,0.352359,463,346020,0.921992,0.92,2,114400,113937,463
651701,2,0.0704718,465,347480,0.912399,0.92,2,114402,113937,465
654581,2,0.0140944,467,348940,0.96648,0.78,2,114404,113937,467
657501,2,5.60282,462,350400,0.945296,0.78,2,114406,113944,462
660421,2,1.12056,464,351860,0.917059,0.78,2,114408,113944,464
663341,2,0.224113,466,353320,0.879412,0.78,2,114410,113944,466
664981,3.6,0.0448225,470,354780,0.911882,0.91,2,114414,113944,470
667901,3.12,8.00896,463,356240,0.926377,0.91,2,114417,113954,463
670821,2.224,1.60179,465,357700,0.897275,0.91,2,114419,113954,465
673301,10.0448,0.320359,477,359160,0.931455,0.85,2,114431,113954,477
676221,3.60896,11.2641,465,360620,0.938291,0.85,2,114433,113968,465
678081,1.52179,2.25281,466,362080,0.947658,0.9,2,114434,113968,466
681001,3.50436,9.25056,459,363540,0.909532,0.9,2,114438,113979,459
683921,2.30087,1.85011,461,365000,0.901906,0.9,2,114440,113979,461
686841,2.06017,0.370022,463,366460,0.972381,0.9,2,114442,113979,463
689761,2.01203,0.0740045,465,367920,0.954476,0.9,2,114444,113979,465
691601,1.20241,0.0148009,466,369380,0.934895,0.93,2,114445,113979,466
743821,2,4,469,397120,0.94,0.96,2,114846,114377,469
745681,1.2,0.8,470,398580,0.932,0.98,2,114847,114377,470
748601,2.64,8.96,462,400040,0.9064,0.98,2,114850,114388,462
751521,2.128,1.792,464,401500,0.85328,0.98,2,114852,114388,464
754441,2.0256,0.3584,466,402960,0.970656,0.98,2,114854,114388,466
757361,2.00512,0.07168,468,404420,0.970131,0.98,2,114856,114388,468
759201,1.20102,0.014336,469,405880,0.930026,0.9,2,114857,114388,469
762121,1.8402,4.00287,466,407340,0.906005,0.9,2,114859,114393,466
765041,1.96804,0.800573,468,408800,0.869201,0.9,2,114861,114393,468
767521,1.99361,0.160115,470,410260,0.82984,0.95,2,114863,114393,470
770441,1.99872,5.63202,465,411720,0.941968,0.95,2,114865,114400,465
773361,1.99974,1.1264,467,413180,0.932394,0.95,2,114867,114400,467
776281,1.99995,0.225281,469,414640,0.882479,0.95,2,114869,114400,469
778341,1.99999,0.0450562,471,416100,0.856496,0.98,2,114871,114400,471
781261,2,3.20901,469,417560,0.819299,0.98,2,114873,114404,469
783541,5.2,0.641802,475,419020,0.71586,0.93,1,114879,114404,475
786461,2.64,10.5284,464,420480,0.911172,0.93,2,114881,114417,464
789381,2.128,2.10567,466,421940,0.886234,0.93,2,114883,114417,466
792301,2.0256,0.421134,468,423400,0.857247,0.93,2,114885,114417,468
795221,2.00512,0.0842269,470,424860,0.955449,0.93,2,114887,114417,470
797061,9.20102,0.0168454,481,426320,0.97509,0.94,2,114898,114417,481
883381,2,0,474,471580,1,0.87,2,115327,114853,474
886301,2,12.8,460,473040,0.976,0.87,2,115329,114869,460
889221,2,2.56,462,474500,0.9072,0.87,2,115331,114869,462
892141,2,0.512,464,475960,0.87744,0.87,2,115333,114869,464
895061,2,0.1024,466,477420,0.823488,0.87,2,115335,114869,466
897981,2,0.02048,468,478880,0.796698,0.87,2,115337,114869,468
900901,2,0.004096,470,480340,0.959339,0.87,2,115339,114869,470
903761,2,0.0008192,472,481800,0.975868,0.77,2,115341,114869,472
906681,3.6,4.80016,470,483260,0.947174,0.77,2,115345,114875,470
909601,2.32,0.960033,472,484720,0.925435,0.77,2,115347,114875,472
912081,2.064,0.192007,474,486180,0.985087,0.99,2,115349,114875,474
1336401,7,495,439,7480,0.01,0,1,117348,116909,439
1339321,339,444.6,429,63473,0.506,0.01,1,117770,117341,429
1342241,69.4,94.52,424,63506,0.6052,0.01,1,117772,117348,424
1345161,15.48,18.904,426,63539,0.59304,0.01,1,117774,117348,426
1348081,4.696,3.7808,428,63572,0.590608,0.01,1,117776,117348,428
1351001,2.5392,0.75616,430,63605,0.590122,0.01,1,117778,117348,430
1353921,2.10784,0.151232,432,63638,0.590024,0.01,1,117780,117348,432
1356841,2.02157,0.0302464,434,63671,0.590005,0.01,1,117782,117348,434
1359761,2.00431,0.00604928,436,63704,0.590001,0.01,1,117784,117348,436
1362681,2.00086,0.00120986,438,63737,0.59,0.01,1,117786,117348,438
1365601,2.00017,0.000241971,440,63770,0.59,0.01,1,117788,117348,440
1368521,2.00003,4.83942e-05,442,63803,0.59,0.01,1,117790,117348,442
1371441,2.00001,9.67884e-06,444,63836,0.59,0.01,1,117792,117348,444
1374361,2,1.93577e-06,446,63869,0.59,0.01,1,117794,117348,446
1377281,2,3.87154e-07,448,63902,0.59,0.01,1,117796,117348,448
1380201,2,7.74307e-08,450,63935,0.59,0.01,1,117798,117348,450
1383121,2,1.54861e-08,452,63968,0.59,0.01,1,117800,117348,452
1386041,2,3.09723e-09,454,64001,0.59,0.01,1,117802,117348,454
1388961,2,6.19446e-10,456,64034,0.59,0.01,1,117804,117348,456
1391881,2,1.23889e-10,458,64067,0.59,0.01,1,117806,117348,458
1394801,2,2.47778e-11,460,64100,0.59,0.01,1,117808,117348,460
1397721,2,4.95556e-12,462,64133,0.59,0.01,1,117810,117348,462
1399181,161.2,9.91113e-13,663,64166,0.622,0.63,1,118011,117348,663
1402101,200.24,337.6,451,64199,0.6924,0.63,1,118221,117770,451
1405021,41.648,69.12,451,64232,0.67448,0.59,1,118223,117772,451
1407941,9.9296,15.424,451,64265,0.702896,0.59,1,118225,117774,451
1410861,3.58592,4.6848,451,64298,0.676579,0.59,1,118227,117776,451
1413781,2.31718,2.53696,451,64331,0.703316,0.59,1,118229,117778,451
1416701,2.06344,2.10739,451,64364,0.676663,0.59,1,118231,117780,451
1419621,2.01269,2.02148,451,64397,0.671333,0.59,1,118233,117782,451
1422541,2.00254,2.0043,451,64430,0.686267,0.59,1,118235,117784,451
1425461,2.00051,2.00086,451,64463,0.689253,0.59,1,118237,117786,451
1428381,2.0001,2.00017,451,64496,0.689851,0.59,1,118239,117788,451
1431301,2.00002,2.00003,451,64529,0.68997,0.59,1,118241,117790,451
1434221,2,2.00001,451,64562,0.689994,0.59,1,118243,117792,451
1437141,2,2,451,64595,0.689999,0.59,1,118245,117794,451
1440061,2,2,451,64627,0.69,0.59,1,118247,117796,451
1442981,2,2,451,64659,0.69,0.59,1,118249,117798,451
1445901,2,2,451,64691,0.69,0.59,1,118251,117800,451
1448821,2,2,451,64723,0.69,0.59,1,118253,117802,451
1451741,2,2,451,64755,0.69,0.59,1,118255,117804,451
1454661,2,2,451,64787,0.69,0.59,1,118257,117806,451
1457581,2,2,451,64819,0.69,0.59,1,118259,117808,451
1460501,2,2,451,64851,0.69,0.63,1,118261,117810,451
1461961,322,161.2,652,64883,0.722,0.71,1,118663,118011,652
1464881,74.8,200.24,455,64915,0.7284,0.67,1,118676,118221,455
1467801,16.56,41.648,455,64947,0.72968,0.67,1,118678,118223,455
1470721,4.912,8.3296,457,64979,0.761936,0.71,2,118680,118223,457
1473641,2.5824,3.26592,457,65011,0.736387,0.67,1,118682,118225,457
1476561,2.11648,2.25318,457,65043,0.731277,0.71,1,118684,118227,457
1479481,2.0233,2.05064,457,65075,0.730255,0.67,1,118686,118229,457
1482401,2.00466,2.01013,457,65107,0.730051,0.67,1,118688,118231,457
1485321,2.00093,2.00203,457,65139,0.73001,0.69,1,118690,118233,457
1488241,2.00019,2.00041,457,65171,0.730002,0.69,1,118692,118235,457
1491161,2.00004,2.00008,457,65203,0.73,0.69,1,118694,118237,457
1494081,2.00001,2.00002,457,65235,0.73,0.69,1,118696,118239,457
1497001,2,2,457,65267,0.73,0.69,1,118698,118241,457
1499921,2,2,457,65299,0.73,0.69,1,118700,118243,457
1502841,2,2,457,65331,0.73,0.69,1,118702,118245,457
1505761,2,2,457,65363,0.73,0.69,1,118704,118247,457
1508681,2,2,457,65395,0.73,0.69,1,118706,118249,457
1511601,2,2,457,65427,0.73,0.69,1,118708,118251,457
1514521,2,2,457,65459,0.73,0.69,1,118710,118253,457
1517441,2,2,457,65491,0.73,0.69,1,118712,118255,457
1520361,2,2,457,65523,0.73,0.69,1,118714,118257,457
1523281,2,2,457,65555,0.73,0.69,1,118716,118259,457
1524741,161.2,2,656,65587,0.73,0.73,1,118917,118261,656
1527661,205.04,322,470,65619,0.794,0.73,2,119133,118663,470
1530581,42.608,74.8,459,65651,0.8068,0.73,2,119135,118676,459
1533501,10.1216,16.56,459,65683,0.80936,0.77,2,119137,118678,459
1536421,3.62432,4.912,459,65715,0.809872,0.73,2,119139,118680,459
1539341,2.32486,2.5824,459,65747,0.809974,0.73,2,119141,118682,459
1542261,2.06497,2.11648,459,65779,0.809995,0.73,2,119143,118684,459
1545181,2.01299,2.0233,459,65811,0.809999,0.73,2,119145,118686,459
1548101,2.0026,2.00466,459,65843,0.81,0.73,2,119147,118688,459
1551021,2.00052,2.00093,459,65875,0.826,0.73,2,119149,118690,459
1553941,2.0001,2.00019,459,65907,0.8292,0.73,2,119151,118692,459
1556861,2.00002,2.00004,459,65939,0.82984,0.73,2,119153,118694,459
1559781,2,2.00001,459,65971,0.829968,0.73,2,119155,118696,459
1562701,2,2,459,66003,0.829994,0.73,2,119157,118698,459
1565621,2,2,459,66035,0.829999,0.73,2,119159,118700,459
1568541,2,2,459,66067,0.83,0.73,2,119161,118702,459
1571461,2,2,459,66099,0.83,0.73,2,119163,118704,459
1574381,2,2,459,66131,0.83,0.73,2,119165,118706,459
1577301,2,2,459,66163,0.83,0.73,2,119167,118708,459
1580221,2,2,459,66195,0.83,0.73,2,119169,118710,459
1583141,2,2,459,66227,0.83,0.73,2,119171,118712,459
1586061,2,2,459,66259,0.83,0.73,2,119173,118714,459
1587521,161.2,2,658,66291,0.846,0.73,2,119374,118716,658
1588981,193.84,161.2,659,66323,0.9132,0.81,2,119576,118917,659
1615261,2,2,464,66611,0.93,0.83,2,119611,119147,464
1618181,2,2,464,66643,0.93,0.83,2,119613,119149,464
1621101,2,2,464,66674,0.93,0.83,2,119615,119151,464
1624021,2,2,464,66705,0.93,0.83,2,119617,119153,464
1626941,2,2,464,66736,0.93,0.83,2,119619,119155,464
1629861,2,2,464,66767,0.93,0.83,2,119621,119157,464
1632781,2,2,464,66798,0.93,0.83,2,119623,119159,464
1635701,2,2,464,66829,0.93,0.83,2,119625,119161,464
1638621,2,2,464,66860,0.93,0.83,2,119627,119163,464
1641541,2,2,464,66891,0.93,0.83,2,119629,119165,464
1644461,2,2,464,66922,0.93,0.83,2,119631,119167,464
1647381,2,2,464,66953,0.93,0.83,2,119633,119169,464
1650301,2,2,464,66984,0.93,0.83,2,119635,119171,464
1651761,161.2,2,663,67015,0.93,0.85,2,119836,119173,663
1993401,11,7,458,32914,0.01,0.63,1,122563,122105,458
1996321,11.8,12.6,456,32978,0.01,0.61,1,122575,122119,456
1999241,10.36,12.12,454,33042,0.002,0.57,1,122585,122131,454
2002161,10.072,12.024,452,33106,0.0084,0.55,1,122595,122143,452
2003621,166.014,11.2048,646,33170,0.00168,0.01,1,122800,122154,646
2006541,78.0029,199.041,456,33234,0.040336,0.03,1,122856,122400,456
2009461,41.2006,79.8082,438,33298,0.112067,0.02,1,122888,122450,438
2012381,26.6401,37.5616,434,33362,0.174413,0.05,1,122911,122477,434
2015301,20.528,27.5123,428,33425,0.266883,0.07,1,122930,122502,428
2018221,14.5056,13.5025,431,33488,0.285377,0.03,1,122943,122512,431
2021141,16.5011,14.7005,433,33551,0.209075,0.01,1,122960,122527,433
2024061,22.5002,22.9401,432,33614,0.0978151,0.01,1,122984,122552,432
2026981,14.1,13.388,433,33677,0.043563,0.01,1,122996,122563,433
2029901,10.82,12.2776,431,33740,0.0087126,0,1,123006,122575,431
2032821,10.164,10.4555,431,33803,0.0257425,0.01,1,123016,122585,431
2034281,162.833,10.0911,622,33866,0.0291485,0,1,123217,122595,622
2037201,85.3666,166.018,483,33928,0.0698297,0.05,1,123283,122800,483
2040121,44.2733,78.0036,461,33990,0.141966,0.13,1,123317,122856,461
2043041,29.6547,41.2007,455,34052,0.172393,0.19,1,123343,122888,455
2045961,22.7309,26.6401,453,34114,0.170479,0.29,1,123364,122911,453
2048881,12.5462,20.528,444,34176,0.258096,0.29,1,123374,122930,444
2051801,12.1092,14.5056,443,34238,0.283619,0.19,1,123386,122943,443
2054721,4.02185,16.5011,428,34300,0.288724,0.07,1,123388,122960,428
2057641,16.0044,22.5002,423,34362,0.305745,0.03,1,123407,122984,423
2060561,12.0009,14.1,422,34424,0.293149,0,1,123418,122996,422
2063481,11.2002,10.82,423,34485,0.27463,0.03,1,123429,123006,423
2066401,9.44004,10.164,422,34546,0.254926,0.03,1,123438,123016,422
2069321,219.488,162.833,493,34607,0.226985,0.08,1,123710,123217,493
2072241,68.6976,85.3666,458,34668,0.125397,0.16,1,123741,123283,458
2075161,41.7395,44.2733,459,34729,0.0890794,0.18,1,123776,123317,459
2078081,26.7479,29.6547,456,34790,0.0978159,0.17,1,123799,123343,456
2081001,13.3496,22.7309,445,34851,0.219563,0.28,1,123809,123364,445
2083921,12.2699,12.5462,447,34912,0.227913,0.29,1,123821,123374,447
2086841,4.05398,12.1092,437,34973,0.229583,0.29,1,123823,123386,437
2089761,15.2108,4.02185,453,35033,0.229916,0.31,1,123841,123388,453
2092681,11.0422,16.0044,444,35093,0.229983,0.29,1,123851,123407,444
2095601,10.2084,12.0009,443,35153,0.245997,0.27,1,123861,123418,443
2098521,6.84169,11.2002,438,35213,0.265199,0.25,1,123867,123429,438
2099981,162.168,9.44004,630,35273,0.0530399,0.22,1,124068,123438,630
2102901,91.6337,219.488,432,35333,0.218608,0.1,1,124142,123710,432
2105821,42.3267,68.6976,431,35393,0.179722,0.08,1,124172,123741,431
2108741,35.6653,41.7395,430,35453,0.219944,0.1,1,124206,123776,430
2111661,27.9331,26.7479,433,35513,0.227989,0.25,1,124232,123799,433
2114581,13.5866,13.3496,433,35573,0.237598,0.23,1,124242,123809,433
2117501,12.3173,12.2699,433,35632,0.26352,0.23,1,124254,123821,433
2120421,4.06346,4.05398,433,35691,0.284704,0.23,1,124256,123823,433
2123341,15.2127,15.2108,433,35750,0.288941,0.23,1,124274,123841,433
2126261,11.0425,3.04216,443,35809,0.257788,0.23,1,124284,123841,443
2129181,11.0085,8.60843,444,35868,0.267558,0.25,1,124295,123851,444
2132101,7.0017,9.72169,440,35927,0.237512,0.27,1,124301,123861,440
2135021,151.8,6.74434,622,35986,0.0475023,0.26,1,124489,123867,622
2137941,94.3601,221.349,427,36045,0.0735005,0.17,1,124569,124142,427
2140861,47.672,68.2698,433,36104,0.1187,0.23,1,124605,124172,433
2143781,33.5344,40.854,429,36163,0.18374,0.23,1,124635,124206,429
2146701,31.5069,28.9708,434,36221,0.116748,0.24,1,124666,124232,434
2149621,14.3014,13.7942,434,36279,0.11935,0.27,1,124676,124242,434
2152541,12.4603,12.3588,434,36337,0.16787,0.29,1,124688,124254,434
2155461,4.09205,4.07177,434,36395,0.145574,0.29,1,124690,124256,434
2158381,15.2184,15.2144,434,36453,0.149115,0.25,1,124708,124274,434
2161301,11.0437,11.0429,434,36511,0.149823,0.27,1,124718,124284,434
2164221,10.2087,11.0086,433,36569,0.165965,0.23,1,124728,124295,433
2167141,6.84175,7.00171,433,36627,0.169193,0,1,124734,124301,433
2170061,142.968,151.8,422,36685,0.0338386,0.08,1,124911,124489,422
2172981,94.1937,94.3601,424,36743,0.0947677,0.13,1,124993,124569,424
2175901,50.8387,47.672,428,36801,0.0429535,0.2,1,125033,124605,428
2178821,30.9677,33.5344,424,36858,0.112591,0.1,1,125059,124635,424
2181741,33.3935,31.5069,427,36915,0.142518,0.12,1,125093,124666,427
2184661,16.2787,14.3014,429,36972,0.156504,0.18,1,125105,124676,429
2187581,12.8557,12.4603,429,37029,0.175301,0.14,1,125117,124688,429
2190501,4.17115,4.09205,429,37086,0.15506,0.15,1,125119,124690,429
2193421,15.2342,15.2184,429,37143,0.183012,0.15,1,125137,124708,429
2196341,11.0468,3.04368,439,37200,0.188602,0.15,1,125147,124708,439
2199261,10.2094,8.60874,439,37257,0.18972,0.17,1,125157,124718,439
2202181,6.84187,9.72175,435,37314,0.189944,0.17,1,125163,124728,435
2205101,136.568,6.74435,598,37371,0.237989,0,1,125332,124734,598
2208021,96.9137,142.949,508,37428,0.175598,0.11,1,125419,124911,508
2210941,49.7827,94.1898,464,37484,0.0991196,0.03,1,125457,124993,464
2213861,33.1565,50.838,453,37540,0.0998239,0.13,1,125486,125033,453
2216781,33.8313,30.9676,461,37596,0.123965,0.15,1,125520,125059,461
2219701,16.3663,33.3935,439,37652,0.160793,0.16,1,125532,125093,439
2222621,15.2733,16.2787,442,37708,0.192159,0.18,1,125547,125105,442
2225541,4.65465,12.8557,432,37764,0.198432,0.15,1,125549,125117,432
2228461,15.3309,4.17115,448,37820,0.199686,0.19,1,125567,125119,448
2231381,11.0662,15.2342,440,37876,0.207937,0.19,1,125577,125137,440
2234301,10.2132,11.0468,440,37932,0.209587,0.19,1,125587,125147,440
2237221,6.84265,10.2094,436,37988,0.209918,0.19,1,125593,125157,436
2240141,134.169,6.84187,596,38044,0.273984,0.25,1,125759,125163,596
2243061,97.2337,136.568,515,38100,0.166797,0.16,1,125847,125332,515
2245981,45.8467,96.9137,461,38155,0.0973593,0.08,1,125880,125419,461
2248901,30.7693,49.7827,450,38210,0.123472,0.1,1,125907,125457,450
2251821,38.9539,33.1565,462,38265,0.104694,0.13,1,125948,125486,462
2254741,17.3908,33.8313,440,38320,0.124939,0.17,1,125960,125520,440
2257661,17.8782,16.3663,446,38375,0.152988,0.2,1,125978,125532,446
2260581,5.17563,15.2733,433,38430,0.158598,0.2,1,125980,125547,433
2263501,15.4351,4.65465,449,38485,0.15172,0.2,1,125998,125549,449
2266421,11.087,15.3309,441,38540,0.174344,0.21,1,126008,125567,441
2269341,10.2174,11.0662,441,38595,0.186869,0.21,1,126018,125577,441
2272261,3.64348,10.2132,433,38650,0.189374,0.21,1,126020,125587,433
2275181,5.5287,6.84265,433,38705,0.189875,0.29,1,126026,125593,433
2278101,137.106,134.169,437,38760,0.301975,0.14,1,126196,125759,437
2281021,88.2211,97.2337,425,38814,0.156395,0.08,1,126272,125847,425
2283941,44.8442,45.8467,426,38868,0.095279,0.13,1,126306,125880,426
2286861,31.3688,30.7693,427,38922,0.0990558,0.1,1,126334,125907,427
2289781,39.8738,38.9539,428,38976,0.131811,0.13,1,126376,125948,428
2292701,19.1748,17.3908,430,39030,0.210362,0.16,1,126390,125960,430
2295621,16.635,17.8782,428,39084,0.186072,0.16,1,126406,125978,428
2298541,4.92699,5.17563,428,39138,0.181214,0.15,1,126408,125980,428
2301461,17.7854,15.4351,431,39192,0.204243,0.18,1,126429,125998,431
2304381,11.5571,11.087,431,39246,0.176849,0.19,1,126439,126008,431
2307301,10.3114,10.2174,431,39300,0.19537,0.19,1,126449,126018,431
2310221,3.66228,3.64348,431,39354,0.231074,0.19,1,126451,126020,431
2313141,5.53246,5.5287,431,39408,0.246215,0.33,1,126457,126026,431
2316061,142.706,137.106,438,39462,0.329243,0.12,1,126634,126196,438
2318981,78.9413,88.2211,425,39516,0.201849,0.08,1,126697,126272,425
2321901,42.1883,44.8442,424,39569,0.17637,0.1,1,126730,126306,424
2324821,31.6377,31.3688,425,39622,0.0832739,0.14,1,126759,126334,425
2327741,39.1275,39.8738,424,39675,0.112655,0.23,1,126800,126376,424
2330661,24.6255,19.1748,431,39728,0.046531,0.18,1,126821,126390,431
2333581,19.3251,16.635,433,39781,0.0813062,0.18,1,126839,126406,433
2336501,5.46502,4.92699,433,39834,0.112261,0.21,1,126841,126408,433
2339421,15.493,17.7854,430,39887,0.158452,0.17,1,126859,126429,430
2342341,12.6986,11.5571,432,39940,0.19969,0.2,1,126871,126439,432
2345261,10.5397,10.3114,432,39993,0.143938,0.24,1,126881,126449,432
2348181,3.70794,3.66228,432,40046,0.164788,0.25,1,126883,126451,432
2351101,5.54159,5.53246,432,40099,0.208958,0.25,1,126889,126457,432
2354021,145.908,1.10649,613,40152,0.273791,0.35,1,127070,126457,613
2356941,73.9817,141.821,492,40205,0.270758,0.17,1,127126,126634,492
2359861,39.5963,78.7643,460,40258,0.222152,0.17,1,127157,126697,460
2362781,31.1193,42.1529,456,40310,0.27643,0.06,1,127186,126730,456
2365701,35.8239,31.6306,464,40362,0.183286,0.12,1,127223,126759,464
2368621,27.1648,39.1261,448,40414,0.204657,0.03,1,127248,126800,448
2371541,21.433,24.6252,447,40466,0.200931,0.09,1,127268,126821,447
2374461,5.88659,19.325,431,40518,0.200186,0.12,1,127270,126839,431
2377381,15.5773,5.46501,447,40570,0.208037,0.17,1,127288,126841,447
2380301,11.1155,15.493,439,40622,0.209607,0.21,1,127298,126859,439
2383221,12.6231,12.6986,440,40674,0.193921,0.13,1,127311,126871,440
2386141,4.12462,10.5397,432,40726,0.190784,0.17,1,127313,126881,432
2389061,5.62492,3.70794,436,40778,0.190157,0.22,1,127319,126883,436
2391981,149.925,5.54159,616,40830,0.254031,0.29,1,127505,126889,616
2394901,73.185,145.908,489,40882,0.226806,0.27,1,127559,127070,489
2397821,41.837,73.9817,467,40934,0.221361,0.21,1,127593,127126,467
2400741,25.9674,39.5963,458,40986,0.204272,0.29,1,127615,127157,458
2403661,37.1935,31.1193,469,41038,0.168854,0.16,1,127655,127186,469
2406581,25.0387,35.8239,454,41089,0.177771,0.21,1,127677,127223,454
2409501,22.6077,27.1648,451,41140,0.195554,0.2,1,127699,127248,451
2412421,6.12155,21.433,433,41191,0.199111,0.2,1,127701,127268,433
2415341,15.6243,5.88659,449,41242,0.247822,0.21,1,127719,127270,449
2418261,11.1249,15.5773,441,41293,0.265564,0.21,1,127729,127288,441
2421181,13.425,11.1155,445,41344,0.269113,0.19,1,127743,127298,445
2424101,4.28499,12.6231,434,41395,0.269823,0.19,1,127745,127311,434
2427021,5.657,4.12462,438,41446,0.237965,0.19,1,127751,127313,438
2429941,151.531,5.62492,620,41497,0.263593,0.27,1,127939,127319,620
2432861,31.9063,149.925,436,41548,0.268719,0.22,1,127941,127505,436
2435781,47.1813,73.185,433,41599,0.301744,0.22,1,127992,127559,433
2438701,36.6363,41.837,433,41650,0.252349,0.2,1,128026,127593,433
2441621,25.7272,25.9674,434,41701,0.25847,0.16,1,128049,127615,434
2444541,36.3455,37.1935,433,41752,0.251694,0.18,1,128088,127655,433
2447461,24.8691,25.0387,433,41803,0.226339,0.2,1,128110,127677,433
2450381,22.5738,22.6077,433,41853,0.269268,0.2,1,128132,127699,433
2453301,7.71476,6.12155,435,41903,0.237854,0.26,1,128136,127701,435
2456221,15.943,15.6243,435,41953,0.287571,0.27,1,128154,127719,435
2459141,11.1886,11.1249,435,42003,0.297514,0.27,1,128164,127729,435
2462061,11.8377,13.425,433,42053,0.339503,0.27,1,128176,127743,433
2464981,3.96754,4.28499,433,42103,0.347901,0.23,1,128178,127745,433
2467901,5.59351,5.657,433,42153,0.31758,0.27,1,128184,127751,433
2470821,153.119,151.531,435,42203,0.391516,0.27,1,128374,127939,435
2473741,32.2237,31.9063,435,42253,0.406303,0.31,1,128376,127941,435
2476661,44.8447,47.1813,432,42303,0.281261,0.24,1,128424,127992,432
2479581,34.5689,36.6363,430,42353,0.336252,0.26,1,128456,128026,430
2482501,26.9138,25.7272,432,42403,0.38725,0.25,1,128481,128049,432
2485421,35.7828,36.3455,431,42453,0.40545,0.22,1,128519,128088,431
2488341,27.1566,24.8691,434,42503,0.39309,0.28,1,128544,128110,434
2491261,25.4313,22.5738,437,42553,0.390618,0.23,1,128569,128132,437
2494181,6.68626,7.71476,435,42603,0.390124,0.3,1,128571,128136,435
2497101,17.3373,15.943,437,42653,0.390025,0.3,1,128591,128154,437
2500021,11.4675,11.1886,437,42702,0.382005,0.35,1,128601,128164,437
2502941,11.8935,11.8377,437,42751,0.420401,0.35,1,128613,128176,437
2505861,3.9787,3.96754,437,42800,0.42808,0.31,1,128615,128178,437
2508781,5.59574,5.59351,437,42849,0.429616,0.41,1,128621,128184,437
2511701,155.519,153.119,440,42898,0.493923,0.41,1,128814,128374,440
2514621,32.7038,32.2237,440,42947,0.538785,0.25,1,128816,128376,440
2517541,44.1408,44.8447,439,42996,0.483757,0.25,1,128863,128424,439
2520461,34.4282,8.96895,471,43045,0.448751,0.35,1,128895,128424,471
2523381,26.8856,27.3938,464,43094,0.41775,0.4,1,128920,128456,464
2526301,34.9771,25.4788,476,43143,0.41155,0.41,1,128957,128481,476
2529221,24.5954,35.4958,460,43192,0.42631,0.39,1,128979,128519,460
2532141,25.7191,27.0991,461,43241,0.453262,0.39,1,129005,128544,461
2535061,6.74382,25.4198,438,43290,0.458652,0.39,1,129007,128569,438
2537981,20.5488,6.68397,460,43339,0.37973,0.39,1,129031,128571,460
2540901,12.1098,17.3368,450,43388,0.451946,0.38,1,129041,128591,450
2543821,12.022,11.4674,452,43437,0.474389,0.43,1,129053,128601,452
2546741,4.00439,11.8935,442,43486,0.478878,0.43,1,129055,128613,442
2549661,5.60088,3.97869,446,43535,0.487776,0.43,1,129061,128615,446
2552581,160.32,5.59574,639,43583,0.521555,0.51,1,129260,128621,639
2555501,33.664,155.519,448,43631,0.544311,0.55,1,129262,128814,448
2558421,45.1328,32.7038,494,43679,0.548862,0.47,1,129310,128816,494
2561341,31.4266,44.1408,475,43727,0.501772,0.44,1,129338,128863,475
2564261,26.2853,34.4282,468,43775,0.460355,0.41,1,129363,128895,468
2567181,34.8571,26.8856,480,43823,0.492071,0.41,1,129400,128920,480
2570101,22.9714,34.9771,463,43871,0.530414,0.43,1,129420,128957,463
2573021,26.1943,24.5954,468,43919,0.434083,0.46,1,129447,128979,468
2575941,7.63886,25.7191,445,43967,0.518817,0.46,1,129450,129005,445
2578861,22.3278,6.74382,469,44015,0.455763,0.36,1,129476,129007,469
2581781,12.4656,20.5488,455,44063,0.507153,0.47,1,129486,129031,455
2584701,12.0931,12.1098,457,44111,0.557431,0.48,1,129498,129041,457
2587621,4.01862,12.022,447,44159,0.567486,0.48,1,129500,129053,447
2590541,5.60372,4.00439,451,44207,0.577497,0.49,1,129506,129055,451
2592001,161.921,5.60088,646,44255,0.571499,0.53,1,129707,129061,646
2594921,33.9841,160.32,449,44303,0.5703,0.55,1,129709,129260,449
2597841,8.39683,33.664,449,44351,0.53806,0.55,1,129711,129262,449
2600761,32.0794,45.1328,439,44399,0.595612,0.49,1,129749,129310,439
2603681,33.6159,31.4266,445,44447,0.583122,0.45,1,129783,129338,445
2606601,29.1232,26.2853,448,44494,0.596624,0.45,1,129811,129363,448
2609521,29.0246,5.25706,477,44541,0.615325,0.5,1,129840,129363,477
2612441,25.8049,30.6514,465,44588,0.587065,0.54,1,129865,129400,465
2615361,29.961,22.1303,476,44635,0.549413,0.41,1,129896,129420,476
2618281,7.5922,26.0261,451,44682,0.509883,0.54,1,129898,129447,451
2621201,22.3184,7.60521,474,44729,0.501976,0.44,1,129924,129450,474
2624121,13.2637,22.321,459,44776,0.580395,0.52,1,129935,129476,459
2627041,12.2527,12.4642,461,44823,0.588079,0.57,1,129947,129486,461
2629961,4.05055,12.0928,451,44870,0.589616,0.57,1,129949,129498,451
2632881,5.61011,4.01857,455,44917,0.589923,0.58,1,129955,129500,455
2634341,161.922,5.60371,650,44964,0.653985,0.57,1,130156,129506,650
2637261,33.1844,161.921,450,45011,0.682797,0.57,1,130157,129707,450
2640181,8.23688,33.9841,450,45058,0.688559,0.53,1,130159,129709,450
2643101,32.8474,8.39683,487,45105,0.673712,0.61,1,130198,129711,487
2646021,32.1695,32.0794,481,45152,0.670742,0.58,1,130230,129749,481
2648941,24.8339,33.6159,470,45199,0.606148,0.6,1,130253,129783,470
2651861,32.1668,29.1232,476,45246,0.57723,0.62,1,130287,129811,476
2654781,25.6334,29.0246,471,45293,0.531446,0.58,1,130311,129840,471
2657701,30.7267,25.8049,478,45340,0.538289,0.54,1,130343,129865,478
2660621,11.7453,29.961,454,45387,0.675658,0.5,1,130350,129896,454
2663541,21.5491,7.5922,476,45433,0.607132,0.5,1,130374,129898,476
2666461,13.9098,22.3184,462,45479,0.609426,0.6,1,130386,129924,462
2669381,12.382,13.2637,463,45525,0.649885,0.59,1,130398,129935,463
2672301,4.07639,12.2527,453,45571,0.657977,0.59,1,130400,129947,453
2675221,5.61528,4.05055,457,45617,0.659595,0.59,1,130406,129949,457
2676681,161.923,5.61011,652,45663,0.859919,0.67,2,130607,129955,652
2679601,35.5846,161.922,455,45709,0.899984,0.69,2,130611,130156,455
2682521,8.71692,33.1844,456,45755,0.907997,0.69,2,130613,130157,456
2685441,33.7434,8.23688,494,45801,0.941599,0.67,2,130653,130159,494
2688361,30.7487,32.8474,485,45847,0.89232,0.67,2,130683,130198,485
2691281,24.5497,32.1695,476,45893,0.890464,0.59,2,130706,130230,476
2694201,32.1099,24.8339,487,45939,0.850093,0.57,2,130740,130253,487
2697121,8.02199,32.1668,455,45985,0.898019,0.52,2,130742,130287,455
2835821,10,14,492,48136,0.63,1,1,132197,131705,492
2838741,13.2,24.4,479,48180,0.67,1,1,132211,131732,479
2841661,10.64,11.28,481,48224,0.598,1,1,132221,131740,481
2844581,25.328,28.656,477,48268,0.3516,1,1,132250,131773,477
2847501,13.8656,13.7312,478,48312,0.28632,1,1,132261,131783,478
2850421,13.9731,15.5462,476,48356,0.145264,1,1,132275,131799,476
2853341,12.3946,11.9092,477,48400,0.101053,1,1,132287,131810,477
2856261,13.6789,11.9818,479,48444,0.0442106,1,1,132301,131822,479
2859181,150.736,147.996,482,48488,0.00884211,1,1,132486,132004,482
2862101,43.7472,45.5993,479,48531,0.0737684,1,1,132503,132024,479
2865021,21.5494,21.9199,479,48574,0.0867537,0.86,1,132519,132040,479
2867941,34.7099,36.384,477,48617,0.121351,0.99,1,132557,132080,477
2870861,25.342,28.8768,473,48660,0.16027,1,1,132580,132107,473
2873781,14.6684,18.5754,469,48703,0.184054,0.75,1,132592,132123,469
2876701,33.3337,46.1151,454,48746,0.140811,0.67,1,132630,132176,454
2879621,14.6667,18.023,453,48789,0.0681622,0.63,1,132640,132187,453
2882541,10.1333,11.6046,452,48832,0.0376324,0.63,1,132649,132197,452
2885461,11.6267,2.32092,464,48875,0.0155265,0.68,1,132661,132197,464
2888381,7.92533,11.6642,457,48918,0.0111053,0.58,1,132668,132211,457
2891301,13.5851,10.3328,462,48961,0.0422211,0.29,1,132683,132221,462
2894221,7.51701,25.2666,439,49004,0.0164442,0.27,1,132689,132250,439
2897141,10.3034,13.8533,439,49047,0.0432888,0.11,1,132700,132261,439
2900061,10.0607,13.9707,435,49090,0.00865777,0.09,1,132710,132275,435
2902981,14.0121,12.3941,438,49133,0.00973155,0.03,1,132725,132287,438
2951161,201,15,622,49858,0.61,0.97,1,133347,132725,622
2954081,68.2,152.6,470,49900,0.714,0.9,1,133382,132912,470
2957001,28.04,45.72,469,49942,0.7908,0.95,2,133400,132931,469
2959921,16.808,20.344,469,49984,0.78216,0.93,2,133414,132945,469
2962841,35.3616,35.2688,470,50026,0.756432,1,2,133454,132984,470
2965761,27.8723,26.2538,472,50068,0.655286,1,1,133480,133008,472
2968681,15.1745,14.8508,472,50110,0.715057,1,1,133492,133020,472
2971601,29.4349,29.3701,472,50152,0.759011,0.98,2,133525,133053,472
2974521,12.287,12.274,472,50194,0.767802,0.97,2,133533,133061,472
2977441,8.8574,9.65481,471,50236,0.76956,0.96,2,133541,133070,471
2980361,11.3715,12.331,470,50278,0.769912,0.94,2,133553,133083,470
2983281,7.0743,7.26619,470,50320,0.769982,0.94,2,133559,133089,470
2986201,12.6149,1.45324,484,50362,0.769996,0.97,2,133573,133089,484
2989121,8.12297,12.2906,476,50404,0.753999,0.95,2,133580,133104,476
2992041,8.02459,8.05813,477,50446,0.7828,0.97,2,133588,133111,477
2994961,8.80492,9.61163,476,50488,0.77256,0.95,2,133597,133121,476
2997881,9.76098,10.7223,475,50530,0.770512,0.89,2,133607,133132,475
3000801,159.552,13.3445,658,50572,0.826102,0.74,2,133804,133146,658
3021241,34,33,460,50864,0.96,0.77,2,133985,133525,460
3024161,13.2,13,460,50905,0.96,0.77,2,133993,133533,460
3027081,9.04,9,460,50946,0.952,0.77,2,134001,133541,460
3030001,11.408,11.4,460,50987,0.9504,0.77,2,134013,133553,460
3032921,7.0816,7.08,460,51028,0.91808,0.77,2,134019,133559,460
3035841,12.6163,12.616,460,51069,0.943616,0.75,2,134033,133573,460
3038761,8.92326,8.1232,461,51110,0.948723,0.79,2,134041,133580,461
3314701,30,45,502,54885,0.01,1,1,136706,136204,502
3317621,33.2,37.8,500,54923,0.026,1,1,136740,136240,500
3320541,23.44,25.96,498,54961,0.0612,1,1,136761,136263,498
3323461,19.888,19.592,499,54999,0.05224,1,1,136780,136281,499
3326381,23.1776,24.7184,497,55037,0.034448,1,1,136804,136307,497
3329301,27.8355,24.9437,501,55075,0.0628896,1,1,136833,136332,501
3332221,16.7671,28.1887,486,55113,0.0525779,0.97,1,136847,136361,486
3335141,13.7534,16.8377,485,55151,0.0345156,1,1,136860,136375,485
3338061,11.5507,14.5675,482,55189,0.0309031,1,1,136871,136389,482
3340981,9.51014,12.5135,479,55227,0.0301806,0.94,1,136880,136401,479
3343901,6.70203,9.7027,476,55265,0.0300361,0.95,1,136886,136410,476
3346821,6.14041,7.54054,475,55303,0.0140072,0.96,1,136892,136417,475
3349741,12.4281,5.50811,484,55341,0.00280144,0.96,1,136906,136422,484
3352661,17.6856,13.9016,487,55379,0.00856029,1,1,136925,136438,487
3355581,13.9371,17.1803,482,55417,0.0417121,0.97,1,136938,136456,482
3358501,12.3874,14.6361,480,55455,0.0163424,0.96,1,136950,136470,480
3361421,89.6775,13.3272,576,55493,0.0752685,0.15,1,137059,136483,576
3364341,49.9355,126.665,461,55531,0.0230537,0.03,1,137099,136638,461
3367261,34.7871,55.7331,454,55569,0.556611,0.01,1,137130,136676,454
3370181,33.3574,35.1466,457,55607,0.519322,0.03,1,137163,136706,457
3373101,24.2715,34.2293,445,55645,0.463864,0.07,1,137185,136740,445
3376021,17.6543,23.6459,440,55683,0.388773,0.05,1,137201,136761,440
3378941,23.5309,19.9292,446,55721,0.261755,0.03,1,137226,136780,446
3381861,27.1062,23.1858,450,55759,0.172351,0.07,1,137254,136804,450
3384781,16.6212,27.8372,435,55797,0.18647,0.05,1,137268,136833,435
3387701,13.7242,16.7674,434,55835,0.173294,0.03,1,137281,136847,434
3390621,11.5448,13.7535,432,55873,0.154659,0.03,1,137292,136860,432
3393541,9.50897,11.5507,430,55911,0.102932,0.03,1,137301,136871,430
3396461,6.70179,9.51014,427,55949,0.0605864,0.03,1,137307,136880,427
3399381,6.14036,6.70203,427,55987,0.0841173,0.01,1,137313,136886,427
3402301,13.2281,6.14041,436,56025,0.0168235,0,1,137328,136892,436
3405221,17.8456,12.4281,441,56063,0.00336469,0.01,1,137347,136906,441
3408141,13.1691,17.6856,434,56101,0.00867294,0.05,1,137359,136925,434
3411061,12.2338,13.9371,433,56138,0.0417346,0.01,1,137371,136938,433
3413981,4.04676,12.3874,423,56175,0.0483469,0.09,1,137373,136950,423
3416901,90.4094,89.6775,426,56212,0.0976694,0.01,1,137485,137059,426
3419821,78.0819,49.9355,461,56249,0.0435339,0.69,1,137560,137099,461
3422741,34.8164,34.7871,454,56286,0.0487068,0.51,1,137584,137130,454
3425661,27.7633,33.3574,447,56323,0.0657414,0.45,1,137610,137163,447
3428581,17.5527,24.2715,440,56360,0.0851483,0.37,1,137625,137185,440
3431501,13.1105,17.6543,436,56397,0.0890297,0.23,1,137637,137201,436
3434421,20.2221,23.5309,433,56434,0.121806,0.15,1,137659,137226,433
3437341,24.8444,27.1062,431,56471,0.0963612,0.19,1,137685,137254,431
3440261,14.5689,16.6212,429,56508,0.123272,0.17,1,137697,137268,429
3443181,12.5138,13.7242,428,56545,0.112654,0.15,1,137709,137281,428
3446101,8.90276,11.5448,425,56582,0.110531,0.09,1,137717,137292,425
3449021,9.78055,9.50897,426,56619,0.110106,0.05,1,137727,137301,426
3451941,5.95611,6.70179,425,56656,0.126021,0.09,1,137732,137307,425
3454861,5.19122,6.14036,424,56693,0.113204,0,1,137737,137313,424
3457781,13.0382,13.2281,424,56730,0.0626408,0,1,137752,137328,424
3460701,16.2076,17.8456,422,56767,0.0125282,0.01,1,137769,137347,422
3463621,14.4415,13.1691,424,56804,0.0105056,0.05,1,137783,137359,424
3466541,10.8883,12.2338,422,56841,0.0101011,0.05,1,137793,137371,422
3469461,3.77766,4.04676,422,56878,0.0100202,0.11,1,137795,137373,422
3472381,93.5555,90.4094,426,56915,0.090004,0.03,1,137911,137485,426
3475301,75.5111,78.0819,422,56952,0.0420008,0.05,1,137982,137560,422
3478221,35.9022,34.8164,424,56989,0.0804002,0.07,1,138008,137584,424
3481141,28.7804,27.7633,425,57026,0.10408,0.09,1,138035,137610,425
3484061,18.5561,17.5527,426,57063,0.076816,0.09,1,138051,137625,426
3486981,13.3112,13.1105,426,57100,0.0713632,0.13,1,138063,137637,426
3489901,20.2622,20.2221,426,57137,0.0862726,0.09,1,138085,137659,426
3492821,24.8524,24.8444,426,57174,0.0892545,0.13,1,138111,137685,426
3495741,15.3705,14.5689,427,57211,0.105851,0.11,1,138124,137697,427
3498661,12.6741,12.5138,427,57248,0.0771702,0.11,1,138136,137709,427
3501581,8.93482,8.90276,427,57285,0.071434,0.11,1,138144,137717,427
3504501,9.78696,9.78055,427,57322,0.0702868,0.13,1,138154,137727,427
3507421,5.15739,5.95611,426,57359,0.102057,0.11,1,138158,137732,426
3510341,5.83148,5.19122,427,57396,0.0764115,0.05,1,138164,137737,427
3513261,9.1663,13.0382,422,57433,0.0712823,0,1,138174,137752,422
3516181,15.4333,16.2076,422,57470,0.0222565,0.01,1,138191,137769,422
3519101,14.2867,14.4415,422,57507,0.0604513,0.01,1,138205,137783,422
3522021,10.8573,10.8883,422,57544,0.0200903,0.01,1,138215,137793,422
3524941,3.77147,3.77766,422,57581,0.0120181,0.11,1,138217,137795,422
3527861,95.9543,93.5555,425,57618,0.0104036,0.11,1,138336,137911,425
3530781,72.7909,18.7111,492,57654,0.0260807,0.03,1,138403,137911,492
3533701,36.9582,60.5422,449,57690,0.0292161,0.09,1,138431,137982,449
3536621,29.7916,32.9084,451,57726,0.0618432,0.11,1,138459,138008,451
3539541,18.7583,28.1817,440,57762,0.0843686,0.07,1,138475,138035,440
3542461,14.1517,18.4363,437,57798,0.104874,0.07,1,138488,138051,437
3545381,20.4303,13.2873,447,57834,0.0769747,0.09,1,138510,138063,447
3548301,24.8861,20.2575,451,57870,0.071395,0.09,1,138536,138085,451
3551221,14.5772,24.8515,437,57906,0.070279,0.11,1,138548,138111,437
3554141,12.5154,15.3703,436,57942,0.0700558,0.07,1,138560,138124,436
3557061,8.90309,12.6741,432,57978,0.0700112,0.07,1,138568,138136,432
3559981,9.78062,8.93481,434,58014,0.0700022,0.07,1,138578,138144,434
3562901,5.15612,9.78696,428,58050,0.0700004,0.11,1,138582,138154,428
3565821,5.83122,5.15739,430,58086,0.0700001,0.07,1,138588,138158,430
3568741,7.56624,5.83148,432,58122,0.07,0.07,1,138596,138164,432
3571661,14.3132,9.1663,438,58158,0.07,0.01,1,138612,138174,438
3574581,14.0626,15.4333,435,58194,0.054,0.07,1,138626,138191,435
3577501,10.8125,14.2867,431,58230,0.0508,0.01,1,138636,138205,431
3580421,3.76251,10.8573,423,58266,0.05016,0.01,1,138638,138215,423
3583341,95.9525,3.77147,540,58302,0.034032,0.01,1,138757,138217,540
3586261,72.7905,95.9543,488,58338,0.0468064,0.03,1,138824,138336,488
3589181,39.3581,72.7909,452,58374,0.0493613,0.03,1,138855,138403,452
3592101,30.2716,36.9582,452,58410,0.0498723,0.07,1,138883,138431,452
3595021,19.6543,29.7916,441,58446,0.0339745,0.09,1,138900,138459,441
3597941,13.5309,18.7583,437,58482,0.0307949,0.11,1,138912,138475,437
3600861,20.3062,14.1517,446,58518,0.030159,0.07,1,138934,138488,446
3603781,24.8612,20.4303,450,58554,0.0460318,0.07,1,138960,138510,450
3606701,14.5722,24.8861,436,58590,0.0492064,0.07,1,138972,138536,436
3609621,12.5144,14.5772,436,58626,0.0498413,0.07,1,138984,138548,436
3612541,8.90289,12.5154,432,58662,0.0499683,0.07,1,138992,138560,432
3615461,9.78058,8.90309,434,58698,0.0499936,0.07,1,139002,138568,434
3618381,5.15612,9.78062,428,58734,0.0499987,0.07,1,139006,138578,428
3621301,5.83122,5.15612,430,58770,0.0499997,0.07,1,139012,138582,430
3624221,7.56624,5.83122,432,58806,0.0499999,0.07,1,139020,138588,432
3627141,13.5132,7.56624,439,58842,0.066,0.07,1,139035,138596,439
3630061,13.9026,14.3132,437,58878,0.0692,0.05,1,139049,138612,437
3632981,9.18053,14.0626,431,58914,0.06984,0.05,1,139057,138626,431
3635901,3.43611,10.8125,423,58950,0.069968,0.05,1,139059,138636,423
3638821,98.2872,3.76251,543,58986,0.0379936,0.03,1,139181,138638,543
3641741,70.8574,95.9525,488,59022,0.0635987,0.05,1,139245,138757,488
3644661,39.7715,72.7905,453,59058,0.0367197,0.05,1,139277,138824,453
3647581,9.5543,39.3581,424,59094,0.0633439,0.05,1,139279,138855,424
3650501,24.3109,30.2716,424,59130,0.0366688,0.03,1,139307,138883,424
3653421,17.6622,19.6543,423,59166,0.0953338,0.03,1,139323,138900,423
3656341,13.1324,13.5309,423,59202,0.0750667,0.03,1,139335,138912,423
3659261,21.0265,20.3062,424,59238,0.0870133,0.05,1,139358,138934,424
3662181,25.0053,24.8612,424,59273,0.105403,0.05,1,139384,138960,424
3665101,14.6011,14.5722,424,59308,0.141081,0.05,1,139396,138972,424
3668021,12.5202,12.5144,424,59343,0.116216,0.05,1,139408,138984,424
3670941,8.90404,8.90289,424,59378,0.111243,0.05,1,139416,138992,424
3673861,9.78081,9.78058,424,59413,0.110249,0.05,1,139426,139002,424
3676781,5.15616,5.15612,424,59448,0.11005,0.05,1,139430,139006,424
3679701,5.83123,5.83122,424,59483,0.11001,0.05,1,139436,139012,424
3682621,7.56625,7.56624,424,59518,0.110002,0.07,1,139444,139020,424
3685541,14.3132,13.5132,425,59553,0.11,0.07,1,139460,139035,425
3688461,14.0626,13.9026,425,59588,0.11,0.07,1,139474,139049,425
3691381,9.21253,9.18053,425,59623,0.126,0.07,1,139482,139057,425
3694301,3.44251,3.43611,425,59658,0.1292,0.03,1,139484,139059,425
3697221,98.2885,98.2872,425,59693,0.03384,0.07,1,139606,139181,425
3700141,70.8577,70.8574,425,59728,0.046768,0.03,1,139670,139245,425
3703061,38.1715,39.7715,423,59763,0.0813536,0.07,1,139700,139277,423
3705981,9.23431,9.5543,423,59798,0.0562707,0.03,1,139702,139279,423
3708901,25.0469,24.3109,424,59833,0.0992541,0.11,1,139731,139307,424
3711821,18.6094,17.6622,425,59868,0.139851,0.07,1,139748,139323,425
3714741,13.3219,13.1324,425,59903,0.14797,0.09,1,139760,139335,425
3717661,21.8644,21.0265,426,59938,0.149594,0.11,1,139784,139358,426
3720581,25.9729,25.0053,427,59973,0.181919,0.15,1,139811,139384,427
3723501,14.7946,14.6011,427,60008,0.188384,0.11,1,139823,139396,427
3726421,12.5589,12.5202,427,60043,0.189677,0.11,1,139835,139408,427
3729341,8.91178,8.90404,427,60078,0.189935,0.11,1,139843,139416,427
3732261,9.78236,9.78081,427,60113,0.189987,0.11,1,139853,139426,427
3735181,5.15647,5.15616,427,60148,0.221997,0.11,1,139857,139430,427
3738101,5.83129,5.83123,427,60183,0.196399,0.11,1,139863,139436,427
3741021,7.56626,7.56625,427,60218,0.19128,0.11,1,139871,139444,427
3743941,14.3133,14.3132,427,60253,0.222256,0.11,1,139887,139460,427
3746861,14.8627,14.0626,428,60288,0.212451,0.13,1,139902,139474,428
3749781,9.37253,9.21253,428,60323,0.17849,0.13,1,139910,139482,428
3752701,3.47451,3.44251,428,60358,0.171698,0.01,1,139912,139484,428
3755621,93.4949,98.2885,422,60393,0.12234,0.05,1,140028,139606,422
3758541,71.499,70.8577,424,60428,0.112468,0.09,1,140094,139670,424
3761461,38.2998,38.1715,424,60463,0.110494,0.05,1,140124,139700,424
3764381,9.25996,9.23431,424,60498,0.0780987,0.11,1,140126,139702,424
3767301,27.452,25.0469,427,60533,0.0716197,0.11,1,140158,139731,427
3770221,19.8904,5.00937,445,60568,0.038324,0.15,1,140176,139731,445
3773141,13.5781,14.6019,440,60603,0.0476648,0.15,1,140188,139748,440
3776061,21.9156,12.5204,452,60638,0.065533,0.15,1,140212,139760,452
3778981,27.5831,21.7041,457,60673,0.0531066,0.19,1,140241,139784,457
3781901,15.1166,25.9408,442,60708,0.0506213,0.19,1,140253,139811,442
3784821,12.6233,14.7882,442,60743,0.0661243,0.19,1,140265,139823,442
3787741,8.92466,12.5576,438,60778,0.0692248,0.19,1,140273,139835,438
3790661,9.78493,8.91153,440,60813,0.069845,0.19,1,140283,139843,440
3793581,5.15699,9.78231,434,60848,0.069969,0.23,1,140287,139853,434
3796501,5.8314,5.15646,436,60883,0.0699938,0.19,1,140293,139857,436
3799421,7.56628,5.83129,438,60918,0.0699988,0.19,1,140301,139863,438
3802341,14.3133,7.56626,446,60952,0.0699998,0.23,1,140317,139871,446
3805261,14.0627,14.3133,444,60986,0.0699999,0.21,1,140331,139887,444
3808181,9.21253,14.8627,437,61020,0.07,0.17,1,140339,139902,437
3811101,3.44251,9.37253,431,61054,0.07,0.17,1,140341,139910,431
3814021,91.0885,3.47451,542,61088,0.262,0.11,1,140454,139912,542
3816941,69.4177,93.4949,490,61122,0.3164,0.11,1,140518,140028,490
3819861,37.8835,71.499,454,61156,0.32728,0.11,1,140548,140094,454
3822781,9.17671,38.2998,426,61190,0.329456,0.07,1,140550,140124,426
3825701,25.8353,9.25996,454,61224,0.329891,0.07,1,140580,140126,454
3828621,20.3671,27.452,441,61258,0.345978,0.03,1,140599,140158,441
3831541,14.4734,19.8904,436,61292,0.365196,0.05,1,140612,140176,436
3834461,22.0947,13.5781,448,61326,0.353039,0.07,1,140636,140188,448
3837381,26.8189,21.9156,452,61360,0.350608,0.05,1,140664,140212,452
3840301,15.7638,27.5831,436,61394,0.366122,0.05,1,140677,140241,436
3843221,12.7528,15.1166,436,61428,0.337224,0.07,1,140689,140253,436
3846141,8.95055,12.6233,432,61462,0.347445,0.07,1,140697,140265,432
3849061,9.79011,8.92466,434,61496,0.349489,0.07,1,140707,140273,434
3851981,5.15802,9.78493,428,61530,0.349898,0.07,1,140711,140283,428
3854901,5.8316,5.15699,430,61564,0.34998,0.07,1,140717,140287,430
3857821,7.56632,5.8314,432,61598,0.349996,0.07,1,140725,140293,432
3860741,14.3133,7.56628,440,61632,0.349999,0.07,1,140741,140301,440
3863661,14.0627,14.3133,438,61666,0.35,0.07,1,140755,140317,438
3866581,9.21253,14.0627,432,61700,0.35,0.07,1,140763,140331,432
3869501,3.44251,9.21253,426,61734,0.366,0.07,1,140765,140339,426
3872421,100.689,3.44251,549,61768,0.4652,0.31,1,140890,140341,549
3875341,72.1377,91.0885,501,61802,0.50104,0.33,1,140955,140454,501
3878261,38.4275,69.4177,467,61836,0.508208,0.33,1,140985,140518,467
3881181,9.28551,37.8835,439,61870,0.509642,0.33,1,140987,140548,439
3884101,25.8571,9.17671,467,61904,0.509928,0.33,1,141017,140550,467
3887021,20.3714,25.8353,456,61938,0.525986,0.35,1,141036,140580,456
3889941,14.4743,20.3671,450,61972,0.545197,0.37,1,141049,140599,450
3892861,4.49486,14.4734,439,62006,0.549039,0.35,1,141051,140612,439
3895781,20.099,22.0947,439,62040,0.645808,0.35,1,141075,140636,439
3898701,26.4198,26.8189,439,62074,0.633162,0.37,1,141103,140664,439
3901621,14.884,15.7638,438,62108,0.662632,0.33,1,141115,140677,438
3904541,13.3768,12.7528,439,62142,0.652526,0.35,1,141128,140689,439
3907461,9.07536,8.95055,439,62176,0.650505,0.35,1,141136,140697,439
3910381,9.81507,9.79011,439,62210,0.650101,0.35,1,141146,140707,439
3913301,5.16301,5.15802,439,62244,0.65002,0.35,1,141150,140711,439
3916221,5.8326,5.8316,439,62278,0.650004,0.35,1,141156,140717,439
3919141,7.56652,7.56632,439,62312,0.650001,0.35,1,141164,140725,439
3922061,14.3133,14.3133,439,62346,0.65,0.35,1,141180,140741,439
3924981,14.8627,14.0627,440,62380,0.666,0.35,1,141195,140755,440
3927901,9.37253,9.21253,440,62414,0.6692,0.37,1,141203,140763,440
3930821,3.47451,3.44251,440,62448,0.66984,0.49,1,141205,140765,440
3933741,105.495,100.689,446,62482,0.797968,0.51,2,141336,140890,446
3936661,73.899,72.1377,447,62516,0.823594,0.51,2,141402,140955,447
3939581,38.7798,38.4275,447,62550,0.876719,0.51,2,141432,140985,447
3942501,9.35596,9.28551,447,62584,0.855344,0.51,2,141434,140987,447
3945421,25.8712,25.8571,447,62618,0.851069,0.53,2,141464,141017,447
3948341,21.1742,20.3714,448,62652,0.850214,0.55,2,141484,141036,448
3951261,15.4348,14.4743,449,62686,0.850043,0.55,2,141498,141049,449
3954181,4.68697,4.49486,449,62720,0.882009,0.67,2,141500,141051,449
3957101,23.3374,20.099,453,62753,0.920402,0.63,2,141528,141075,453
4161501,11,13,508,65049,0.72,1,1,143068,142560,508
4164421,11,9.8,510,65081,0.76,1,2,143079,142569,510
4165881,11,11.56,509,65113,0.784,1,2,143090,142581,509
4233041,373.4,415.112,457,30660,0.1568,0.55,1,143554,143097,457
4235961,131.48,114.222,489,30729,0.03936,0,1,143625,143136,489
4238881,115.896,140.444,454,30798,0.015872,0,1,143737,143283,454
4241801,63.9792,78.4889,442,30867,0.0031744,0,1,143788,143346,442
4244721,44.7958,48.4978,441,30936,0.00063488,0.03,1,143828,143387,441
4247641,51.3592,39.2996,457,31004,0.024127,0.03,1,143881,143424,457
4250561,32.6718,47.8599,435,31072,0.0128254,0,1,143909,143474,435
4253481,22.5344,26.372,434,31140,0.00256508,0,1,143929,143495,434
4256401,28.5069,25.2744,439,31208,0.000513016,0,1,143959,143520,439
4259321,13.7014,20.2549,430,31276,0.0401026,0.01,1,143969,143539,430
4262241,5.94027,12.051,424,31344,0.0480205,0,1,143973,143549,424
4265161,60.3881,6.41019,493,31412,0.0176041,0.01,1,144047,143554,493
4268081,100.878,58.082,533,31479,0.0275208,0.01,1,144158,143625,533
4271001,61.7755,101.216,473,31546,0.00550416,0,1,144210,143737,473
4273921,43.5551,61.0433,461,31613,0.00110083,0,1,144249,143788,461
4276841,51.111,44.2087,474,31680,0.0242202,0.03,1,144302,143828,474
4279761,33.4222,51.2417,450,31747,0.044844,0.01,1,144331,143881,450
4282681,21.8844,32.6483,441,31814,0.00896881,0,1,144350,143909,441
4285601,29.9769,22.5297,453,31881,0.00179376,0,1,144382,143929,453
4288521,12.3954,28.5059,431,31947,0.00835875,0.05,1,144390,143959,431
4291441,6.47908,13.7012,426,32013,0.0256718,0.05,1,144395,143969,426
4294361,59.6958,5.94024,495,32079,0.0291343,0.01,1,144468,143973,495
4297281,100.739,60.388,532,32145,0.00582687,0.03,1,144579,144047,532
4300201,61.7478,100.878,473,32211,0.00116537,0,1,144631,144158,473
4303121,43.5496,61.7755,460,32277,0.00823308,0,1,144670,144210,460
4306041,51.1099,43.5551,474,32343,0.00964662,0.03,1,144723,144249,474
4308961,34.222,51.111,451,32408,0.00992932,0.05,1,144753,144302,451
4311881,21.2444,33.4222,440,32473,0.00198586,0,1,144771,144331,440
4314801,29.8489,21.8844,453,32538,0.000397173,0,1,144803,144350,453
4317721,12.3698,29.9769,429,32603,0.0240794,0.01,1,144811,144382,429
4320641,7.27396,12.3954,427,32668,0.0288159,0.03,1,144817,144390,427
4323561,59.8548,6.47908,495,32733,0.0137632,0.03,1,144890,144395,495
4326481,13.571,59.6958,424,32798,0.0267526,0,1,144892,144468,424
4329401,89.9142,100.739,422,32862,0.0293505,0,1,145001,144579,422
4332321,60.3828,61.7478,423,32926,0.0138701,0.01,1,145054,144631,423
4335241,42.4766,43.5496,422,32990,0.010774,0.01,1,145092,144670,422
4338161,50.8953,51.1099,422,33054,0.0101548,0.01,1,145145,144723,422
4341081,34.1791,34.222,422,33118,0.00203096,0,1,145175,144753,422
4344001,22.8358,21.2444,424,33182,0.0244062,0,1,145195,144771,424
4346921,29.3672,29.8489,423,33246,0.00488124,0.03,1,145226,144803,423
4349841,11.4734,12.3698,422,33310,0.0409762,0.03,1,145233,144811,422
4352761,7.09469,7.27396,422,33373,0.0481952,0.01,1,145239,144817,422
4355681,60.6189,59.8548,423,33436,0.00963905,0.03,1,145313,144890,423
4358601,13.7238,13.571,423,33499,0.00992781,0.03,1,145315,144892,423
4361521,89.1448,89.9142,422,33562,0.0259856,0.01,1,145423,145001,422
4364441,61.029,60.3828,423,33625,0.00519711,0.01,1,145477,145054,423
4367361,41.8058,42.4766,422,33688,0.0250394,0.01,1,145514,145092,422
4370281,50.7612,50.8953,422,33751,0.0770079,0,1,145567,145145,422
4373201,34.1522,34.1791,422,33814,0.0394016,0.03,1,145597,145175,422
4376121,22.8304,22.8358,422,33877,0.0158803,0,1,145617,145195,422
4379041,30.1661,29.3672,423,33939,0.0271761,0.05,1,145649,145226,423
4381961,10.8332,11.4734,422,34001,0.00543521,0.05,1,145655,145233,422
4384881,6.96664,7.09469,422,34063,0.041087,0,1,145661,145239,422
4387801,60.5933,60.6189,422,34125,0.00821741,0.01,1,145735,145313,422
4390721,13.7187,13.7238,422,34187,0.0416435,0.03,1,145737,145315,422
4393641,89.1437,89.1448,422,34249,0.0323287,0.03,1,145845,145423,422
4396561,60.2287,17.829,475,34311,0.00646574,0,1,145898,145423,475
4399481,41.6457,46.7658,458,34373,0.0252931,0.03,1,145935,145477,458
4402401,50.7292,38.9532,474,34435,0.0610586,0.09,1,145988,145514,474
4405321,34.1458,50.1906,451,34496,0.0682117,0.03,1,146018,145567,451
4408241,22.8292,34.0381,441,34557,0.0216423,0.01,1,146038,145597,441
4411161,30.1658,22.8076,453,34618,0.0283285,0.03,1,146070,145617,453
4414081,10.8332,30.1615,427,34679,0.00566569,0,1,146076,145649,427
4417001,6.96663,10.8323,427,34740,0.00913314,0.05,1,146082,145655,427
4419921,60.5933,6.96646,495,34801,0.00982663,0,1,146156,145661,495
4422841,13.7187,60.5933,423,34862,0.00996533,0.05,1,146158,145735,423
4425761,89.1437,13.7187,529,34923,0.0259931,0.03,1,146266,145737,529
4428681,61.0287,89.1437,475,34984,0.0291986,0,1,146320,145845,475
4431601,41.0057,60.2287,458,35044,0.0298397,0.03,1,146356,145898,458
4434521,51.4012,41.6457,475,35104,0.0619679,0.07,1,146410,145935,475
4437441,33.4802,50.7292,451,35164,0.0203936,0.07,1,146439,145988,451
4440361,22.696,34.1458,441,35224,0.0280787,0.01,1,146459,146018,441
4443281,30.1392,22.8292,453,35284,0.00561574,0.03,1,146491,146038,453
4446201,10.8278,30.1658,427,35344,0.00112315,0,1,146497,146070,427
4449121,6.96557,10.8332,427,35404,0.0242246,0.01,1,146503,146076,427
4452041,61.3931,6.96663,496,35464,0.00484493,0.01,1,146578,146082,496
4454961,13.8786,60.5933,424,35524,0.00896898,0.01,1,146580,146156,424
4457881,88.3757,13.7187,529,35584,0.0257938,0.03,1,146687,146158,529
4460801,60.8751,89.1437,475,35643,0.00515876,0.03,1,146741,146266,475
4463721,13.775,61.0287,423,35702,0.00903175,0.03,1,146743,146320,423
4466641,30.755,41.0057,422,35761,0.00980635,0.07,1,146778,146356,422
4469561,51.751,51.4012,425,35820,0.00996127,0.01,1,146835,146410,425
4472481,31.1502,33.4802,422,35879,0.0579923,0.03,1,146861,146439,422
4475401,23.03,22.696,423,35938,0.0195984,0,1,146882,146459,423
4478321,30.206,30.1392,423,35997,0.0279197,0,1,146914,146491,423
4481241,10.0412,10.8278,422,36056,0.00558394,0.03,1,146919,146497,422
4484161,6.80824,6.96557,422,36115,0.0251168,0,1,146925,146503,422
4487081,61.3616,61.3931,422,36174,0.00502336,0.01,1,147000,146578,422
4490001,13.8723,13.8786,422,36232,0.00900467,0.03,1,147002,146580,422
4492921,88.3745,88.3757,422,36290,0.0258009,0,1,147109,146687,422
4495841,61.6749,60.8751,423,36348,0.0291602,0.01,1,147164,146741,423
4498761,13.935,13.775,423,36406,0.029832,0.01,1,147166,146743,423
4501681,29.987,30.755,422,36464,0.0139664,0.01,1,147200,146778,422
4504601,51.5974,51.751,422,36522,0.0107933,0.07,1,147257,146835,422
4507521,31.9195,31.1502,423,36580,0.0421587,0.01,1,147284,146861,423
4510441,22.3839,23.03,422,36638,0.0324317,0.03,1,147304,146882,422
4513361,30.0768,30.206,422,36696,0.0144863,0,1,147336,146914,422
4516281,10.0154,10.0412,422,36754,0.00289727,0.03,1,147341,146919,422
4519201,6.80307,6.80824,422,36811,0.0405795,0,1,147347,146925,422
4522121,61.3606,61.3616,422,36868,0.00811589,0.01,1,147422,147000,422
4525041,13.8721,13.8723,422,36925,0.0416232,0.03,1,147424,147002,422
4527961,88.3744,88.3745,422,36982,0.0323246,0.03,1,147531,147109,422
4530881,61.6749,61.6749,422,37039,0.0144649,0.03,1,147586,147164,422
4533801,13.935,13.935,422,37096,0.010893,0.01,1,147588,147166,422
4536721,29.987,29.987,422,37153,0.0101786,0.01,1,147622,147200,422
4539641,50.7974,5.9974,478,37210,0.0260357,0.01,1,147678,147200,478
4542561,31.7595,46.7995,448,37267,0.0452071,0.05,1,147705,147257,448
4545481,22.3519,30.9599,441,37324,0.0330414,0.03,1,147725,147284,441
4548401,30.8704,22.192,454,37381,0.00660829,0.01,1,147758,147304,454
4551321,9.37408,30.0384,426,37438,0.00132166,0,1,147762,147336,426
4554241,6.67482,10.0077,427,37494,0.00826433,0.05,1,147768,147341,427
4557161,61.335,6.80154,496,37550,0.00965287,0,1,147843,147347,496
4560081,13.867,61.3603,423,37606,0.00993057,0.05,1,147845,147422,423
4563001,88.3734,13.8721,528,37662,0.0259861,0.03,1,147952,147424,528
4565921,61.6747,88.3744,476,37718,0.0131972,0.01,1,148007,147531,476
4568841,13.9349,61.6749,423,37774,0.0106394,0.01,1,148009,147586,423
4571761,29.987,13.935,455,37830,0.0101279,0.01,1,148043,147588,455
4574681,52.3974,29.987,479,37886,0.0420256,0.03,1,148101,147622,479
4577601,32.0795,50.7974,450,37942,0.0804051,0.05,1,148128,147678,450
4580521,21.6159,31.7595,442,37998,0.120081,0.03,1,148147,147705,442
4583441,29.9232,22.3519,454,38054,0.0640162,0,1,148179,147725,454
4586361,9.18464,30.8704,425,38110,0.0208032,0,1,148183,147758,425
4589281,7.43693,9.37408,428,38165,0.0601606,0.01,1,148190,147762,428
4592201,61.4874,6.67482,497,38220,0.0120321,0.01,1,148265,147768,497
4595121,13.8975,61.335,424,38275,0.0104064,0.01,1,148267,147843,424
4598041,87.5795,13.867,528,38330,0.0260813,0.03,1,148373,147845,528
4600961,61.5159,88.3734,476,38385,0.0292163,0.01,1,148428,147952,476
4603881,13.9032,61.6747,423,38440,0.0298433,0.01,1,148430,148007,423
4606801,29.9806,13.9349,455,38495,0.0139687,0.01,1,148464,148009,455
4609721,53.9961,29.987,481,38550,0.0427937,0.05,1,148524,148043,481
4612641,33.9992,52.3974,452,38605,0.0645587,0.09,1,148553,148101,452
4615561,8.39984,32.0795,427,38660,0.0689117,0.13,1,148555,148128,427
4618481,17.68,21.6159,428,38715,0.133782,0.05,1,148575,148147,428
4621401,25.936,29.9232,424,38770,0.130756,0.01,1,148603,148179,424
4624321,8.3872,9.18464,424,38824,0.0981513,0.07,1,148607,148183,424
4627241,5.67744,7.43693,422,38878,0.10763,0,1,148612,148190,422
4630161,61.1355,61.4874,422,38932,0.021526,0.01,1,148687,148265,422
4633081,13.8271,13.8975,422,38986,0.0123052,0.03,1,148689,148267,422
4636001,87.5654,87.5795,422,39040,0.026461,0.03,1,148795,148373,422
4638921,61.5131,61.5159,422,39094,0.0292922,0.03,1,148850,148428,422
4641841,13.9026,13.9032,422,39148,0.0298584,0.01,1,148852,148430,422
4644761,29.9805,29.9806,422,39202,0.0139717,0.05,1,148886,148464,422
4647681,55.5961,53.9961,424,39256,0.0267943,0.07,1,148948,148524,424
4650601,35.9192,33.9992,426,39310,0.0453589,0.07,1,148979,148553,426
4653521,8.78384,8.39984,426,39364,0.0490718,0.15,1,148981,148555,426
4656441,18.5568,17.68,427,39418,0.0498144,0.13,1,149002,148575,427
4659361,25.3114,25.936,426,39472,0.0499629,0.09,1,149029,148603,426
4662281,8.26227,8.3872,426,39526,0.0179926,0.11,1,149033,148607,426
4665201,4.85245,5.67744,425,39579,0.0115985,0,1,149037,148612,425
4668121,58.5705,61.1355,422,39632,0.0023197,0.01,1,149109,148687,422
4671041,13.3141,13.8271,422,39685,0.0404639,0.03,1,149111,148689,422
4673961,87.4628,87.5654,422,39738,0.0320928,0.03,1,149217,148795,422
4676881,61.4926,61.5131,422,39791,0.0144186,0.03,1,149272,148850,422
4679801,13.8985,13.9026,422,39844,0.0108837,0.01,1,149274,148852,422
4682721,29.9797,29.9805,422,39897,0.0101767,0.03,1,149308,148886,422
4685641,56.3959,55.5961,423,39950,0.0100353,0.05,1,149371,148948,423
4688561,36.0792,35.9192,423,40003,0.0420071,0.05,1,149402,148979,423
4691481,8.81584,8.78384,423,40056,0.0484014,0.05,1,149404,148981,423
4694401,17.7632,18.5568,422,40109,0.0176803,0.05,1,149424,149002,422
4697321,24.3526,3.71135,448,40162,0.0275361,0.05,1,149450,149002,448
4700241,8.07053,22.3423,425,40215,0.0455072,0.01,1,149454,149029,425
4703161,4.81411,7.66845,425,40268,0.0491014,0.01,1,149458,149033,425
4706081,58.5628,4.73369,493,40320,0.0338203,0,1,149530,149037,493
4709001,13.3126,58.5467,423,40372,0.0307641,0.05,1,149532,149109,423
4711921,87.4625,13.3093,527,40424,0.0301528,0.03,1,149638,149111,527
4714841,61.4925,87.4619,476,40476,0.0140306,0.01,1,149693,149217,476
4717761,13.8985,61.4924,423,40528,0.0108061,0.01,1,149695,149272,423
4720681,29.9797,13.8985,455,40580,0.0101612,0.01,1,149729,149274,455
4723601,57.1959,29.9797,485,40632,0.0420322,0.01,1,149793,149308,485
4726521,35.4392,56.3959,452,40684,0.0324064,0.05,1,149823,149371,452
4729441,8.68784,36.0792,423,40736,0.0304813,0.05,1,149825,149402,423
4732361,17.7376,8.81584,441,40788,0.0300963,0.01,1,149845,149404,441
4735281,25.9475,17.7632,449,40840,0.0460193,0.03,1,149873,149424,449
4738201,8.3895,24.3526,427,40892,0.0492039,0.05,1,149877,149450,427
4741121,4.8779,8.07053,427,40944,0.0498408,0.05,1,149881,149454,427
4744041,57.7756,4.81411,494,40996,0.113968,0.03,1,149952,149458,494
4746961,13.1551,58.5628,424,41047,0.126794,0.03,1,149954,149530,424
4749881,86.631,13.3126,527,41098,0.0493587,0.03,1,150059,149532,527
4752801,61.3262,87.4625,476,41149,0.0338717,0.01,1,150114,149638,476
4755721,13.8652,61.4925,423,41200,0.0307743,0.01,1,150116,149693,423
4758641,29.973,13.8985,455,41251,0.0141549,0.01,1,150150,149695,455
4761561,57.1946,29.9797,485,41302,0.026831,0.05,1,150214,149729,485
4764481,36.2389,57.1959,452,41353,0.0133662,0.03,1,150245,149793,452
4767401,8.84778,35.4392,424,41404,0.0266732,0.03,1,150247,149823,424
4770321,17.7696,8.68784,442,41455,0.0453346,0.03,1,150267,149825,442
4773241,27.5539,17.7376,452,41506,0.0170669,0.05,1,150297,149845,452
4776161,7.11078,25.9475,426,41557,0.0114134,0.05,1,150299,149873,426
4779081,4.62216,8.3895,426,41608,0.0422827,0.05,1,150303,149877,426
4782001,4.12443,4.8779,426,41659,0.0484565,0.13,1,150307,149881,426
4784921,59.2249,57.7756,428,41710,0.129691,0.13,1,150380,149952,428
4787841,13.445,13.1551,428,41761,0.145938,0.03,1,150382,149954,428
4790761,81.889,86.631,422,41812,0.0531877,0.03,1,150481,150059,422
4793681,60.3778,61.3262,422,41862,0.0346375,0.03,1,150536,150114,422
4796601,13.6756,13.8652,422,41912,0.0309275,0.01,1,150538,150116,422
4799521,29.9351,29.973,422,41962,0.0141855,0.03,1,150572,150150,422
4802441,57.987,57.1946,423,42012,0.0108371,0.01,1,150637,150214,423
4805361,37.1974,36.2389,424,42062,0.0101674,0.03,1,150669,150245,424
4808281,9.03948,8.84778,424,42112,0.0260335,0.05,1,150671,150247,424
4811201,17.8079,17.7696,424,42162,0.0612067,0.01,1,150691,150267,424
4814121,27.5616,27.5539,424,42212,0.0362413,0.01,1,150721,150297,424
4817041,7.11232,7.11078,424,42262,0.0312483,0.05,1,150723,150299,424
4819961,5.42246,4.62216,425,42312,0.0462497,0.05,1,150728,150303,425
4822881,4.28449,4.12443,425,42362,0.0652499,0.15,1,150732,150307,425
4825801,62.4569,59.2249,429,42412,0.05305,0.15,1,150809,150380,429
4828721,14.0914,13.445,429,42462,0.08261,0.03,1,150811,150382,429
4831641,76.4183,81.889,422,42512,0.120522,0.03,1,150903,150481,422
4834561,59.2837,60.3778,422,42562,0.0321044,0.03,1,150958,150536,422
4837481,13.4567,13.6756,422,42612,0.0144209,0.01,1,150960,150538,422
4840401,29.8913,29.9351,422,42662,0.0108842,0.01,1,150994,150572,422
4843321,57.9783,57.987,422,42711,0.0101768,0.01,1,151059,150637,422
4846241,37.9957,37.1974,423,42760,0.0580354,0.03,1,151092,150669,423
4849161,9.19913,9.03948,423,42809,0.0356071,0.07,1,151094,150671,423
4852081,17.8398,17.8079,423,42858,0.0311214,0.03,1,151114,150691,423
4855001,28.368,27.5616,424,42907,0.0462243,0.03,1,151145,150721,424
4857921,7.27359,7.11232,424,42956,0.0492449,0.05,1,151147,150723,424
4860841,4.65472,5.42246,423,43005,0.049849,0.05,1,151151,150728,423
4863761,4.13094,1.08449,427,43054,0.0179698,0.07,1,151155,150728,427
4866681,62.4262,3.4169,500,43103,0.043594,0.05,1,151232,150732,500
4869601,14.0852,62.2834,425,43152,0.0487188,0.09,1,151234,150809,425
4872521,74.817,14.0567,513,43201,0.209744,0.13,1,151324,150811,513
4875441,58.9634,76.4113,476,43250,0.0499487,0.01,1,151379,150903,476
4878361,13.3927,59.2823,423,43299,0.0179897,0.01,1,151381,150958,423
4881281,29.8785,13.4565,455,43348,0.0115979,0.01,1,151415,150960,455
4884201,59.5757,29.8913,488,43397,0.0103196,0.01,1,151482,150994,488
4887121,37.5151,57.9783,455,43446,0.0420639,0.07,1,151514,151059,455
4890041,9.10303,37.9957,424,43495,0.0484128,0.03,1,151516,151092,424
4892961,17.8206,9.19913,442,43544,0.0496826,0.03,1,151536,151094,442
4895881,27.5641,17.8398,452,43592,0.0659365,0.05,1,151566,151114,452
4898801,7.11282,28.368,423,43640,0.0691873,0.05,1,151568,151145,423
4901721,4.62256,7.27359,425,43688,0.0698375,0.05,1,151572,151147,425
4904641,4.92451,4.65472,426,43736,0.0859675,0.01,1,151577,151151,426
4907561,64.1849,4.13094,501,43784,0.0891935,0.05,1,151656,151155,501
4910481,14.437,62.4262,426,43832,0.0578387,0.05,1,151658,151232,426
4913401,82.0874,14.0852,523,43880,0.291568,0.25,1,151757,151234,523
4916321,50.8175,74.817,476,43928,0.210314,0.01,1,151800,151324,476
4919241,11.7635,58.9634,423,43976,0.194063,0.01,1,151802,151379,423
4922161,29.5527,13.3927,455,44024,0.0628125,0.01,1,151836,151381,455
4925081,61.1105,29.8785,490,44072,0.0365625,0.01,1,151905,151415,490
4928001,37.8221,59.5757,455,44120,0.0633125,0.05,1,151937,151482,455
4930921,9.16442,37.5151,425,44168,0.0686625,0.05,1,151939,151514,425
4933841,18.6329,9.10303,444,44216,0.0857325,0.05,1,151960,151516,444
4936761,27.7266,17.8206,454,44264,0.0891465,0.07,1,151990,151536,454
4939681,7.14532,27.5641,426,44312,0.0898293,0.07,1,151992,151566,426
4942601,4.62906,7.11282,428,44360,0.0899659,0.07,1,151996,151568,428
4945521,4.12581,4.62256,428,44408,0.0899932,0.09,1,152000,151572,428
4948441,65.6252,4.92451,504,44456,0.121999,0.09,1,152081,151577,504
4951361,14.725,64.1849,427,44503,0.1284,0.05,1,152083,151656,427
4954281,4.54501,14.437,427,44550,0.12968,0.35,1,152085,151658,427
4957201,90.509,82.0874,440,44597,0.417936,0.19,1,152197,151757,440
4960121,43.7018,50.8175,429,44644,0.491587,0.19,1,152229,151800,429
4963041,10.3404,11.7635,429,44691,0.506317,0.03,1,152231,151802,429
4965961,23.6681,29.5527,422,44738,0.525263,0.03,1,152258,151836,422
4968881,62.3336,61.1105,425,44785,0.337053,0.07,1,152330,151905,425
4971801,38.0667,37.8221,425,44832,0.363411,0.07,1,152362,151937,425
4974721,9.21334,9.16442,425,44879,0.368682,0.09,1,152364,151939,425
4977641,19.4427,18.6329,426,44926,0.401736,0.09,1,152386,151960,426
4980561,27.8885,27.7266,426,44973,0.392347,0.09,1,152416,151990,426
4983481,7.17771,7.14532,426,45020,0.390469,0.09,1,152418,151992,426
4986401,4.63554,4.62906,426,45067,0.390094,0.09,1,152422,151996,426
4989321,4.12711,4.12581,426,45114,0.390019,0.13,1,152426,152000,426
4992241,68.8254,65.6252,430,45161,0.374004,0.13,1,152511,152081,430
4995161,15.3651,14.725,430,45208,0.370801,0.13,1,152513,152083,430
4998081,4.67302,4.54501,430,45255,0.37016,0.49,1,152515,152085,430
5001001,103.335,90.509,446,45302,0.738032,0.51,1,152643,152197,446
5003921,47.0669,43.7018,447,45349,0.875606,0.51,2,152676,152229,447
5006841,11.0134,10.3404,447,45396,0.903121,0.53,2,152678,152231,447
5009761,19.8027,23.6681,442,45442,0.908624,0.29,2,152700,152258,442
5012681,59.1605,62.3336,439,45488,0.925725,0.37,2,152769,152330,439
5184961,34,44,479,48145,0.27,1,1,154576,154097,479
5187881,22,27.2,475,48189,0.286,1,1,154595,154120,475
5190801,25.2,23.04,479,48233,0.1932,1,1,154621,154142,479
5193721,52.24,52.608,478,48277,0.20664,1,1,154680,154202,478
5196641,30.448,28.1216,481,48321,0.145328,1,1,154705,154224,481
5199561,26.0896,21.6243,486,48365,0.0690656,1,1,154730,154244,486
5202481,24.4179,21.1249,489,48409,0.0538131,1,1,154754,154265,489
5205401,19.2836,17.825,490,48453,0.0347626,1,1,154772,154282,490
5208321,16.6567,11.565,496,48496,0.0629525,1,1,154788,154292,496
5211241,17.7313,13.513,500,48539,0.0685905,1,1,154806,154306,500
5214161,17.1463,14.7026,502,48582,0.0697181,1,1,154823,154321,502
5217081,19.4293,32.5405,485,48625,0.0539436,1,1,154843,154358,485
5220001,19.8859,22.5081,485,48668,0.0827887,1,1,154863,154378,485
5222921,18.3772,15.7016,489,48711,0.0725577,0.53,1,154881,154392,489
5225841,68.4754,105.54,442,48754,0.0705115,0.37,1,154962,154520,442
5228761,24.8951,38.7081,434,48797,0.0381023,0.27,1,154976,154542,434
5231681,32.979,34.9416,435,48840,0.0156205,0.27,1,155011,154576,435
5234601,21.7958,6.98832,454,48883,0.0271241,0.29,1,155030,154576,454
5237521,25.9592,16.5977,462,48926,0.0454248,0.17,1,155057,154595,462
5240441,45.1918,24.1195,486,48969,0.033085,0.21,1,155107,154621,486
5243361,25.0384,52.0239,447,49012,0.670617,0.13,1,155127,154680,447
5246281,25.8077,30.4048,448,49055,0.734123,0.05,1,155153,154705,448
5249201,25.1615,26.081,448,49098,0.714825,0.05,1,155178,154730,448
5252121,19.4323,24.4162,442,49141,0.598965,0.03,1,155196,154754,442
5255041,15.8865,19.2832,439,49184,0.511793,0.07,1,155211,154772,439
5257961,18.3773,16.6566,442,49227,0.462359,0.07,1,155230,154788,442
5260881,18.8755,17.7313,443,49270,0.420472,0.07,1,155249,154806,443
5263801,16.5751,17.1463,442,49313,0.348094,0.05,1,155265,154823,442
5266721,19.315,19.4293,442,49356,0.333619,0.09,1,155285,154843,442
5269641,17.463,19.8859,439,49399,0.362724,0.07,1,155302,154863,439
5272561,68.2926,18.3772,502,49442,0.0965448,0.07,1,155383,154881,502
5275481,24.8585,68.4754,435,49485,0.0593089,0.03,1,155397,154962,435
5278401,32.9717,24.8951,456,49528,0.0198618,0.01,1,155432,154976,456
5281321,22.5943,32.979,441,49571,0.0119724,0.03,1,155452,155011,441
5284241,25.3189,21.7958,448,49614,0.0103945,0.05,1,155478,155030,448
5287161,76.2638,25.9592,510,49656,0.106079,0.03,1,155567,155057,510
5290081,30.4528,45.1918,479,49698,0.141216,0.83,1,155586,155107,479
5293001,25.2906,25.0384,483,49740,0.148243,0.75,1,155610,155127,483
5295921,20.2581,25.8077,476,49782,0.101649,0.71,1,155629,155153,476
5298841,14.4516,25.1615,464,49824,0.15633,0.57,1,155642,155178,464
5301761,13.2903,19.4323,459,49866,0.151266,0.49,1,155655,155196,459
5304681,16.2581,15.8865,461,49908,0.134253,0.45,1,155672,155211,461
5307601,16.0516,18.3773,458,49950,0.130851,0.41,1,155688,155230,458
5310521,15.2103,18.8755,454,49992,0.14617,0.33,1,155703,155249,454
5313441,19.8421,16.5751,459,50034,0.133234,0.33,1,155724,155265,459
5316361,15.1684,19.315,453,50076,0.162647,0.37,1,155738,155285,453
5319281,57.4337,17.463,504,50118,0.0725294,0.03,1,155806,155302,504
5322201,21.0867,68.2926,435,50160,0.102506,0.05,1,155818,155383,435
5325121,32.2173,24.8585,456,50202,0.0445012,0.01,1,155853,155397,456
5328041,22.4435,32.9717,441,50244,0.0329002,0.01,1,155873,155432,441
5330961,25.2887,22.5943,447,50286,0.01458,0.01,1,155899,155452,447
5333881,6.65774,25.3189,423,50328,0.010916,0.13,1,155901,155478,423
5336801,76.5316,76.2638,428,50370,0.0901832,0.15,1,155995,155567,428
5339721,29.7063,30.4528,427,50412,0.106037,0.15,1,156013,155586,427
5342641,25.1413,25.2906,427,50454,0.157207,0.09,1,156037,155610,427
5345561,21.8283,20.2581,429,50496,0.119441,0.17,1,156058,155629,429
5348481,13.9657,14.4516,428,50538,0.111888,0.15,1,156070,155642,428
5351401,13.9931,13.2903,429,50580,0.142378,0.13,1,156084,155655,429
5354321,15.5986,16.2581,428,50622,0.116476,0.13,1,156100,155672,428
5357241,15.9197,16.0516,428,50664,0.111295,0.15,1,156116,155688,428
5360161,15.9839,15.2103,429,50706,0.110259,0.13,1,156132,155703,429
5363081,20.7968,19.8421,430,50748,0.142052,0.17,1,156154,155724,430
5366001,15.3594,15.1684,430,50790,0.11641,0.05,1,156168,155738,430
5368921,55.0719,57.4337,427,50831,0.159282,0.11,1,156233,155806,427
5371841,17.4144,21.0867,423,50872,0.167856,0.03,1,156241,155818,423
5374761,31.4829,32.2173,423,50913,0.121571,0.03,1,156276,155853,423
5377681,22.2966,22.4435,423,50954,0.0323143,0.01,1,156296,155873,423
5380601,25.2593,25.2887,423,50995,0.0304629,0.01,1,156322,155899,423
5383521,6.65186,6.65774,423,51036,0.00609257,0.11,1,156324,155901,423
5386441,79.7304,76.5316,427,51077,0.0252185,0.11,1,156422,155995,427
5389361,31.1461,29.7063,428,51118,0.0450437,0.17,1,156441,156013,428
5392281,25.4292,25.1413,428,51159,0.0170087,0.11,1,156465,156037,428
5395201,21.0858,21.8283,427,51200,0.0434017,0.11,1,156485,156058,427
5398121,13.8172,13.9657,427,51241,0.0326803,0.15,1,156497,156070,427
5401041,13.9634,13.9931,427,51282,0.0305361,0.11,1,156511,156084,427
5403961,15.5927,15.5986,427,51323,0.0781072,0.11,1,156527,156100,427
5406881,15.9185,15.9197,427,51364,0.0556214,0.11,1,156543,156116,427
5409801,15.9837,15.9839,427,51405,0.0831243,0.15,1,156559,156132,427
5412721,20.7967,20.7968,427,51446,0.0886249,0.11,1,156581,156154,427
5415641,15.3593,15.3594,427,51487,0.089725,0.17,1,156595,156168,427
5418561,57.4719,55.0719,430,51528,0.041945,0.17,1,156663,156233,430
5421481,18.6944,17.4144,431,51569,0.048389,0.11,1,156672,156241,431
5424401,25.3389,31.4829,423,51610,0.0496778,0.01,1,156699,156276,423
5427321,20.2678,22.2966,422,51651,0.0339356,0.03,1,156718,156296,422
5430241,24.8536,25.2593,422,51692,0.0307871,0,1,156744,156322,422
5433161,6.57071,6.65186,422,51733,0.0301574,0.03,1,156746,156324,422
5436081,79.7141,79.7304,422,51774,0.0460315,0.03,1,156844,156422,422
5439001,30.3428,15.9461,440,51815,0.0172063,0.05,1,156862,156422,440
5441921,25.2686,18.3892,445,51856,0.0434413,0.01,1,156886,156441,445
5444841,21.8537,22.8778,442,51897,0.0806883,0.05,1,156907,156465,442
5447761,13.9707,20.5756,434,51938,0.0561376,0.03,1,156919,156485,434
5450681,14.7941,13.7151,437,51979,0.0352275,0.03,1,156934,156497,437
5453601,15.7588,13.943,439,52020,0.0630455,0.09,1,156950,156511,439
5456521,15.9518,15.5886,439,52060,0.0686091,0.05,1,156966,156527,439
5459441,15.9904,15.9177,439,52100,0.0697218,0.09,1,156982,156543,439
5462361,20.7981,15.9835,445,52140,0.0699444,0.09,1,157004,156559,445
5465281,15.3596,20.7967,437,52180,0.0699889,0.09,1,157018,156581,437
5468201,56.6719,15.3593,490,52220,0.0859978,0.03,1,157085,156595,490
5471121,20.1344,57.4719,433,52260,0.1052,0.05,1,157096,156663,433
5474041,24.8269,18.6944,450,52300,0.10904,0.05,1,157122,156672,450
5476961,18.5654,25.3389,440,52340,0.125808,0.03,1,157139,156699,440
5479881,24.5131,20.2678,447,52380,0.0491616,0.03,1,157165,156718,447
5482801,6.50261,24.8536,423,52420,0.0338323,0.03,1,157167,156744,423
5485721,79.7005,6.57071,519,52460,0.0627665,0.05,1,157265,156746,519
5488641,31.1401,79.7141,440,52500,0.0845533,0.01,1,157284,156844,440
5491561,27.028,30.3428,448,52540,0.104911,0.05,1,157310,156862,448
5494481,21.4056,25.2686,444,52580,0.124982,0.09,1,157330,156886,444
5497401,13.8811,21.8537,435,52620,0.128996,0.05,1,157342,156907,435
5500321,15.5762,13.9707,439,52660,0.129799,0.03,1,157358,156919,439
5503241,15.9152,14.7941,440,52700,0.14596,0.07,1,157374,156934,440
5506161,15.983,15.7588,440,52740,0.165192,0.07,1,157390,156950,440
5509081,15.9966,15.9518,440,52780,0.169038,0.07,1,157406,156966,440
5512001,20.7993,15.9904,446,52820,0.169808,0.07,1,157428,156982,446
5514921,15.3599,20.7981,438,52860,0.169962,0.07,1,157442,157004,438
5517841,57.472,15.3596,492,52900,0.201992,0.09,1,157510,157018,492
5520761,19.4944,56.6719,435,52940,0.208398,0.11,1,157520,157085,435
5523681,26.2989,20.1344,452,52980,0.24168,0.11,1,157548,157096,452
5526601,18.0598,24.8269,442,53020,0.248336,0.13,1,157564,157122,442
5529521,21.212,18.5654,447,53060,0.265667,0.03,1,157586,157139,447
5532441,5.84239,24.5131,423,53100,0.237133,0.03,1,157588,157165,423
5535361,81.9685,6.50261,522,53140,0.167427,0.07,1,157689,157167,522
5538281,31.5937,79.7005,443,53180,0.169485,0.09,1,157708,157265,443
5541201,28.7187,31.1401,452,53220,0.169897,0.11,1,157736,157284,452
5544121,7.34375,27.028,428,53260,0.169979,0.13,1,157738,157310,428
5547041,17.4687,21.4056,428,53300,0.185996,0.13,1,157758,157330,428
5549961,13.0938,13.8811,428,53339,0.205199,0.13,1,157770,157342,428
5552881,16.2188,15.5762,429,53378,0.22504,0.15,1,157787,157358,429
5555801,16.8438,15.9152,430,53417,0.245008,0.17,1,157804,157374,430
5558721,16.1688,15.983,430,53456,0.217002,0.17,1,157820,157390,430
5561641,16.0338,15.9966,430,53495,0.2114,0.17,1,157836,157406,430
5564561,20.8068,20.7993,430,53534,0.24228,0.17,1,157858,157428,430
5567481,15.3613,15.3599,430,53573,0.216456,0.21,1,157872,157442,430
5570401,59.0723,57.472,432,53612,0.243291,0.21,1,157942,157510,432
5573321,19.8145,19.4944,432,53651,0.248658,0.25,1,157952,157520,432
5576241,27.9629,26.2989,434,53690,0.297732,0.25,1,157982,157548,434
5579161,18.3926,18.0598,434,53729,0.275546,0.27,1,157998,157564,434
5582081,20.4785,21.212,433,53768,0.303109,0.23,1,158019,157586,433
5585001,5.6957,5.84239,433,53807,0.308622,0.15,1,158021,157588,433
5587921,78.7391,81.9685,429,53846,0.325724,0.17,1,158118,157689,429
5590841,31.7478,31.5937,430,53885,0.297145,0.17,1,158138,157708,430
5593761,28.7496,28.7187,430,53924,0.307429,0.17,1,158166,157736,430
5596681,7.34991,7.34375,430,53963,0.309486,0.19,1,158168,157738,430
5599601,19.07,17.4687,432,54002,0.325897,0.21,1,158190,157758,432
5602521,13.414,13.0938,432,54041,0.313179,0.23,1,158202,157770,432
5605441,17.0828,16.2188,433,54080,0.342636,0.25,1,158220,157787,433
5608361,16.2166,16.8438,432,54119,0.348527,0.21,1,158236,157804,432
5611281,16.0433,16.1688,432,54158,0.333705,0.21,1,158252,157820,432
5614201,16.0087,16.0338,432,54197,0.362741,0.25,1,158268,157836,432
5617121,20.8017,20.8068,432,54236,0.384548,0.21,1,158290,157858,432
5620041,15.3603,15.3613,432,54275,0.38891,0.25,1,158304,157872,432
5622961,60.6721,59.0723,434,54314,0.341782,0.25,1,158376,157942,434
5625881,20.1344,19.8145,434,54353,0.332356,0.31,1,158386,157952,434
5628801,28.8269,27.9629,435,54392,0.314471,0.27,1,158417,157982,435
5631721,19.3654,18.3926,436,54431,0.326894,0.31,1,158434,157998,436
5634641,21.4731,20.4785,437,54470,0.313379,0.31,1,158456,158019,437
5637561,5.89461,5.6957,437,54509,0.342676,0.33,1,158458,158021,437
5640481,77.9789,78.7391,436,54548,0.332535,0.29,1,158554,158118,436
5643401,31.5958,31.7478,436,54587,0.362507,0.31,1,158574,158138,436
5646321,30.3192,28.7496,438,54626,0.368501,0.31,1,158604,158166,438
5649241,7.66383,7.34991,438,54665,0.3697,0.33,1,158606,158168,438
5652161,17.5328,19.07,436,54703,0.36994,0.33,1,158626,158190,436
5655081,13.1066,3.814,448,54741,0.337988,0.31,1,158638,158190,448
5658001,17.0213,10.3628,454,54779,0.331598,0.35,1,158656,158202,454
5660921,17.0043,16.4726,453,54817,0.36232,0.35,1,158673,158220,453
5663841,16.2009,16.0945,453,54855,0.352464,0.33,1,158689,158236,453
5666761,16.0402,16.0189,453,54893,0.350493,0.37,1,158705,158252,453
5669681,21.608,16.0038,460,54931,0.366099,0.39,1,158728,158268,460
5672601,15.5216,20.8008,452,54969,0.36922,0.39,1,158742,158290,452
5675521,59.9043,15.3602,509,55007,0.353844,0.33,1,158813,158304,509
5678441,19.9809,60.672,447,55045,0.350769,0.33,1,158823,158376,447
5681361,27.9962,20.1344,467,55083,0.366154,0.31,1,158853,158386,467
5684281,18.3992,28.8269,452,55121,0.385231,0.33,1,158869,158417,452
5687201,22.0798,19.3654,458,55159,0.373046,0.31,1,158892,158434,458
5690121,6.01597,21.4731,438,55197,0.370609,0.35,1,158894,158456,438
5693041,78.8032,5.89461,533,55235,0.418122,0.33,1,158991,158458,533
5695961,31.7606,77.9789,457,55273,0.427624,0.37,1,159011,158554,457
5698881,30.3521,31.5958,467,55311,0.429525,0.37,1,159041,158574,467
5701801,7.67043,30.3192,439,55349,0.429905,0.37,1,159043,158604,439
5704721,17.5341,7.66383,457,55387,0.429981,0.37,1,159063,158606,457
5707641,13.1068,17.5328,449,55425,0.445996,0.33,1,159075,158626,449
5710561,17.0214,13.1066,455,55463,0.465199,0.33,1,159093,158638,455
5713481,17.8043,17.0213,455,55501,0.48504,0.37,1,159111,158656,455
5716401,16.3609,17.0043,454,55539,0.521008,0.35,1,159127,158673,454
5719321,16.0722,16.2009,454,55577,0.544202,0.35,1,159143,158689,454
5722241,22.4144,16.0402,462,55615,0.54884,0.37,1,159167,158705,462
5725161,15.6829,21.608,453,55653,0.549768,0.37,1,159181,158728,453
5728081,59.1366,15.5216,509,55691,0.565954,0.35,1,159251,158742,509
5731001,19.8273,59.9043,448,55729,0.569191,0.35,1,159261,158813,448
5733921,28.7655,19.9809,469,55767,0.585838,0.37,1,159292,158823,469
5736841,19.3531,27.9962,456,55805,0.605168,0.39,1,159309,158853,456
5739761,21.4706,18.3992,462,55843,0.609034,0.37,1,159331,158869,462
5742681,5.89412,22.0798,441,55881,0.609807,0.37,1,159333,158892,441
5745601,81.1788,6.01597,539,55919,0.673961,0.43,1,159433,158894,539
5748521,32.2358,78.8032,462,55957,0.686792,0.43,1,159453,158991,462
5751441,30.4472,31.7606,472,55995,0.689358,0.43,1,159483,159011,472
5754361,7.68943,30.3521,444,56033,0.689872,0.43,1,159485,159041,444
5757281,18.3379,7.67043,463,56071,0.673974,0.43,1,159506,159043,463
5760201,14.0676,17.5341,456,56109,0.654795,0.45,1,159519,159063,456
5763121,17.2135,13.1068,462,56146,0.682959,0.47,1,159537,159075,462
5766041,5.0427,17.0214,446,56183,0.688592,0.49,1,159539,159093,446
5768961,17.0085,17.8043,448,56220,0.689718,0.53,1,159559,159111,448
5771881,17.0017,16.3609,449,56257,0.705944,0.55,1,159576,159127,449
5774801,16.2003,16.0722,449,56294,0.725189,0.55,1,159592,159143,449
5777721,22.4401,22.4144,449,56331,0.745038,0.55,1,159616,159167,449
5780641,16.488,15.6829,450,56368,0.765008,0.57,2,159631,159181,450
5783561,59.2976,59.1366,450,56405,0.737001,0.57,1,159701,159251,450
5786481,19.8595,19.8273,450,56442,0.7314,0.59,1,159711,159261,450
5789401,29.5719,28.7655,451,56479,0.77828,0.61,2,159743,159292,451
5792321,20.3144,19.3531,452,56516,0.755656,0.61,2,159761,159309,452
5795241,21.6629,21.4706,452,56553,0.767131,0.61,2,159783,159331,452
5798161,5.93258,5.89412,452,56590,0.769426,0.69,2,159785,159333,452
5801081,84.3865,81.1788,456,56627,0.833885,0.69,2,159889,159433,456
5804001,32.8773,32.2358,456,56664,0.814777,0.69,2,159909,159453,456
5806921,30.5755,30.4472,456,56701,0.810955,0.69,2,159939,159483,456
5809841,7.71509,7.68943,456,56738,0.810191,0.67,2,159941,159485,456
5812761,17.543,18.3379,455,56775,0.810038,0.65,2,159961,159506,455
5815681,14.7086,14.0676,456,56812,0.810008,0.69,2,159975,159519,456
5818601,17.3417,17.2135,456,56849,0.842001,0.69,2,159993,159537,456
5821521,5.06834,5.0427,456,56886,0.8164,0.69,2,159995,159539,456
5824441,17.0137,17.0085,456,56923,0.85128,0.71,2,160015,159559,456
5827361,18.6027,17.0017,458,56960,0.890256,0.73,2,160034,159576,458
5830281,17.3205,16.2003,459,56997,0.882051,0.75,2,160051,159592,459
5833201,22.6641,22.4401,459,57034,0.88841,0.77,2,160075,159616,459
5836121,15.7328,16.488,458,57071,0.889682,0.73,2,160089,159631,458
5839041,59.1466,59.2976,458,57108,0.889936,0.73,2,160159,159701,458
5841961,19.8293,19.8595,458,57145,0.889987,0.79,2,160169,159711,458
5844881,30.3659,29.5719,459,57182,0.873997,0.75,2,160202,159743,459
5847801,20.4732,20.3144,459,57219,0.9028,0.77,2,160220,159761,459
5850721,22.4946,21.6629,460,57256,0.86056,0.77,2,160243,159783,460
5853641,6.09893,5.93258,460,57293,0.884112,0.85,2,160245,159785,460
5856561,86.0198,84.3865,462,57330,0.840822,0.81,2,160351,159889,462
5859481,33.204,32.8773,462,57367,0.864164,0.81,2,160371,159909,462
5862401,30.6408,30.5755,462,57404,0.884833,0.81,2,160401,159939,462
5865321,7.72816,7.71509,462,57441,0.888967,0.81,2,160403,159941,462
5868241,17.5456,17.543,462,57478,0.889793,0.81,2,160423,159961,462
5871161,14.7091,14.7086,462,57515,0.889959,0.85,2,160437,159975,462
5874081,18.9418,17.3417,464,57552,0.857992,0.81,2,160457,159993,464
5877001,5.38836,5.06834,464,57589,0.851598,0.86,2,160459,159995,464
6180681,50,57,487,28618,0.13,0.59,1,163080,162593,487
6183601,43.6,56.2,473,28692,0.114,0.47,1,163122,162649,473
6186521,38.32,53.64,457,28766,0.1428,0.03,1,163159,162702,457
6189441,72.464,86.728,443,28840,0.06856,0.03,1,163240,162797,443
6192361,56.0928,54.9456,448,28913,0.013712,0.03,1,163292,162844,448
6195281,40.8186,47.7891,439,28986,0.0747424,0.09,1,163329,162890,439
6198201,49.7637,45.5578,446,29059,0.0229485,0.05,1,163381,162935,446
6201121,19.5527,31.5116,430,29132,0.0445897,0.03,1,163393,162963,430
6204041,52.7105,21.5023,472,29205,0.0329179,0.01,1,163454,162982,472
6206961,52.9421,42.7005,477,29277,0.0625836,0.13,1,163507,163030,477
6209881,44.9884,48.5401,470,29349,0.100517,0.11,1,163550,163080,470
6212801,39.3977,43.308,466,29421,0.0761033,0.15,1,163588,163122,466
6215721,66.2795,38.2616,502,29493,0.135221,0.05,1,163661,163159,502
6218641,55.6559,72.4523,474,29565,0.0350441,0,1,163714,163240,474
6221561,39.9312,56.0905,458,29637,0.0470088,0.09,1,163750,163292,458
6224481,51.1862,40.8181,475,29708,0.0494018,0.01,1,163804,163329,475
6227401,18.2372,49.7636,433,29779,0.0498804,0.05,1,163814,163381,433
6230321,5.24745,19.5527,423,29850,0.0499761,0.03,1,163816,163393,423
6233241,49.0495,52.7105,422,29921,0.0659952,0.07,1,163876,163454,422
6236161,55.4099,52.9421,426,29992,0.037199,0.11,1,163933,163507,426
6239081,46.282,44.9884,427,30063,0.0314398,0.07,1,163977,163550,427
6242001,38.8564,39.3977,426,30133,0.062288,0.15,1,164014,163588,426
6244921,68.5713,66.2795,429,30203,0.0524576,0.01,1,164090,163661,429
6247841,51.3143,55.6559,423,30273,0.0344915,0.05,1,164137,163714,423
6250761,39.0629,39.9312,423,30343,0.0308983,0.05,1,164173,163750,423
6253681,51.8126,51.1862,424,30413,0.0461797,0.05,1,164228,163804,424
6256601,18.3625,18.2372,424,30483,0.0172359,0.05,1,164238,163814,424
6259521,5.2725,5.24745,424,30552,0.0434472,0.07,1,164240,163816,424
6262441,48.2545,49.0495,423,30621,0.0166894,0.03,1,164299,163876,423
6265361,55.2509,55.4099,423,30690,0.0433379,0.03,1,164356,163933,423
6268281,47.0502,46.282,424,30759,0.0966676,0.07,1,164401,163977,424
6271201,39.81,38.8564,425,30828,0.0913335,0.05,1,164439,164014,425
6274121,67.962,68.5713,424,30897,0.154267,0.03,1,164514,164090,424
6277041,49.5924,51.3143,422,30965,0.166853,0.03,1,164559,164137,422
6279961,38.7185,39.0629,422,31033,0.105371,0.05,1,164595,164173,422
6282881,51.7437,51.8126,422,31101,0.0290741,0.01,1,164650,164228,422
6285801,18.3487,18.3625,422,31169,0.0138148,0.05,1,164660,164238,422
6288721,5.26975,5.2725,422,31237,0.042763,0.01,1,164662,164240,422
6291641,48.254,48.2545,422,31305,0.0805526,0.01,1,164721,164299,422
6294561,56.0508,9.6509,480,31373,0.0561105,0.05,1,164779,164299,480
6297481,48.0102,47.5302,469,31440,0.0832221,0.11,1,164825,164356,469
6300401,40.802,45.506,463,31507,0.120644,0.09,1,164864,164401,463
6303321,69.7604,39.5012,502,31574,0.144129,0.17,1,164941,164439,502
6306241,48.3521,67.9002,470,31641,0.132826,0.17,1,164984,164514,470
6309161,36.8704,49.58,459,31708,0.130565,0.09,1,165018,164559,459
6312081,49.7741,38.716,476,31775,0.114113,0.01,1,165071,164595,476
6315001,17.9548,51.7432,431,31842,0.110823,0.01,1,165081,164650,431
6317921,5.19096,18.3486,423,31908,0.110165,0.05,1,165083,164660,423
6320841,49.8382,5.26973,482,31974,0.158033,0.09,1,165144,164662,482
6323761,56.3676,48.2539,481,32040,0.167607,0.05,1,165202,164721,481
6326681,50.4735,56.0508,472,32106,0.201521,0.09,1,165251,164779,472
6329601,42.0947,48.0102,466,32172,0.224304,0.13,1,165291,164825,466
6332521,70.8189,40.802,505,32238,0.244861,0.15,1,165369,164864,505
6335441,47.7638,69.7604,470,32304,0.264972,0.13,1,165411,164941,470
6338361,36.7528,48.3521,461,32369,0.268994,0.13,1,165445,164984,461
6341281,48.9506,36.8704,479,32434,0.269799,0.11,1,165497,165018,479
6344201,17.7901,49.7741,436,32499,0.26996,0.11,1,165507,165071,436
6347121,5.15802,17.9548,428,32564,0.269992,0.11,1,165509,165081,428
6350041,52.2316,5.19096,490,32629,0.349998,0.17,1,165573,165083,490
6352961,56.8463,49.8382,487,32694,0.366,0.17,1,165631,165144,487
6355881,50.5693,56.3676,478,32759,0.3692,0.21,1,165680,165202,478
6358801,11.7139,50.4735,431,32824,0.36984,0.23,1,165682,165251,431
6361721,35.9428,42.0947,433,32888,0.369968,0.25,1,165724,165291,433
6364641,70.3886,70.8189,434,32952,0.369994,0.27,1,165803,165369,434
6367561,48.4777,47.7638,435,33016,0.385999,0.27,1,165846,165411,435
6370481,36.8955,36.7528,435,33080,0.3892,0.27,1,165880,165445,435
6373401,48.9791,48.9506,435,33144,0.42184,0.27,1,165932,165497,435
6376321,17.7958,17.7901,435,33208,0.396368,0.27,1,165942,165507,435
6379241,5.15916,5.15802,435,33272,0.391274,0.37,1,165944,165509,435
6382161,56.2318,52.2316,440,33336,0.310255,0.37,1,166013,165573,440
6385081,58.4464,56.8463,441,33399,0.326051,0.37,1,166072,165631,441
6388001,50.0893,50.5693,440,33462,0.29721,0.37,1,166120,165680,440
6390921,11.6179,11.7139,440,33525,0.323442,0.37,1,166122,165682,440
6393841,34.3236,35.9428,438,33588,0.312688,0.37,1,166162,165724,438
6396761,73.2647,70.3886,442,33651,0.406538,0.39,1,166245,165803,442
6399681,48.2529,48.4777,441,33714,0.441308,0.39,1,166287,165846,441
6402601,36.8506,36.8955,441,33777,0.448261,0.43,1,166321,165880,441
6405521,48.9701,48.9791,441,33840,0.449652,0.39,1,166373,165932,441
6408441,17.794,17.7958,441,33902,0.44993,0.39,1,166383,165942,441
6411361,5.1588,5.15916,441,33964,0.481986,0.29,1,166385,165944,441
6414281,52.2318,56.2318,436,34026,0.488397,0.33,1,166449,166013,436
6417201,57.6464,58.4464,436,34088,0.553679,0.29,1,166508,166072,436
6420121,49.9293,50.0893,436,34150,0.598736,0.33,1,166556,166120,436
6423041,11.5859,11.6179,436,34212,0.607747,0.33,1,166558,166122,436
6425961,34.3172,2.32357,476,34274,0.577549,0.31,1,166598,166122,476
6428881,76.4634,32.4647,523,34336,0.63551,0.43,1,166685,166162,523
6431801,51.2927,72.8929,485,34398,0.615102,0.45,1,166730,166245,485
6434721,37.4585,48.1786,477,34459,0.62702,0.45,1,166764,166287,477
6437641,49.0917,36.8357,495,34520,0.629404,0.45,1,166816,166321,495
6440561,17.8183,48.9671,453,34581,0.629881,0.45,1,166826,166373,453
6443481,5.16367,17.7934,445,34642,0.629976,0.49,1,166828,166383,445
6446401,52.2327,5.15869,507,34703,0.629995,0.49,1,166892,166385,507
6449321,61.6465,52.2317,507,34764,0.661999,0.57,1,166956,166449,507
6452241,51.5293,57.6463,497,34825,0.7164,0.61,1,167005,166508,497
6455161,11.9059,49.9293,451,34886,0.72728,0.61,1,167007,166556,451
6458081,34.3812,11.5859,489,34947,0.729456,0.57,1,167047,166558,489
6461001,79.6762,34.3172,540,35007,0.761891,0.65,2,167138,166598,540
6463921,51.1352,76.4634,497,35067,0.752378,0.61,2,167182,166685,497
6466841,37.427,51.2927,486,35127,0.814476,0.63,2,167216,166730,486
6469761,49.0854,37.4585,504,35187,0.826895,0.63,2,167268,166764,504
6472681,17.8171,49.0917,462,35247,0.829379,0.63,2,167278,166816,462
6475601,5.16342,17.8183,454,35307,0.829876,0.63,2,167280,166826,454
6478521,52.2327,5.16367,516,35367,0.829975,0.63,2,167344,166828,516
6481441,64.8465,52.2327,520,35427,0.877995,0.67,2,167412,166892,520
6484361,52.9693,61.6465,506,35487,0.935599,0.73,2,167462,166956,506
6487281,12.1939,51.5293,459,35547,0.94712,0.73,2,167464,167005,459
6490201,34.4388,11.9059,497,35606,0.949424,0.73,2,167504,167007,497
6493121,81.2878,34.3812,550,35665,0.901885,0.77,2,167597,167047,550
6496041,17.8576,79.6762,461,35724,0.892377,0.75,2,167599,167138,461
6498961,38.7715,51.1352,461,35783,0.938475,0.83,2,167643,167182,461
6522321,2,2,469,36253,0.89,0.95,2,167933,167464,469
6525241,32.4,32.4,469,36311,0.858,0.89,2,167973,167504,469
6528161,78.48,80.88,466,36369,0.8836,0.89,2,168063,167597,466
6531081,17.296,17.776,466,36427,0.88872,0.95,2,168065,167599,466
6665401,30,21,484,39005,0.53,1,1,169836,169352,484
6668321,28.4,25,486,39059,0.482,1,1,169864,169378,486
6671241,74.48,76.2,483,39113,0.2484,1,1,169950,169467,483
6674161,28.496,28.04,484,39167,0.21768,1,1,169967,169483,484
6677081,33.6992,36.008,481,39221,0.163536,1,1,170002,169521,481
6680001,34.7398,37.6016,478,39275,0.136707,1,1,170037,169559,478
6682921,22.148,25.1203,475,39329,0.0673414,0.94,1,170056,169581,475
6685841,26.8296,27.4241,475,39383,0.0214683,1,1,170084,169609,475
6688761,27.7659,29.4848,473,39437,0.0442937,0.91,1,170112,169639,473
6691681,19.1532,23.497,468,39491,0.0488587,0.99,1,170129,169661,468
6694601,25.4306,30.2994,463,39544,0.0657717,0.61,1,170156,169693,463
6697521,63.4861,74.0599,451,39597,0.0531543,0.61,1,170229,169778,451
6700441,34.2972,37.212,450,39650,0.0186309,0.53,1,170256,169806,450
6703361,26.8594,31.4424,445,39703,0.0437262,0.47,1,170281,169836,445
6706281,22.9719,28.6885,439,39756,0.0327452,0.19,1,170303,169864,439
6709201,66.1944,74.5377,430,39809,0.062549,0.21,1,170380,169950,430
6712121,26.0389,28.5075,429,39862,0.0845098,0.15,1,170396,169967,429
6715041,30.0078,33.7015,425,39915,0.040902,0.13,1,170427,170002,425
6717961,34.0016,34.7403,425,39968,0.22418,0.05,1,170462,170037,425
6720881,20.4003,22.1481,423,40021,0.276836,0.01,1,170479,170056,423
6723801,25.6801,26.8296,422,40074,0.287367,0.01,1,170506,170084,422
6726721,28.336,5.36592,451,40127,0.289473,0.05,1,170535,170084,451
6729641,17.6672,23.4732,438,40180,0.305895,0.05,1,170550,170112,438
6732561,25.9334,18.2946,449,40233,0.277179,0.07,1,170578,170129,449
6735481,63.5867,25.2589,495,40285,0.239436,0.05,1,170651,170156,495
6738401,34.3173,63.4518,449,40337,0.183887,0.01,1,170678,170229,449
6741321,26.0635,34.2904,446,40389,0.172777,0.05,1,170702,170256,446
6744241,23.6127,26.8581,444,40441,0.122555,0.03,1,170725,170281,444
6747161,67.1225,22.9716,500,40493,0.176511,0.07,1,170803,170303,500
6750081,26.2245,66.1943,439,40545,0.187302,0.09,1,170819,170380,439
6753001,37.2449,26.0389,463,40597,0.15746,0.03,1,170859,170396,463
6755921,37.049,30.0078,469,40649,0.263492,0.27,1,170896,170427,469
6758841,21.8098,34.0016,452,40701,0.284698,0.29,1,170914,170462,452
6761761,25.162,20.4003,461,40753,0.28894,0.29,1,170940,170479,461
6764681,29.0324,25.6801,464,40805,0.289788,0.29,1,170970,170506,464
6767601,18.6065,28.336,451,40857,0.305958,0.31,1,170986,170535,451
6770521,25.3213,17.6672,463,40909,0.325191,0.27,1,171013,170550,463
6773441,61.0643,25.9334,505,40961,0.377038,0.23,1,171083,170578,505
6776361,31.4129,63.5867,456,41013,0.387408,0.17,1,171107,170651,456
6779281,23.8826,34.3173,451,41064,0.405482,0.17,1,171129,170678,451
6782201,22.3765,26.0635,449,41115,0.425096,0.11,1,171151,170702,449
6785121,70.0753,23.6127,508,41166,0.397019,0.19,1,171233,170725,508
6788041,26.8151,67.1225,446,41217,0.391404,0.19,1,171249,170803,446
6790961,40.563,26.2245,474,41268,0.454281,0.15,1,171293,170819,474
6793881,38.5126,37.2449,472,41319,0.546856,0.29,1,171331,170859,472
6796801,22.1025,37.049,453,41370,0.565371,0.29,1,171349,170896,453
6799721,25.2205,21.8098,461,41421,0.585074,0.29,1,171375,170914,461
6802641,29.8441,25.162,466,41472,0.605015,0.29,1,171406,170940,466
6805561,19.5688,29.0324,453,41523,0.625003,0.31,1,171423,170970,453
6808481,5.51376,18.6065,439,41574,0.597001,0.33,1,171425,170986,439
6811401,21.9028,25.3213,438,41625,0.5914,0.39,1,171451,171013,438
6814321,62.7806,61.0643,441,41676,0.68628,0.39,1,171524,171083,441
6817241,32.5561,31.4129,442,41727,0.689256,0.41,1,171549,171107,442
6820161,24.1112,23.8826,442,41778,0.721851,0.43,1,171571,171129,442
6823081,23.2222,22.3765,443,41829,0.71237,0.39,1,171594,171151,443
6826001,68.6444,70.0753,441,41879,0.774474,0.39,2,171674,171233,441
6828921,27.3289,26.8151,442,41929,0.770895,0.47,2,171691,171249,442
6831841,47.0658,40.563,450,41979,0.834179,0.57,2,171743,171293,450
6834761,39.8132,38.5126,450,42029,0.910836,0.57,2,171781,171331,450
6837681,22.3626,22.1025,450,42079,0.926167,0.59,2,171799,171349,450
6840601,26.8725,25.2205,452,42129,0.897233,0.61,2,171827,171375,452
6843521,30.1745,29.8441,452,42179,0.875447,0.63,2,171858,171406,452
6846441,18.8349,19.5688,451,42229,0.839089,0.59,2,171874,171423,451
6849361,5.36698,5.51376,451,42279,0.863818,0.59,2,171876,171425,451
6852281,22.6734,21.9028,452,42329,0.868764,0.71,2,171903,171451,452
6963241,49,21,511,44184,0.19,1,1,173261,172750,511
6966161,28.2,21.8,512,44232,0.094,1,1,173284,172772,512
6969081,27.24,25.96,512,44280,0.0188,1,1,173311,172799,512
6972001,22.248,19.592,515,44328,0.01176,1,1,173332,172817,515
6974921,23.6496,17.5184,522,44376,0.042352,1,1,173356,172834,522
6977841,41.5299,17.9037,550,44424,0.0084704,1,1,173402,172852,550
6980761,27.506,60.3807,503,44471,0.0576941,1,1,173426,172923,503
6983681,20.7012,39.2761,488,44518,0.0675388,1,1,173445,172957,488
6986601,23.3402,25.4552,490,44565,0.0855078,1,1,173469,172979,490
6989521,21.468,21.091,491,44612,0.169102,1,1,173490,172999,491
6992441,57.0936,64.2182,482,44659,0.15382,0.97,1,173556,173074,482
6995361,27.4187,32.8436,477,44706,0.118764,0.85,1,173576,173099,477
6998281,28.6837,39.3687,465,44753,0.0637528,0.61,1,173605,173140,465
7001201,32.1367,44.6737,452,44800,0.0527506,0.55,1,173638,173186,452
7004121,20.8273,29.7347,444,44847,0.0345501,0.19,1,173656,173212,444
7007041,29.7655,45.147,427,44894,0.06291,0.07,1,173688,173261,427
7009961,21.1531,27.4294,423,44941,0.036582,0,1,173707,173284,423
7012881,25.8306,27.0859,423,44988,0.0073164,0.01,1,173734,173311,423
7015801,21.1661,22.2172,422,45035,0.00146328,0.05,1,173754,173332,422
7018721,23.4332,23.6434,422,45082,0.0242927,0,1,173778,173356,422
7021641,45.4866,41.5287,427,45129,0.0128585,0.07,1,173829,173402,427
7024561,25.8973,27.5057,424,45176,0.0745717,0.07,1,173850,173426,424
7027481,19.5795,20.7011,423,45223,0.0549143,0.09,1,173868,173445,423
7030401,23.1159,23.3402,423,45270,0.0509829,0.19,1,173892,173469,423
7033321,26.2232,21.468,429,45317,0.0101966,0.15,1,173919,173490,429
7036241,53.2446,57.0936,423,45364,0.0260393,0.11,1,173979,173556,423
7039161,26.6489,27.4187,423,45410,0.109208,0.05,1,173999,173576,423
7042081,27.7298,28.6837,422,45456,0.125842,0.05,1,174027,173605,422
7045001,31.946,32.1367,422,45502,0.0491683,0.03,1,174060,173638,422
7047921,31.1892,20.8273,435,45548,0.0178337,0.07,1,174091,173656,435
7050841,21.4378,29.7655,422,45594,0.0275667,0.03,1,174110,173688,422
7053761,19.4876,21.1531,422,45640,0.0455133,0,1,174129,173707,422
7056681,25.4975,25.8306,422,45686,0.00910267,0,1,174156,173734,422
7059601,21.0995,21.1661,422,45732,0.00982053,0.03,1,174176,173754,422
7062521,23.4199,23.4332,422,45778,0.0259641,0.01,1,174200,173778,422
7065441,48.684,45.4866,426,45824,0.0131928,0.09,1,174255,173829,426
7068361,24.1368,25.8973,423,45870,0.0426386,0.05,1,174273,173850,423
7071281,18.4274,19.5795,422,45916,0.0805277,0.05,1,174290,173868,422
7074201,23.6855,3.91589,447,45962,0.0401055,0.05,1,174315,173868,447
7077121,24.7371,19.9832,448,46008,0.0160211,0,1,174340,173892,448
7080041,55.3474,25.5966,484,46054,0.0432042,0.03,1,174403,173919,484
7082961,26.2695,53.1193,443,46100,0.0326408,0.13,1,174422,173979,443
7085881,26.0539,26.6239,449,46146,0.0305282,0.13,1,174448,173999,449
7088801,31.6108,27.7248,454,46192,0.0461056,0.03,1,174481,174027,454
7091721,31.1222,31.945,452,46238,0.0172211,0.01,1,174512,174060,452
7094641,21.4244,31.189,440,46284,0.0274442,0.03,1,174531,174091,440
7097561,19.4849,21.4378,440,46330,0.0294888,0.05,1,174550,174110,440
7100481,25.497,19.4876,448,46376,0.0138978,0,1,174577,174129,448
7103401,21.0994,25.4975,441,46421,0.0267796,0.01,1,174597,174156,441
7106321,23.4199,21.0995,445,46466,0.0133559,0.03,1,174621,174176,445
7109241,50.284,23.4199,478,46511,0.0266712,0.01,1,174678,174200,478
7112161,23.6568,48.684,440,46556,0.0133342,0.05,1,174695,174255,440
7115081,17.5314,24.1368,438,46601,0.0266668,0.09,1,174711,174273,438
7118001,24.3063,18.4274,447,46646,0.0293334,0.03,1,174737,174290,447
7120921,25.6613,23.6855,448,46691,0.00586667,0.01,1,174763,174315,448
7123841,55.5323,24.7371,486,46736,0.0891733,0.05,1,174826,174340,486
7126761,25.5065,55.3474,441,46781,0.137835,0.03,1,174844,174403,441
7129681,25.9013,26.2695,448,46826,0.163567,0.03,1,174870,174422,448
7132601,30.7803,26.0539,454,46871,0.168713,0.05,1,174902,174448,454
7135521,31.7561,31.6108,453,46916,0.217743,0.01,1,174934,174481,453
7138441,20.7512,31.1222,440,46961,0.163549,0.03,1,174952,174512,440
7141361,19.3502,21.4244,440,47006,0.13671,0.03,1,174971,174531,440
7144281,25.47,19.4849,448,47051,0.0833419,0.01,1,174998,174550,448
7147201,21.094,25.497,441,47096,0.0566684,0.03,1,175018,174577,441
7150121,23.4188,21.0994,445,47141,0.0193337,0.01,1,175042,174597,445
7153041,51.0838,23.4199,479,47186,0.0118667,0.03,1,175100,174621,479
7155961,23.0168,50.284,438,47231,0.0103733,0.01,1,175116,174678,438
7158881,17.4034,23.6568,437,47276,0.00207467,0.03,1,175132,174695,437
7161801,25.0807,17.5314,448,47321,0.0404149,0.03,1,175159,174711,448
7164721,26.6161,24.3063,449,47366,0.032083,0,1,175186,174737,449
7167641,6.92323,25.6613,425,47411,0.0064166,0.11,1,175188,174763,425
7170561,53.3846,55.5323,427,47455,0.0732833,0.15,1,175253,174826,427
7173481,27.4769,25.5065,430,47499,0.102657,0.17,1,175274,174844,430
7176401,26.2954,25.9013,430,47543,0.0765313,0.17,1,175300,174870,430
7179321,30.8591,30.7803,430,47587,0.0713063,0.23,1,175332,174902,430
7182241,32.5718,31.7561,431,47631,0.102261,0.15,1,175365,174934,431
7185161,19.3144,20.7512,429,47675,0.108452,0.13,1,175381,174952,429
7188081,16.6629,19.3502,426,47719,0.14169,0.07,1,175397,174971,426
7191001,21.7326,25.47,422,47763,0.148338,0.05,1,175420,174998,422
7193921,20.3465,21.094,422,47807,0.117668,0.01,1,175440,175018,422
7196841,23.2693,23.4188,422,47851,0.0635335,0.01,1,175464,175042,422
7199761,51.0539,51.0838,422,47895,0.0527067,0.01,1,175522,175100,422
7202681,23.8108,23.0168,423,47939,0.0345413,0,1,175539,175116,423
7205601,16.7622,17.4034,422,47983,0.0309083,0.05,1,175554,175132,422
7208521,26.5524,25.0807,424,48027,0.00618165,0.03,1,175583,175159,424
7211441,26.9105,26.6161,424,48071,0.0412363,0,1,175610,175186,424
7214361,6.9821,6.92323,424,48115,0.0482473,0.09,1,175612,175188,424
7217281,53.3964,53.3846,424,48159,0.0816495,0.11,1,175677,175253,424
7220201,28.2793,27.4769,425,48203,0.10433,0.07,1,175699,175274,425
7223121,26.4559,26.2954,425,48247,0.140866,0.07,1,175725,175300,425
7226041,30.8912,30.8591,425,48291,0.196173,0.11,1,175757,175332,425
7228961,34.1782,32.5718,427,48335,0.191235,0.11,1,175792,175365,427
7231881,19.6356,19.3144,427,48379,0.238247,0.15,1,175808,175381,427
7234801,16.7271,16.6629,427,48423,0.215649,0.15,1,175824,175397,427
7237721,21.7454,21.7326,427,48467,0.22713,0.11,1,175847,175420,427
7240641,16.3491,20.3465,422,48510,0.245426,0.05,1,175862,175440,422
7243561,22.4698,23.2693,422,48553,0.153085,0.05,1,175886,175464,422
7246481,50.894,51.0539,422,48596,0.038617,0.03,1,175944,175522,422
7249401,23.7788,23.8108,422,48639,0.0317234,0.03,1,175961,175539,422
7252321,16.7558,16.7622,422,48682,0.0623447,0,1,175976,175554,422
7255241,26.5512,26.5524,422,48725,0.0124689,0.05,1,176005,175583,422
7258161,26.9102,26.9105,422,48768,0.0744938,0.05,1,176032,175610,422
7261081,6.98205,6.9821,422,48811,0.0868988,0.09,1,176034,175612,422
7264001,54.9964,53.3964,424,48854,0.0573798,0.09,1,176101,175677,424
7266921,29.3993,10.6793,447,48897,0.0514759,0.11,1,176124,175677,447
7269841,29.0799,19.7359,454,48940,0.0662952,0.15,1,176153,175699,454
7272761,32.216,24.7472,461,48983,0.053259,0.21,1,176186,175725,461
7275681,36.0432,30.5494,466,49026,0.0506518,0.19,1,176223,175757,466
7278601,20.0086,34.1099,447,49069,0.0501304,0.25,1,176239,175792,447
7281521,16.8017,19.622,447,49112,0.0500261,0.21,1,176255,175808,447
7284441,22.5603,16.7244,455,49155,0.0500052,0.23,1,176279,175824,455
7287361,14.1121,21.7449,444,49198,0.050001,0.25,1,176291,175847,444
7290281,17.2224,16.349,447,49241,0.0500002,0.13,1,176309,175862,447
7293201,48.2445,22.4698,479,49284,0.034,0.01,1,176365,175886,479
7296121,23.2489,50.894,438,49327,0.0148,0.03,1,176382,175944,438
7299041,17.4498,23.7788,437,49370,0.04296,0.07,1,176398,175961,437
7301961,25.89,16.7558,450,49413,0.008592,0,1,176426,175976,450
7304881,28.378,26.5512,450,49456,0.0577184,0.09,1,176455,176005,450
7307801,7.2756,26.9102,425,49499,0.0675437,0.09,1,176457,176032,425
7310721,55.8551,6.98205,491,49542,0.0695087,0.05,1,176525,176034,491
7313641,30.371,54.9964,448,49585,0.0699017,0.05,1,176549,176101,448
7316561,28.4742,29.3993,453,49627,0.10198,0.07,1,176577,176124,453
7319481,31.2948,29.0799,456,49669,0.172396,0.05,1,176609,176153,456
7322401,35.859,32.216,460,49711,0.186479,0.05,1,176646,176186,460
7325321,19.9718,36.0432,439,49753,0.205296,0.05,1,176662,176223,439
7328241,16.7944,20.0086,439,49795,0.209059,0.05,1,176678,176239,439
7331161,22.5589,16.8017,447,49837,0.241812,0.05,1,176702,176255,447
7334081,14.1118,22.5603,435,49879,0.248362,0.05,1,176714,176279,435
7337001,18.0224,14.1121,442,49921,0.265672,0.05,1,176733,176291,442
7339921,46.8045,17.2224,478,49963,0.173135,0.03,1,176787,176309,478
7342841,22.9609,48.2445,439,50005,0.138627,0.01,1,176804,176365,439
7345761,18.1922,23.2489,439,50047,0.147725,0.05,1,176821,176382,439
7348681,25.2384,17.4498,450,50089,0.101545,0,1,176848,176398,450
7351601,29.8477,25.89,453,50131,0.044309,0.07,1,176879,176426,453
7354521,7.56954,28.378,426,50173,0.0328618,0.07,1,176881,176455,426
7357441,55.9139,7.2756,492,50215,0.0625724,0.07,1,176949,176457,492
7360361,30.3828,55.8551,448,50257,0.0685145,0.07,1,176973,176525,448
7363281,30.8766,30.371,455,50299,0.0697029,0.11,1,177004,176549,455
7366201,7.77531,28.4742,429,50341,0.0699406,0.19,1,177006,176577,429
7369121,29.5551,31.2948,432,50383,0.0859881,0.19,1,177041,176609,432
7372041,34.711,35.859,431,50425,0.0891976,0.21,1,177077,176646,431
7374961,20.5422,19.9718,432,50467,0.10584,0.21,1,177094,176662,432
7377881,18.5084,16.7944,434,50509,0.109168,0.25,1,177112,176678,434
7380801,22.9017,22.5589,434,50551,0.109834,0.25,1,177136,176702,434
7383721,14.1803,14.1118,434,50593,0.109967,0.27,1,177148,176714,434
7386641,17.2361,18.0224,433,50635,0.109993,0.15,1,177166,176733,433
7389561,43.4472,46.8045,429,50677,0.141999,0.13,1,177216,176787,429
7392481,21.4894,22.9609,428,50719,0.1484,0.15,1,177232,176804,428
7395401,18.6979,18.1922,429,50761,0.16568,0.09,1,177250,176821,429
7398321,21.3396,25.2384,424,50802,0.153136,0.03,1,177272,176848,424
7401241,28.2679,29.8477,423,50843,0.182627,0.03,1,177302,176879,423
7404161,7.25358,7.56954,423,50884,0.188525,0.07,1,177304,176881,423
7407081,57.4507,55.9139,425,50925,0.173705,0.07,1,177374,176949,425
7410001,30.6901,30.3828,425,50966,0.170741,0.07,1,177398,176973,425
7412921,30.938,30.8766,425,51007,0.154148,0.07,1,177429,177004,425
7415841,7.78761,7.77531,425,51048,0.16683,0.09,1,177431,177006,425
7418761,30.3575,29.5551,426,51089,0.185366,0.09,1,177467,177041,426
7421681,34.8715,34.711,426,51130,0.253073,0.11,1,177503,177077,426
7424601,21.3743,20.5422,427,51171,0.298615,0.11,1,177521,177094,427
7427521,18.6749,18.5084,427,51212,0.275723,0.11,1,177539,177112,427
7430441,22.935,22.9017,427,51253,0.271145,0.11,1,177563,177136,427
7433361,14.187,14.1803,427,51294,0.286229,0.11,1,177575,177148,427
7436281,17.2374,17.2361,427,51335,0.305246,0.15,1,177593,177166,427
7439201,43.4475,43.4472,427,51376,0.373049,0.15,1,177643,177216,427
7442121,21.4895,21.4894,427,51417,0.38661,0.17,1,177659,177232,427
7445041,19.4979,18.6979,428,51458,0.373322,0.15,1,177678,177250,428
7447961,22.2996,21.3396,429,51499,0.354664,0.19,1,177701,177272,429
7450881,28.4599,28.2679,429,51540,0.382933,0.19,1,177731,177302,429
7453801,7.29198,7.25358,429,51581,0.388587,0.17,1,177733,177304,429
7456721,56.6584,57.4507,428,51622,0.389717,0.17,1,177802,177374,428
7459641,30.5317,30.6901,428,51663,0.405943,0.15,1,177826,177398,428
7462561,32.5063,30.938,430,51704,0.425189,0.17,1,177859,177429,430
7465481,8.10127,7.78761,430,51745,0.397038,0.19,1,177861,177431,430
7468401,31.2203,30.3575,431,51786,0.407408,0.19,1,177898,177467,431
7471321,37.4441,6.0715,470,51827,0.393482,0.27,1,177937,177467,470
7474241,21.8888,30.0143,452,51868,0.390696,0.31,1,177955,177503,452
7477161,18.7778,20.4029,452,51909,0.390139,0.27,1,177973,177521,452
7480081,23.7556,18.4806,459,51950,0.406028,0.27,1,177998,177539,459
7483001,15.1511,22.8961,448,51991,0.361206,0.29,1,178011,177563,448
7485921,18.2302,14.1792,455,52031,0.368241,0.31,1,178030,177575,455
7488841,44.446,17.2358,488,52071,0.385648,0.39,1,178081,177593,488
7491761,21.6892,43.4472,454,52111,0.38913,0.39,1,178097,177643,454
7494681,18.7378,21.4894,456,52151,0.405826,0.37,1,178115,177659,456
7497601,22.9476,19.4979,461,52191,0.409165,0.35,1,178139,177678,461
7500521,28.5895,22.2996,468,52231,0.425833,0.39,1,178169,177701,468
7503441,7.3179,28.4599,440,52271,0.429167,0.39,1,178171,177731,440
7506361,59.0636,7.29198,510,52311,0.445833,0.39,1,178243,177733,510
7509281,31.0127,56.6584,465,52351,0.481167,0.41,1,178267,177802,465
7512201,32.6025,30.5317,474,52391,0.504233,0.43,1,178300,177826,474
7515121,8.12051,32.5063,443,52431,0.508847,0.39,1,178302,177859,443
7518041,31.2241,8.10127,478,52471,0.477769,0.41,1,178339,177861,478
7520961,36.6448,31.2203,479,52511,0.519554,0.39,1,178377,177898,479
7523881,21.729,37.4441,458,52551,0.527911,0.39,1,178395,177937,458
7526801,18.7458,21.8888,458,52591,0.561582,0.39,1,178413,177955,458
7529721,22.9492,18.7778,464,52631,0.568316,0.41,1,178437,177973,464
7532641,14.1898,23.7556,451,52671,0.569663,0.35,1,178449,177998,451
7535561,18.838,15.1511,458,52711,0.585933,0.37,1,178469,178011,458
7538481,45.3676,18.2302,491,52751,0.637187,0.39,1,178521,178030,491
7541401,21.8735,44.446,456,52791,0.647437,0.39,1,178537,178081,456
7544321,19.5747,21.6892,459,52831,0.665487,0.41,1,178556,178097,459
7547241,23.1149,18.7378,465,52871,0.669098,0.41,1,178580,178115,465
7550161,29.423,22.9476,472,52911,0.65382,0.43,1,178611,178139,472
7553081,7.4846,28.5895,444,52951,0.650764,0.43,1,178613,178169,444
7556001,61.4969,7.3179,517,52991,0.634153,0.45,1,178688,178171,517
7558921,31.4994,59.0636,469,53031,0.630831,0.49,1,178712,178243,469
7561841,31.8999,31.0127,477,53071,0.646166,0.51,1,178744,178267,477
7564761,7.97998,32.6025,446,53111,0.649233,0.51,1,178746,178300,446
7567681,31.196,8.12051,481,53151,0.649847,0.47,1,178783,178302,481
7570601,39.0392,31.2241,485,53191,0.665969,0.53,1,178824,178339,485
7573521,22.2078,36.6448,465,53231,0.685194,0.53,1,178842,178377,465
7576441,6.04157,21.729,449,53271,0.689039,0.57,1,178844,178395,449
7579361,16.4083,18.7458,450,53311,0.705808,0.57,1,178863,178413,450
7582281,22.4817,22.9492,450,53350,0.725162,0.57,1,178887,178437,450
7585201,14.0963,14.1898,450,53389,0.761032,0.59,2,178899,178449,450
7588121,19.6193,18.838,451,53428,0.784206,0.65,2,178920,178469,451
7591041,47.9239,45.3676,454,53467,0.772841,0.65,2,178975,178521,454
7593961,22.3848,21.8735,454,53506,0.770568,0.67,2,178991,178537,454
7596881,20.477,19.5747,455,53545,0.802114,0.67,2,179011,178556,455
7599801,23.2954,23.1149,455,53584,0.776423,0.65,2,179035,178580,455
7602721,28.6591,29.423,454,53623,0.803285,0.65,2,179065,178611,454
7605641,7.33182,7.4846,454,53662,0.808657,0.63,2,179067,178613,454
7608561,60.6664,61.4969,453,53701,0.841731,0.63,2,179141,178688,453
7611481,32.1333,31.4994,454,53740,0.832346,0.65,2,179166,178712,454
7614401,32.0267,31.8999,454,53779,0.798469,0.65,2,179198,178744,454
7617321,8.00533,7.97998,454,53818,0.791694,0.65,2,179200,178746,454
7620241,31.2011,31.196,454,53857,0.806339,0.67,2,179237,178783,454
7623161,40.6402,39.0392,456,53896,0.809268,0.69,2,179280,178824,456
7626081,22.528,22.2078,456,53935,0.841854,0.69,2,179298,178842,456
7629001,6.10561,6.04157,456,53974,0.816371,0.71,2,179300,178844,456
7631921,17.2211,16.4083,457,54013,0.811274,0.73,2,179320,178863,457
7634841,23.4442,22.4817,458,54052,0.842255,0.77,2,179345,178887,458
7637761,14.2888,14.0963,458,54091,0.848451,0.79,2,179357,178899,458
7640681,20.4578,19.6193,459,54130,0.89769,0.77,2,179379,178920,459
7643601,47.2916,47.9239,458,54169,0.923538,0.77,2,179433,178975,458
7646521,23.0583,22.3848,459,54208,0.928708,0.81,2,179450,178991,459
7649441,21.4117,20.477,460,54247,0.945741,0.77,2,179471,179011,460
7652361,23.4823,23.2954,460,54286,0.917148,0.81,2,179495,179035,460
7883041,28,26,493,57267,0.55,1,1,181578,181085,493
7885961,21.6,21.2,493,57304,0.47,1,1,181598,181105,493
7888881,21.12,17.04,498,57341,0.342,1,1,181619,181121,498
7891801,27.424,38.608,483,57378,0.1404,1,1,181648,181165,483
7894721,29.4848,26.9216,489,57415,0.05208,1,1,181678,181189,489
7897641,20.297,22.1843,486,57452,0.018416,0.99,1,181696,181210,486
7900561,20.8594,20.4369,487,57489,0.0036832,1,1,181717,181230,487
7903481,20.1719,12.8874,496,57526,0.0247366,1,1,181737,181241,496
7906401,18.4344,24.1775,487,57563,0.00494733,1,1,181755,181268,487
7909321,20.4869,24.8355,483,57600,0.000989466,1,1,181776,181293,483
7912241,24.0974,26.5671,481,57637,0.00819789,1,1,181801,181320,481
7915161,17.6195,5.31342,497,57673,0.0256396,0.92,1,181817,181320,497
7918081,13.9239,17.8627,489,57709,0.0451279,0.97,1,181830,181341,489
7921001,27.5848,14.7725,506,57745,0.0490256,1,1,181861,181355,506
7923921,32.717,30.9545,505,57781,0.0178051,0.9,1,181895,181390,505
7926841,27.3434,30.9909,500,57817,0.00356102,0.87,1,181921,181421,500
7929761,23.0687,29.3982,493,57853,0.0247122,0.83,1,181943,181450,493
7932681,36.6137,26.6796,507,57889,0.0449424,0.79,1,181983,181476,507
7935601,22.5227,42.1359,480,57925,0.00898849,0.73,1,182002,181522,480
7938521,20.5045,30.8272,472,57961,0.0097977,0.55,1,182022,181550,472
7941441,16.9009,28.5654,460,57997,0.0259595,0.45,1,182038,181578,460
7944361,12.9802,21.7131,452,58033,0.0131919,0.31,1,182050,181598,452
7947281,18.596,21.1426,451,58069,0.0746384,0.09,1,182070,181619,451
7950201,26.9192,27.4285,451,58105,0.0389277,0.03,1,182099,181648,451
7953121,19.7838,29.4857,439,58141,0.0317855,0.01,1,182117,181678,439
7956041,21.5568,20.2971,443,58177,0.00635711,0,1,182139,181696,443
7958961,19.5114,20.8594,441,58213,0.0252714,0.03,1,182158,181717,441
7961881,20.7023,20.1719,442,58249,0.0290543,0,1,182179,181737,442
7964801,18.5405,18.4344,442,58285,0.00581086,0,1,182197,181755,442
7967721,24.5081,20.4869,447,58321,0.00916217,0.01,1,182223,181776,447
7970641,17.7016,24.0974,438,58357,0.00983243,0.03,1,182239,181801,438
7973561,13.1403,17.6195,434,58393,0.00996649,0.05,1,182251,181817,434
7976481,27.4281,13.9239,452,58429,0.0419933,0.05,1,182282,181830,452
7979401,33.4856,27.5848,456,58465,0.0643987,0.01,1,182317,181861,456
7982321,27.4971,32.717,448,58501,0.0528797,0,1,182343,181895,448
7985241,22.2994,27.3434,443,58537,0.0185759,0.03,1,182364,181921,443
7988161,36.4599,23.0687,461,58573,0.00371519,0.05,1,182404,181943,461
7991081,22.492,36.6137,440,58609,0.072743,0,1,182423,181983,440
7994001,21.2984,22.5227,442,58645,0.0225486,0.01,1,182444,182002,442
7996921,16.2597,20.5045,437,58681,0.0285097,0.03,1,182459,182022,437
7999841,15.2519,16.9009,436,58717,0.0137019,0.01,1,182474,182038,436
8002761,17.4504,12.9802,442,58753,0.0267404,0.09,1,182492,182050,442
8005681,25.8901,18.596,450,58789,0.0293481,0.03,1,182520,182070,450
8008601,21.178,26.9192,441,58825,0.0298696,0.03,1,182540,182099,441
8011521,20.2356,19.7838,443,58861,0.00597392,0,1,182560,182117,443
8014441,19.2471,21.5568,440,58897,0.00119478,0.03,1,182579,182139,440
8017361,20.6494,19.5114,442,58933,0.024239,0.03,1,182600,182158,442
8020281,18.5299,20.7023,439,58969,0.00484779,0,1,182618,182179,439
8023201,24.506,18.5405,447,59005,0.0249696,0.01,1,182644,182197,447
8026121,17.7012,24.5081,437,59041,0.0129939,0.01,1,182660,182223,437
8029041,13.1402,17.7016,433,59077,0.0105988,0.01,1,182672,182239,433
8031961,4.22805,13.1403,423,59113,0.0261198,0.05,1,182674,182251,423
8034881,24.8456,27.4281,422,59149,0.029224,0.07,1,182704,182282,422
8037801,32.9691,33.4856,422,59185,0.0458448,0.05,1,182739,182317,422
8040721,27.3938,27.4971,422,59221,0.017169,0.01,1,182765,182343,422
8043641,22.2788,22.2994,422,59256,0.0114338,0,1,182786,182364,422
8046561,38.8558,36.4599,425,59291,0.0262868,0.09,1,182829,182404,425
8049481,22.1712,22.492,424,59326,0.0132574,0.01,1,182847,182423,424
8052401,22.8342,21.2984,426,59361,0.0106515,0.03,1,182870,182444,426
8055321,14.1668,16.2597,423,59396,0.0421303,0.01,1,182882,182459,423
8058241,14.8334,15.2519,423,59431,0.0164261,0.03,1,182897,182474,423
8061161,17.3667,17.4504,423,59466,0.0112852,0.03,1,182915,182492,423
8064081,25.0733,25.8901,422,59501,0.026257,0.03,1,182942,182520,422
8067001,21.8147,21.178,423,59536,0.0132514,0,1,182963,182540,423
8069921,19.5629,20.2356,422,59571,0.0266503,0,1,182982,182560,422
8072841,19.1126,19.2471,422,59606,0.0293301,0.03,1,183001,182579,422
8075761,20.6225,20.6494,422,59641,0.029866,0,1,183022,182600,422
8078681,19.3245,18.5299,423,59676,0.0139732,0.03,1,183041,182618,423
8081601,23.8649,24.506,422,59711,0.0267946,0.01,1,183066,182644,422
8084521,17.573,17.7012,422,59746,0.0453589,0.01,1,183082,182660,422
8087441,13.1146,13.1402,422,59781,0.0170718,0.03,1,183094,182672,422
8090361,4.22292,4.22805,422,59816,0.0114144,0.03,1,183096,182674,422
8093281,24.8446,24.8456,422,59851,0.0262829,0.05,1,183126,182704,422
8096201,32.9689,32.9691,422,59886,0.0132566,0.01,1,183161,182739,422
8099121,27.3938,27.3938,422,59921,0.0426513,0.01,1,183187,182765,422
8102041,22.2788,22.2788,422,59956,0.0325303,0.03,1,183208,182786,422
8104961,38.8558,38.8558,422,59991,0.0305061,0.01,1,183251,182829,422
8107881,22.1712,22.1712,422,60026,0.0141012,0.01,1,183269,182847,422
8110801,22.8342,22.8342,422,60061,0.00282024,0.05,1,183292,182870,422
8113721,14.1668,14.1668,422,60096,0.040564,0.01,1,183304,182882,422
8116641,14.8334,14.8334,422,60131,0.0321128,0.01,1,183319,182897,422
8119561,18.1667,17.3667,423,60166,0.0464226,0.03,1,183338,182915,423
8122481,24.4333,25.0733,422,60201,0.0332845,0.01,1,183364,182942,422
8125401,21.6867,21.8147,422,60236,0.0306569,0.03,1,183385,182963,422
8128321,19.5373,19.5629,422,60271,0.0301314,0.03,1,183404,182982,422
8131241,19.1075,19.1126,422,60306,0.0140263,0.03,1,183423,183001,422
8134161,20.6215,20.6225,422,60341,0.0268053,0.01,1,183444,183022,422
8137081,19.3243,19.3245,422,60376,0.0133611,0.03,1,183463,183041,422
8140001,23.8649,23.8649,422,60411,0.0426722,0.05,1,183488,183066,422
8142921,17.573,17.573,422,60446,0.0165344,0.01,1,183504,183082,422
8145841,13.1146,13.1146,422,60481,0.0433069,0.01,1,183516,183094,422
8148761,4.22292,4.22292,422,60516,0.0166614,0.03,1,183518,183096,422
8151681,24.8446,24.8446,422,60551,0.0273323,0.03,1,183548,183126,422
8154601,32.1689,4.96892,456,60586,0.0454665,0.01,1,183582,183126,456
8157521,27.2338,28.9938,447,60621,0.0330933,0.05,1,183608,183161,447
8160441,22.2468,26.5988,442,60656,0.0306187,0.03,1,183629,183187,442
8163361,38.8494,22.1198,464,60691,0.0141237,0.03,1,183672,183208,464
8166281,22.1699,38.824,439,60726,0.0428247,0.01,1,183690,183251,439
8169201,22.834,22.1648,444,60761,0.0165649,0,1,183713,183269,444
8172121,14.1668,22.833,433,60796,0.027313,0.05,1,183725,183292,433
8175041,14.8334,14.1666,436,60831,0.0134626,0.03,1,183740,183304,436
8177961,18.1667,14.8333,440,60866,0.0266925,0.05,1,183759,183319,440
8180881,24.4333,18.1667,447,60901,0.0053385,0.03,1,183785,183338,447
8183801,21.6867,24.4333,442,60936,0.0410677,0.03,1,183806,183364,442
8186721,19.5373,21.6867,440,60970,0.00821354,0.03,1,183825,183385,440
8189641,19.1075,19.5373,440,61004,0.0256427,0.01,1,183844,183404,440
8192561,20.6215,19.1075,442,61038,0.0131285,0.03,1,183865,183423,442
8195481,19.3243,20.6215,440,61072,0.0266257,0.01,1,183884,183444,440
8198401,23.8649,19.3243,446,61106,0.0293251,0.05,1,183909,183463,446
8201321,17.573,23.8649,437,61140,0.013865,0.01,1,183925,183488,437
8204241,13.1146,17.573,433,61174,0.026773,0.05,1,183937,183504,433
8207161,4.22292,13.1146,423,61208,0.0293546,0.01,1,183939,183516,423
8210081,24.8446,4.22292,451,61242,0.0298709,0.03,1,183969,183518,451
8213001,32.1689,24.8446,455,61276,0.0299742,0.05,1,184003,183548,455
8215921,27.2338,32.1689,447,61310,0.0139948,0.03,1,184029,183582,447
8218841,23.0468,27.2338,443,61344,0.026799,0.03,1,184051,183608,443
8221761,39.8094,22.2468,466,61378,0.0293598,0.01,1,184095,183629,466
8224681,20.7619,38.8494,439,61412,0.029872,0.05,1,184111,183672,439
8227601,23.3524,22.1699,445,61446,0.0139744,0.01,1,184135,183690,445
8230521,14.2705,22.834,434,61480,0.0267949,0.03,1,184147,183713,434
8233441,15.6541,14.1668,438,61514,0.061359,0.01,1,184163,183725,438
8236361,17.5308,14.8334,441,61548,0.0842718,0.03,1,184181,183740,441
8239281,23.5062,18.1667,447,61582,0.0728544,0,1,184206,183759,447
8242201,22.3012,24.4333,443,61616,0.0545709,0.05,1,184228,183785,443
8245121,18.8602,21.6867,440,61650,0.0349142,0,1,184246,183806,440
8248041,18.972,19.5373,440,61684,0.00698283,0.03,1,184265,183825,440
8250961,20.5944,19.1075,442,61718,0.0253966,0.01,1,184286,183844,442
8253881,19.3189,20.6215,440,61752,0.0290793,0.03,1,184305,183865,440
8256801,23.8638,19.3243,446,61786,0.0138159,0.03,1,184330,183884,446
8259721,18.3728,23.8649,438,61820,0.0267632,0.01,1,184347,183909,438
8262641,14.0746,17.573,435,61854,0.00535263,0.03,1,184360,183925,435
8265561,4.41491,13.1146,425,61888,0.0410705,0.03,1,184362,183937,425
8268481,23.283,4.22292,451,61922,0.0322141,0.03,1,184390,183939,451
8271401,32.6566,24.8446,456,61956,0.0304428,0.03,1,184425,183969,456
8274321,26.5313,32.1689,447,61990,0.0140886,0.01,1,184450,184003,447
8277241,6.90626,27.2338,423,62024,0.0268177,0.03,1,184452,184029,423
8280161,18.1813,23.0468,422,62058,0.0293635,0.03,1,184473,184051,422
8283081,39.6363,39.8094,423,62092,0.00587271,0.03,1,184518,184095,423
8286001,20.7272,20.7619,423,62126,0.0411745,0.01,1,184534,184111,423
8288921,23.3455,23.3524,423,62160,0.0322349,0.03,1,184558,184135,423
8291841,15.8691,14.2705,425,62194,0.014447,0.07,1,184572,184147,425
8294761,15.9738,15.6541,425,62228,0.0108894,0.09,1,184588,184163,425
8297681,19.9948,17.5308,428,62262,0.0261779,0.07,1,184609,184181,428
8300601,19.199,23.5062,422,62296,0.0452356,0.05,1,184628,184206,422
8303521,21.4398,22.3012,422,62330,0.00904712,0.03,1,184650,184228,422
8306441,18.688,18.8602,422,62364,0.00980942,0,1,184668,184246,422
8309361,18.9376,18.972,422,62398,0.0259619,0.03,1,184687,184265,422
8312281,21.3875,20.5944,423,62432,0.0291924,0.03,1,184709,184286,423
8315201,19.4775,19.3189,423,62466,0.00583848,0.01,1,184728,184305,423
8318121,24.6955,23.8638,424,62500,0.0411677,0.03,1,184754,184330,424
8321041,16.9391,18.3728,422,62534,0.0322335,0,1,184769,184347,422
8323961,13.7878,14.0746,422,62568,0.0304467,0.05,1,184782,184360,422
8326881,4.35756,4.41491,422,62602,0.0300893,0.03,1,184784,184362,422
8329801,23.2715,23.283,422,62636,0.0460179,0.03,1,184812,184390,422
8332721,33.4543,32.6566,423,62670,0.0332036,0.01,1,184848,184425,423
8335641,25.8909,26.5313,422,62704,0.0146407,0.03,1,184872,184450,422
8338561,6.77817,6.90626,422,62737,0.0109281,0.03,1,184874,184452,422
8341481,18.1556,18.1813,422,62770,0.0101856,0,1,184895,184473,422
8344401,39.6311,39.6363,422,62803,0.0260371,0.05,1,184940,184518,422
8347321,20.7262,20.7272,422,62836,0.0132074,0.03,1,184956,184534,422
8350241,23.3452,23.3455,422,62869,0.0266415,0.01,1,184980,184558,422
8353161,15.869,15.8691,422,62902,0.0133283,0.01,1,184994,184572,422
8356081,15.9738,15.9738,422,62935,0.0106657,0.03,1,185010,184588,422
8359001,20.7948,19.9948,423,62968,0.0261331,0.05,1,185032,184609,423
8361921,18.559,19.199,422,63001,0.0772266,0,1,185050,184628,422
8364841,22.1118,21.4398,423,63034,0.0554453,0.01,1,185073,184650,423
8367761,18.0224,18.688,422,63067,0.0350891,0.03,1,185090,184668,422
8370681,18.8045,18.9376,422,63100,0.0150178,0.03,1,185109,184687,422
8373601,21.3609,21.3875,422,63133,0.0110036,0,1,185131,184709,422
8376521,20.2722,19.4775,423,63166,0.0262007,0.05,1,185151,184728,423
8379441,24.0544,24.6955,422,63199,0.0132401,0.03,1,185176,184754,422
8382361,16.8109,16.9391,422,63232,0.042648,0.03,1,185191,184769,422
8385281,13.7622,13.7878,422,63265,0.0485296,0.03,1,185204,184782,422
8388201,4.35244,4.35756,422,63298,0.0497059,0.05,1,185206,184784,422
8391121,23.2705,23.2715,422,63331,0.0179412,0.03,1,185234,184812,422
8394041,34.2541,33.4543,423,63364,0.0115882,0.01,1,185271,184848,423
8396961,25.2508,25.8909,422,63397,0.0423176,0.01,1,185294,184872,422
8399881,6.65016,6.77817,422,63430,0.0644635,0.01,1,185296,184874,422
8402801,18.13,18.1556,422,63463,0.0128927,0.01,1,185317,184895,422
8405721,38.826,3.63113,466,63496,0.0585785,0.03,1,185361,184895,466
8408641,20.5652,36.7262,437,63529,0.0357157,0.01,1,185377,184940,437
8411561,23.313,20.1452,445,63562,0.00714314,0.03,1,185401,184956,445
8414481,15.8626,23.229,435,63595,0.0254286,0.01,1,185415,184980,435
8417401,15.9725,15.8458,437,63628,0.0290857,0.01,1,185431,184994,437
8420321,21.5945,15.9692,444,63661,0.0138171,0.03,1,185454,185010,444
8423241,20.3189,20.7938,442,63694,0.0107634,0.09,1,185474,185032,442
8426161,21.6638,18.5588,446,63727,0.0261527,0.05,1,185496,185050,446
8429081,16.3328,22.1118,438,63760,0.0452305,0.03,1,185511,185073,438
8432001,18.4666,18.0224,440,63793,0.0330461,0.01,1,185530,185090,440
8434921,21.2933,18.8045,443,63826,0.0306092,0.01,1,185552,185109,443
8437841,20.2587,21.3609,441,63859,0.0301218,0.03,1,185572,185131,441
8440761,24.8517,20.2722,447,63892,0.0300244,0.01,1,185598,185151,447
8443681,16.9703,24.0544,437,63925,0.0780049,0.05,1,185613,185176,437
8446601,12.9941,16.8109,434,63958,0.087601,0.05,1,185625,185191,434
8449521,4.19881,13.7622,423,63991,0.0895202,0.05,1,185627,185204,423
8452441,23.2398,4.35244,449,64024,0.025904,0.01,1,185655,185206,449
8455361,35.048,23.2705,459,64057,0.0131808,0.01,1,185693,185234,459
8458281,24.6096,34.2541,444,64090,0.0426362,0.05,1,185715,185271,444
8461201,6.52192,25.2508,423,64123,0.0485272,0.07,1,185717,185294,423
8464121,18.1044,6.65016,442,64156,0.0497054,0,1,185738,185296,442
8467041,39.6209,18.13,466,64189,0.0819411,0.07,1,185783,185317,466
8469961,20.7242,38.826,438,64222,0.0883882,0.03,1,185799,185361,438
8472881,23.3448,20.5652,446,64255,0.105678,0,1,185823,185377,446
8475801,15.869,23.313,436,64288,0.0771355,0.03,1,185837,185401,436
8478721,15.9738,15.8626,438,64321,0.0714271,0.03,1,185853,185415,438
8481641,21.5948,15.9725,445,64354,0.0862854,0.01,1,185876,185431,445
8484561,20.319,21.5945,442,64387,0.0252571,0.01,1,185896,185454,442
8487481,21.6638,20.3189,444,64420,0.0290514,0.03,1,185918,185474,444
8490401,15.5328,21.6638,436,64453,0.0298103,0.05,1,185932,185496,436
8493321,18.3066,16.3328,440,64486,0.00596206,0.03,1,185951,185511,440
8496241,23.6613,18.4666,446,64519,0.0251924,0.03,1,185976,185530,446
8499161,18.3323,21.2933,441,64552,0.0450385,0.03,1,185993,185552,441
8502081,26.8665,20.2587,450,64585,0.0490077,0.03,1,186022,185572,450
8505001,18.1733,24.8517,440,64618,0.0818015,0.09,1,186038,185598,440
8507921,11.6347,16.9703,435,64650,0.10436,0.09,1,186048,185613,435
8510841,3.92693,12.9941,425,64682,0.108872,0.09,1,186050,185625,425
8513761,21.5854,4.19881,449,64714,0.109774,0.01,1,186076,185627,449
8516681,35.5171,23.2398,460,64746,0.0619549,0.01,1,186115,185655,460
8519601,26.3034,35.048,446,64778,0.036391,0.05,1,186139,185693,446
8522521,6.86068,24.6096,426,64810,0.0632782,0.05,1,186141,185715,426
8525441,15.7721,6.52192,442,64842,0.0526556,0.05,1,186159,185717,442
8528361,42.3544,18.1044,470,64874,0.0185311,0.09,1,186208,185738,470
8531281,21.2709,39.6209,441,64906,0.0277062,0.09,1,186224,185783,441
8534201,5.85418,20.7242,427,64938,0.0295412,0.11,1,186226,185799,427
8537121,18.7708,23.3448,425,64970,0.0619082,0.07,1,186248,185823,425
8540041,14.9542,15.869,425,65002,0.0683816,0.07,1,186262,185837,425
8542961,15.7908,15.9738,425,65034,0.0376763,0.09,1,186278,185853,425
8545881,20.7582,21.5948,424,65066,0.0315353,0.01,1,186300,185876,424
8548801,19.3516,20.319,423,65098,0.0463071,0.03,1,186319,185896,423
8551721,21.4703,21.6638,423,65130,0.0332614,0.03,1,186341,185918,423
8554641,16.2941,15.5328,424,65162,0.0466523,0,1,186356,185932,424
8557561,16.8588,18.3066,422,65194,0.0333305,0.03,1,186373,185951,422
8560481,24.1718,23.6613,423,65226,0.00666609,0.05,1,186399,185976,423
8563401,17.6344,18.3323,422,65258,0.0413332,0.05,1,186415,185993,422
8566321,29.1269,26.8665,425,65290,0.0322666,0.09,1,186447,186022,425
8569241,20.2254,18.1733,427,65322,0.0464533,0.11,1,186465,186038,427
8572161,12.0451,11.6347,427,65354,0.0172907,0.11,1,186475,186048,427
8575081,4.00901,3.92693,427,65386,0.0434581,0.11,1,186477,186050,427
8578001,20.0018,21.5854,425,65418,0.0166916,0.05,1,186501,186076,425
8580921,33.6004,35.5171,423,65450,0.0273383,0.03,1,186538,186115,423
8583841,26.7201,26.3034,424,65482,0.0294677,0.07,1,186563,186139,424
8586761,6.94401,6.86068,424,65514,0.0298935,0.05,1,186565,186141,424
8589681,14.1888,15.7721,422,65546,0.0619787,0.01,1,186581,186159,422
8592601,42.8378,42.3544,423,65578,0.0843957,0.03,1,186631,186208,423
8595521,21.3676,21.2709,423,65610,0.0568791,0.03,1,186647,186224,423
8598441,5.87351,5.85418,423,65642,0.0513758,0.07,1,186649,186226,423
8601361,18.7747,18.7708,423,65674,0.0502752,0.07,1,186671,186248,423
8604281,14.9549,14.9542,423,65706,0.066055,0.03,1,186685,186262,423
8607201,15.791,15.7908,423,65738,0.069211,0.03,1,186701,186278,423
8610121,20.7582,20.7582,423,65770,0.0858422,0.05,1,186723,186300,423
8613041,19.3516,19.3516,423,65802,0.121168,0.03,1,186742,186319,423
8615961,21.4703,21.4703,423,65834,0.128234,0.05,1,186764,186341,423
8618881,17.0941,16.2941,424,65866,0.129647,0.03,1,186780,186356,424
8621801,15.4188,16.8588,422,65898,0.145929,0,1,186795,186373,422
8624721,23.8838,24.1718,422,65930,0.0531859,0.05,1,186821,186399,422
8627641,17.5768,17.6344,422,65962,0.0346372,0.03,1,186837,186415,422
8630561,29.1154,29.1269,422,65994,0.0149274,0.05,1,186869,186447,422
8633481,20.2231,20.2254,422,66026,0.0589855,0.01,1,186887,186465,422
8636401,12.0446,12.0451,422,66058,0.0357971,0.05,1,186897,186475,422
8639321,4.00892,4.00901,422,66090,0.0631594,0.01,1,186899,186477,422
8642241,20.8018,20.0018,423,66122,0.0526319,0.03,1,186924,186501,423
8645161,32.9604,33.6004,422,66154,0.0825264,0.03,1,186960,186538,422
8648081,27.3921,26.7201,423,66186,0.0565053,0.03,1,186986,186563,423
8651001,7.07841,6.94401,423,66218,0.0513011,0.07,1,186988,186565,423
8653921,14.2157,14.1888,423,66250,0.0822602,0.09,1,187004,186581,423
8656841,43.6431,42.8378,424,66282,0.088452,0.05,1,187055,186631,424
8659761,21.5286,21.3676,424,66314,0.0576904,0.05,1,187071,186647,424
8662681,5.90573,5.87351,424,66346,0.0515381,0.05,1,187073,186649,424
8665601,18.7811,18.7747,424,66378,0.0503076,0.05,1,187095,186671,424
8668521,14.9562,3.75494,438,66410,0.0500615,0.07,1,187109,186671,438
8671441,16.5912,11.951,441,66442,0.0660123,0.07,1,187126,186685,441
8674361,21.7182,15.1902,448,66474,0.0852025,0.09,1,187149,186701,448
8677281,20.3436,20.638,446,66506,0.0890405,0.13,1,187169,186723,446
8680201,21.6687,19.3276,449,66538,0.0898081,0.13,1,187191,186742,449
8683121,17.1337,21.4655,443,66570,0.0899616,0.13,1,187207,186764,443
8686041,12.2267,17.0931,438,66602,0.121992,0.15,1,187218,186780,438
8688961,21.6454,15.4186,447,66634,0.0643985,0.03,1,187242,186795,447
8691881,17.9291,23.8837,438,66665,0.0208797,0.03,1,187259,186821,438
8694801,28.3858,17.5767,453,66696,0.0281759,0.01,1,187290,186837,453
8697721,20.8772,29.1153,440,66727,0.0136352,0.07,1,187309,186869,440
8700641,12.1754,20.2231,432,66758,0.026727,0.03,1,187319,186887,432
8703561,4.03509,12.0446,424,66789,0.0293454,0.07,1,187321,186897,424
8706481,22.407,4.00892,449,66820,0.0458691,0.05,1,187348,186899,449
8709401,32.4814,20.8018,459,66851,0.0811738,0.09,1,187383,186924,459
8712321,27.2963,32.9604,449,66882,0.0882348,0.05,1,187409,186960,449
8715241,7.05926,27.3921,425,66913,0.089647,0.05,1,187411,186986,425
8718161,15.0119,7.07841,440,66944,0.0739294,0.09,1,187428,186988,440
8721081,43.0024,14.2157,474,66975,0.0867859,0.09,1,187478,187004,474
8724001,21.4005,43.6431,439,67006,0.0893572,0.05,1,187494,187055,439
8726921,5.88009,21.5286,425,67037,0.0898714,0.05,1,187496,187071,425
8729841,18.776,5.90573,445,67068,0.105974,0.05,1,187518,187073,445
8732761,14.9552,18.7811,437,67099,0.125195,0.05,1,187532,187095,437
8735681,17.391,14.9562,441,67130,0.145039,0.07,1,187550,187109,441
8738601,22.6782,16.5912,448,67161,0.165008,0.09,1,187574,187126,448
8741521,20.5356,21.7182,445,67192,0.185002,0.09,1,187594,187149,445
8744441,21.7071,20.3436,447,67223,0.189,0.09,1,187616,187169,447
8747361,17.9414,21.6687,442,67254,0.1738,0.09,1,187633,187191,442
8750281,11.5883,17.1337,436,67285,0.17076,0.13,1,187643,187207,436
8753201,18.3177,12.2267,445,67316,0.170152,0.05,1,187663,187218,445
8756121,18.0635,21.6454,439,67347,0.13803,0.01,1,187681,187242,439
8759041,27.6127,17.9291,452,67378,0.0836061,0.03,1,187711,187259,452
8761961,21.5225,28.3858,441,67409,0.0567212,0.01,1,187731,187290,441
8764881,12.3045,20.8772,432,67440,0.0513442,0.03,1,187741,187309,432
8767801,4.0609,12.1754,424,67471,0.0502688,0.03,1,187743,187319,424
8770721,24.0122,4.03509,451,67502,0.0500538,0.05,1,187772,187321,451
8773641,33.6024,22.407,460,67533,0.0820108,0.09,1,187808,187348,460
8776561,27.5205,32.4814,451,67564,0.104402,0.09,1,187834,187383,451
8779481,7.1041,27.2963,427,67595,0.10888,0.09,1,187836,187409,427
8782401,15.8208,7.05926,443,67626,0.109776,0.07,1,187854,187411,443
8785321,42.3642,15.0119,475,67657,0.109955,0.09,1,187903,187428,475
8788241,22.0728,43.0024,442,67688,0.141991,0.09,1,187920,187478,442
8791161,6.01457,21.4005,428,67719,0.148398,0.09,1,187922,187494,428
8794081,19.6029,5.88009,449,67750,0.13368,0.11,1,187945,187496,449
8797001,15.9206,18.776,442,67781,0.146736,0.13,1,187960,187518,442
8799921,17.5841,14.9552,446,67812,0.149347,0.15,1,187978,187532,446
8802841,5.11682,17.391,430,67843,0.149869,0.17,1,187980,187550,430
8805761,20.2234,22.6782,430,67874,0.149974,0.19,1,188004,187574,430
8808681,20.8447,20.5356,431,67905,0.165995,0.19,1,188025,187594,431
8811601,21.7689,21.7071,431,67936,0.137199,0.17,1,188047,187616,431
8814521,17.1538,17.9414,430,67967,0.16344,0.17,1,188063,187633,430
8817441,11.4308,11.5883,430,67998,0.136688,0.17,1,188073,187643,430
8820361,18.2862,18.3177,430,68029,0.163338,0.13,1,188093,187663,430
8823281,17.2572,18.0635,429,68060,0.168668,0.07,1,188110,187681,429
8826201,24.2514,27.6127,425,68091,0.169734,0.05,1,188136,187711,425
8829121,20.0503,21.5225,424,68122,0.217947,0.05,1,188155,187731,424
8832041,12.8101,12.3045,425,68153,0.211589,0.05,1,188166,187741,425
8834961,4.16201,4.0609,425,68184,0.210318,0.05,1,188168,187743,425
8837881,23.2324,24.0122,424,68215,0.178064,0.09,1,188196,187772,424
8840801,35.8465,33.6024,427,68246,0.155613,0.11,1,188235,187808,427
8843721,27.9693,27.5205,427,68277,0.183123,0.11,1,188261,187834,427
8846641,7.19386,7.1041,427,68308,0.188625,0.11,1,188263,187836,427
8849561,15.8388,15.8208,427,68339,0.189725,0.11,1,188281,187854,427
8852481,43.1678,42.3642,428,68370,0.173945,0.15,1,188331,187903,428
8855401,21.4336,22.0728,427,68401,0.170789,0.15,1,188347,187920,427
8858321,5.88671,6.01457,427,68432,0.170158,0.13,1,188349,187922,427
8861241,20.3773,19.6029,428,68463,0.170032,0.15,1,188373,187945,428
8864161,16.8755,15.9206,429,68494,0.202006,0.15,1,188389,187960,429
8867081,17.7751,17.5841,429,68525,0.256401,0.15,1,188407,187978,429
8870001,5.15502,5.11682,429,68556,0.26728,0.15,1,188409,187980,429
8872921,20.231,20.2234,429,68587,0.269456,0.17,1,188433,188004,429
8875841,20.0462,20.8447,428,68618,0.237891,0.13,1,188453,188025,428
8878761,21.6092,21.7689,428,68649,0.263578,0.17,1,188475,188047,428
8881681,17.1218,17.1538,428,68680,0.316716,0.13,1,188491,188063,428
8884601,11.4244,11.4308,428,68711,0.295343,0.17,1,188501,188073,428
8887521,18.2849,18.2862,428,68742,0.323069,0.17,1,188521,188093,428
8890441,18.857,17.2572,430,68773,0.344614,0.17,1,188540,188110,430
8893361,24.5714,24.2514,430,68803,0.348923,0.23,1,188566,188136,430
8896281,20.9143,20.0503,431,68833,0.365785,0.21,1,188586,188155,431
8899201,12.1829,12.8101,430,68863,0.337157,0.21,1,188596,188166,430
8902121,4.03657,4.16201,430,68893,0.363431,0.17,1,188598,188168,430
8905041,23.2073,23.2324,430,68923,0.384686,0.15,1,188626,188196,430
8907961,35.0415,35.8465,429,68953,0.372937,0.19,1,188664,188235,429
8910881,27.8083,27.9693,429,68983,0.402587,0.19,1,188690,188261,429
8913801,7.16166,7.19386,429,69013,0.408517,0.19,1,188692,188263,429
8916721,15.8323,15.8388,429,69043,0.441703,0.17,1,188710,188281,429
8919641,43.9665,43.1678,430,69073,0.480341,0.17,1,188761,188331,430
8922561,21.5933,21.4336,430,69103,0.472068,0.17,1,188777,188347,430
8925481,5.91866,5.88671,430,69133,0.470414,0.17,1,188779,188349,430
8928401,21.9837,20.3773,432,69163,0.518083,0.21,1,188805,188373,432
8931321,17.1967,16.8755,432,69193,0.495617,0.27,1,188821,188389,432
8934241,18.6393,17.7751,433,69223,0.507123,0.27,1,188840,188407,433
8937161,5.32787,5.15502,433,69253,0.509425,0.27,1,188842,188409,433
8940081,20.2656,20.231,433,69283,0.509885,0.23,1,188866,188433,433
8943001,20.8531,20.0462,434,69313,0.493977,0.23,1,188887,188453,434
8945921,22.5706,4.00924,457,69343,0.506795,0.27,1,188910,188453,457
8948841,17.3141,18.4018,451,69373,0.509359,0.33,1,188926,188475,451
8951761,11.4628,16.4804,445,69403,0.509872,0.29,1,188936,188491,445
8954681,18.2926,11.2961,455,69433,0.509974,0.33,1,188956,188501,455
8957601,19.6585,18.2592,455,69463,0.509995,0.35,1,188976,188521,455
8960521,25.5317,18.8518,463,69493,0.541999,0.35,1,189003,188540,463
8963441,21.1063,24.5704,457,69523,0.5164,0.37,1,189023,188566,457
8966361,13.0213,20.9141,448,69553,0.52728,0.33,1,189034,188586,448
8969281,4.20425,12.1828,440,69583,0.529456,0.37,1,189036,188596,440
8972201,23.2409,4.03656,466,69613,0.529891,0.39,1,189064,188598,466
8975121,36.6482,23.2073,478,69643,0.497978,0.37,1,189104,188626,478
8978041,28.9296,35.0415,467,69673,0.507596,0.41,1,189131,188664,467
8980961,7.38593,27.8083,443,69703,0.509519,0.41,1,189133,188690,443
8983881,15.8772,7.16166,459,69733,0.509904,0.45,1,189151,188692,459
8986801,45.5754,15.8323,494,69763,0.541981,0.49,1,189204,188710,494
8989721,23.5151,43.9665,461,69793,0.580396,0.47,1,189222,188761,461
8992641,6.30302,21.5933,447,69823,0.588079,0.47,1,189224,188777,447
8995561,22.0606,5.91866,471,69853,0.557616,0.53,1,189250,188779,471
8998481,17.2121,21.9837,461,69883,0.551523,0.49,1,189266,188805,461
9001401,17.8424,17.1967,463,69913,0.566305,0.51,1,189284,188821,463
9004321,5.16848,18.6393,446,69943,0.569261,0.51,1,189286,188840,446
9007241,20.2337,5.32787,468,69973,0.585852,0.51,1,189310,188842,468
9010161,21.6467,20.2656,466,70003,0.60517,0.49,1,189332,188866,466
9013081,23.5293,20.8531,469,70033,0.609034,0.51,1,189356,188887,469
9016001,17.5059,22.5706,462,70063,0.609807,0.51,1,189372,188910,462
9018921,11.5012,17.3141,456,70093,0.609961,0.51,1,189382,188926,456
9021841,18.3002,11.4628,466,70123,0.657992,0.51,1,189402,188936,466
9024761,19.66,18.2926,466,70153,0.667598,0.51,1,189422,188956,466
9027681,25.532,19.6585,473,70183,0.66952,0.55,1,189449,188976,473
9030601,21.1064,25.5317,466,70213,0.669904,0.51,1,189469,189003,466
9033521,13.8213,21.1063,458,70243,0.669981,0.53,1,189481,189023,458
9036441,4.36426,13.0213,449,70273,0.669996,0.53,1,189483,189034,449
9039361,23.2729,4.20425,475,70303,0.701999,0.53,1,189511,189036,475
9042281,35.0546,23.2409,485,70333,0.7084,0.49,1,189549,189064,485
9045201,29.4109,36.6482,473,70363,0.70968,0.51,1,189577,189104,473
9048121,7.48218,28.9296,448,70393,0.709936,0.51,1,189579,189131,448
9051041,15.8964,7.38593,464,70423,0.741987,0.51,1,189597,189133,464
9053961,47.1793,15.8772,501,70453,0.748397,0.55,1,189652,189151,501
9056881,23.8359,45.5754,466,70483,0.765679,0.59,2,189670,189204,466
9059801,6.36717,23.5151,450,70513,0.769136,0.59,2,189672,189222,450
9062721,22.0734,6.30302,474,70543,0.769827,0.55,2,189698,189224,474
9065641,18.0147,22.0606,465,70573,0.785965,0.55,2,189715,189250,465
9068561,18.0029,17.2121,467,70603,0.757193,0.57,2,189733,189266,467
9071481,5.20059,17.8424,451,70633,0.751439,0.57,2,189735,189284,451
9074401,21.0401,5.16848,474,70663,0.782288,0.59,2,189760,189286,474
9077321,22.608,20.2337,473,70693,0.804458,0.61,2,189783,189310,473
9080241,23.7216,21.6467,475,70723,0.808892,0.61,2,189807,189332,475
9083161,17.5443,23.5293,467,70753,0.809778,0.61,2,189823,189356,467
9086081,5.10886,17.5059,453,70783,0.809956,0.61,2,189825,189372,453
9089001,9.82177,11.5012,454,70813,0.825991,0.67,2,189836,189382,454
9091921,18.7644,18.3002,455,70843,0.813198,0.67,2,189857,189402,455
9094841,20.5529,19.66,456,70873,0.79464,0.67,2,189878,189422,456
9097761,24.9106,25.532,455,70903,0.774928,0.67,2,189904,189449,455
9100681,20.9821,21.1064,455,70933,0.802986,0.67,2,189924,189469,455
9103601,14.5964,13.8213,456,70963,0.792597,0.67,2,189937,189481,456
9106521,4.51928,4.36426,456,70993,0.790519,0.71,2,189939,189483,456
9109441,24.1039,23.2729,457,71023,0.790104,0.71,2,189968,189511,457
9112361,35.2208,35.0546,457,71053,0.822021,0.71,2,190006,189549,457
9115281,30.2442,29.4109,458,71083,0.820404,0.71,2,190035,189577,458
9118201,7.64883,7.48218,458,71112,0.820081,0.75,2,190037,189579,458
9121121,16.7298,15.8964,459,71141,0.828016,0.75,2,190056,189597,459
9124041,48.146,47.1793,460,71170,0.829603,0.77,2,190112,189652,460
9126961,24.0292,23.8359,460,71199,0.797921,0.77,2,190130,189670,460
9129881,6.40584,6.36717,460,71228,0.791584,0.77,2,190132,189672,460
9132801,22.0812,22.0734,460,71257,0.822317,0.79,2,190158,189698,460
9135721,17.2162,18.0147,459,71286,0.796463,0.75,2,190174,189715,459
9138641,18.6432,18.0029,460,71315,0.823293,0.75,2,190193,189733,460
9141561,5.32865,5.20059,460,71344,0.828659,0.79,2,190195,189735,460
9144481,21.8657,21.0401,461,71373,0.829732,0.81,2,190221,189760,461
9147401,23.5731,22.608,462,71402,0.829946,0.81,2,190245,189783,462
9150321,23.9146,23.7216,462,71431,0.861989,0.81,2,190269,189807,462
9153241,17.5829,17.5443,462,71460,0.884398,0.81,2,190285,189823,462
9156161,5.11658,5.10886,462,71489,0.85688,0.83,2,190287,189825,462
9159081,9.02332,9.82177,461,71518,0.851376,0.81,2,190297,189836,461
9162001,17.8047,18.7644,460,71547,0.898275,0.79,2,190317,189857,460
9164921,19.5609,20.5529,459,71576,0.923655,0.77,2,190337,189878,459
9167841,25.5122,24.9106,460,71605,0.928731,0.81,2,190364,189904,460
9170761,21.1024,20.9821,460,71634,0.929746,0.79,2,190384,189924,460
9173681,13.8205,14.5964,459,71663,0.929949,0.79,2,190396,189937,459
9385381,40,53,443,35040,0.07,0.21,1,192293,191850,443
9391221,60.8,73,431,35040,0.118,0.21,1,192359,191928,431
9401441,22.56,27.4,428,35040,0.1116,0.03,1,192372,191944,428
9439401,59.712,63.08,425,35040,0.06232,0.03,1,192441,192016,425
9442321,51.9424,35.816,446,35100,0.012464,0.07,1,192491,192045,446
9445241,23.1885,39.1632,422,35160,0.0424928,0.03,1,192507,192085,422
9448161,23.0377,25.4326,423,35220,0.0644986,0.03,1,192530,192107,423
9451081,24.6075,18.6865,431,35280,0.0368997,0.03,1,192555,192124,431
9454001,16.1215,17.3373,428,35340,0.0473799,0.03,1,192569,192141,428
9456921,38.4243,19.4675,452,35400,0.049476,0.03,1,192613,192161,452
9459841,42.8849,47.8935,441,35460,0.0178952,0.05,1,192657,192216,441
9462761,38.177,39.1787,441,35520,0.043579,0.07,1,192694,192253,441
9465681,43.6354,39.8357,446,35580,0.0487158,0.13,1,192739,192293,446
9468601,45.5271,41.5671,450,35639,0.0657432,0.11,1,192785,192335,450
9471521,32.3054,37.9134,442,35698,0.117149,0.05,1,192814,192372,442
9474441,45.6611,41.9827,448,35757,0.11143,0,1,192863,192415,448
9477361,49.1322,69.1965,422,35816,0.0462859,0.05,1,192913,192491,422
9480281,22.6264,26.6393,422,35875,0.0172572,0.07,1,192929,192507,422
9483201,23.7253,23.7279,423,35934,0.0274514,0.03,1,192953,192530,423
9486121,25.5451,24.7456,424,35993,0.0294903,0.05,1,192979,192555,424
9489041,16.309,16.1491,424,36052,0.0138981,0.05,1,192993,192569,424
9491961,36.8618,38.4298,422,36111,0.0267796,0.01,1,193035,192613,422
9494881,43.3724,42.886,423,36170,0.0453559,0.05,1,193080,192657,423
9497801,39.8745,38.1772,425,36228,0.0330712,0.05,1,193119,192694,425
9500721,44.7749,43.6354,426,36286,0.0786142,0.07,1,193165,192739,426
9503641,45.755,45.5271,426,36344,0.103723,0.13,1,193211,192785,426
9506561,33.951,32.3054,428,36402,0.108745,0.11,1,193242,192814,428
9509481,45.1902,45.6611,427,36460,0.0937489,0.03,1,193290,192863,427
9512401,45.038,49.1322,422,36518,0.15475,0.01,1,193335,192913,422
9515321,21.8076,22.6264,422,36576,0.03895,0.03,1,193351,192929,422
9518241,24.3615,23.7253,423,36634,0.01579,0.03,1,193376,192953,423
9521161,24.8723,25.5451,422,36692,0.027158,0.01,1,193401,192979,422
9524081,16.1745,16.309,422,36750,0.0454316,0.03,1,193415,192993,422
9527001,36.8349,36.8618,422,36808,0.0330863,0.05,1,193457,193035,422
9529921,43.367,43.3724,422,36865,0.0466173,0.03,1,193502,193080,422
9532841,40.6734,39.8745,423,36922,0.0813235,0.09,1,193542,193119,423
9535761,45.7347,44.7749,424,36979,0.0882647,0.11,1,193589,193165,424
9538681,46.7469,45.755,425,37036,0.121653,0.11,1,193636,193211,425
9541601,34.1494,33.951,425,37093,0.128331,0.09,1,193667,193242,425
9544521,46.0299,45.1902,426,37150,0.177666,0.09,1,193716,193290,426
9547441,41.206,9.03804,466,37207,0.155533,0.17,1,193756,193290,466
9550361,21.0412,37.8076,437,37264,0.151107,0.01,1,193772,193335,437
9553281,24.2082,20.3615,446,37321,0.0702213,0.01,1,193797,193351,446
9556201,24.8416,24.0723,446,37378,0.0380443,0.03,1,193822,193376,446
9559121,16.1683,24.8145,435,37435,0.0316089,0.05,1,193836,193401,435
9562041,36.8337,16.1629,463,37491,0.00632177,0.03,1,193878,193415,463
9564961,43.3667,36.8326,466,37547,0.0252644,0.05,1,193923,193457,466
9567881,42.2733,43.3665,463,37603,0.0610529,0.09,1,193965,193502,463
9570801,47.6547,40.6733,472,37659,0.0842106,0.09,1,194014,193542,472
9573721,47.1309,45.7347,472,37715,0.120842,0.13,1,194061,193589,472
9576641,35.8262,46.7469,458,37771,0.160168,0.13,1,194094,193636,458
9579561,47.9652,34.1494,478,37827,0.200034,0.19,1,194145,193667,478
9582481,40.793,46.0299,468,37883,0.192007,0.15,1,194184,193716,468
9585401,17.7586,41.206,440,37939,0.190401,0.15,1,194196,193756,440
9588321,22.7517,21.0412,448,37995,0.20608,0.05,1,194220,193772,448
9591241,23.7503,24.2082,447,38051,0.225216,0.03,1,194244,193797,447
9594161,15.9501,24.8416,436,38107,0.229043,0.03,1,194258,193822,436
9597081,35.99,16.1683,463,38162,0.197809,0,1,194299,193836,463
9600001,43.998,36.8337,467,38217,0.159562,0.03,1,194345,193878,467
9602921,43.9996,43.3667,466,38272,0.167912,0.07,1,194389,193923,466
9605841,48.7999,42.2733,474,38327,0.185582,0.09,1,194439,193965,474
9608761,48.96,47.6547,474,38382,0.189116,0.13,1,194488,194014,474
9611681,37.792,47.1309,462,38437,0.221823,0.17,1,194523,194061,462
9614601,48.3584,35.8262,480,38492,0.228365,0.21,1,194574,194094,480
9617521,41.6717,47.9652,469,38547,0.229673,0.19,1,194614,194145,469
9620441,17.9343,40.793,442,38602,0.245935,0.19,1,194626,194184,442
9623361,5.18687,17.7586,432,38657,0.249187,0.21,1,194628,194196,432
9626281,20.2374,22.7517,432,38712,0.249837,0.23,1,194652,194220,432
9629201,24.0475,23.7503,433,38767,0.313967,0.23,1,194677,194244,433
9632121,16.8095,15.9501,434,38821,0.326793,0.19,1,194692,194258,434
9635041,33.7619,35.99,431,38875,0.361359,0.15,1,194730,194299,431
9637961,41.9524,43.998,429,38929,0.336272,0.17,1,194774,194345,429
9640881,45.1905,43.9996,431,38983,0.331254,0.19,1,194820,194389,431
9643801,49.8381,48.7999,432,39037,0.362251,0.19,1,194871,194439,432
9646721,48.3676,48.96,431,39091,0.36845,0.23,1,194919,194488,431
9649641,39.2735,37.792,433,39145,0.44969,0.23,1,194956,194523,433
9652561,48.6547,48.3584,433,39199,0.417938,0.23,1,195007,194574,433
9655481,42.5309,41.6717,434,39253,0.443588,0.25,1,195048,194614,434
9658401,18.1062,17.9343,434,39307,0.416717,0.25,1,195060,194626,434
9661321,5.22124,5.18687,434,39361,0.443344,0.25,1,195062,194628,434
9664241,21.0442,20.2374,435,39415,0.432669,0.33,1,195087,194652,435
9667161,25.8088,24.0475,437,39469,0.446534,0.33,1,195114,194677,437
9670081,17.9618,16.8095,438,39523,0.481307,0.37,1,195130,194692,438
9673001,33.9924,33.7619,438,39576,0.472261,0.33,1,195168,194730,438
9675921,41.9985,41.9524,438,39629,0.518452,0.33,1,195212,194774,438
9678841,43.5997,45.1905,436,39682,0.49569,0.37,1,195256,194820,436
9681761,52.7199,49.8381,440,39735,0.507138,0.37,1,195311,194871,440
9684681,49.744,48.3676,441,39788,0.541428,0.47,1,195360,194919,441
9687601,41.1488,39.2735,443,39841,0.580286,0.41,1,195399,194956,443
9690521,48.2298,48.6547,442,39894,0.588057,0.45,1,195449,195007,442
9693441,42.446,42.5309,442,39947,0.589611,0.41,1,195490,195048,442
9696361,18.0892,18.1062,442,40000,0.621922,0.45,1,195502,195060,442
9699281,5.21784,5.22124,442,40053,0.596384,0.43,1,195504,195062,442
9702201,20.2436,21.0442,441,40106,0.623277,0.43,1,195528,195087,441
9705121,27.2487,4.20885,470,40159,0.580655,0.45,1,195557,195087,470
9708041,19.0497,22.4418,460,40212,0.588131,0.49,1,195574,195114,460
9710961,35.0099,17.2884,483,40265,0.589626,0.47,1,195613,195130,483
9713881,42.202,33.8577,489,40317,0.589925,0.53,1,195657,195168,489
9716801,44.4404,41.9715,490,40369,0.605985,0.49,1,195702,195212,490
9719721,52.8881,43.5943,501,40421,0.641197,0.51,1,195757,195256,501
9722641,51.3776,52.7189,497,40473,0.648239,0.55,1,195808,195311,497
9725561,41.4755,49.7438,487,40525,0.665648,0.59,1,195847,195360,487
9728481,49.0951,41.1488,499,40577,0.71713,0.59,1,195898,195399,499
9731401,43.419,48.2298,491,40629,0.727426,0.59,1,195940,195449,491
9734321,18.2838,42.4459,462,40681,0.729485,0.63,1,195952,195490,462
9737241,5.25676,18.0892,452,40733,0.729897,0.59,1,195954,195502,452
9740161,20.2514,5.21784,474,40785,0.745979,0.63,1,195978,195504,474
9743081,27.2503,20.2436,479,40837,0.765196,0.57,2,196007,195528,479
9746001,19.0501,27.2487,467,40889,0.769039,0.59,2,196024,195557,467
9748921,35.01,19.0497,489,40941,0.801808,0.59,2,196063,195574,489
9751841,42.202,35.0099,494,40993,0.808362,0.59,2,196107,195613,494
9754761,45.2404,42.202,496,41044,0.809672,0.61,2,196153,195657,496
9757681,54.6481,44.4404,508,41095,0.841934,0.65,2,196210,195702,508
9760601,52.5296,52.8881,505,41146,0.880387,0.65,2,196262,195757,505
9763521,42.5059,51.3776,494,41197,0.856077,0.67,2,196302,195808,494
9766441,50.9012,41.4755,508,41248,0.899215,0.73,2,196355,195847,508
9769361,43.7802,49.0951,499,41299,0.923843,0.73,2,196397,195898,499
9772281,19.156,43.419,470,41350,0.912769,0.73,2,196410,195940,470
9775201,5.43121,18.2838,460,41401,0.910554,0.73,2,196412,195952,460
9778121,20.2862,5.25676,482,41452,0.910111,0.75,2,196436,195954,482
9781041,26.4572,20.2514,486,41503,0.910022,0.77,2,196464,195978,486
9783961,6.89145,27.2503,459,41554,0.910004,0.77,2,196466,196007,459
9786881,15.7783,19.0501,460,41605,0.942001,0.81,2,196484,196024,460
9982521,25,23,493,44876,0.77,1,2,198835,198342,493
9985441,21.8,24.6,489,44923,0.754,1,2,198856,198367,489
9988361,33.16,15.32,512,44970,0.5748,1,1,198892,198380,512
9991281,25.832,14.264,522,45017,0.49096,1,1,198916,198394,522
9994201,25.9664,17.2528,530,45064,0.410192,1,1,198942,198412,530
9997121,13.9933,24.2506,515,45111,0.362038,1,1,198953,198438,515
10000041,5.19866,25.6501,492,45158,0.352408,1,1,198956,198464,492
10002961,21.8397,22.73,496,45205,0.222482,1,1,198982,198486,496
10005881,27.5679,27.746,496,45252,0.116496,1,1,199011,198515,496
10008801,45.5136,53.5492,486,45299,0.0952993,0.99,1,199061,198575,486
10011721,53.9027,45.9098,498,45346,0.0430599,1,1,199117,198619,498
10014641,34.7805,50.782,476,45393,0.096612,0.96,1,199147,198671,476
10017561,38.1561,42.1564,475,45439,0.0593224,0.95,1,199186,198711,475
10020481,59.6312,63.6313,471,45485,0.0998645,0.87,1,199251,198780,471
10023401,30.3262,36.7263,464,45531,0.0439729,0.77,1,199274,198810,464
10026321,23.6652,27.3453,461,45577,0.0327946,0.75,1,199296,198835,461
10029241,18.333,22.2691,457,45623,0.0625589,0.53,1,199313,198856,457
10032161,24.4666,33.2538,447,45669,0.100512,0.47,1,199339,198892,447
10035081,19.2933,25.8508,441,45715,0.0921024,0.39,1,199357,198916,441
10038001,22.2587,25.9702,438,45761,0.0744205,0.35,1,199380,198942,438
10040921,13.2517,13.994,438,45807,0.0868841,0.35,1,199391,198953,438
10043841,4.25035,5.19881,437,45853,0.0893768,0.19,1,199393,198956,437
10046761,16.0501,21.8398,430,45899,0.105875,0.09,1,199412,198982,430
10049681,20.81,27.568,423,45945,0.0771751,0.09,1,199434,199011,423
10052601,43.362,5.51359,472,45991,0.055435,0.09,1,199483,199011,472
10055521,53.4724,41.1027,478,46037,0.051087,0.03,1,199539,199061,478
10058441,35.4945,53.0205,453,46083,0.0342174,0.11,1,199570,199117,453
10061361,37.4989,34.6041,461,46129,0.0468435,0.05,1,199608,199147,461
10064281,59.4998,38.1208,487,46175,0.0653687,0.11,1,199673,199186,487
10067201,30.3,59.6242,445,46221,0.0850737,0.03,1,199696,199251,445
10070121,23.66,30.3248,444,46267,0.121015,0.03,1,199718,199274,444
10073041,22.332,23.665,444,46313,0.096203,0.07,1,199740,199296,444
10075961,22.8664,18.333,450,46359,0.0912406,0.11,1,199763,199313,450
10078881,21.3733,24.4666,445,46404,0.106248,0.09,1,199784,199339,445
10081801,20.2747,19.2933,447,46449,0.10925,0.07,1,199804,199357,447
10084721,13.6549,22.2587,436,46494,0.10985,0.09,1,199816,199380,436
10087641,4.33099,13.2517,427,46539,0.10997,0.09,1,199818,199391,427
10090561,15.2662,4.25035,443,46584,0.109994,0.11,1,199836,199393,443
10093481,18.2532,16.0501,443,46629,0.125999,0.07,1,199855,199412,443
10096401,42.8506,20.81,470,46674,0.0811998,0.05,1,199904,199434,470
10099321,53.3701,43.362,477,46719,0.07224,0.05,1,199960,199483,477
10102241,36.274,53.4724,453,46764,0.054448,0.03,1,199992,199539,453
10105161,40.0548,35.4945,463,46809,0.0508896,0.05,1,200033,199570,463
10108081,59.211,37.4989,489,46854,0.0661779,0.07,1,200097,199608,489
10111001,31.8422,59.4998,449,46899,0.0692356,0.09,1,200122,199673,449
10113921,24.7684,30.3,449,46944,0.117847,0.13,1,200145,199696,449
10116841,20.9537,23.66,447,46989,0.127569,0.09,1,200165,199718,447
10119761,22.5907,22.332,448,47034,0.113514,0.09,1,200188,199740,448
10122681,22.1181,22.8664,447,47079,0.126703,0.11,1,200210,199763,447
10125601,20.4236,21.3733,446,47124,0.145341,0.11,1,200230,199784,446
10128521,13.6847,20.2747,438,47169,0.149068,0.11,1,200242,199804,438
10131441,4.33695,13.6549,428,47214,0.149814,0.11,1,200244,199816,428
10134361,15.2674,4.33099,444,47259,0.149963,0.11,1,200262,199818,444
10137281,17.4535,15.2662,444,47304,0.181993,0.13,1,200280,199836,444
10140201,41.8907,18.2532,473,47349,0.188398,0.07,1,200328,199855,473
10143121,51.5781,42.8506,478,47394,0.15768,0.07,1,200382,199904,478
10146041,11.9156,53.3701,424,47438,0.151536,0.05,1,200384,199960,424
10148961,27.9831,36.274,424,47482,0.230307,0.05,1,200416,199992,424
10151881,38.3966,40.0548,424,47526,0.358061,0.07,1,200457,200033,424
10154801,59.6793,59.211,425,47570,0.415612,0.07,1,200522,200097,425
10157721,33.5359,31.8422,427,47614,0.411122,0.13,1,200549,200122,427
10160641,25.9072,24.7684,428,47658,0.442225,0.13,1,200573,200145,428
10163561,21.1814,20.9537,428,47702,0.432445,0.11,1,200593,200165,428
10166481,22.6363,22.5907,428,47746,0.462489,0.13,1,200616,200188,428
10169401,22.9273,22.1181,429,47790,0.500498,0.15,1,200639,200210,429
10172321,20.5855,20.4236,429,47834,0.5241,0.15,1,200659,200230,429
10175241,13.7171,13.6847,429,47878,0.52882,0.15,1,200671,200242,429
10178161,4.34342,4.33695,429,47922,0.561764,0.15,1,200673,200244,429
10181081,16.8687,15.2674,431,47966,0.552353,0.19,1,200693,200262,431
10184001,17.7737,17.4535,431,48010,0.550471,0.19,1,200711,200280,431
10186921,41.9547,41.8907,431,48054,0.582094,0.15,1,200759,200328,431
10189841,50.791,51.5781,430,48098,0.572419,0.15,1,200812,200382,430
10192761,11.7582,11.9156,430,48142,0.570484,0.25,1,200814,200384,430
10195681,29.5516,27.9831,432,48186,0.586097,0.39,1,200848,200416,432
10198601,45.9103,38.3966,441,48230,0.637219,0.43,1,200898,200457,441
10201521,62.7821,59.6793,443,48274,0.727444,0.41,1,200965,200522,443
10204441,33.3564,33.5359,442,48318,0.745489,0.45,1,200991,200549,442
10207361,25.8713,25.9072,442,48362,0.749098,0.43,1,201015,200573,442
10210281,22.7743,21.1814,444,48406,0.74982,0.47,1,201037,200593,444
10213201,24.5549,22.6363,446,48450,0.749964,0.51,1,201062,200616,446
10216121,24.111,22.9273,447,48493,0.813993,0.53,2,201086,200639,447
10219041,21.6222,20.5855,448,48536,0.810799,0.53,2,201107,200659,448
10221961,14.7244,13.7171,449,48579,0.82616,0.57,2,201120,200671,449
10224881,4.54489,4.34342,449,48622,0.829232,0.55,2,201122,200673,449
10227801,16.909,16.8687,449,48665,0.829846,0.55,2,201142,200693,449
10230721,17.7818,17.7737,449,48708,0.797969,0.59,2,201160,200711,449
10233641,41.9564,41.9547,449,48751,0.807594,0.57,2,201208,200759,449
10236561,49.9913,50.791,448,48794,0.841519,0.57,2,201260,200812,448
10239481,11.5983,11.7582,448,48837,0.848304,0.57,2,201262,200814,448
10242401,29.5197,2.35164,482,48880,0.817661,0.59,2,201296,200814,482
10423441,27,24,514,51484,0.61,1,1,203143,202629,514
10426361,30.2,19.2,527,51525,0.562,1,1,203174,202647,527
10429281,17.24,34.24,503,51566,0.4884,1,1,203188,202685,503
10432201,21.848,34.048,492,51607,0.37768,1,1,203211,202719,492
10435121,27.5696,26.8096,496,51648,0.307536,1,1,203240,202744,496
10438041,27.9139,30.1619,493,51689,0.197507,1,1,203268,202775,493
10440961,26.3828,30.0324,489,51730,0.159501,1,1,203294,202805,489
10443881,41.2766,44.4065,486,51771,0.0319003,1,1,203339,202853,486
10446801,29.0553,8.8813,512,51812,0.0783801,1,1,203365,202853,512
10449721,32.2111,34.5763,504,51853,0.071676,0.96,1,203398,202894,504
10452641,32.0422,34.1153,502,51894,0.0383352,0.91,1,203430,202928,502
10455561,28.8084,32.4231,498,51935,0.015667,1,1,203458,202960,498
10458481,24.9617,28.8846,494,51976,0.0271334,0.95,1,203482,202988,494
10461401,28.1923,26.5769,497,52017,0.0294267,0.95,1,203511,203014,497
10464321,27.2385,28.5154,495,52057,0.0618853,0.91,1,203538,203043,495
10467241,11.8477,31.3031,471,52097,0.0363771,0.85,1,203546,203075,471
10470161,21.5695,17.4606,481,52137,0.0312754,0.71,1,203570,203089,481
10473081,21.9139,25.0921,476,52177,0.0302551,0.61,1,203592,203116,476
10476001,25.9828,26.6184,476,52217,0.046051,0.55,1,203619,203143,476
10478921,14.7966,30.1237,457,52257,0.0172102,0.47,1,203631,203174,457
10481841,18.1593,17.2247,462,52297,0.011442,0.35,1,203650,203188,462
10484761,21.2319,21.8449,461,52337,0.0262884,0.29,1,203672,203211,461
10487681,24.2464,27.569,457,52377,0.0292577,0.17,1,203697,203240,457
10490601,21.6493,27.9138,450,52417,0.0618515,0.15,1,203718,203268,450
10493521,40.3299,26.3828,469,52457,0.0523703,0,1,203763,203294,469
10496441,28.066,41.2766,449,52497,0.0504741,0.09,1,203788,203339,449
10499361,32.0132,29.0553,456,52537,0.0660948,0.07,1,203821,203365,456
10502281,30.4026,32.2111,453,52577,0.053219,0.03,1,203851,203398,453
10505201,28.4805,32.0422,449,52617,0.0506438,0.01,1,203879,203430,449
10508121,25.6961,28.8084,446,52657,0.0341288,0.03,1,203904,203458,446
10511041,29.1392,24.9617,452,52697,0.126826,0.03,1,203934,203482,452
10513961,26.6278,28.1923,449,52737,0.0973651,0.07,1,203960,203511,449
10516881,11.7256,27.2385,430,52777,0.091473,0.03,1,203968,203538,430
10519801,21.5451,11.8477,446,52817,0.0902946,0.03,1,203992,203546,446
10522721,22.709,21.5695,445,52857,0.106059,0.03,1,204015,203570,445
10525641,24.5418,21.9139,448,52897,0.141212,0.05,1,204040,203592,448
10528561,15.3084,25.9828,434,52937,0.132242,0.01,1,204053,203619,434
10531481,19.0617,14.7966,442,52977,0.130448,0.01,1,204073,203631,442
10534401,19.8123,18.1593,443,53017,0.0980897,0.03,1,204093,203650,443
10537321,25.5625,21.2319,448,53057,0.139618,0.03,1,204120,203672,448
10540241,22.7125,24.2464,445,53097,0.115924,0.07,1,204142,203697,445
10543161,40.5425,21.6493,469,53137,0.143185,0.05,1,204187,203718,469
10546081,27.3085,40.3299,448,53177,0.132637,0.05,1,204211,203763,448
10549001,30.2617,28.066,454,53217,0.162527,0.07,1,204242,203788,454
10551921,7.65234,32.0132,423,53257,0.168505,0.05,1,204244,203821,423
10554841,26.3305,30.4026,424,53297,0.121701,0.05,1,204275,203851,424
10557761,26.0661,28.4805,422,53336,0.0963402,0.03,1,204301,203879,422
10560681,26.8132,25.6961,424,53375,0.091268,0.15,1,204328,203904,424
10563601,30.1626,29.1392,425,53414,0.122254,0.09,1,204359,203934,425
10566521,27.6325,26.6278,426,53453,0.0804507,0.09,1,204386,203960,426
10569441,13.5265,11.7256,428,53492,0.0720901,0.09,1,204396,203968,428
10572361,18.7053,21.5451,424,53531,0.070418,0.11,1,204416,203992,424
10575281,26.1411,22.709,429,53570,0.134084,0.15,1,204444,204015,429
10578201,25.2282,24.5418,429,53609,0.162817,0.13,1,204469,204040,429
10581121,14.6456,15.3084,428,53648,0.136563,0.13,1,204481,204053,428
10584041,18.9291,19.0617,428,53687,0.163313,0.09,1,204501,204073,428
10586961,19.7858,19.8123,428,53726,0.168663,0.15,1,204521,204093,428
10589881,24.7572,25.5625,427,53765,0.217733,0.11,1,204547,204120,427
10592801,23.3514,22.7125,428,53804,0.211547,0.15,1,204570,204142,428
10595721,39.8703,40.5425,427,53843,0.210309,0.13,1,204614,204187,427
10598641,27.9741,27.3085,428,53882,0.194062,0.17,1,204639,204211,428
10601561,30.3948,30.2617,428,53921,0.206812,0.17,1,204670,204242,428
10604481,7.67896,7.65234,428,53960,0.177362,0.11,1,204672,204244,428
10607401,23.9358,26.3305,425,53999,0.171472,0.09,1,204700,204275,425
10610321,26.3872,26.0661,426,54038,0.234294,0.09,1,204727,204301,426
10613241,25.2774,26.8132,424,54077,0.198859,0.13,1,204752,204328,424
10616161,31.4555,30.1626,426,54116,0.239772,0.07,1,204785,204359,426
10619081,27.0911,27.6325,425,54155,0.279954,0.07,1,204811,204386,425
10622001,13.4182,13.5265,425,54194,0.287991,0.07,1,204821,204396,425
10624921,20.2836,18.7053,427,54233,0.289598,0.15,1,204843,204416,427
10627841,28.0567,26.1411,429,54272,0.32192,0.17,1,204873,204444,429
10630761,24.8113,25.2282,428,54311,0.328384,0.13,1,204897,204469,428
10633681,14.5623,14.6456,428,54350,0.329677,0.17,1,204909,204481,428
10636601,19.7125,18.9291,429,54389,0.361935,0.17,1,204930,204501,429
10639521,21.5425,19.7858,431,54428,0.368387,0.23,1,204952,204521,431
10642441,25.1085,24.7572,431,54467,0.369677,0.21,1,204978,204547,431
10645361,24.2217,23.3514,432,54506,0.369935,0.21,1,205002,204570,432
10648281,40.0443,39.8703,432,54545,0.385987,0.19,1,205046,204614,432
10651201,27.2089,27.9741,431,54584,0.389197,0.21,1,205070,204639,431
10654121,29.4418,30.3948,430,54623,0.389839,0.17,1,205100,204670,430
10657041,7.48835,7.67896,430,54662,0.389968,0.17,1,205102,204672,430
10659961,23.8977,23.9358,430,54700,0.405994,0.17,1,205130,204700,430
10662881,27.1795,4.78716,458,54738,0.409199,0.25,1,205158,204700,458
10665801,24.6359,22.5574,455,54776,0.44184,0.19,1,205182,204727,455
10668721,32.9272,24.5115,465,54814,0.432368,0.25,1,205217,204752,465
10671641,29.7854,31.3023,461,54852,0.478474,0.29,1,205246,204785,461
10674561,13.9571,27.0605,445,54890,0.487695,0.29,1,205256,204811,445
10677481,21.9914,13.4121,459,54928,0.489539,0.29,1,205280,204821,459
10680401,28.3983,20.2824,467,54966,0.505908,0.33,1,205310,204843,467
10683321,24.8797,28.0565,461,55004,0.525182,0.33,1,205334,204873,461
10686241,15.3759,24.8113,450,55042,0.513036,0.33,1,205347,204897,450
10689161,20.6752,14.5623,460,55080,0.510607,0.37,1,205369,204909,460
10692081,20.935,19.7125,460,55118,0.526121,0.37,1,205390,204930,460
10695001,25.787,21.5425,465,55156,0.513224,0.37,1,205417,204952,465
10697921,24.3574,25.1085,463,55194,0.542645,0.37,1,205441,204978,463
10700841,40.8715,24.2217,484,55232,0.532529,0.39,1,205486,205002,484
10703761,27.3743,40.0443,464,55270,0.530506,0.39,1,205510,205046,464
10706681,29.4749,27.2089,470,55308,0.546101,0.39,1,205540,205070,470
10709601,7.49497,29.4418,442,55346,0.54922,0.39,1,205542,205100,442
10712521,24.699,7.48835,469,55384,0.565844,0.41,1,205571,205102,469
10715441,27.3398,23.8977,469,55422,0.569169,0.41,1,205599,205130,469
10718361,26.268,27.1795,467,55460,0.569834,0.45,1,205625,205158,467
10721281,34.0536,24.6359,479,55498,0.585967,0.43,1,205661,205182,479
10724201,30.8107,32.9272,474,55536,0.589193,0.49,1,205691,205217,474
10727121,14.1621,29.7854,455,55574,0.589839,0.49,1,205701,205246,455
10730041,22.0324,13.9571,469,55612,0.621968,0.49,1,205725,205256,469
10732961,29.2065,21.9914,476,55650,0.628394,0.51,1,205756,205280,476
10735881,25.8413,28.3983,471,55688,0.613679,0.53,1,205781,205310,471
10738801,14.7683,24.8797,459,55726,0.610736,0.51,1,205793,205334,459
10741721,20.5537,15.3759,468,55764,0.610147,0.51,1,205815,205347,468
10744641,20.1107,20.6752,466,55802,0.626029,0.53,1,205835,205369,466
10747561,27.2221,20.935,474,55840,0.645206,0.51,1,205864,205390,474
10750481,25.4444,25.787,472,55878,0.633041,0.55,1,205889,205417,472
10753401,40.2889,24.3574,492,55916,0.646608,0.53,1,205933,205441,492
10756321,27.2578,40.8715,471,55954,0.665322,0.53,1,205957,205486,471
10759241,30.2516,27.3743,478,55992,0.701064,0.55,1,205988,205510,478
10762161,7.65031,29.4749,450,56030,0.708213,0.55,1,205990,205540,450
10765081,25.5301,7.49497,478,56068,0.709643,0.57,1,206020,205542,478
10768001,27.506,24.699,477,56106,0.725928,0.57,1,206048,205571,477
10770921,26.3012,27.3398,475,56143,0.729186,0.57,1,206074,205599,475
10773841,6.86024,26.268,451,56180,0.729837,0.59,1,206076,205625,451
10776761,30.172,34.0536,451,56217,0.777967,0.59,2,206112,205661,451
10779681,30.0344,30.8107,451,56254,0.755593,0.59,2,206142,205691,451
10782601,14.8069,14.1621,452,56291,0.783119,0.63,2,206153,205701,452
10785521,22.9614,22.0324,453,56328,0.788624,0.63,2,206178,205725,453
10788441,29.3923,29.2065,453,56365,0.821725,0.61,2,206209,205756,453
10791361,25.0785,25.8413,452,56402,0.828345,0.61,2,206233,205781,452
10794281,14.6157,14.7683,452,56439,0.829669,0.61,2,206245,205793,452
10797201,20.5231,20.5537,452,56476,0.845934,0.63,2,206267,205815,452
10800121,20.9046,20.1107,453,56513,0.833187,0.65,2,206288,205835,453
10803041,26.5809,27.2221,452,56550,0.878637,0.63,2,206316,205864,452
10805961,26.1162,25.4444,453,56587,0.887727,0.65,2,206342,205889,453
10808881,41.2232,40.2889,454,56624,0.857545,0.67,2,206387,205933,454
10811801,28.2446,27.2578,455,56661,0.867509,0.71,2,206412,205957,455
10826401,26,26,458,56846,0.91,0.73,2,206532,206074,458
10829321,6.8,6.8,458,56883,0.942,0.79,2,206534,206076,458
10832241,30.96,30.16,459,56920,0.9484,0.75,2,206571,206112,459
10835161,30.992,30.032,460,56957,0.94968,0.79,2,206602,206142,460
11138841,37,31,499,28618,0.01,1,1,209249,208750,499
11141761,54.6,59,492,28692,0.026,0.88,1,209308,208816,492
11144681,53.32,53.4,493,28766,0.0292,0.67,1,209361,208868,493
11147601,62.664,71.48,482,28840,0.01384,0.41,1,209426,208944,482
11150521,47.7328,67.096,460,28913,0.042768,0.11,1,209470,209010,460
11153441,40.7466,63.0192,437,28986,0.0325536,0.05,1,209509,209072,437
11156361,56.1493,59.8038,438,29059,0.00651072,0,1,209569,209131,438
11159281,30.4299,36.7608,431,29132,0.00930214,0,1,209593,209162,431
11162201,38.086,24.9522,449,29205,0.0418604,0.05,1,209633,209184,449
11165121,37.2172,27.3904,458,29277,0.0323721,0.01,1,209670,209212,458
11168041,55.4434,35.0781,481,29349,0.0304744,0.03,1,209730,209249,481
11170961,54.2887,54.2156,476,29421,0.0300949,0.03,1,209784,209308,476
11173881,62.0577,53.2431,487,29493,0.030019,0.01,1,209848,209361,487
11176801,50.0115,62.6486,469,29565,0.110004,0.05,1,209895,209426,469
11179721,38.0023,47.7297,460,29637,0.110001,0.03,1,209930,209470,460
11182641,56.4005,40.7459,482,29708,0.0220002,0,1,209991,209509,482
11185561,29.6801,56.1492,445,29779,0.0124,0.01,1,210014,209569,445
11188481,7.53602,30.4298,423,29850,0.02648,0.05,1,210016,209593,423
11191401,33.5072,38.086,423,29921,0.029296,0.03,1,210056,209633,423
11194321,35.5014,37.2172,422,29992,0.0618592,0.03,1,210092,209670,422
11197241,55.9003,55.4434,423,30063,0.0123718,0.03,1,210153,209730,423
11200161,53.5801,54.2887,422,30133,0.0264744,0.03,1,210206,209784,422
11203081,65.116,62.0577,426,30203,0.109295,0.13,1,210274,209848,426
11206001,52.2232,50.0115,428,30273,0.157859,0.11,1,210323,209895,428
11208921,36.0446,38.0023,425,30343,0.183572,0,1,210355,209930,425
11211841,54.4089,56.4005,423,30413,0.0607144,0.01,1,210414,209991,423
11214761,28.4818,29.6801,422,30483,0.148143,0.03,1,210436,210014,422
11217681,7.29636,7.53602,422,30552,0.165629,0.03,1,210438,210016,422
11220601,33.4593,33.5072,422,30621,0.105126,0.07,1,210478,210056,422
11223521,36.2919,35.5014,423,30690,0.0450251,0,1,210515,210092,423
11226441,55.2584,55.9003,422,30759,0.017005,0.03,1,210575,210153,422
11229361,53.4517,53.5801,422,30828,0.027401,0.13,1,210628,210206,422
11232281,68.2903,65.116,426,30897,0.0614802,0.17,1,210700,210274,426
11235201,54.4581,52.2232,428,30965,0.100296,0.19,1,210751,210323,428
11238121,37.2916,36.0446,429,31033,0.140059,0.03,1,210784,210355,429
11241041,49.0583,54.4089,422,31101,0.100012,0.17,1,210836,210414,422
11243961,32.2117,28.4818,428,31169,0.124002,0.17,1,210864,210436,428
11246881,8.04233,7.29636,428,31237,0.1288,0.09,1,210866,210438,428
11249801,28.8085,33.4593,422,31305,0.16176,0.09,1,210900,210478,422
11252721,36.1617,6.69185,460,31373,0.104352,0.03,1,210938,210478,460
11255641,53.6323,30.9384,481,31440,0.12487,0.01,1,210996,210515,481
11258561,53.1265,54.1877,474,31507,0.0329741,0.03,1,211049,210575,474
11261481,71.4253,53.2375,497,31574,0.0945948,0.07,1,211125,210628,497
11264401,56.6851,68.2475,478,31641,0.074919,0.11,1,211178,210700,478
11267321,38.537,54.4495,461,31708,0.0389838,0.15,1,211212,210751,461
11270241,45.3074,37.2899,475,31775,0.0797968,0.09,1,211259,210784,475
11273161,34.6615,49.058,455,31842,0.199959,0.13,1,211291,210836,455
11276081,8.5323,32.2116,429,31908,0.223992,0.13,1,211293,210864,429
11279001,28.9065,8.04232,461,31974,0.228798,0.17,1,211327,210866,461
11281921,34.5813,28.8085,463,32040,0.24576,0.09,1,211363,210900,463
11284841,54.1163,36.1617,484,32106,0.233152,0.13,1,211422,210938,484
11287761,50.0233,53.6323,475,32172,0.23063,0.01,1,211471,210996,475
11290681,72.4047,53.1265,500,32238,0.214126,0.11,1,211549,211049,500
11293601,56.8809,71.4253,477,32304,0.194825,0.07,1,211602,211125,477
11296521,36.9762,56.6851,456,32369,0.206965,0.03,1,211634,211178,456
11299441,47.3952,38.537,472,32434,0.241393,0.09,1,211684,211212,472
11302361,40.679,45.3074,464,32499,0.408279,0.23,1,211723,211259,464
11305281,9.73581,34.6615,434,32564,0.441656,0.23,1,211725,211291,434
11308201,29.1472,8.5323,466,32629,0.480331,0.23,1,211759,211293,466
11311121,35.4294,28.9065,469,32694,0.504066,0.25,1,211796,211327,469
11314041,53.4859,34.5813,491,32759,0.508813,0.23,1,211854,211363,491
11316961,12.2972,54.1163,434,32824,0.509763,0.23,1,211856,211422,434
11319881,40.8594,50.0233,433,32888,0.541952,0.21,1,211904,211471,433
11322801,69.7719,72.4047,432,32952,0.580391,0.19,1,211981,211549,432
11325721,56.3544,56.8809,432,33016,0.668078,0.21,1,212034,211602,432
11328641,36.8709,36.9762,432,33080,0.717616,0.25,1,212066,211634,432
11331561,49.7742,47.3952,435,33144,0.759523,0.45,2,212119,211684,435
11430841,51,61,524,35247,0.45,1,1,213576,213052,524
11433761,35,55.4,501,35307,0.274,1,1,213607,213106,501
11436681,28.6,41.48,490,35367,0.0628,1,1,213634,213144,490
11439601,39.32,22.696,514,35427,0.02056,1,1,213676,213162,514
11442521,57.464,32.5392,541,35487,0.076112,1,1,213738,213197,541
11445441,40.2928,60.1078,510,35547,0.0552224,1,1,213774,213264,510
11448361,40.8586,36.8216,520,35606,0.0190445,1,1,213815,213295,520
11451281,46.5717,32.9643,536,35665,0.0038089,1,1,213863,213327,536
11454201,29.3143,54.5929,501,35724,0.152762,1,1,213888,213387,501
11457121,26.6629,37.3186,494,35783,0.150552,0.89,1,213914,213420,494
11460041,26.1326,47.4637,470,35842,0.0301105,0.81,1,213940,213470,470
11462961,40.4265,53.4927,459,35901,0.0460221,0.45,1,213984,213525,459
11465881,34.4853,51.4985,441,35960,0.0332044,0.23,1,214017,213576,441
11468801,21.2971,35.0997,428,36019,0.0306409,0.01,1,214035,213607,428
11471721,21.0594,28.6199,422,36078,0.00612818,0.01,1,214056,213634,422
11474641,38.6119,39.324,423,36137,0.00922564,0.09,1,214099,213676,423
11477561,56.5224,57.4648,422,36195,0.0418451,0.05,1,214160,213738,422
11480481,40.1045,40.293,422,36253,0.032369,0.01,1,214196,213774,422
11483401,43.2209,40.8586,425,36311,0.0624738,0,1,214240,213815,425
11486321,55.0442,46.5717,435,36369,0.0364948,0.19,1,214298,213863,435
11489241,27.0088,29.3143,430,36427,0.0632989,0.15,1,214318,213888,430
11492161,21.4018,26.6629,424,36485,0.0846598,0,1,214338,213914,424
11495081,23.4804,26.1326,422,36543,0.120932,0.05,1,214362,213940,422
11498001,39.8961,40.4265,422,36601,0.0801864,0.03,1,214406,213984,422
11500921,35.1792,34.4853,423,36659,0.0400373,0.03,1,214440,214017,423
11503841,20.6358,21.2971,422,36717,0.0800075,0,1,214457,214035,422
11506761,20.9272,21.0594,422,36775,0.0160015,0.01,1,214478,214056,422
11509681,38.5854,38.6119,422,36832,0.0112003,0.05,1,214521,214099,422
11512601,56.5171,56.5224,422,36889,0.0742401,0.03,1,214582,214160,422
11515521,40.1034,40.1045,422,36946,0.038848,0.07,1,214618,214196,422
11518441,45.6207,43.2209,425,37003,0.0477696,0.03,1,214665,214240,425
11521361,53.1241,55.0442,422,37060,0.0255539,0.07,1,214720,214298,422
11524281,26.6248,27.0088,422,37117,0.0291108,0.09,1,214740,214318,422
11527201,22.925,21.4018,424,37174,0.0138222,0.09,1,214762,214338,424
11530121,24.585,4.28035,449,37231,0.0427644,0.13,1,214787,214338,449
11533041,37.717,20.0561,466,37288,0.0485529,0.07,1,214828,214362,466
11535961,34.7434,39.2112,456,37345,0.0817106,0.03,1,214862,214406,456
11538881,19.7487,35.0422,438,37402,0.120342,0.09,1,214878,214440,438
11541801,22.3497,20.6084,444,37458,0.0240684,0,1,214901,214457,444
11544721,37.2699,20.9217,464,37514,0.0448137,0.01,1,214942,214478,464
11547641,56.254,38.5843,482,37570,0.0489627,0.09,1,215003,214521,482
11550561,40.0508,56.5169,457,37626,0.0497925,0.03,1,215039,214582,457
11553481,45.6102,40.1034,468,37682,0.0179585,0.05,1,215086,214618,468
11556401,53.122,45.6207,476,37738,0.0035917,0.02,1,215141,214665,476
11559321,26.6244,53.1241,441,37794,0.0407183,0.03,1,215161,214720,441
11562241,22.9249,26.6248,443,37850,0.0321437,0.01,1,215183,214740,443
11565161,26.185,22.925,448,37906,0.0304287,0.05,1,215210,214762,448
11568081,38.037,24.585,464,37962,0.0300857,0.05,1,215251,214787,464
11571001,36.4074,37.717,459,38018,0.0300171,0.09,1,215287,214828,459
11573921,20.0815,34.7434,441,38074,0.0460034,0.13,1,215303,214862,441
11576841,19.2163,19.7487,444,38129,0.00920069,0,1,215322,214878,444
11579761,36.6433,22.3497,462,38184,0.0258401,0.05,1,215363,214901,462
11582681,56.1287,37.2699,482,38239,0.013168,0.05,1,215424,214942,482
11585601,40.0257,56.254,457,38294,0.0266336,0.05,1,215460,215003,457
11588521,46.4051,40.0508,469,38349,0.0133267,0.01,1,215508,215039,469
11591441,52.481,45.6102,476,38404,0.00266534,0,1,215562,215086,476
11594361,26.4962,53.122,441,38459,0.00853307,0.05,1,215582,215141,441
11597281,23.6992,26.6244,444,38514,0.0417066,0.03,1,215605,215161,444
11600201,26.3398,22.9249,449,38569,0.0323413,0.03,1,215632,215183,449
11603121,6.86797,26.185,424,38624,0.0304683,0.03,1,215634,215210,424
11606041,33.3736,38.037,423,38679,0.0300937,0.03,1,215674,215251,423
11608961,36.2747,36.4074,424,38734,0.0140187,0.05,1,215711,215287,424
11611881,20.0549,20.0815,424,38789,0.0108037,0,1,215727,215303,424
11614801,17.611,19.2163,422,38843,0.00216075,0.03,1,215744,215322,422
11617721,37.1222,36.6433,423,38897,0.00843215,0.01,1,215786,215363,423
11620641,55.4244,56.1287,422,38951,0.00168643,0.03,1,215846,215424,422
11623561,39.8849,40.0257,422,39005,0.0403373,0.01,1,215882,215460,422
11626481,47.977,46.4051,424,39059,0.0160675,0,1,215932,215508,424
11629401,51.1954,52.481,422,39113,0.00321349,0.01,1,215984,215562,422
11632321,27.0391,26.4962,423,39167,0.0246427,0.05,1,216005,215582,423
11635241,24.6078,23.6992,424,39221,0.0449285,0.03,1,216029,215605,424
11638161,25.7216,26.3398,423,39275,0.0329857,0.03,1,216055,215632,423
11641081,6.74431,6.86797,423,39329,0.0625971,0.03,1,216057,215634,423
11644001,33.3489,33.3736,423,39383,0.0685194,0.01,1,216097,215674,423
11646921,35.4698,36.2747,422,39437,0.0857039,0.01,1,216133,215711,422
11649841,19.894,20.0549,422,39491,0.0571408,0,1,216149,215727,422
11652761,17.5788,17.611,422,39544,0.0114282,0.01,1,216166,215744,422
11655681,37.1158,37.1222,422,39597,0.0102856,0,1,216208,215786,422
11658601,55.4232,55.4244,422,39650,0.00205713,0.05,1,216268,215846,422
11661521,39.8846,39.8849,422,39703,0.0404114,0.01,1,216304,215882,422
11664441,49.5769,47.977,424,39756,0.0960823,0,1,216356,215932,424
11667361,49.9154,51.1954,422,39809,0.0192165,0.03,1,216406,215984,422
11670281,26.7831,27.0391,422,39862,0.0278433,0.05,1,216427,216005,422
11673201,24.5566,24.6078,422,39915,0.0135687,0.03,1,216451,216029,422
11676121,26.5113,25.7216,423,39968,0.0107137,0.07,1,216478,216055,423
11679041,6.90226,6.74431,423,40021,0.0101427,0.07,1,216480,216057,423
11681961,33.3805,33.3489,423,40074,0.0580285,0.07,1,216520,216097,423
11684881,33.8761,6.66977,457,40127,0.0356057,0.09,1,216554,216097,457
11687801,19.5752,30.134,437,40180,0.0311211,0.05,1,216570,216133,437
11690721,17.515,18.8268,438,40233,0.0142242,0,1,216587,216149,438
11693641,37.103,17.3654,463,40285,0.0108448,0.01,1,216629,216166,463
11696561,55.4206,37.0731,481,40337,0.026169,0,1,216689,216208,481
11699481,39.8841,55.4146,457,40389,0.0292338,0.05,1,216725,216268,457
11702401,55.1768,39.8829,480,40441,0.0298468,0.11,1,216784,216304,480
11705321,45.4354,49.5766,471,40493,0.0299694,0,1,216827,216356,471
11708241,25.8871,49.9153,442,40545,0.0299939,0.03,1,216848,216406,442
11711161,24.3774,26.7831,445,40597,0.0299988,0.01,1,216872,216427,445
11714081,26.4755,24.5566,448,40649,0.0299998,0.01,1,216899,216451,448
11717001,6.8951,26.5113,423,40701,0.03,0.01,1,216901,216478,423
11719921,34.179,6.90226,462,40753,0.062,0.07,1,216942,216480,462
11722841,34.0358,33.3805,456,40805,0.1004,0.03,1,216976,216520,456
11725761,19.6072,33.8761,438,40857,0.10808,0.03,1,216992,216554,438
11728681,16.7214,19.5752,438,40909,0.125616,0.01,1,217008,216570,438
11731601,36.9443,17.515,463,40961,0.0331232,0.01,1,217050,216587,463
11734521,55.3889,37.103,481,41013,0.0146246,0.03,1,217110,216629,481
11737441,39.8778,55.4206,457,41064,0.0429249,0.03,1,217146,216689,457
11740361,56.7756,39.8841,482,41115,0.048585,0.03,1,217207,216725,482
11743281,44.1551,55.1768,464,41166,0.081717,0.03,1,217248,216784,464
11746201,26.431,45.4354,443,41217,0.0403434,0.03,1,217270,216827,443
11749121,24.4862,25.8871,446,41268,0.0640687,0.03,1,217294,216848,446
11752041,26.4972,24.3774,449,41319,0.0688137,0.03,1,217321,216872,449
11754961,6.89945,26.4755,424,41370,0.0857627,0.03,1,217323,216899,424
11757881,35.7799,6.8951,465,41421,0.105153,0.07,1,217366,216901,465
11760801,35.956,34.179,460,41472,0.18103,0.11,1,217402,216942,460
11763721,19.9912,34.0358,442,41523,0.188206,0.11,1,217418,216976,442
11766641,5.59824,19.6072,428,41574,0.189641,0.13,1,217420,216992,428
11769561,9.11965,16.7214,422,41625,0.189928,0.01,1,217430,217008,422
11772481,35.4239,36.9443,422,41676,0.0939856,0.01,1,217472,217050,422
11775401,55.8848,55.3889,423,41727,0.0267971,0.05,1,217533,217110,423
11778321,39.177,39.8778,422,41778,0.0453594,0.05,1,217568,217146,422
11781241,57.4354,56.7756,423,41829,0.0330719,0.09,1,217630,217207,423
11784161,43.4871,44.1551,422,41879,0.0946144,0.03,1,217670,217248,422
11787081,27.8974,26.431,424,41929,0.0909229,0.07,1,217694,217270,424
11790001,25.5795,24.4862,425,41979,0.106185,0.07,1,217719,217294,425
11792921,27.5159,26.4972,426,42029,0.125237,0.09,1,217747,217321,426
11795841,7.10318,6.89945,426,42079,0.161047,0.11,1,217749,217323,426
11798761,36.6206,35.7799,427,42129,0.168209,0.2,1,217793,217366,427
11801681,39.3241,35.956,431,42179,0.201642,0.19,1,217833,217402,431
11804601,20.6648,19.9912,431,42229,0.208328,0.19,1,217849,217418,431
11807521,5.73296,5.59824,431,42279,0.209666,0.19,1,217851,217420,431
11810441,9.14659,9.11965,431,42329,0.177933,0.07,1,217861,217430,431
11813361,28.2293,35.4239,422,42379,0.219587,0.01,1,217894,217472,422
11816281,54.4459,55.8848,422,42429,0.0519173,0.05,1,217955,217533,422
11819201,38.8892,39.177,422,42479,0.0503835,0.03,1,217990,217568,422
11822121,57.3778,57.4354,422,42529,0.0500767,0.11,1,218052,217630,422
11825041,45.8756,43.4871,425,42579,0.0820153,0.09,1,218095,217670,425
11827961,28.3751,27.8974,425,42629,0.120403,0.11,1,218119,217694,425
11830881,26.475,25.5795,426,42679,0.160081,0.13,1,218145,217719,426
11833801,29.295,27.5159,428,42728,0.136016,0.17,1,218175,217747,428
11836721,7.459,7.10318,428,42777,0.131203,0.17,1,218177,217749,428
11839641,36.6918,36.6206,428,42826,0.194241,0.21,1,218221,217793,428
11842561,40.9384,39.3241,430,42875,0.302848,0.21,1,218263,217833,430
11845481,20.9877,20.6648,430,42924,0.37257,0.21,1,218279,217849,430
11848401,5.79753,5.73296,430,42973,0.386514,0.17,1,218281,217851,430
11851321,9.95951,9.14659,431,43022,0.373303,0.17,1,218292,217861,431
11854241,27.5919,1.82932,463,43071,0.338661,0.23,1,218324,217861,463
11857161,47.1184,26.7659,482,43120,0.267732,0.01,1,218376,217894,482
11860081,37.4237,54.1532,456,43169,0.221546,0.05,1,218411,217955,456
11863001,57.0847,38.8306,483,43218,0.164309,0.05,1,218473,217990,483
11865921,48.2169,57.3661,467,43267,0.136862,0.09,1,218519,218052,467
11868841,31.2434,45.8732,451,43316,0.131372,0.13,1,218546,218095,451
11871761,27.0487,28.3746,453,43365,0.146274,0.17,1,218572,218119,453
11874681,29.4097,26.4749,457,43414,0.165255,0.13,1,218602,218145,457
11877601,7.48195,29.295,429,43463,0.169051,0.13,1,218604,218175,429
11880521,39.0964,7.459,474,43512,0.16981,0.21,1,218651,218177,474
11883441,47.0193,36.6918,479,43560,0.201962,0.33,1,218700,218221,479
11886361,23.0039,40.9384,454,43608,0.224392,0.39,1,218717,218263,454
11889281,6.20077,20.9877,440,43656,0.228878,0.39,1,218719,218279,440
11892201,9.24015,5.79753,448,43704,0.229776,0.37,1,218729,218281,448
11895121,27.448,9.95951,469,43752,0.229955,0.33,1,218761,218292,469
11898041,42.2896,27.5919,483,43800,0.261991,0.25,1,218807,218324,483
11900961,36.4579,47.1184,466,43848,0.252398,0.21,1,218842,218376,466
11903881,54.4916,37.4237,490,43896,0.25048,0.15,1,218901,218411,490
11906801,46.8983,57.0847,473,43944,0.250096,0.13,1,218946,218473,473
11909721,31.7797,48.2169,455,43992,0.218019,0.13,1,218974,218519,455
11912641,27.1559,31.2434,454,44040,0.211604,0.15,1,219000,218546,454
11915561,30.2312,27.0487,459,44088,0.194321,0.17,1,219031,218572,459
11918481,7.64624,29.4097,431,44136,0.190864,0.17,1,219033,218602,431
11921401,41.5292,7.48195,479,44184,0.302173,0.17,1,219083,218604,479
11924321,46.7059,39.0964,480,44232,0.308435,0.21,1,219131,218651,480
11927241,23.7412,47.0193,449,44280,0.309687,0.23,1,219149,218700,449
11930161,6.34823,23.0039,434,44328,0.309937,0.23,1,219151,218717,434
11933081,9.26965,6.20077,442,44376,0.309987,0.23,1,219161,218719,442
11936001,27.4539,9.24015,464,44424,0.325998,0.23,1,219193,218729,464
11938921,7.09079,27.448,434,44471,0.329199,0.27,1,219195,218761,434
11941841,39.0182,42.2896,435,44518,0.39384,0.25,1,219242,218807,435
11944761,35.0036,36.4579,434,44565,0.406768,0.25,1,219276,218842,434
11947681,54.2007,54.4916,434,44612,0.425354,0.25,1,219335,218901,434
11950601,46.8401,46.8983,434,44659,0.413071,0.21,1,219380,218946,434
11953521,30.168,31.7797,432,44706,0.394614,0.21,1,219406,218974,432
11956441,26.8336,27.1559,432,44753,0.422923,0.19,1,219432,219000,432
11959361,30.1667,30.2312,432,44800,0.412585,0.19,1,219463,219031,432
11962281,7.63334,7.64624,432,44847,0.410517,0.33,1,219465,219033,432
11965201,45.5267,41.5292,437,44894,0.506103,0.31,1,219520,219083,437
11968121,47.5053,46.7059,437,44941,0.541221,0.31,1,219568,219131,437
11971041,23.9011,23.7412,437,44988,0.516244,0.31,1,219586,219149,437
11973961,6.38021,6.34823,437,45035,0.543249,0.31,1,219588,219151,437
11976881,9.27604,9.26965,437,45082,0.51665,0.33,1,219598,219161,437
11979801,28.2552,27.4539,438,45129,0.49533,0.33,1,219631,219193,438
11982721,7.25104,7.09079,438,45176,0.491066,0.41,1,219633,219195,438
11985641,40.6502,39.0182,440,45223,0.554213,0.41,1,219682,219242,440
11988561,36.13,35.0036,441,45270,0.566843,0.43,1,219717,219276,441
11991481,54.426,54.2007,441,45317,0.585369,0.41,1,219776,219335,441
11994401,46.8852,46.8401,441,45364,0.605074,0.39,1,219821,219380,441
11997321,30.177,30.168,441,45410,0.641015,0.43,1,219847,219406,441
12000241,26.8354,26.8336,441,45456,0.648203,0.41,1,219873,219432,441
12003161,30.9671,30.1667,442,45502,0.633641,0.41,1,219905,219463,442
12006081,7.79342,7.63334,442,45548,0.630728,0.53,1,219907,219465,442
12009001,49.5587,45.5267,447,45594,0.726146,0.55,1,219967,219520,447
12011921,48.3117,47.5053,447,45640,0.753229,0.51,2,220015,219568,447
12014841,24.0623,23.9011,447,45686,0.806646,0.55,2,220033,219586,447
12017761,6.41247,6.38021,447,45732,0.833329,0.51,2,220035,219588,447
12020681,9.28249,9.27604,447,45778,0.806666,0.49,2,220045,219598,447
12023601,27.4565,28.2552,446,45824,0.793333,0.49,2,220077,219631,446
12026521,7.0913,7.25104,446,45870,0.822667,0.57,2,220079,219633,446
12029441,42.2183,40.6502,448,45916,0.796533,0.57,2,220130,219682,448
12032361,37.2437,8.13004,484,45962,0.807307,0.57,2,220166,219682,484
12035281,55.4487,29.626,509,46008,0.841461,0.59,2,220226,219717,509
12038201,47.8897,53.1252,496,46054,0.848292,0.61,2,220272,219776,496
12041121,30.3779,46.625,477,46100,0.865658,0.65,2,220298,219821,477
12044041,26.8756,30.125,477,46146,0.869132,0.65,2,220324,219847,477
12046961,31.7751,26.825,484,46192,0.885826,0.63,2,220357,219873,484
12049881,7.95502,30.965,454,46238,0.889165,0.63,2,220359,219905,454
12052801,52.791,7.793,516,46284,0.905833,0.75,2,220423,219907,516
12204641,32,25,519,48596,0.87,1,2,222021,221502,519
12206101,28.8,27.4,519,48639,0.758,1,2,222049,221530,519
12257201,397.76,450.28,453,21900,0.1596,0.43,1,222539,222086,453
12260121,156.352,149.256,475,22724,0.07192,0.25,1,222635,222160,475
12263041,70.4704,91.4512,447,22817,0.070384,0.13,1,222684,222237,447
12265961,31.6941,46.2902,434,22910,0.0700768,0.03,1,222706,222272,434
12268881,75.1388,62.858,453,23003,0.0380154,0.01,1,222792,222339,453
12271801,56.6278,50.9716,457,23095,0.0316031,0.05,1,222844,222387,457
12274721,77.7256,86.9943,444,23187,0.0463206,0.03,1,222927,222483,444
12277641,25.9451,35.7989,434,23278,0.0652641,0.01,1,222940,222506,434
12280561,99.589,33.5598,519,23369,0.0850528,0.05,1,223058,222539,519
12283481,61.5178,83.512,475,23460,0.121011,0.07,1,223110,222635,475
12286401,26.7036,55.9024,444,23550,0.128202,0.07,1,223128,222684,444
12289321,74.1407,28.7805,508,23640,0.0656404,0.03,1,223214,222706,508
12292241,57.2281,74.5561,475,23730,0.0211281,0.03,1,223267,222792,475
12295161,77.8456,56.5112,506,23819,0.0282256,0.05,1,223350,222844,506
12298081,24.3691,77.7022,434,23908,0.0456451,0.07,1,223361,222927,434
12301001,6.47382,25.9404,423,23997,0.049129,0.09,1,223363,222940,423
12303921,98.0948,99.5881,426,24085,0.0818258,0.13,1,223484,223058,426
12306841,62.819,61.5176,428,24173,0.104365,0.13,1,223538,223110,428
12309761,26.9638,26.7035,428,24261,0.108873,0.05,1,223556,223128,428
12312681,70.1928,74.1407,423,24348,0.0457746,0.01,1,223637,223214,423
12315601,56.4386,57.2281,423,24435,0.0331549,0.03,1,223690,223267,423
12318521,77.6877,77.8456,423,24522,0.046631,0.05,1,223773,223350,423
12321441,24.3375,24.3691,423,24608,0.0653262,0.05,1,223784,223361,423
12324361,6.46751,6.47382,423,24694,0.0690652,0.09,1,223786,223363,423
12327281,98.8935,98.0948,424,24780,0.069813,0.11,1,223908,223484,424
12330201,63.7787,62.819,425,24866,0.133963,0.11,1,223963,223538,425
12333121,27.1557,26.9638,425,24951,0.146793,0.03,1,223981,223556,425
12336041,67.8311,70.1928,422,25036,0.181359,0.03,1,224059,223637,422
12338961,55.9662,56.4386,422,25121,0.0922717,0.05,1,224112,223690,422
12341881,79.1932,77.6877,424,25205,0.0264543,0.07,1,224197,223773,424
12344801,24.6386,24.3375,424,25289,0.0292909,0.07,1,224208,223784,424
12347721,6.52773,6.46751,424,25373,0.0458582,0.07,1,224210,223786,424
12350641,99.7055,98.8935,425,25457,0.0971716,0.07,1,224333,223908,425
12353561,64.7411,19.7787,481,25540,0.171434,0.15,1,224389,223908,481
12356481,27.3482,47.9557,444,25623,0.202287,0.15,1,224407,223963,444
12359401,67.8696,23.9911,504,25706,0.224457,0.19,1,224485,223981,504
12362321,52.7739,67.1982,475,25788,0.212891,0.07,1,224534,224059,475
12365241,77.7548,55.8396,506,25870,0.162578,0.01,1,224618,224112,506
12368161,26.751,79.1679,435,25952,0.152516,0.03,1,224632,224197,435
12371081,6.95019,24.6336,426,26034,0.118503,0.05,1,224634,224208,426
12374001,101.39,6.52672,549,26115,0.0957006,0.11,1,224759,224210,549
12376921,69.078,99.7053,487,26196,0.12314,0.19,1,224820,224333,487
12379841,28.2156,64.7411,449,26277,0.160628,0.21,1,224838,224389,449
12382761,68.8431,27.3482,510,26358,0.280126,0.23,1,224917,224407,510
12385681,52.1686,67.8696,480,26438,0.320025,0.21,1,224965,224485,480
12388601,75.2337,52.7739,512,26518,0.328005,0.15,1,225046,224534,512
12391521,25.4467,77.7548,441,26598,0.345601,0.15,1,225059,224618,441
12394441,6.68935,26.751,429,26678,0.31712,0.11,1,225061,224632,429
12397361,99.7379,6.95019,550,26757,0.359424,0.09,1,225184,224634,550
12400281,71.9476,101.39,490,26836,0.383885,0.13,1,225249,224759,490
12403201,29.5895,69.078,448,26915,0.404777,0.17,1,225268,224820,448
12406121,7.5179,28.2156,432,26994,0.408955,0.31,1,225270,224838,432
12409041,68.7036,68.8431,437,27072,0.441791,0.33,1,225354,224917,437
12411961,52.9407,52.1686,438,27150,0.432358,0.33,1,225403,224965,438
12414881,75.3881,75.2337,438,27228,0.446472,0.35,1,225484,225046,438
12417801,24.6776,25.4467,437,27306,0.497294,0.31,1,225496,225059,437
12420721,6.53553,6.68935,437,27384,0.507459,0.37,1,225498,225061,437
12423641,102.107,99.7379,440,27461,0.557492,0.39,1,225624,225184,440
12426561,74.8214,71.9476,443,27538,0.631498,0.41,1,225692,225249,443
12429481,29.3643,29.5895,442,27615,0.6463,0.41,1,225710,225268,442
12432401,7.47286,7.5179,442,27692,0.64926,0.45,1,225712,225270,442
12435321,68.6946,68.7036,442,27768,0.665852,0.43,1,225796,225354,442
12438241,53.7389,52.9407,443,27844,0.71717,0.45,1,225846,225403,443
12441161,77.1478,75.3881,445,27920,0.727434,0.51,1,225929,225484,445
12444081,25.0296,24.6776,445,27996,0.745487,0.51,1,225941,225496,445
12447001,6.60591,6.53553,445,28072,0.781097,0.57,2,225943,225498,445
12449921,106.121,102.107,450,28147,0.75622,0.65,2,226074,225624,450
12452841,77.2242,74.8214,452,28222,0.783244,0.65,2,226144,225692,452
12455761,29.8448,29.3643,452,28297,0.836649,0.65,2,226162,225710,452
12458681,7.56897,7.47286,452,28372,0.81533,0.65,2,226164,225712,452
12461601,70.3138,1.49457,538,28447,0.859066,0.67,2,226250,225712,538
12464521,54.8628,67.4989,505,28521,0.899813,0.73,2,226301,225796,505
12484961,2,18,463,29036,0.91,0.81,2,226625,226162,463
12595921,32,62,503,31687,0.65,1,1,228537,228034,503
12598841,24.8,28.4,506,31754,0.57,1,1,228560,228054,506
12601761,50.56,23.28,541,31821,0.538,1,1,228617,228076,541
12604681,58.912,58.256,535,31887,0.3716,1,1,228678,228143,535
12607601,46.9824,62.0512,516,31953,0.33832,0.99,1,228722,228206,516
12610521,34.1965,38.8102,514,32019,0.347664,1,1,228753,228239,514
12613441,30.0393,45.362,496,32085,0.301533,1,1,228782,228286,496
12616361,26.8079,28.2724,498,32151,0.324307,1,1,228808,228310,498
12619281,86.9616,24.0545,577,32217,0.360861,0.79,1,228910,228333,577
12622201,60.5923,96.0109,517,32283,0.336172,0.67,1,228964,228447,517
12625121,36.9185,65.6022,490,32349,0.395234,0.65,1,228995,228505,490
12628041,21.7837,38.7204,476,32414,0.375047,0.55,1,229013,228537,476
12630961,41.9567,26.1441,500,32479,0.355009,0.53,1,229060,228560,500
12633881,53.1913,50.8288,499,32544,0.367002,0.33,1,229116,228617,499
12636801,45.0383,58.9658,481,32609,0.3854,0.33,1,229159,228678,481
12639721,33.8077,46.9932,468,32674,0.40508,0.35,1,229190,228722,468
12642641,30.7615,34.1986,467,32739,0.409016,0.29,1,229220,228753,467
12645561,7.75231,30.0397,440,32804,0.441803,0.33,1,229222,228782,440
12648481,22.3505,26.8079,440,32868,0.480361,0.37,1,229248,228808,440
12651401,86.0701,86.9616,440,32932,0.536072,0.33,1,229350,228910,440
12654321,58.814,60.5923,438,32996,0.611214,0.41,1,229402,228964,438
12657241,38.1628,36.9185,440,33060,0.658243,0.37,1,229435,228995,440
12660161,22.0326,21.7837,440,33124,0.667649,0.35,1,229453,229013,440
12663081,42.0065,41.9567,440,33188,0.66953,0.37,1,229500,229060,440
12666001,53.2013,53.1913,440,33252,0.669906,0.39,1,229556,229116,440
12668921,46.6403,45.0383,442,33316,0.701981,0.41,1,229601,229159,442
12671841,34.1281,33.8077,442,33379,0.772396,0.41,2,229632,229190,442
12674761,33.2256,30.7615,445,33442,0.770479,0.45,2,229665,229220,445
12677681,8.24512,7.75231,445,33505,0.770096,0.49,2,229667,229222,445
12680601,22.449,22.3505,445,33568,0.738019,0.55,1,229693,229248,445
12683521,88.4898,86.0701,448,33631,0.763604,0.63,2,229798,229350,448
12686441,61.698,58.814,451,33694,0.736721,0.67,1,229853,229402,451
12689361,40.3396,38.1628,453,33757,0.747344,0.67,1,229888,229435,453
12692281,23.2679,22.0326,454,33820,0.765469,0.67,2,229907,229453,454
12695201,43.0536,42.0065,455,33883,0.833094,0.67,2,229955,229500,455
12698121,53.4107,53.2013,455,33945,0.830619,0.71,2,230011,229556,455
12701041,49.0821,46.6403,458,34007,0.830124,0.79,2,230059,229601,458
12703961,35.4164,34.1281,459,34069,0.862025,0.77,2,230091,229632,459
12706881,32.6833,33.2256,458,34131,0.884405,0.77,2,230123,229665,458
12709801,8.13666,8.24512,458,34193,0.888881,0.73,2,230125,229667,458
12712721,20.8273,22.449,456,34255,0.889776,0.73,2,230149,229693,456
12715641,88.9655,4.4898,562,34317,0.921955,0.77,2,230255,229693,562
12718561,61.7931,84.898,512,34379,0.944391,0.73,2,230310,229798,512
12721481,41.1586,60.9796,493,34441,0.948878,0.75,2,230346,229853,493
12724401,24.2317,40.1959,478,34502,0.965776,0.77,2,230366,229888,478
12852881,32,30,488,37101,0.51,1,1,232192,231704,488
12855801,30.4,34,483,37158,0.382,1,1,232222,231739,483
12858721,32.48,6.8,516,37215,0.3084,1,1,232255,231739,516
12861641,32.096,29.36,513,37272,0.29368,1,1,232287,231774,513
12864561,29.6192,31.472,510,37329,0.210736,1,1,232316,231806,510
12867481,59.5238,33.4944,543,37386,0.0661472,1,1,232383,231840,543
12870401,45.5048,57.0989,522,37443,0.0212294,1,1,232425,231903,522
12873321,45.901,57.8198,510,37499,0.124246,1,1,232471,231961,510
12876241,31.5802,41.164,501,37555,0.0968492,0.96,1,232499,231998,501
12879161,21.516,31.4328,491,37611,0.0753698,0.97,1,232518,232027,491
12882081,24.3032,26.2866,491,37667,0.071074,0.85,1,232543,232052,491
12885001,58.4606,29.2573,528,37723,0.0222148,0.65,1,232610,232082,528
12887921,32.4921,68.2515,476,37779,0.060443,0.51,1,232636,232160,476
12890841,24.0984,39.2503,466,37835,0.0680886,0.35,1,232658,232192,466
12893761,29.6197,31.8501,467,37891,0.0536177,0.29,1,232689,232222,467
12896681,28.3239,32.77,462,37947,0.0827235,0.29,1,232717,232255,462
12899601,24.0648,32.154,453,38003,0.104545,0.19,1,232740,232287,453
12902521,58.413,29.6308,491,38059,0.0769089,0.03,1,232807,232316,491
12905441,47.6826,59.5262,469,38115,0.0153818,0.01,1,232852,232383,469
12908361,46.3365,45.5052,473,38170,0.0430764,0.15,1,232898,232425,473
12911281,28.4673,45.901,451,38225,0.0646153,0.09,1,232922,232471,451
12914201,20.8935,31.5802,442,38280,0.0689231,0.07,1,232941,232499,442
12917121,24.9787,21.516,449,38335,0.101785,0.07,1,232967,232518,449
12920041,57.7957,24.3032,490,38390,0.108357,0.01,1,233033,232543,490
12922961,34.7591,58.4606,452,38445,0.109671,0.07,1,233062,232610,452
12925881,22.9518,32.4921,446,38500,0.109934,0.07,1,233082,232636,446
12928801,30.1904,24.0984,456,38555,0.0779869,0.05,1,233114,232658,456
12931721,29.2381,29.6197,454,38610,0.103597,0.09,1,233143,232689,454
12934641,7.44761,28.3239,428,38665,0.0767195,0.11,1,233145,232717,428
12937561,19.8895,24.0648,428,38720,0.0873439,0.07,1,233168,232740,428
12940481,55.9779,58.413,426,38775,0.169469,0,1,233233,232807,426
12943401,44.7956,47.6826,423,38829,0.185894,0.05,1,233275,232852,423
12946321,47.3591,46.3365,425,38883,0.173179,0.07,1,233323,232898,425
12949241,29.4718,28.4673,426,38937,0.202636,0.07,1,233348,232922,426
12952161,20.2944,20.8935,425,38991,0.192527,0.11,1,233366,232941,425
12955081,26.4589,24.9787,427,39045,0.222505,0.11,1,233394,232967,427
12958001,58.0918,57.7957,427,39099,0.260501,0.11,1,233460,233033,427
12960921,34.8184,34.7591,427,39153,0.2521,0.11,1,233489,233062,427
12963841,22.9637,22.9518,427,39207,0.26642,0.07,1,233509,233082,427
12966761,28.5927,30.1904,425,39261,0.269284,0.11,1,233539,233114,425
12969681,28.9185,29.2381,425,39315,0.253857,0.07,1,233568,233143,425
12972601,7.38371,7.44761,425,39369,0.250771,0.09,1,233570,233145,425
12975521,20.6767,19.8895,426,39423,0.250154,0.19,1,233594,233168,426
12978441,60.1353,55.9779,431,39477,0.298031,0.19,1,233664,233233,431
12981361,44.0271,44.7956,429,39530,0.323606,0.17,1,233704,233275,429
12984281,48.0054,47.3591,430,39583,0.344721,0.21,1,233753,233323,430
12987201,29.6011,29.4718,430,39636,0.396944,0.19,1,233778,233348,430
12990121,21.9202,20.2944,432,39689,0.407389,0.23,1,233798,233366,432
12993041,27.584,26.4589,433,39742,0.393478,0.27,1,233827,233394,433
12995961,58.3168,58.0918,433,39795,0.406696,0.25,1,233893,233460,433
12998881,34.8634,34.8184,433,39848,0.441339,0.27,1,233922,233489,433
13001801,22.9727,22.9637,433,39901,0.448268,0.27,1,233942,233509,433
13004721,28.5945,28.5927,433,39954,0.465654,0.25,1,233972,233539,433
13007641,28.9189,28.9185,433,40007,0.485131,0.25,1,234001,233568,433
13010561,7.38378,7.38371,433,40060,0.489026,0.25,1,234003,233570,433
13013481,21.4768,1.47674,458,40113,0.489805,0.25,1,234028,233570,458
13016401,61.0954,19.4953,505,40166,0.505961,0.31,1,234099,233594,505
13019321,44.2191,59.8991,475,40219,0.509192,0.33,1,234139,233664,475
13022241,50.4438,43.9798,487,40271,0.541838,0.35,1,234191,233704,487
13025161,30.8888,47.996,464,40323,0.596368,0.41,1,234217,233753,464
13028081,23.7778,29.5992,461,40375,0.607274,0.41,1,234239,233778,461
13031001,27.9556,21.9198,470,40427,0.641455,0.39,1,234268,233798,470
13033921,58.3911,27.584,507,40479,0.632291,0.41,1,234334,233827,507
13036841,36.4782,58.3168,472,40531,0.646458,0.45,1,234365,233893,472
13039761,23.2956,34.8634,463,40583,0.649292,0.45,1,234385,233922,463
13042681,29.4591,22.9727,474,40635,0.665858,0.47,1,234416,233942,474
13045601,29.8918,28.5945,474,40687,0.685172,0.49,1,234446,233972,474
13048521,7.57836,28.9189,447,40739,0.689034,0.49,1,234448,234001,447
13051441,21.5157,7.38378,470,40791,0.673807,0.49,1,234473,234003,470
13054361,60.3031,21.4768,515,40843,0.702761,0.51,1,234543,234028,515
13057281,45.6606,61.0954,486,40895,0.740552,0.51,1,234585,234099,486
13060201,53.1321,44.2191,501,40947,0.78011,0.55,2,234640,234139,501
13063121,33.0264,50.4438,477,40999,0.772022,0.61,2,234668,234191,477
13066041,24.2053,30.8888,473,41050,0.770404,0.61,2,234690,234217,473
13068961,28.0411,23.7778,480,41101,0.770081,0.65,2,234719,234239,480
13071881,59.2082,27.9556,518,41152,0.786016,0.63,2,234786,234268,518
13074801,37.4416,58.3911,484,41203,0.789203,0.65,2,234818,234334,484
13077721,23.4883,36.4782,473,41254,0.789841,0.65,2,234838,234365,473
13080641,30.2977,23.2956,485,41305,0.789968,0.67,2,234870,234385,485
13083561,30.8595,29.4591,485,41356,0.789994,0.69,2,234901,234416,485
13086481,7.77191,29.8918,457,41407,0.789999,0.69,2,234903,234446,457
13089401,20.7544,7.57836,479,41458,0.822,0.67,2,234927,234448,479
13092321,61.7509,21.5157,526,41509,0.7964,0.71,2,234999,234473,526
13095241,13.9502,60.3031,458,41560,0.79128,0.75,2,235001,234543,458
13098161,37.19,45.6606,459,41611,0.806256,0.79,2,235044,234585,459
13101081,51.438,53.1321,459,41662,0.889251,0.77,2,235099,234640,459
13104001,33.4876,33.0264,460,41713,0.90585,0.77,2,235128,234668,460
13264601,41,33,516,44411,0.79,1,2,236973,236457,516
13267521,37.8,44.2,506,44458,0.662,1,1,237010,236504,506
13270441,30.76,32.84,505,44505,0.5884,1,1,237039,236534,505
13273361,22.152,28.168,498,44552,0.55768,1,1,237059,236561,498
13276281,30.0304,31.2336,498,44599,0.439536,1,1,237091,236593,498
13279201,38.0061,57.4467,474,44646,0.367907,1,1,237131,236657,474
13282121,50.0012,43.4893,487,44693,0.225581,1,1,237184,236697,487
13285041,38.0002,31.8979,493,44740,0.133116,1,1,237219,236726,493
13287961,28.4,27.9796,492,44787,0.130623,1,1,237245,236753,492
13290881,23.28,23.1959,492,44834,0.0661246,0.97,1,237267,236775,492
13293801,15.856,27.8392,477,44881,0.0692249,0.92,1,237281,236804,477
13296721,19.9712,23.1678,476,44928,0.053845,1,1,237302,236826,476
13299641,32.7942,38.2336,470,44975,0.050769,0.95,1,237338,236868,470
13302561,33.7588,32.4467,473,45022,0.0341538,0.82,1,237372,236899,473
13305481,29.1518,32.8893,468,45069,0.0308308,0.79,1,237400,236932,468
13308401,32.2304,39.3779,460,45116,0.0461662,0.63,1,237433,236973,460
13311321,30.4461,37.4756,453,45163,0.0652332,0.57,1,237463,237010,453
13314241,23.6892,30.6951,446,45210,0.117047,0.55,1,237485,237039,446
13317161,17.5378,22.139,442,45257,0.0634093,0.41,1,237501,237059,442
13320081,28.3076,30.0278,441,45304,0.0846819,0.35,1,237532,237091,441
13323001,35.2615,38.0056,438,45351,0.0729364,0.19,1,237569,237131,438
13325921,42.2523,50.0011,429,45398,0.0865873,0.11,1,237613,237184,429
13328841,30.8505,38.0002,422,45444,0.105317,0.13,1,237641,237219,422
13331761,27.7701,28.4,423,45490,0.125063,0.05,1,237668,237245,423
13334681,22.354,23.28,422,45536,0.113013,0.07,1,237689,237267,422
13337601,16.4708,15.856,423,45582,0.142603,0.05,1,237704,237281,423
13340521,19.2942,19.9712,422,45628,0.148521,0.05,1,237724,237302,422
13343441,33.4588,32.7942,423,45674,0.149704,0.03,1,237761,237338,423
13346361,34.6918,33.7588,424,45720,0.149941,0.03,1,237796,237372,424
13349281,28.5384,29.1518,423,45766,0.0699882,0.05,1,237823,237400,423
13352201,31.3077,32.2304,422,45812,0.0859976,0.07,1,237855,237433,422
13355121,32.6615,30.4461,425,45858,0.0731995,0.13,1,237888,237463,425
13358041,23.3323,23.6892,424,45904,0.11864,0.05,1,237909,237485,424
13360961,17.4665,17.5378,424,45950,0.127728,0.05,1,237925,237501,424
13363881,27.4933,3.50757,454,45996,0.0975456,0.09,1,237955,237501,454
13366801,35.8987,25.5015,461,46042,0.107509,0.07,1,237993,237532,461
13369721,43.9797,34.7003,470,46088,0.109502,0.09,1,238039,237569,470
13372641,31.1959,42.1401,454,46134,0.1259,0.11,1,238067,237613,454
13375561,28.6392,30.828,454,46180,0.16118,0.13,1,238095,237641,454
13378481,22.5278,27.7656,448,46226,0.152236,0.11,1,238116,237668,448
13381401,15.7056,22.3531,441,46272,0.118447,0.15,1,238130,237689,441
13384321,21.5411,16.4706,449,46318,0.0956894,0.15,1,238153,237704,449
13387241,31.5082,19.2941,463,46364,0.123138,0.15,1,238187,237724,463
13390161,34.3016,33.4588,461,46409,0.128628,0.15,1,238222,237761,461
13393081,26.0603,34.6918,450,46454,0.145726,0.05,1,238246,237796,450
13396001,32.4121,28.5384,457,46499,0.149145,0.09,1,238280,237823,457
13398921,32.0824,31.3077,457,46544,0.165829,0.07,1,238312,237855,457
13401841,24.0165,32.6615,446,46589,0.185166,0.13,1,238334,237888,446
13404761,17.6033,23.3323,441,46634,0.189033,0.13,1,238350,237909,441
13407681,27.5207,17.4665,455,46679,0.189807,0.09,1,238380,237925,455
13410601,36.7041,27.4933,464,46724,0.237961,0.11,1,238419,237955,464
13413521,44.9408,35.8987,473,46769,0.279592,0.11,1,238466,237993,473
13416441,32.1882,43.9797,456,46814,0.287918,0.13,1,238495,238039,456
13419361,29.6376,31.1959,457,46859,0.305584,0.17,1,238524,238067,457
13422281,20.3275,28.6392,447,46904,0.309117,0.15,1,238542,238095,447
13425201,15.2655,22.5278,440,46949,0.325823,0.11,1,238556,238116,440
13428121,22.2531,15.7056,450,46994,0.329165,0.09,1,238580,238130,450
13431041,31.6506,21.5411,461,47039,0.361833,0.13,1,238614,238153,461
13433961,34.3301,31.5082,462,47084,0.352367,0.13,1,238649,238187,462
13436881,26.866,34.3016,452,47129,0.366473,0.15,1,238674,238222,452
13439801,33.3732,26.0603,463,47174,0.401295,0.15,1,238709,238246,463
13442721,33.0746,32.4121,462,47219,0.440259,0.17,1,238742,238280,462
13445641,24.2149,32.0824,452,47264,0.432052,0.19,1,238764,238312,452
13448561,17.643,24.0165,446,47309,0.43041,0.19,1,238780,238334,446
13451481,28.3286,17.6033,461,47354,0.446082,0.19,1,238811,238350,461
13454401,7.26572,27.5207,433,47399,0.417216,0.25,1,238813,238380,433
13457321,34.2531,36.7041,435,47443,0.427443,0.29,1,238854,238419,435
13460241,45.2506,44.9408,436,47487,0.461489,0.29,1,238902,238466,436
13463161,32.2501,32.1882,436,47531,0.532298,0.31,1,238931,238495,436
13466081,30.45,29.6376,437,47575,0.54646,0.31,1,238961,238524,437
13469001,20.49,20.3275,437,47619,0.549292,0.33,1,238979,238542,437
13471921,16.098,15.2655,438,47663,0.565858,0.33,1,238994,238556,438
13474841,22.4196,22.2531,438,47707,0.601172,0.37,1,239018,238580,438
13477761,33.2839,31.6506,440,47751,0.624234,0.35,1,239054,238614,440
13480681,33.8568,34.3301,439,47795,0.596847,0.37,1,239088,238649,439
13483601,28.3714,26.866,441,47839,0.607369,0.41,1,239115,238674,441
13486521,35.2743,33.3732,443,47883,0.625474,0.45,1,239152,238709,443
13489441,33.4549,33.0746,443,47927,0.645095,0.43,1,239185,238742,443
13492361,24.291,24.2149,443,47971,0.681019,0.43,1,239207,238764,443
13495281,17.6582,17.643,443,48015,0.704204,0.45,1,239223,238780,443
13498201,27.5316,28.3286,442,48059,0.708841,0.41,1,239253,238811,442
13501121,7.10633,7.26572,442,48103,0.709768,0.43,1,239255,238813,442
13504041,35.0213,34.2531,443,48147,0.725954,0.47,1,239297,238854,443
13506961,47.8043,45.2506,446,48191,0.761191,0.55,2,239348,238902,446
13509881,33.5608,32.2501,447,48235,0.800238,0.55,2,239378,238931,447
13512801,30.7122,30.45,447,48279,0.792048,0.55,2,239408,238961,447
13515721,20.5424,20.49,447,48323,0.79041,0.57,2,239426,238979,447
13518641,16.9085,16.098,448,48367,0.790082,0.61,2,239442,238994,448
13521561,24.1817,22.4196,450,48411,0.790016,0.63,2,239468,239018,450
13524481,34.4363,33.2839,451,48455,0.790003,0.59,2,239505,239054,451
13527401,34.0873,33.8568,451,48498,0.806001,0.61,2,239539,239088,451
13530321,29.2175,28.3714,452,48541,0.8572,0.63,2,239567,239115,452
13533241,36.2435,35.2743,453,48584,0.85144,0.65,2,239605,239152,453
13536161,35.2487,33.4549,455,48627,0.882288,0.69,2,239640,239185,455
13539081,25.4497,24.291,456,48670,0.888458,0.71,2,239663,239207,456
13542001,18.6899,17.6582,457,48713,0.905692,0.71,2,239680,239223,457
13544921,27.738,27.5316,457,48756,0.877138,0.71,2,239710,239253,457
13547841,7.1476,7.10633,457,48799,0.903428,0.73,2,239712,239255,457
13550761,35.8295,35.0213,458,48842,0.892686,0.73,2,239755,239297,458
13553681,47.1659,7.00425,508,48885,0.890537,0.77,2,239805,239297,508
13556601,35.0332,42.2008,489,48928,0.922107,0.81,2,239837,239348,489
13559521,31.8066,32.4402,490,48971,0.912421,0.79,2,239868,239378,490
13562441,20.7613,30.488,478,49014,0.910484,0.79,2,239886,239408,478
13565361,16.9523,20.4976,476,49057,0.910097,0.79,2,239902,239426,476
13568281,24.1905,16.8995,486,49100,0.942019,0.79,2,239928,239442,486
13571201,34.4381,24.1799,497,49143,0.932404,0.79,2,239965,239468,497
13585801,22,35,486,49358,0.91,0.89,2,240126,239640,486
13588721,18.8,25.4,481,49401,0.942,0.91,2,240144,239663,481
13990221,54,45,472,25633,0.25,0.77,1,244114,243642,472
13993141,63.6,52.2,484,25716,0.154,0.63,1,244180,243696,484
13996061,71.92,76.04,476,25798,0.0868,0.59,1,244254,243778,476
13998981,50.384,64.808,459,25880,0.08936,0.51,1,244299,243840,459
14001901,54.0768,45.7616,473,25962,0.121872,0.43,1,244354,243881,473
14004821,22.0154,38.7523,450,26044,0.128374,0.45,1,244368,243918,450
14007741,27.6031,30.1505,451,26125,0.113675,0.37,1,244397,243946,451
14010661,65.5206,54.0301,466,26206,0.126735,0.25,1,244472,244006,466
14013581,71.5041,54.006,485,26287,0.209347,0.25,1,244545,244060,485
14016501,63.1008,54.0012,492,26368,0.209869,0.13,1,244606,244114,492
14019421,71.0202,63.6002,499,26448,0.273974,0.07,1,244679,244180,499
14022341,51.004,71.92,471,26528,0.270795,0.09,1,244725,244254,471
14025261,55.0008,50.384,482,26608,0.286159,0.13,1,244781,244299,482
14028181,20.6002,54.0768,439,26688,0.305232,0.13,1,244793,244354,439
14031101,28.92,22.0154,456,26767,0.325046,0.11,1,244824,244368,456
14034021,65.784,27.6031,502,26846,0.361009,0.13,1,244899,244397,502
14036941,14.7568,65.5206,429,26925,0.368202,0.23,1,244901,244472,429
14039861,64.5514,71.5041,433,27004,0.41764,0.21,1,244978,244545,433
14042781,59.3103,63.1008,430,27082,0.475528,0.29,1,245036,244606,430
14045701,75.8621,71.0202,437,27160,0.503106,0.27,1,245116,244679,437
14048621,50.3724,51.004,435,27238,0.524621,0.29,1,245160,244725,435
14051541,56.4745,55.0008,437,27316,0.544924,0.31,1,245218,244781,437
14054461,20.8949,20.6002,437,27394,0.580985,0.33,1,245230,244793,437
14057381,29.779,28.92,438,27471,0.572197,0.37,1,245262,244824,438
14060301,67.5558,65.784,440,27548,0.618439,0.37,1,245339,244899,440
14063221,15.1112,14.7568,440,27625,0.627688,0.43,1,245341,244901,440
14066141,67.0222,64.5514,443,27702,0.629538,0.49,1,245421,244978,443
14069061,60.6044,59.3103,444,27778,0.645908,0.51,1,245480,245036,444
14071981,76.9209,75.8621,445,27854,0.729182,0.53,1,245561,245116,445
14074901,51.3842,50.3724,446,27930,0.761836,0.55,2,245606,245160,446
14077821,59.0768,56.4745,449,28006,0.784367,0.59,2,245667,245218,449
14080741,21.4154,20.8949,449,28082,0.804874,0.57,2,245679,245230,449
14083661,30.6831,29.779,450,28157,0.840975,0.63,2,245712,245262,450
14086581,70.1366,67.5558,453,28232,0.848195,0.63,2,245792,245339,453
14089501,15.6273,15.1112,453,28307,0.817639,0.63,2,245794,245341,453
14092421,67.1255,67.0222,453,28382,0.891528,0.63,2,245874,245421,453
14095341,60.6251,13.4044,512,28457,0.858306,0.65,2,245933,245421,512
14098261,80.925,49.8809,539,28531,0.835661,0.75,2,246019,245480,539
14101181,52.185,74.7762,503,28605,0.815132,0.77,2,246064,245561,503
14104101,61.637,50.9552,522,28679,0.907026,0.79,2,246128,245606,522
14107021,21.9274,58.991,473,28753,0.893405,0.81,2,246140,245667,473
14109941,32.3855,21.3982,496,28827,0.890681,0.85,2,246175,245679,496
14112861,69.6771,30.6796,542,28900,0.922136,0.85,2,246254,245712,542
14115781,15.5354,70.1359,464,28973,0.928427,0.81,2,246256,245792,464
14118701,68.7071,15.6272,544,29046,0.929685,0.91,2,246338,245794,544
14121621,60.1414,67.1254,522,29119,0.929937,0.85,2,246396,245874,522
14226741,57,26,543,31630,0.95,1,2,248156,247613,543
14229661,37,57.2,510,31697,0.902,1,2,248188,247678,510
14337701,29,23,492,34079,0.87,1,2,249871,249379,492
14340621,46.6,53.4,482,34141,0.87,0.95,2,249922,249440,482
14343541,38.12,34.68,488,34203,0.774,0.94,2,249958,249470,488
14346461,30.024,27.736,490,34265,0.7068,0.94,1,249986,249496,490
14349381,32.4048,5.5472,523,34327,0.64536,1,1,250019,249496,523
14352301,41.681,27.5094,534,34389,0.617072,1,1,250063,249529,534
14355221,36.3362,51.1019,512,34450,0.483414,1,1,250098,249586,512
14358141,37.6672,42.2204,510,34511,0.456683,1,1,250136,249626,510
14361061,66.7334,41.2441,543,34572,0.339337,1,1,250210,249667,543
14363981,62.9467,67.4488,531,34633,0.235867,0.95,1,250272,249741,531
14366901,41.3893,66.2898,501,34694,0.151173,0.85,1,250308,249807,501
14369821,27.4779,41.258,490,34755,0.118235,0.87,1,250332,249842,490
14372741,45.4956,31.4516,511,34816,0.111647,0.87,1,250382,249871,511
14375661,38.6991,47.0903,497,34877,0.0943294,0.75,1,250419,249922,497
14378581,23.7398,38.2181,481,34938,0.122866,0.69,1,250439,249958,481
14381501,27.148,30.0436,481,34999,0.128573,0.63,1,250467,249986,481
14384421,41.4296,32.4087,493,35059,0.145715,0.61,1,250512,250019,493
14387341,30.6859,41.6817,477,35119,0.197143,0.45,1,250540,250063,477
14390261,35.7372,36.3363,479,35179,0.223429,0.45,1,250577,250098,479
14393181,62.3474,37.6673,510,35239,0.244686,0.31,1,250646,250136,510
14396101,59.6695,66.7335,495,35299,0.280937,0.21,1,250705,250210,495
14399021,35.9339,62.9467,463,35359,0.288187,0.13,1,250735,250272,463
14401941,26.3868,41.3893,451,35419,0.257637,0.11,1,250759,250308,451
14404861,45.2774,27.4779,477,35479,0.299528,0.11,1,250809,250332,477
14407781,37.0555,45.4956,462,35539,0.339906,0.09,1,250844,250382,462
14410701,25.0111,38.6991,447,35598,0.363981,0.13,1,250866,250419,447
14413621,25.8022,23.7398,453,35657,0.368796,0.13,1,250892,250439,453
14416541,6.76044,27.148,427,35716,0.369759,0.15,1,250894,250467,427
14419461,38.9521,41.4296,429,35775,0.385952,0.21,1,250941,250512,429
14422381,31.7904,30.6859,431,35834,0.38919,0.23,1,250971,250540,431
14425301,37.5581,35.7372,433,35893,0.373838,0.25,1,251010,250577,433
14428221,64.3116,62.3474,435,35952,0.434768,0.29,1,251081,250646,435
14431141,60.8623,59.6695,436,36011,0.430954,0.29,1,251141,250705,436
14434061,36.1725,35.9339,436,36070,0.430191,0.25,1,251171,250735,436
14436981,24.8345,26.3868,434,36129,0.462038,0.31,1,251193,250759,434
14439901,48.9669,45.2774,439,36187,0.468408,0.35,1,251248,250809,439
14442821,38.5934,37.0555,440,36245,0.469682,0.37,1,251284,250844,440
14445741,25.3187,25.0111,440,36303,0.501936,0.37,1,251306,250866,440
14448661,25.8637,25.8022,440,36361,0.476387,0.37,1,251332,250892,440
14451581,6.77275,6.76044,440,36419,0.471277,0.39,1,251334,250894,440
14454501,38.1545,38.9521,439,36477,0.486255,0.39,1,251380,250941,439
14457421,33.2309,31.7904,441,36535,0.537251,0.37,1,251412,250971,441
14460341,37.0462,37.5581,440,36593,0.54745,0.45,1,251450,251010,440
14463261,65.8092,64.3116,442,36651,0.62949,0.43,1,251523,251081,442
14466181,61.9618,60.8623,443,36709,0.677898,0.43,1,251584,251141,443
14469101,36.3924,36.1725,443,36767,0.68758,0.47,1,251614,251171,443
14472021,25.6785,24.8345,444,36824,0.705516,0.47,1,251637,251193,444
14474941,48.3357,48.9669,443,36881,0.725103,0.47,1,251691,251248,443
14477861,40.0671,38.5934,445,36938,0.761021,0.51,2,251729,251284,445
14480781,25.6134,25.3187,445,36995,0.816204,0.47,2,251751,251306,445
14483701,25.9227,25.8637,445,37052,0.811241,0.47,2,251777,251332,445
14486621,6.78454,6.77275,445,37109,0.842248,0.49,2,251779,251334,445
14489541,38.9569,38.1545,446,37166,0.83245,0.49,2,251826,251380,446
14492461,34.1914,7.63091,479,37223,0.83049,0.55,2,251859,251380,479
14495381,40.4383,27.1262,489,37280,0.830098,0.55,2,251901,251412,489
14498301,66.4877,35.8252,524,37337,0.84602,0.65,2,251974,251450,524
14501221,63.6975,65.565,514,37394,0.849204,0.69,2,252037,251523,514
14504141,38.3395,61.913,485,37451,0.897841,0.69,2,252069,251584,485
14507061,26.8679,36.3826,479,37507,0.907568,0.71,2,252093,251614,479
14509981,50.1736,25.6765,512,37563,0.877514,0.73,2,252149,251637,512
14512901,42.0347,48.3353,498,37619,0.919503,0.77,2,252189,251691,498
14515821,26.0069,40.0671,482,37675,0.895901,0.83,2,252211,251729,482
14518741,26.8014,25.6134,487,37731,0.87518,0.81,2,252238,251751,487
14521661,6.96028,25.9227,463,37787,0.871036,0.85,2,252240,251777,463
14524581,40.5921,6.78454,510,37843,0.886207,0.83,2,252289,251779,510
14527501,33.7184,38.9569,495,37899,0.905241,0.83,2,252321,251826,495
14530421,41.9437,34.1914,506,37955,0.909048,0.83,2,252365,251859,506
14679341,44,27,530,40694,0.79,1,2,254282,253752,530
14682261,33.6,47.8,508,40746,0.678,1,1,254313,253805,508
14685181,30.72,18.36,527,40798,0.6556,1,1,254343,253816,527
14688101,55.744,34.072,551,40850,0.45912,1,1,254405,253854,551
14691021,34.3488,70.8144,500,40902,0.467824,1,1,254434,253934,500
14693941,43.6698,38.1629,516,40954,0.453565,1,1,254480,253964,516
14696861,41.534,34.8326,523,41006,0.434713,1,1,254521,253998,523
14699781,34.7068,49.3665,503,41057,0.382943,1,1,254554,254051,503
14702701,38.9414,35.4733,511,41108,0.420589,0.91,1,254594,254083,511
14705621,29.3883,38.2947,499,41159,0.428118,0.95,1,254621,254122,499
14708541,29.0777,32.4589,497,41210,0.381624,0.97,1,254650,254153,497
14711461,25.0155,29.6918,492,41261,0.356325,0.91,1,254674,254182,492
14714381,26.6031,27.5384,492,41312,0.351265,0.85,1,254701,254209,492
14717301,35.7206,28.7077,501,41363,0.382253,0.79,1,254739,254238,501
14720221,25.5441,40.9415,480,41414,0.388451,0.65,1,254762,254282,480
14723141,32.3088,32.9883,483,41465,0.38969,0.65,1,254796,254313,483
14726061,48.0618,30.5977,505,41516,0.389938,0.41,1,254848,254343,505
14728981,11.2124,55.7195,445,41567,0.389988,0.47,1,254850,254405,445
14731901,22.2425,34.3439,441,41618,0.389998,0.45,1,254875,254434,441
14734821,45.2485,43.6688,446,41669,0.39,0.43,1,254926,254480,446
14737741,41.8497,41.5338,446,41720,0.374,0.37,1,254967,254521,446
14740661,29.9699,34.7068,440,41771,0.4188,0.43,1,254994,254554,440
14743581,39.594,38.9413,442,41822,0.36376,0.43,1,255036,254594,442
14746501,28.7188,29.3883,441,41872,0.352752,0.37,1,255062,254621,441
14749421,28.9438,29.0777,441,41922,0.39855,0.35,1,255091,254650,441
14752341,22.5888,25.0155,438,41972,0.39171,0.35,1,255112,254674,438
14755261,26.9177,26.6031,439,42022,0.422342,0.39,1,255140,254701,439
14758181,37.3835,35.7206,441,42072,0.444468,0.39,1,255180,254739,441
14761101,27.4767,25.5441,443,42122,0.464894,0.39,1,255205,254762,443
14764021,29.4953,32.3088,439,42172,0.484979,0.39,1,255235,254796,439
14766941,49.0991,48.0618,441,42222,0.488996,0.39,1,255289,254848,441
14769861,11.4198,11.2124,441,42272,0.489799,0.39,1,255291,254850,441
14772781,22.284,22.2425,441,42322,0.47396,0.39,1,255316,254875,441
14775701,43.6568,45.2485,439,42372,0.534792,0.37,1,255365,254926,439
14778621,42.3314,41.8497,440,42422,0.530958,0.43,1,255407,254967,440
14781541,30.8663,29.9699,441,42472,0.594192,0.35,1,255435,254994,441
14784461,38.1733,39.594,439,42522,0.622838,0.35,1,255475,255036,439
14787381,28.4347,28.7188,439,42572,0.612568,0.41,1,255501,255062,439
14790301,29.6869,28.9438,440,42622,0.674514,0.39,1,255531,255091,440
14793221,23.5374,22.5888,441,42672,0.686903,0.43,1,255553,255112,441
14796141,27.1075,26.9177,441,42721,0.705381,0.45,1,255581,255140,441
14799061,38.2215,37.3835,442,42770,0.773076,0.47,2,255622,255180,442
14801981,28.4443,27.4767,443,42819,0.786615,0.49,2,255648,255205,443
14804901,30.4889,29.4953,444,42868,0.821323,0.49,2,255679,255235,444
14807821,49.2978,49.0991,444,42917,0.828265,0.49,2,255733,255289,444
14810741,11.4596,11.4198,444,42966,0.829653,0.47,2,255735,255291,444
14813661,22.2919,22.284,444,43015,0.829931,0.47,2,255760,255316,444
14816581,45.2584,4.45679,495,43064,0.813986,0.55,2,255811,255316,495
14819501,44.2517,40.0914,490,43113,0.826797,0.53,2,255855,255365,490
14822421,32.0503,41.6183,477,43162,0.877359,0.61,2,255884,255407,477
14825341,39.2101,30.7237,490,43211,0.919472,0.63,2,255925,255435,490
14828261,30.242,38.1447,478,43260,0.927894,0.61,2,255953,255475,478
14831181,30.8484,28.4289,483,43309,0.913579,0.69,2,255984,255501,483
14834101,23.7697,29.6858,475,43358,0.910716,0.69,2,256006,255531,475
14837021,27.9539,23.5372,482,43407,0.926143,0.71,2,256035,255553,482
14839941,41.5908,27.1074,499,43456,0.881229,0.79,2,256080,255581,499
14842861,29.1182,38.2215,484,43505,0.872246,0.79,2,256106,255622,484
14845781,32.2236,28.4443,491,43553,0.870449,0.83,2,256139,255648,491
14848701,50.4447,30.4889,515,43601,0.87009,0.83,2,256194,255679,515
14851621,11.6889,49.2978,463,43649,0.870018,0.83,2,256196,255733,463
14854541,23.1378,11.4596,487,43697,0.902004,0.83,2,256222,255735,487
14857461,45.4276,22.2919,513,43745,0.908401,0.81,2,256273,255760,513
15044341,35,22,523,46729,0.73,1,1,258355,257832,523
15047261,31.8,28.4,524,46774,0.682,1,1,258386,257862,524
15048721,35.16,29.68,530,46819,0.5444,1,1,258422,257892,530
15098361,387.032,453.136,446,21900,0.13288,0.17,1,258897,258451,446
15101281,135.806,141.027,456,21997,0.066576,0.01,1,258970,258514,456
15104201,107.161,108.205,456,22093,0.0533152,0.05,1,259070,258614,456
15107121,65.4323,70.4411,450,22189,0.050663,0,1,259125,258675,450
15110041,64.2865,67.6882,447,22285,0.0501326,0.03,1,259189,258742,447
15112961,48.8573,47.9376,449,22380,0.0660265,0.03,1,259234,258785,449
15115881,57.7715,56.7875,450,22475,0.0212053,0.03,1,259294,258844,450
15118801,20.3543,35.3575,431,22569,0.0442411,0.03,1,259305,258874,431
15121721,72.8709,25.4715,494,22663,0.0328482,0.05,1,259391,258897,494
