#Ack,ack_ewma(ms),send_ewma(ms),rtt_ratio,cwnd (Bytes),Last Router Ocupation Ack Arriaval(Packets),Last Router Ocupation Packet Sent(Packets),Network Situation,AckArrival(ms),TSInsideAck(ms),RTTAck(ms)
4381,2,0,428,16060,0,0.06,1,60849,60421,428
7301,2,0,430,18980,0,0.06,1,60851,60421,430
10221,2,0,432,21900,0.008,0.06,1,60853,60421,432
13141,2,0,434,24820,0.0096,0.06,1,60855,60421,434
14601,161.2,0,635,27740,0.00192,0,1,61056,60421,635
17521,213.84,340.8,436,29200,0.024384,0,1,61283,60847,436
20441,67.568,92.16,437,32120,0.0128768,0.01,1,61314,60877,437
23361,37.5136,42.432,437,35040,0.00257536,0.01,1,61344,60907,437
26281,30.7027,32.4864,436,37960,0.000515072,0,1,61373,60937,436
29201,30.1405,30.4973,436,40880,0.00810301,0.01,1,61403,60967,436
32121,30.0281,30.0995,436,43800,0.0096206,0,1,61433,60997,436
35041,30.0056,30.0199,436,46720,0.00192412,0,1,61463,61027,436
37961,30.0011,30.004,436,49640,0.000384824,0,1,61493,61057,436
40881,30.0002,30.0008,436,52560,7.69648e-05,0,1,61523,61087,436
43801,30,30.0002,436,55480,1.5393e-05,0.03,1,61553,61117,436
46721,139.6,138.8,437,58400,0.0240031,0.02,1,61720,61283,437
49641,51.12,51.76,436,61320,0.0768006,0,1,61749,61313,436
52561,35.024,34.352,437,64240,0.19936,0,1,61780,61343,437
55481,31.0048,30.8704,437,67160,0.383872,0.01,1,61810,61373,437
58401,30.201,30.1741,437,70080,0.548774,0,1,61840,61403,437
61321,28.4402,29.2348,436,73000,0.629755,0.02,1,61868,61432,436
64241,24.088,26.647,433,75920,0.613951,0,1,61891,61458,433
67161,20.8176,22.9294,431,78840,0.36279,0,1,61911,61480,431
70081,20.1635,20.5859,431,81760,0.072558,0,1,61931,61500,431
73001,20.0327,20.1172,431,84680,0.0145116,0.01,1,61951,61520,431
75921,20.0065,20.0234,431,87600,0.00290232,0,1,61971,61540,431
78841,20.8013,20.0047,432,90520,0.000580464,0,1,61992,61560,432
81761,20.1603,20.0009,432,93440,0.000116093,0,1,62012,61580,432
84681,20.0321,20.0002,432,96360,0.00802322,0.03,1,62032,61600,432
87601,19.2064,20,431,99280,0.00960464,0,1,62051,61620,431
90521,20.6413,20,432,102200,0.00992093,0,1,62072,61640,432
93441,20.1283,20,432,105120,0.00198419,0,1,62092,61660,432
96361,20.8257,20,433,108040,0.000396837,0.02,1,62113,61680,433
99281,20.1651,20,433,110960,0.0720794,0.03,1,62133,61700,433
102201,22.433,20,436,113880,0.102416,0.11,1,62156,61720,436
105121,23.6866,20,440,116800,0.108483,0.21,1,62180,61740,440
108041,19.9373,18.4,441,119720,0.205697,0.25,1,62199,61758,441
110961,21.5875,16.48,447,122640,0.289139,0.35,1,62221,61774,447
113881,20.3175,16.096,451,125560,0.337828,0.44,1,62241,61790,451
116801,24.0635,16.0192,460,128480,0.459566,0.6,1,62266,61806,460
119721,16.0127,16.0038,458,131400,0.491913,0.6,1,62280,61822,458
122641,16.8025,16.0008,459,134320,0.538383,0.63,1,62297,61838,459
125561,17.7605,16.0002,461,137240,0.587677,0.65,1,62315,61854,461
128481,14.7521,16,459,140160,0.629535,0.65,1,62329,61870,459
131401,6.95042,16,448,143080,0.629907,0.46,1,62334,61886,448
134321,2.99008,16,434,146000,0.653981,0.16,1,62336,61902,434
137241,9.39802,16,429,148920,0.682796,0,1,62347,61918,429
140161,13.8796,16,428,151840,0.648559,0,1,62362,61934,428
143081,14.7759,14.4,429,154760,0.457712,0.01,1,62377,61948,429
146001,13.3552,14.08,428,157680,0.267542,0,1,62390,61962,428
148921,13.871,14.016,428,160600,0.173508,0,1,62404,61976,428
151841,13.9742,14.0032,428,163520,0.0347017,0,1,62418,61990,428
154761,14.7948,14.0006,429,166440,0.00694034,0.01,1,62433,62004,429
157681,13.359,14.0001,428,169360,0.00138807,0.01,1,62446,62018,428
160601,13.8718,14,428,172280,0.000277613,0.01,1,62460,62032,428
163521,11.5744,12.4,427,175200,5.55227e-05,0.03,1,62471,62044,427
166441,12.7149,12.08,428,178120,1.11045e-05,0.01,1,62484,62056,428
169361,12.143,12.016,428,181040,2.22091e-06,0.05,1,62496,62068,428
172281,10.4286,11.2032,427,183960,0.0240004,0.01,1,62506,62079,427
175201,11.6857,10.2406,429,186880,0.00480009,0.05,1,62518,62089,429
178121,7.93714,10.0481,426,189800,0.000960018,0.04,1,62525,62099,426
181041,11.9874,10.0096,429,192720,0.008192,0.05,1,62538,62109,429
183961,11.9975,10.0019,431,195640,0.0096384,0.09,1,62550,62119,431
186881,9.5995,10.0004,430,198560,0.00992768,0.13,1,62559,62129,430
189801,10.7199,10.0001,431,201480,0.0179855,0.13,1,62570,62139,431
192721,11.744,10,433,204400,0.107597,0.18,1,62582,62149,433
195641,8.7488,10,431,207320,0.0935194,0.17,1,62590,62159,431
198561,9.74976,10,431,210240,0.0667039,0.14,1,62600,62169,431
201481,14.75,10,437,213160,0.0213408,0.15,1,62616,62179,437
204401,11.75,9.2,439,216080,0.0842682,0.23,1,62627,62188,439
207321,10.35,8.24,441,219000,0.120854,0.29,1,62637,62196,441
210241,8.47,8.048,441,221920,0.144171,0.33,1,62645,62204,441
213161,7.294,8.0096,440,224840,0.132834,0.32,1,62652,62212,440
216081,11.0588,8.00192,444,227760,0.154567,0.35,1,62664,62220,444
219001,9.41176,8.00038,445,230680,0.0869134,0.36,1,62673,62228,445
221921,7.48235,8.00008,444,233600,0.0573827,0.39,1,62680,62236,444
224841,9.49647,8.00002,446,236520,0.0194765,0.39,1,62690,62244,446
227761,12.2993,8,451,239440,0.115895,0.44,1,62703,62252,451
230681,9.65986,8,452,242360,0.0951791,0.51,1,62712,62260,452
233601,9.93197,8,454,245280,0.0590358,0.5,1,62722,62268,454
236521,7.58639,8,453,248200,0.0598072,0.57,1,62729,62276,453
239441,9.51728,8,455,251120,0.0839614,0.55,1,62739,62284,455
242361,7.50346,8,454,254040,0.0807923,0.59,1,62746,62292,454
245281,9.50069,8,456,256960,0.0801584,0.58,1,62756,62300,456
248201,7.50014,8,455,259880,0.104032,0.62,1,62763,62308,455
251121,8.70003,8,456,262800,0.100806,0.65,1,62772,62316,456
254041,9.74001,8,458,265720,0.108161,0.67,1,62782,62324,458
255841,8.348,8,458,268640,0.0936323,0.69,1,62790,62332,458
258761,8.8696,7.2,460,270440,0.106726,0.72,1,62799,62339,460
261681,5.77392,6.24,459,273360,0.109345,0.72,1,62804,62345,459
264601,2.75478,6.048,455,276280,0.125869,0.7,1,62806,62351,455
267281,2.15096,6.0096,451,279200,0.145174,0.6,1,62808,62357,451
270201,2.03019,9.20192,443,281880,0.157035,0.47,1,62810,62367,443
271861,3.60604,6.64038,441,284800,0.151407,0.27,1,62814,62373,441
273521,3.12121,11.7281,431,286460,0.150281,0.21,1,62817,62386,431
276441,5.42424,8.74562,429,288120,0.150056,0.19,1,62823,62394,429
278101,3.48485,6.54912,426,291040,0.118011,0.12,1,62826,62400,426
279761,4.69697,7.70982,423,292700,0.119602,0,1,62831,62408,423
282681,16.9394,16.742,424,294360,0.0319204,0,1,62851,62427,424
284341,9.78788,8.14839,426,297280,0.00638409,0.03,1,62859,62433,426
286421,9.15758,8.02968,427,298940,0.00127682,0,1,62868,62441,427
288081,5.83152,8.80594,423,301020,0.000255364,0,1,62873,62450,423
291001,19.5663,18.5612,425,302680,0.00805107,0.01,1,62896,62471,425
293921,8.71326,8.51224,425,305600,0.00961022,0.01,1,62902,62477,425
295781,8.14265,6.50245,427,308520,0.00992204,0.03,1,62910,62483,427
297441,6.42853,8.50049,424,310380,0.0259844,0.01,1,62916,62492,424
299521,6.88571,7.3001,424,312040,0.0611969,0.02,1,62923,62499,424
302441,12.5771,12.66,424,314120,0.0122394,0.01,1,62937,62513,424
305361,8.11543,7.332,425,317040,0.0184479,0,1,62944,62519,425
307221,8.02309,6.2664,427,319960,0.0116896,0.03,1,62952,62525,427
308881,4.80462,7.65328,423,321820,0.0103379,0.05,1,62956,62533,423
311801,8.96092,7.93066,425,323480,0.00206758,0.01,1,62966,62541,425
313461,9.79218,6.38613,429,326400,0.000413517,0.06,1,62976,62547,429
315541,14.7584,8.47723,436,328060,0.0720827,0.02,1,62992,62556,436
317201,8.55169,12.8954,429,330140,0.110417,0.12,1,62999,62570,429
320121,8.11034,9.77909,428,331800,0.0780833,0.14,1,63007,62579,428
321781,6.42207,6.75582,428,334720,0.135617,0.11,1,63013,62585,428
324701,4.48441,6.95116,425,336380,0.131123,0.11,1,63017,62592,425
326561,3.29688,4.59023,424,339300,0.146225,0.06,1,63020,62596,424
328641,15.0594,12.918,427,341160,0.165245,0.09,1,63038,62611,427
331561,13.4119,11.3836,429,343240,0.113049,0.12,1,63051,62622,429
333221,6.68238,5.47672,430,346160,0.10261,0.12,1,63056,62626,430
334881,3.73648,4.29534,429,347820,0.076522,0.18,1,63059,62630,429
337801,7.9473,8.05907,429,349480,0.111304,0.18,1,63068,62639,429
339461,7.98946,4.81181,433,352400,0.134261,0.15,1,63076,62643,433
341121,5.59789,7.36236,430,354060,0.114852,0.15,1,63081,62651,430
343201,5.11958,7.07247,428,355720,0.0709704,0.13,1,63086,62658,428
346121,7.42392,9.41449,426,357800,0.110194,0.09,1,63094,62668,426
347781,11.0848,5.0829,434,360720,0.182039,0.09,1,63106,62672,434
350701,7.01696,10.6166,428,362380,0.196408,0.04,1,63112,62684,428
352561,5.40339,5.32332,429,365300,0.215282,0.15,1,63117,62688,429
355481,7.48068,7.46466,429,367160,0.235056,0.17,1,63125,62696,429
357141,8.69614,4.69293,434,370080,0.239011,0.12,1,63134,62700,434
358801,4.93923,11.3386,425,371740,0.255802,0.08,1,63138,62713,425
360881,5.78785,5.46772,427,373400,0.26716,0.11,1,63144,62717,427
363801,7.55757,7.49354,427,375480,0.229432,0.09,1,63152,62725,427
365461,7.91151,4.69871,431,375480,0.221886,0.13,1,63160,62729,431
367121,5.5823,7.33974,428,375480,0.268377,0.14,1,63165,62737,428
370041,10.7165,11.0679,428,375480,0.277675,0.1,1,63177,62749,428
372961,5.34329,5.41359,428,375480,0.247535,0.1,1,63181,62753,428
374821,8.26866,4.28272,433,375480,0.265507,0.14,1,63190,62757,433
377741,6.45373,8.05654,430,375480,0.253101,0.12,1,63196,62766,430
380021,10.8907,4.81131,438,375480,0.25062,0.1,1,63208,62770,438
381681,6.17815,12.1623,429,375480,0.282124,0.14,1,63213,62784,429
384601,9.23563,10.4325,429,375480,0.272425,0.13,1,63223,62794,429
386881,6.64713,5.28649,431,375480,0.214485,0.14,1,63229,62798,431
388961,4.52943,5.0573,430,375480,0.218897,0.15,1,63233,62803,430
391881,4.10589,3.41146,431,375480,0.227779,0.17,1,63237,62806,431
394801,4.02118,3.88229,431,375480,0.245556,0.15,1,63241,62810,431
396661,2.40424,3.97646,429,375480,0.241111,0.16,1,63243,62814,429
399581,3.68085,4.79529,428,375480,0.256222,0.15,1,63247,62819,428
402481,3.93617,4.15906,428,375480,0.283244,0.12,1,63251,62823,428
405401,5.58723,7.23181,426,375480,0.288649,0.12,1,63257,62831,426
408321,3.51745,4.64636,425,375480,0.27373,0.08,1,63260,62835,425
410801,2.30349,4.12927,423,375480,0.254746,0,1,63262,62839,423
412881,16.4607,16.8259,423,375480,0.194949,0,1,63282,62859,423
414961,9.69214,9.76517,423,375480,0.14299,0,1,63290,62867,423
417041,6.73843,6.75303,423,375480,0.068598,0,1,63296,62873,423
419121,8.54769,8.55061,423,375480,0.0137196,0,1,63305,62882,423
422041,19.3095,18.5101,424,377560,0.00274392,0.01,1,63327,62903,424
424321,7.86191,6.90202,425,377560,0.00854878,0.05,1,63332,62907,425
427241,7.97238,9.3804,423,377560,0.00170976,0.07,1,63340,62917,423
429941,11.9945,5.07608,432,377560,0.00834195,0.01,1,63353,62921,432
432021,9.5989,10.6152,429,377560,0.00166839,0.05,1,63362,62933,429
434101,8.31978,10.123,427,377560,0.0163337,0.03,1,63370,62943,427
435761,4.86396,8.42461,423,377560,0.00326674,0.01,1,63374,62951,423
437841,4.97279,5.68492,423,377560,0.0246533,0.02,1,63379,62956,423
440761,12.1946,10.737,425,377560,0.0529307,0,1,63393,62968,425
443461,19.2389,5.3474,442,377560,0.0185861,0.09,1,63414,62972,442
445541,14.2478,15.4695,437,377560,0.0117172,0.11,1,63427,62990,437
448241,7.64956,13.4939,430,377560,0.0503434,0.15,1,63433,63003,430
450321,11.1299,10.6988,432,377560,0.0660687,0.18,1,63445,63013,432
453241,9.42598,8.53976,433,377560,0.0772137,0.19,1,63454,63021,433
456161,4.2852,4.90795,432,377560,0.151443,0.15,1,63457,63025,432
459061,18.457,4.18159,450,377560,0.126289,0.13,1,63479,63029,450
461141,14.8914,20.0363,440,377560,0.0412577,0.14,1,63493,63053,440
464061,5.37828,14.4073,430,377560,0.0482515,0.17,1,63496,63066,430
465921,1.87566,6.08145,427,377560,0.0736503,0.14,1,63497,63070,427
468841,7.57513,8.41629,427,377560,0.0467301,0.1,1,63506,63079,427
471761,7.11503,4.88326,430,377560,0.089346,0.06,1,63513,63083,430
474241,7.02301,4.17665,433,377560,0.121869,0.19,1,63520,63087,433
476321,10.2046,9.63533,433,377560,0.112374,0.2,1,63531,63098,433
478401,14.8409,13.1271,435,377560,0.118475,0.22,1,63547,63112,435
481321,9.36818,7.42541,437,377560,0.127695,0.27,1,63555,63118,437
483601,4.27364,4.68508,436,377560,0.129539,0.25,1,63558,63122,436
485681,4.85473,4.93702,436,377560,0.137908,0.27,1,63563,63127,436
488601,16.1709,16.1874,436,377560,0.139582,0.25,1,63582,63146,436
491521,7.23419,6.43748,437,377560,0.171916,0.27,1,63587,63150,437
494001,4.64684,4.4875,437,377560,0.154383,0.27,1,63591,63154,437
496921,12.1294,12.0975,437,377560,0.134877,0.27,1,63605,63168,437
499621,10.4259,5.6195,443,377560,0.0989753,0.26,1,63615,63172,443
501701,9.28517,8.3239,443,377560,0.163795,0.3,1,63624,63181,443
503361,5.05703,10.4648,436,377560,0.136759,0.26,1,63628,63192,436
506281,8.21141,8.49296,437,377560,0.115352,0.26,1,63637,63200,437
508561,4.04228,4.89859,436,377560,0.0950704,0.28,1,63640,63204,436
511481,12.0085,13.7797,434,377560,0.0430141,0.27,1,63654,63220,434
514181,8.00169,5.95594,437,377560,0.0566028,0.2,1,63661,63224,437
516261,9.60034,5.19119,442,377560,0.115321,0.27,1,63671,63229,442
519181,5.92007,7.43824,439,377560,0.119064,0.29,1,63676,63237,439
522081,5.98401,4.68765,441,377560,0.0958128,0.28,1,63682,63241,441
525001,3.5968,6.53753,437,377560,0.107163,0.32,1,63685,63248,437
527921,3.11936,4.50751,436,377560,0.109433,0.32,1,63688,63252,436
530841,3.82387,4.1015,436,377560,0.0938865,0.29,1,63692,63256,436
533521,3.96477,4.0203,436,377560,0.106777,0.29,1,63696,63260,436
536441,4.79295,7.20406,433,377560,0.141355,0.29,1,63701,63268,433
539361,4.15859,4.64081,433,377560,0.140271,0.21,1,63705,63272,433
541841,2.43172,4.12816,431,377560,0.140054,0.19,1,63707,63276,431
543921,2.08634,6.42563,426,377560,0.124011,0,1,63709,63283,426
546841,11.6173,14.0851,424,377560,0.104802,0.01,1,63723,63299,424
549541,10.3235,6.01703,430,377560,0.0689604,0.05,1,63733,63303,430
551621,28.4647,9.2034,453,377560,0.0137921,0.06,1,63766,63313,453
554541,8.89294,28.2407,424,377560,0.00275842,0,1,63770,63346,424
557441,4.17859,8.84814,423,377560,0.00855168,0.07,1,63773,63350,423
560361,6.43572,6.56963,424,377560,0.00971034,0.05,1,63780,63356,424
562021,10.0871,4.51393,431,377560,0.00194207,0.01,1,63791,63360,431
564101,9.21743,9.70279,429,377560,0.000388413,0.05,1,63800,63371,429
566801,5.84349,8.34056,426,377560,0.0320777,0.08,1,63805,63379,426
568881,7.5687,10.4681,423,377560,0.0144155,0.03,1,63813,63390,423
570961,5.51374,6.09362,423,377560,0.00288311,0.01,1,63818,63395,423
573881,27.5027,26.0187,425,377560,0.00857662,0.07,1,63851,63426,425
575541,14.3005,8.40374,432,377560,0.0337153,0.11,1,63862,63430,432
578461,7.66011,10.4807,427,377560,0.00674306,0.07,1,63868,63441,427
580741,10.332,5.29615,434,377560,0.0733486,0.1,1,63879,63445,434
582821,8.4664,7.45923,434,377560,0.0466697,0.16,1,63887,63453,434
584901,4.89328,6.29185,432,377560,0.0493339,0.2,1,63891,63459,432
586561,2.57866,6.05837,428,377560,0.0498668,0.1,1,63893,63465,428
589481,12.5157,15.6117,425,377560,0.0579734,0.05,1,63908,63483,425
591141,12.1031,6.32233,433,377560,0.0435947,0.11,1,63920,63487,433
593221,11.2206,10.0645,433,377560,0.0167189,0.09,1,63931,63498,433
596141,7.04413,9.21289,430,377560,0.0353438,0.11,1,63937,63507,430
598421,3.80883,5.04258,429,377560,0.0790688,0.12,1,63940,63511,429
600501,3.96177,3.40852,430,377560,0.0878137,0.14,1,63944,63514,430
602161,2.39235,4.6817,427,377560,0.0655628,0.13,1,63946,63519,427
605081,10.8785,9.73634,429,377560,0.101113,0.13,1,63959,63530,429
606741,9.37569,5.14727,434,377560,0.100223,0.17,1,63968,63534,434
608821,16.2751,9.02945,442,377560,0.172045,0.13,1,63986,63544,442
611521,7.25503,14.6059,431,377560,0.178409,0.13,1,63991,63560,431
614441,6.25101,7.72118,431,377560,0.139682,0.16,1,63997,63566,431
616721,4.4502,4.74424,431,377560,0.115936,0.18,1,64001,63570,431
619641,16.09,16.9488,430,377560,0.111187,0.14,1,64020,63590,430
621921,6.41801,6.58977,430,377560,0.110237,0.13,1,64024,63594,430
624841,5.2836,6.91795,428,377560,0.0940475,0.15,1,64029,63601,428
627121,4.25672,4.58359,428,377560,0.10681,0.13,1,64033,63605,428
630041,17.6513,19.3167,426,377560,0.0453619,0.14,1,64054,63628,426
632321,8.33027,7.06334,428,377560,0.0490724,0.14,1,64060,63632,428
634401,5.66605,3.81267,430,377560,0.0418145,0.07,1,64065,63635,430
637321,13.1332,14.3625,428,377560,0.104363,0.09,1,64080,63652,428
639601,7.42664,6.07251,430,377560,0.108873,0.08,1,64086,63656,430
642521,4.68533,6.8145,427,377560,0.109775,0.15,1,64090,63663,427
644801,4.93707,4.5629,428,377560,0.101955,0.13,1,64095,63667,428
646881,6.58741,4.91258,430,377560,0.036391,0.13,1,64102,63672,430
649801,8.51748,9.78252,428,377560,0.127278,0.13,1,64111,63683,428
652721,6.5035,5.1565,430,377560,0.153456,0.1,1,64117,63687,430
654581,6.1007,4.2313,432,377560,0.142691,0.15,1,64123,63691,432
657501,2.82014,5.64626,428,377560,0.140538,0.2,1,64125,63697,428
660421,3.76403,4.32925,428,377560,0.156108,0.17,1,64129,63701,428
663341,3.95281,4.06585,428,377560,0.143222,0.14,1,64133,63705,428
666261,4.79056,4.01317,429,377560,0.148644,0.13,1,64138,63709,429
669181,3.35811,4.00263,428,377560,0.149729,0.13,1,64141,63713,428
672101,2.27162,4.00053,426,377560,0.141946,0.14,1,64143,63717,426
674961,3.65432,4.00011,426,377560,0.116389,0.1,1,64147,63721,426
677041,7.13086,8.80002,424,377560,0.135278,0,1,64155,63731,424
679961,11.8262,12.96,423,377560,0.0990556,0,1,64168,63745,423
681621,23.9652,5.792,446,377560,0.0198111,0.03,1,64195,63749,446
684541,7.19305,21.9584,423,377560,0.0119622,0.03,1,64198,63775,423
686821,10.2386,7.59168,430,377560,0.0103924,0,1,64209,63779,430
689741,6.84772,10.3183,425,377560,0.0100785,0.01,1,64215,63790,425
692641,3.76954,5.26367,424,377560,0.0020157,0.01,1,64218,63794,424
695561,14.3539,15.4527,423,377560,0.0244031,0,1,64235,63812,423
697841,7.67078,6.29055,425,377560,0.0288806,0.05,1,64241,63816,425
700761,7.93416,9.25811,423,377560,0.00577613,0.04,1,64249,63826,423
703461,31.9868,5.05162,457,377560,0.00915523,0.03,1,64287,63830,457
706161,11.1974,29.8103,427,377560,0.033831,0.05,1,64293,63866,427
709081,7.83947,13.1621,425,377560,0.0307662,0.09,1,64300,63875,425
710741,14.3679,5.83241,437,377560,0.0381532,0.07,1,64316,63879,437
713661,6.07358,12.3665,427,377560,0.0556307,0.06,1,64320,63893,427
716581,3.61472,5.6733,426,377560,0.0351261,0.09,1,64323,63897,426
719061,11.1229,4.33466,435,377560,0.0470252,0.1,1,64336,63901,435
721141,16.6246,12.8669,438,377560,0.033405,0.03,1,64354,63916,438
723221,14.5249,14.5734,437,377560,0.022681,0.07,1,64368,63931,437
726141,7.70498,14.1147,429,377560,0.0125362,0.11,1,64374,63945,429
729041,3.941,6.02294,428,377560,0.0105072,0.12,1,64377,63949,428
731961,5.5882,6.00459,428,377560,0.0581014,0.15,1,64383,63955,428
734661,9.11764,4.40092,434,377560,0.0836203,0.12,1,64393,63959,434
736741,9.02353,8.08018,434,377560,0.128724,0.11,1,64402,63968,434
738821,17.8047,5.61604,449,377560,0.0657448,0.11,1,64422,63973,449
741741,8.36094,21.9232,429,377560,0.085149,0.11,1,64428,63999,429
744661,4.07219,7.58464,428,377560,0.0730298,0.1,1,64431,64003,428
747581,4.01444,4.71693,428,377560,0.062606,0.12,1,64435,64007,428
749221,18.4029,4.14339,446,377560,0.0365212,0.12,1,64457,64011,446
752141,6.88058,19.2287,427,377560,0.0633042,0.1,1,64461,64034,427
755041,4.57612,7.04574,427,377560,0.0686608,0.11,1,64465,64038,427
757961,6.51522,8.60915,425,377560,0.0297322,0.08,1,64472,64047,425
759621,6.90304,4.92183,428,377560,0.0219464,0.05,1,64479,64051,428
761701,7.78061,5.78437,430,377560,0.0923893,0.08,1,64487,64057,430
763361,5.55612,6.75687,428,377560,0.0664779,0.07,1,64492,64064,428
765441,6.71122,6.15137,429,377560,0.0772956,0.11,1,64499,64070,429
768361,14.9422,17.2303,426,377560,0.111459,0.11,1,64516,64090,426
770641,6.18845,6.64605,426,377560,0.118292,0.08,1,64520,64094,426
773561,6.03769,3.72921,429,377560,0.0876584,0.04,1,64526,64097,429
775841,6.00754,3.94584,431,377560,0.0735317,0.12,1,64532,64101,431
777921,6.80151,5.58917,432,377560,0.0547063,0.19,1,64539,64107,432
780001,5.3603,5.91783,431,377560,0.0589413,0.14,1,64544,64113,431
782921,9.87206,10.7836,430,377560,0.0757883,0.17,1,64555,64125,430
785201,5.17441,5.35671,430,377560,0.0711576,0.17,1,64559,64129,430
788121,5.83488,6.67134,429,377560,0.0702315,0.16,1,64565,64136,429
791041,4.36698,4.53427,429,377560,0.0540463,0.15,1,64569,64140,429
793521,4.0734,4.10685,429,377560,0.0668093,0.14,1,64573,64144,429
796441,4.81468,5.62137,428,377560,0.0693619,0.15,1,64578,64150,428
799361,4.16294,4.32427,428,377560,0.0778724,0.12,1,64582,64154,428
802281,2.43259,4.06485,426,377560,0.0715745,0.12,1,64584,64158,426
805201,2.88652,4.01297,425,377560,0.0623149,0.13,1,64587,64162,425
808081,3.7773,4.00259,425,377560,0.060463,0.07,1,64591,64166,425
810161,7.95546,8.80052,424,377560,0.0360926,0.01,1,64600,64176,424
813081,27.1911,28.1601,423,377560,0.0232185,0,1,64632,64209,423
815361,8.63822,8.83202,423,377560,0.0126437,0.01,1,64636,64213,423
818281,7.32764,7.3664,423,377560,0.0105287,0.01,1,64643,64220,423
821201,6.26553,4.67328,425,377560,0.00210575,0,1,64649,64224,425
823681,4.45311,4.13466,425,377560,0.00042115,0.06,1,64653,64228,425
825761,6.49062,8.02693,423,377560,0.00808423,0,1,64660,64237,423
828681,7.69812,8.00539,423,377560,0.00961685,0.02,1,64668,64245,423
830341,9.53962,4.80108,429,377560,0.00992337,0.03,1,64678,64249,429
832421,28.3079,8.16022,453,377560,0.00998467,0.07,1,64711,64258,453
834081,9.66158,28.032,425,377560,0.00999693,0.05,1,64716,64291,425
837001,12.3323,16.0064,425,377560,0.0339994,0.01,1,64729,64304,425
839281,6.46646,6.40128,426,377560,0.0627999,0.09,1,64734,64308,426
841361,10.0933,10.0803,426,377560,0.05256,0.04,1,64745,64319,426
844281,6.81866,6.81605,426,377560,0.050512,0.07,1,64751,64325,426
847201,5.36373,4.56321,427,377560,0.0501024,0.06,1,64756,64329,427
849061,5.07275,4.11264,428,377560,0.0820205,0.11,1,64761,64333,428
851141,19.4145,7.22253,443,377560,0.0564041,0.03,1,64784,64341,443
853221,11.0829,20.6445,428,377560,0.0192808,0.02,1,64793,64365,428
855301,8.61658,9.7289,429,377560,0.0118562,0.05,1,64801,64372,429
856961,4.92332,7.54578,426,377560,0.0263712,0.06,1,64805,64379,426
859881,8.98466,7.10916,429,377560,0.0452742,0.1,1,64815,64386,429
862161,5.79693,4.62183,430,377560,0.0490548,0.13,1,64820,64390,430
865081,5.15939,4.92437,430,377560,0.089811,0.14,1,64825,64395,430
866741,13.0319,4.18487,441,377560,0.0819622,0.06,1,64840,64399,441
868821,12.2064,15.237,435,377560,0.0243924,0.07,1,64852,64417,435
871741,7.24128,14.2474,427,377560,0.0368785,0.06,1,64858,64431,427
874021,7.84826,6.04948,431,377560,0.0553757,0.1,1,64866,64435,431
876941,5.56965,10.0099,425,377560,0.0590751,0.04,1,64871,64446,425
879221,10.7139,5.20198,433,377560,0.027815,0.08,1,64883,64450,433
881301,10.9428,10.6404,432,377560,0.021563,0.06,1,64894,64462,432
884221,8.58856,10.9281,429,377560,0.0283126,0.06,1,64902,64473,429
886081,2.51771,5.38562,426,377560,0.0296625,0.11,1,64903,64477,426
889001,6.10354,6.67712,426,377560,0.0219325,0.13,1,64910,64484,426
891701,6.82071,4.53542,429,377560,0.0443865,0.05,1,64917,64488,429
894401,6.16414,6.50708,428,377560,0.0808773,0.09,1,64923,64495,428
896481,8.43283,7.70142,429,377560,0.0481755,0.1,1,64932,64503,429
899401,15.2866,19.1403,424,377560,0.0416351,0.09,1,64949,64525,424
901681,7.85731,7.02806,426,377560,0.032327,0.05,1,64955,64529,426
904601,7.97146,7.80561,426,377560,0.0304654,0.09,1,64963,64537,426
906881,4.79429,4.76112,426,377560,0.0300931,0.06,1,64967,64541,426
909801,6.55886,5.75222,427,377560,0.0780186,0.11,1,64974,64547,427
912501,10.9118,4.35044,435,377560,0.0796037,0.1,1,64986,64551,435
915421,4.58235,11.2701,425,377560,0.111921,0.06,1,64989,64564,425
918321,4.91647,5.45402,426,377560,0.0943842,0.09,1,64994,64568,426
921241,7.38329,7.4908,426,377560,0.0748768,0.08,1,65002,64576,426
924161,4.67666,4.69816,426,377560,0.0949754,0.07,1,65006,64580,426
926021,3.33533,4.13963,425,377560,0.0749951,0.08,1,65009,64584,425
928941,3.86707,4.82793,424,377560,0.046999,0.09,1,65013,64589,424
931861,3.97341,4.16559,424,377560,0.0493998,0.05,1,65017,64593,424
934781,3.19468,4.03312,423,377560,0.07388,0.06,1,65020,64597,423
937701,3.83894,4.00662,423,377560,0.046776,0.06,1,65024,64601,423
940621,3.96779,4.00132,423,377560,0.0573552,0.01,1,65028,64605,423
942661,27.9936,4.00026,453,377560,0.011471,0.01,1,65062,64609,453
945581,9.59871,28.0001,424,377560,0.00229421,0.03,1,65067,64643,424
948481,5.11974,8.80001,424,377560,0.000458842,0.01,1,65071,64647,424
951401,10.6239,12.16,423,377560,0.0240918,0,1,65083,64660,423
954321,5.32479,5.632,423,377560,0.0288184,0.01,1,65087,64664,423
956181,7.46496,4.3264,427,377560,0.0137637,0.01,1,65095,64668,427
958881,3.89299,6.46528,423,377560,0.00275273,0.02,1,65098,64675,423
960961,7.1786,7.69306,423,377560,0.000550547,0.05,1,65106,64683,423
963881,37.4357,35.1386,426,377560,0.00811011,0.06,1,65151,64725,426
966581,12.2871,10.2277,428,377560,0.00162202,0.07,1,65157,64729,428
968661,8.85743,7.64554,429,377560,0.0563244,0.05,1,65165,64736,429
971581,6.57149,7.92911,427,377560,0.0112649,0.08,1,65171,64744,427
973861,6.9143,4.78582,430,377560,0.034253,0.11,1,65178,64748,430
975941,10.1829,8.15716,432,377560,0.0468506,0.03,1,65189,64757,432
978861,6.03657,11.2314,425,377560,0.00937012,0.03,1,65194,64769,425
981141,16.4073,5.44629,440,377560,0.065874,0.03,1,65213,64773,440
983221,8.08146,17.0893,426,377560,0.0131748,0.04,1,65219,64793,426
985301,8.01629,7.41785,429,377560,0.026635,0.05,1,65227,64798,429
987381,9.60326,7.08357,432,377560,0.029327,0.08,1,65237,64805,432
989461,9.92065,8.61671,433,377560,0.0378654,0.12,1,65247,64814,433
992381,5.18413,9.72334,427,377560,0.0315731,0.08,1,65251,64824,427
995281,3.43683,5.14467,426,377560,0.0383146,0.03,1,65254,64828,426
997361,19.0874,19.4289,426,377560,0.0636629,0.06,1,65277,64851,426
1000281,11.8175,11.8858,426,377560,0.0847326,0.08,1,65287,64861,426
1002561,6.36349,5.57716,427,377560,0.0729465,0.08,1,65292,64865,427
1005481,9.2727,11.5154,424,377560,0.0945893,0.03,1,65302,64878,424
1007761,5.05454,5.50309,424,377560,0.0669179,0.01,1,65306,64882,424
1009841,6.61091,6.70062,424,377560,0.101384,0.03,1,65313,64889,424
1012761,15.7222,14.1401,426,377560,0.0282767,0.03,1,65331,64905,426
1015681,7.14444,6.02802,427,377560,0.0216553,0.05,1,65336,64909,427
1018601,3.02889,4.4056,425,377560,0.0283311,0.09,1,65338,64913,425
1020661,7.80578,4.08112,430,377560,0.0216662,0.05,1,65347,64917,430
1023581,4.76116,8.01622,425,377560,0.0523332,0.05,1,65351,64926,425
1025441,3.35223,4.80324,424,377560,0.0664666,0.07,1,65354,64930,424
1027521,6.27045,5.76065,425,377560,0.0292933,0.05,1,65361,64936,425
1030441,20.4541,18.7521,427,377560,0.0298587,0.05,1,65385,64958,427
1032721,7.29082,6.95043,427,377560,0.0299717,0.1,1,65389,64962,427
1035641,7.05816,7.79009,426,377560,0.00599435,0.12,1,65396,64970,426
1037921,4.61163,4.75802,426,377560,0.00919887,0.05,1,65400,64974,426
1040001,6.52233,6.5516,426,377560,0.00983977,0.1,1,65407,64981,426
1042921,12.5045,10.9103,428,377560,0.057968,0.08,1,65421,64993,428
1045841,4.10089,5.38206,426,377560,0.0435936,0.1,1,65423,64997,426
1047701,3.22018,4.27641,425,377560,0.0327187,0.1,1,65426,65001,425
1050621,5.44404,4.85528,426,377560,0.0785437,0.08,1,65432,65006,426
1052901,5.88881,4.17106,428,377560,0.103709,0.09,1,65438,65010,428
1055821,4.37776,6.43421,425,377560,0.140742,0.1,1,65442,65017,425
1058741,4.07555,4.48684,425,377560,0.156148,0.07,1,65446,65021,425
1061661,3.21511,4.09737,424,377560,0.14323,0.07,1,65449,65025,424
1064581,3.84302,4.01947,424,377560,0.132646,0.07,1,65453,65029,424
1067501,3.9686,4.00389,424,377560,0.114529,0.04,1,65457,65033,424
1070421,3.99372,4.00078,424,377560,0.118906,0.06,1,65461,65037,424
1072661,27.1987,4.00016,453,377560,0.0717812,0.01,1,65494,65041,453
1075581,8.63975,27.2,424,377560,0.0303562,0.03,1,65498,65074,424
1078501,4.12795,8.64001,423,377560,0.00607125,0.03,1,65501,65078,423
1080981,10.4256,4.928,431,377560,0.00921425,0.01,1,65513,65082,431
1083901,5.28512,10.5856,423,377560,0.00184285,0,1,65517,65094,423
1086821,4.25702,5.31712,423,377560,0.00836857,0.03,1,65521,65098,423
1089741,4.0514,4.26342,423,377560,0.00967371,0.02,1,65525,65102,423
1091381,6.41028,4.05268,426,377560,0.00193474,0.03,1,65532,65106,426
1093461,42.0821,5.61054,471,377560,0.000386949,0.08,1,65583,65112,471
1096381,12.4164,42.7221,424,377560,0.00807739,0.04,1,65588,65164,424
1099281,5.68328,11.7444,424,377560,0.00961548,0.06,1,65592,65168,424
1102201,8.33666,8.74888,425,377560,0.0179231,0.05,1,65601,65176,425
1103861,7.26733,4.94978,428,377560,0.0115846,0.08,1,65608,65180,428
1105941,10.2535,7.38996,431,377560,0.0263169,0.07,1,65619,65188,431
1108861,6.85069,9.47799,427,377560,0.00526338,0.07,1,65625,65198,427
1111141,11.7701,5.0956,436,377560,0.0490527,0.01,1,65638,65202,436
1113221,15.154,13.8191,436,377560,0.00981054,0.04,1,65654,65218,436
1115921,6.23081,14.7638,425,377560,0.0339621,0.06,1,65658,65233,425
1118001,12.4462,13.3528,426,377560,0.0467924,0.08,1,65672,65246,426
1120921,9.68923,11.4706,424,377560,0.0173585,0.05,1,65681,65257,424
1123841,6.73785,5.49411,426,377560,0.0434717,0.02,1,65687,65261,426
1126321,4.54757,4.29882,426,377560,0.0326943,0.09,1,65691,65265,426
1128401,17.7095,16.0598,428,377560,0.0705389,0.12,1,65712,65284,428
1131321,14.7419,14.412,428,377560,0.0781078,0.12,1,65726,65298,428
1133601,6.14838,6.08239,428,377560,0.0476216,0.11,1,65730,65302,428
1136521,6.02968,10.0165,423,377560,0.0495243,0.06,1,65736,65313,423
1139441,4.40594,5.2033,423,377560,0.0419049,0.02,1,65740,65317,423
1142341,17.6812,4.24066,440,377560,0.032381,0.05,1,65761,65321,440
1145261,9.13624,16.8481,427,377560,0.0304762,0.05,1,65768,65341,427
1148181,3.42725,6.56963,425,377560,0.0300952,0.05,1,65770,65345,425
1150661,6.28545,4.51393,428,377560,0.046019,0.09,1,65777,65349,428
1153581,4.45709,5.70279,426,377560,0.121204,0.06,1,65781,65355,426
1156481,4.09142,4.34056,426,377560,0.144241,0.08,1,65785,65359,426
1158561,8.01828,6.46811,428,377560,0.156848,0.01,1,65794,65366,428
1161481,27.2037,28.4936,426,377560,0.0793696,0.03,1,65826,65400,426
1164401,9.44073,8.89872,427,377560,0.0958739,0.03,1,65831,65404,427
1167301,6.68815,4.97974,429,377560,0.0991748,0.08,1,65837,65408,429
1170221,6.13763,8.19595,426,377560,0.083835,0.07,1,65843,65417,426
1172501,4.42753,4.83919,426,377560,0.072767,0.02,1,65847,65421,426
1174581,7.28551,3.36784,431,377560,0.0305534,0.09,1,65855,65424,431
1177501,6.2571,5.47357,431,377560,0.0221107,0.11,1,65861,65430,431
1180421,4.45142,4.29471,431,377560,0.0284221,0.13,1,65865,65434,431
1182901,7.29028,4.05894,435,377560,0.0616844,0.17,1,65873,65438,435
1185821,3.85806,8.01179,429,377560,0.0683369,0.18,1,65876,65447,429
1188101,5.57161,4.80236,431,377560,0.0616674,0.14,1,65882,65451,431
1191021,4.31432,6.56047,428,377560,0.0923335,0.13,1,65886,65458,428
1193941,4.06286,4.51209,428,377560,0.0824667,0.12,1,65890,65462,428
1196861,4.01257,4.10242,428,377560,0.0484933,0.13,1,65894,65466,428
1199781,3.20251,4.02048,427,377560,0.0656987,0.13,1,65897,65470,427
1202661,19.0405,4.0041,446,377560,0.0611397,0,1,65920,65474,446
1204741,11.0081,21.6008,429,377560,0.0202279,0.04,1,65929,65500,429
1207661,5.40162,12.3202,423,377560,0.0120456,0.01,1,65933,65510,423
1210581,4.28032,5.66403,423,377560,0.0104091,0.03,1,65937,65514,423
1213061,6.45606,4.33281,426,377560,0.0260818,0.02,1,65944,65518,426
1215981,4.49121,6.46656,423,377560,0.0292164,0,1,65948,65525,423
1218901,4.09824,4.49331,423,377560,0.0138433,0.03,1,65952,65529,423
1221381,6.41965,4.09866,426,377560,0.0107687,0.02,1,65959,65533,426
1223461,44.4839,5.61973,474,377560,0.00215373,0.06,1,66013,65539,474
1226381,12.0968,45.1239,423,377560,0.000430746,0.04,1,66017,65594,423
1228661,6.41936,12.2248,424,377560,0.00808615,0.02,1,66022,65598,424
1230321,4.48387,4.84496,425,377560,0.0416172,0.01,1,66026,65601,425
1232401,5.69677,6.56899,424,377560,0.0323234,0.02,1,66032,65608,424
1235321,13.9394,13.3138,425,377560,0.0464647,0.01,1,66048,65623,425
1238021,6.78787,5.86276,426,377560,0.0652929,0.03,1,66053,65627,426
1239681,5.35757,3.57255,428,377560,0.0530586,0.14,1,66058,65630,428
1241761,6.67151,10.3145,423,377560,0.0106117,0.07,1,66065,65642,423
1243841,14.9343,14.0629,425,377560,0.0581223,0.06,1,66082,65657,425
1246761,12.5869,12.4126,425,377560,0.0276245,0.06,1,66094,65669,425
1248421,10.5174,5.68252,431,377560,0.0135249,0.1,1,66104,65673,431
1250501,11.7035,9.1365,433,377560,0.034705,0.08,1,66116,65683,433
1253421,5.54069,9.8273,427,377560,0.046941,0.11,1,66120,65693,427
1255701,5.10814,5.16546,428,377560,0.0253882,0.1,1,66125,65697,428
1257361,5.02163,5.03309,428,377560,0.0210776,0.15,1,66130,65702,428
1259441,9.80433,11.4066,426,377560,0.0282155,0.04,1,66141,65715,426
1261521,13.1609,14.2813,425,377560,0.0616431,0.06,1,66155,65730,425
1264441,13.0322,14.0563,424,377560,0.0683286,0.04,1,66168,65744,424
1267361,5.80643,6.01125,424,377560,0.0616657,0.01,1,66172,65748,424
1269841,5.16129,4.40225,425,377560,0.0363331,0.03,1,66177,65752,425
1272761,17.0323,13.6805,429,377560,0.0472666,0.04,1,66197,65768,429
1274421,9.80645,5.93609,433,377560,0.00945333,0.15,1,66205,65772,433
1277341,8.36129,7.58722,433,377560,0.0258907,0.16,1,66213,65780,433
1280261,3.27226,4.71744,431,377560,0.0211781,0.13,1,66215,65784,431
1283181,2.25445,4.14349,429,377560,0.0122356,0.2,1,66217,65788,429
1286101,2.85089,4.0287,428,377560,0.0104471,0.16,1,66220,65792,428
1288981,3.77018,4.00574,428,377560,0.0260894,0.12,1,66224,65796,428
1291061,31.954,4.00115,463,377560,0.0292179,0.08,1,66263,65800,463
1293981,9.59081,35.2002,424,377560,0.0298436,0.07,1,66267,65843,424
1296901,5.11816,10.24,424,377560,0.0299687,0.06,1,66271,65847,424
1299381,5.02363,5.24801,425,377560,0.0139937,0.02,1,66276,65851,425
1302301,5.80473,5.0496,426,377560,0.0267987,0.03,1,66282,65856,426
1304581,7.56095,4.20992,430,377560,0.0613597,0.07,1,66290,65860,430
1307501,3.91219,6.44198,426,377560,0.084272,0.1,1,66293,65867,426
1309781,10.3824,4.4884,434,377560,0.136854,0.12,1,66305,65871,434
1312701,4.47649,9.69768,426,377560,0.131371,0.13,1,66308,65882,426
1315621,4.0953,5.13954,426,377560,0.106274,0.11,1,66312,65886,426
1318101,3.21906,4.22791,425,377560,0.0772548,0.06,1,66315,65890,425
1321021,3.84381,3.24558,426,377560,0.055451,0.07,1,66319,65893,426
1323941,4.76876,3.84912,427,377560,0.0670902,0.08,1,66324,65897,427
1326861,4.15375,3.96982,427,377560,0.069418,0.09,1,66328,65901,427
1329781,4.03075,3.99396,427,377560,0.0698836,0.1,1,66332,65905,427
1331621,19.2061,3.99879,446,377560,0.0379767,0.02,1,66355,65909,446
1334541,7.04123,21.5998,424,377560,0.0315953,0.01,1,66359,65935,424
1336821,5.40825,7.51995,425,377560,0.0143191,0.03,1,66364,65939,425
1339741,4.28165,5.50399,424,377560,0.0108638,0.05,1,66368,65944,424
1341601,2.45633,4.3008,422,377560,0.0261728,0.01,1,66370,65948,422
1344521,4.49127,4.06016,423,377560,0.00523455,0.05,1,66375,65952,423
1347441,4.09825,4.01203,423,377560,0.00904691,0.02,1,66379,65956,423
1349921,4.01965,4.00241,423,377560,0.0178094,0.03,1,66383,65960,423
1352001,7.20393,7.20048,423,377560,0.0275619,0.05,1,66391,65968,423
1354921,47.8408,47.8401,423,377560,0.00551238,0.05,1,66449,66026,423
1357841,13.5682,12.768,424,377560,0.00910247,0,1,66454,66030,424
1360761,6.71363,5.7536,425,377560,0.0418205,0.03,1,66459,66034,425
1363441,5.34273,4.35072,426,377560,0.0323641,0.01,1,66464,66038,426
1366361,17.8685,19.2701,424,377560,0.0624728,0.01,1,66485,66061,424
1369281,8.37371,7.05403,426,377560,0.0844946,0.01,1,66491,66065,426
1372201,4.87474,4.61081,426,377560,0.0808989,0.06,1,66495,66069,426
1374261,15.3749,4.12216,440,377560,0.0561798,0.02,1,66513,66073,440
1376341,11.875,17.6244,430,377560,0.019236,0.02,1,66524,66094,430
1378421,11.975,11.5249,432,377560,0.0518472,0.05,1,66536,66104,432
1380501,13.595,11.905,434,377560,0.0663694,0.08,1,66550,66116,434
1383421,5.919,13.581,424,377560,0.0532739,0.07,1,66554,66130,424
1386321,3.5838,5.9162,423,377560,0.0426548,0.03,1,66557,66134,423
1388401,9.51676,6.78324,427,377560,0.032531,0.05,1,66568,66141,427
1390481,5.10335,5.35665,426,377560,0.0545062,0.06,1,66572,66146,426
1392561,9.82067,9.87133,426,377560,0.0109012,0.06,1,66583,66157,426
1394641,9.96413,12.3743,423,377560,0.0581802,0.03,1,66593,66170,423
1397561,10.7928,9.67485,425,377560,0.0356361,0.02,1,66604,66179,425
1400481,6.15857,5.13497,426,377560,0.0231272,0.03,1,66609,66183,426
1402341,18.8317,4.22699,444,377560,0.0126254,0.03,1,66631,66187,444
1405261,9.36634,20.8454,426,377560,0.0505251,0.01,1,66638,66212,426
1408161,5.87327,7.36908,427,377560,0.010105,0.03,1,66643,66216,427
1411081,6.77465,4.67382,430,377560,0.042021,0.09,1,66650,66220,430
1414001,5.35493,4.13476,431,377560,0.0884042,0.15,1,66655,66224,431
1416481,3.47099,4.02695,430,377560,0.113681,0.14,1,66658,66228,430
1419401,3.8942,3.20539,431,377560,0.102736,0.15,1,66662,66231,431
1421061,26.3788,3.84108,459,377560,0.0445472,0.02,1,66694,66235,459
1423981,10.0758,31.9682,426,377560,0.0169094,0.03,1,66700,66274,426
1426901,5.21515,9.59364,426,377560,0.0273819,0.05,1,66704,66278,426
1429821,5.84303,5.11873,428,377560,0.0294764,0.09,1,66710,66282,428
1432741,5.16861,4.22375,429,377560,0.0138953,0.09,1,66715,66286,429
1434581,4.23372,4.04475,429,377560,0.0187791,0.13,1,66719,66290,429
1436661,6.44674,4.00895,432,377560,0.0677558,0.17,1,66726,66294,432
1438321,2.88935,7.20179,426,377560,0.0775512,0.11,1,66728,66302,426
1441241,7.77787,8.64036,426,377560,0.11151,0.1,1,66737,66311,426
1444161,4.75557,4.92807,426,377560,0.110302,0.07,1,66741,66315,426
1447081,4.15111,4.18561,426,377560,0.13406,0.09,1,66745,66319,426
1450001,4.03022,4.03712,426,377560,0.138812,0.1,1,66749,66323,426
1452921,4.00604,4.00742,426,377560,0.123762,0.1,1,66753,66327,426
1455841,4.00121,4.00148,426,377560,0.104752,0.1,1,66757,66331,426
1458761,4.00024,4.0003,426,377560,0.0849505,0.1,1,66761,66335,426
1461621,23.2,4.00006,450,377560,0.12099,0.03,1,66789,66339,450
1464541,7.84001,24.8,424,377560,0.088198,0.01,1,66793,66369,424
1467441,3.968,8.16,423,377560,0.0816396,0.04,1,66796,66373,423
1470361,5.5936,4.832,425,377560,0.0883279,0.06,1,66802,66377,425
1473281,3.51872,4.1664,424,377560,0.0816656,0.05,1,66805,66381,424
1476181,3.90374,4.03328,424,377560,0.0723331,0.07,1,66809,66385,424
1479101,3.98075,4.00666,424,377560,0.0624666,0.04,1,66813,66389,424
1480961,2.39615,4.00133,422,377560,0.0524933,0.06,1,66815,66393,422
1483041,6.07923,5.60027,423,377560,0.0344987,0.05,1,66822,66399,423
1485961,53.2158,52.3201,424,377560,0.0308997,0,1,66887,66463,424
1488881,15.4432,13.664,426,377560,0.0221799,0.01,1,66893,66467,426
1491801,6.28863,5.9328,426,377560,0.012436,0.04,1,66897,66471,426
1494481,5.25773,4.38656,427,377560,0.0104872,0.09,1,66902,66475,427
1497401,15.4515,17.6773,424,377560,0.0100974,0.08,1,66920,66496,424
1500321,7.09031,6.73546,425,377560,0.0260195,0.06,1,66925,66500,425
1502801,4.61806,4.54709,425,377560,0.0292039,0.01,1,66929,66504,425
1504881,16.9236,16.9094,425,377560,0.0618408,0.07,1,66949,66524,425
1506961,12.9847,12.1819,426,377560,0.0123682,0.08,1,66961,66535,426
1509041,7.39694,8.03638,425,377560,0.00247363,0.06,1,66967,66542,425
1511961,13.4794,12.8073,426,377560,0.000494726,0.06,1,66982,66556,426
1514881,5.89588,5.76145,426,377560,0.0320989,0.08,1,66986,66560,426
1517361,4.37918,4.35229,426,377560,0.0464198,0.07,1,66990,66564,426
1520281,8.87584,9.67046,425,377560,0.041284,0.04,1,67000,66575,425
1522981,9.77517,5.13409,431,377560,0.0562568,0.08,1,67010,66579,431
1525061,9.15503,7.42682,432,377560,0.0512514,0.08,1,67019,66587,432
1527141,12.231,11.0854,433,377560,0.0102503,0.03,1,67032,66599,433
1529221,12.8462,11.8171,434,377560,0.0100501,0.05,1,67045,66611,434
1530881,6.56924,13.5634,425,377560,0.01801,0.07,1,67050,66625,425
1532961,10.1138,12.3127,424,377560,0.027602,0.01,1,67061,66637,424
1535881,9.22277,6.46254,428,377560,0.0215204,0,1,67070,66642,428
1537541,8.24455,4.49251,432,377560,0.0363041,0.12,1,67078,66646,432
1540461,4.04891,7.2985,427,377560,0.0312608,0.14,1,67081,66654,427
1543381,4.00978,4.6597,427,377560,0.0142522,0.14,1,67085,66658,427
1545861,4.00196,4.13194,427,377560,0.00285043,0.12,1,67089,66662,427
1548781,4.00039,7.22639,423,377560,0.0165701,0.07,1,67093,66670,423
1551061,29.6001,4.64528,455,377560,0.011314,0.06,1,67129,66674,455
1553981,9.92002,28.9291,425,377560,0.0182628,0.05,1,67134,66709,425
1556901,5.984,8.98581,426,377560,0.0116526,0.03,1,67139,66713,426
1559821,5.1968,4.99716,427,377560,0.0103305,0.09,1,67144,66717,427
1562741,4.23936,4.19943,427,377560,0.0340661,0.09,1,67148,66721,427
1565201,4.84787,4.03989,428,377560,0.0308132,0.11,1,67153,66725,428
1568121,8.16957,6.40798,430,377560,0.0701626,0.14,1,67162,66732,430
1570821,5.63391,4.4816,431,377560,0.0300325,0.11,1,67167,66736,431
1572901,9.12678,4.89632,436,377560,0.0460065,0.14,1,67177,66741,436
1575821,5.02536,10.5793,428,377560,0.0412013,0.12,1,67181,66753,428
1578741,4.20507,5.31585,428,377560,0.00824026,0.12,1,67185,66757,428
1581661,4.04101,4.26317,428,377560,0.0576481,0.13,1,67189,66761,428
1584581,4.0082,4.05263,428,377560,0.0915296,0.14,1,67193,66765,428
1587501,4.00164,4.01053,428,377560,0.0423059,0.14,1,67197,66769,428
1589121,4.00033,4.00211,428,377560,0.0164612,0.1,1,67201,66773,428
1592041,16.0001,17.6004,426,377560,0.0272922,0.11,1,67220,66794,426
1594961,6.40001,6.72008,426,377560,0.0694584,0.1,1,67224,66798,426
1596821,3.68,4.54402,425,377560,0.0618917,0.11,1,67227,66802,425
1599741,3.936,4.1088,425,377560,0.0363783,0.1,1,67231,66806,425
1602021,3.1872,4.02176,424,377560,0.0472757,0.06,1,67234,66810,424
1604941,2.23744,3.20435,423,377560,0.0494551,0.06,1,67236,66813,423
1606801,2.84749,3.84087,422,377560,0.073891,0.03,1,67239,66817,422
1609721,6.1695,4.76817,424,377560,0.0627782,0.01,1,67246,66822,424
1612001,3.6339,4.15363,423,377560,0.0685556,0.05,1,67249,66826,423
1614081,3.12678,3.23073,423,377560,0.0697111,0.01,1,67252,66829,423
1617001,56.6254,55.0461,425,377560,0.0219422,0.03,1,67322,66897,425
1619921,15.3251,14.2092,426,377560,0.00438844,0,1,67327,66901,426
1622841,4.66501,6.04185,424,377560,0.00887769,0.05,1,67329,66905,424
1625521,3.333,4.40837,423,377560,0.00177554,0.05,1,67332,66909,423
1628441,18.2666,16.0817,426,377560,0.0963551,0.03,1,67354,66928,426
1630721,6.85332,6.41633,426,377560,0.091271,0.03,1,67358,66932,426
1633641,4.57066,3.68327,427,377560,0.0982542,0.05,1,67362,66935,427
1635301,16.1141,3.93665,442,377560,0.0756508,0.01,1,67381,66939,442
1637381,15.2228,17.5873,436,377560,0.0791302,0.05,1,67396,66960,436
1640081,7.84457,16.3175,426,377560,0.055826,0,1,67402,66976,426
1642161,7.16891,8.86349,426,377560,0.0111652,0.08,1,67409,66983,426
1645081,10.2338,11.3727,425,377560,0.026233,0.05,1,67420,66995,425
1648001,6.84676,5.47454,427,377560,0.0292466,0.07,1,67426,66999,427
1649861,6.96935,4.29491,430,377560,0.0618493,0.09,1,67433,67003,430
1651941,7.79387,7.25898,430,377560,0.0443699,0.09,1,67441,67011,430
1654861,5.55877,10.2518,424,377560,0.032874,0.03,1,67446,67022,424
1657141,17.1118,5.25036,440,377560,0.0465748,0.03,1,67466,67026,440
1659221,10.6224,17.0501,429,377560,0.025315,0.03,1,67475,67046,429
1661921,6.12447,10.61,425,377560,0.021063,0.06,1,67480,67055,425
1664001,6.82489,7.722,425,377560,0.0282126,0.05,1,67487,67062,425
1666081,8.56498,10.3444,423,377560,0.0216425,0.01,1,67496,67073,423
1669001,17.713,14.0689,428,377560,0.0123285,0.03,1,67516,67088,428
1671921,5.9426,6.01378,427,377560,0.0024657,0.08,1,67519,67092,427
1674841,4.38852,4.40276,427,377560,0.0324931,0.13,1,67523,67096,427
1677761,4.0777,4.08055,427,377560,0.0624986,0.12,1,67527,67100,427
1679601,2.41554,4.01611,425,377560,0.1005,0.02,1,67529,67104,425
1681681,23.6831,24.8032,424,377560,0.1001,0.06,1,67558,67134,424
1684601,15.9366,15.3606,425,377560,0.04402,0.06,1,67572,67147,425
1687521,5.58732,6.27213,424,377560,0.056804,0.06,1,67575,67151,424
1690001,4.31746,4.45443,424,377560,0.0753608,0.09,1,67579,67155,424
1692921,5.66349,5.69089,424,377560,0.0550722,0.06,1,67585,67161,424
1695841,5.1327,4.33818,425,377560,0.0430144,0.02,1,67590,67165,425
1697701,4.22654,4.06764,425,377560,0.0646029,0.06,1,67594,67169,425
1700621,6.44531,5.61353,426,377560,0.100921,0.06,1,67601,67175,426
1703521,5.28906,4.32271,427,377560,0.0921841,0.15,1,67606,67179,427
1706441,8.25781,10.4645,424,377560,0.0424368,0.06,1,67615,67191,424
1709361,4.85156,5.29291,424,377560,0.0324874,0.04,1,67619,67195,424
1712281,4.17031,4.25858,424,377560,0.0464975,0.06,1,67623,67199,424
1715201,4.03406,4.05172,424,377560,0.0332995,0.06,1,67627,67203,424
1718121,4.00681,4.01034,424,377560,0.0146599,0.06,1,67631,67207,424
1720161,5.60136,4.00207,426,377560,0.034932,0.07,1,67637,67211,426
1723081,13.9203,12.8004,427,377560,0.0149864,0.04,1,67653,67226,427
1725361,5.98405,5.76008,427,377560,0.0269973,0.07,1,67657,67230,427
1728281,4.39681,5.15202,426,377560,0.0533995,0.08,1,67661,67235,426
1731201,4.07936,4.2304,426,377560,0.0346799,0.09,1,67665,67239,426
1734101,4.01587,4.04608,426,377560,0.030936,0.09,1,67669,67243,426
1737021,4.00317,4.00922,426,377560,0.0541872,0.09,1,67673,67247,426
1739301,4.80063,4.00184,427,377560,0.0348374,0.09,1,67678,67251,427
1742221,4.96013,7.20037,424,377560,0.0309675,0.06,1,67683,67259,424
1745121,4.19203,4.64007,424,377560,0.0301935,0.03,1,67687,67263,424
1748041,60.0384,58.528,426,377560,0.0140387,0,1,67761,67335,426
1750961,17.6077,14.9056,429,377560,0.00280774,0,1,67768,67339,429
1753881,5.92154,6.18112,428,377560,0.000561548,0.07,1,67771,67343,428
1756561,3.58431,4.43622,427,377560,0.00011231,0.09,1,67774,67347,427
1758641,10.3169,8.08725,430,377560,0.0240225,0.13,1,67786,67356,430
1761561,13.2634,13.6174,429,377560,0.0688045,0.1,1,67800,67371,429
1763841,6.65267,5.92349,430,377560,0.0617609,0.16,1,67805,67375,430
1765921,7.73053,9.1847,428,377560,0.0443522,0.04,1,67813,67385,428
1768841,14.3461,17.8369,424,377560,0.0408704,0.01,1,67829,67405,424
1771121,6.06922,6.76739,424,377560,0.0321741,0.05,1,67833,67409,424
1773201,6.81384,6.15348,425,377560,0.0144348,0.1,1,67840,67415,425
1776121,13.3628,13.2307,425,377560,0.010887,0.07,1,67855,67430,425
1778401,5.87255,5.84614,425,377560,0.0101774,0.04,1,67859,67434,425
1780481,4.37451,3.56923,426,377560,0.0420355,0.09,1,67863,67437,426
1783401,11.2749,11.1138,426,377560,0.0084071,0.08,1,67876,67450,426
1785681,3.85498,5.42277,424,377560,0.0256814,0.02,1,67878,67454,424
1787761,11.171,11.4846,424,377560,0.00513628,0.02,1,67891,67467,424
1789841,12.6342,12.6969,424,377560,0.0330273,0.03,1,67904,67480,424
1792761,9.72684,9.73938,424,377560,0.0306055,0.07,1,67913,67489,424
1795041,5.14537,5.14788,424,377560,0.0301211,0.04,1,67917,67493,424
1797121,16.2291,15.4296,425,377560,0.00602422,0,1,67936,67511,425
1800041,12.0458,8.68591,429,377560,0.00920484,0.05,1,67947,67518,429
1802321,6.40916,4.93718,430,377560,0.00184097,0.15,1,67952,67522,430
1805241,10.0818,12.1874,427,377560,0.0323682,0.14,1,67963,67536,427
1808161,3.61637,5.63749,425,377560,0.0544736,0.1,1,67965,67540,425
1810641,5.52327,4.3275,427,377560,0.0668947,0.08,1,67971,67544,427
1812721,18.7047,19.2655,426,377560,0.0533789,0.08,1,67993,67567,426
1815641,12.5409,13.4531,425,377560,0.0426758,0.07,1,68004,67579,425
1818561,7.30819,5.89062,427,377560,0.0245352,0.06,1,68010,67583,427
1821481,5.46164,4.37812,428,377560,0.012907,0.07,1,68015,67587,428
1823121,4.29233,4.07562,428,377560,0.0105814,0.13,1,68019,67591,428
1826041,4.85847,4.81512,428,377560,0.0421163,0.13,1,68024,67596,428
1828321,3.37169,4.16302,427,377560,0.0484233,0.12,1,68027,67600,427
1831241,7.07434,8.03261,426,377560,0.0736846,0.07,1,68035,67609,426
1834161,3.81487,4.80652,425,377560,0.0867369,0.04,1,68038,67613,425
1836021,4.76297,4.1613,426,377560,0.0573474,0.07,1,68043,67617,426
1838941,5.75259,5.63226,426,377560,0.0834695,0.04,1,68049,67623,426
1841221,5.95052,4.32645,428,377560,0.136694,0.07,1,68055,67627,428
1844141,4.3901,8.06529,423,377560,0.139339,0.04,1,68059,67636,423
1847061,4.07802,4.81306,423,377560,0.123868,0.03,1,68063,67640,423
1849981,4.8156,4.16261,424,377560,0.0807735,0.03,1,68068,67644,424
1852661,8.96312,4.03252,430,377560,0.0561547,0.04,1,68078,67648,430
1854741,10.5926,9.6065,430,377560,0.0512309,0.04,1,68089,67659,430
1857661,5.31852,9.9213,424,377560,0.0182462,0.06,1,68093,67669,424
1860581,4.2637,5.18426,424,377560,0.0116492,0.05,1,68097,67673,424
1863501,4.05274,4.23685,424,377560,0.0343298,0.05,1,68101,67677,424
1866421,4.01055,4.04737,424,377560,0.078866,0.05,1,68105,67681,424
1869341,4.00211,4.00947,424,377560,0.0717732,0.04,1,68109,67685,424
1871381,7.20042,4.00189,428,377560,0.0543546,0.06,1,68117,67689,428
1874301,4.64008,7.20038,424,377560,0.0188709,0.02,1,68121,67697,424
1876161,3.32802,4.64008,423,377560,0.0277742,0.01,1,68124,67701,423
1878241,52.6656,52.928,423,377560,0.0215548,0.01,1,68189,67766,423
1881161,20.1331,19.3856,424,377560,0.00431097,0.03,1,68201,67777,424
1884081,8.02662,7.07712,425,377560,0.000862193,0.05,1,68206,67781,425
1887001,6.40532,4.61542,427,377560,0.00817244,0.04,1,68212,67785,427
1889061,4.48106,4.12308,427,377560,0.0736345,0.06,1,68216,67789,427
1891141,9.69621,4.82462,433,377560,0.0147269,0.09,1,68227,67794,433
1893221,5.93924,10.5649,426,377560,0.0429454,0.09,1,68232,67806,426
1894881,2.78785,4.51298,425,377560,0.0565891,0.1,1,68234,67809,425
1896961,11.7576,12.9026,424,377560,0.0753178,0.07,1,68248,67824,424
1899041,9.55151,8.18052,426,377560,0.0390636,0.02,1,68257,67831,426
1901961,5.9103,7.2361,424,377560,0.0478127,0.05,1,68262,67838,424
1903621,3.58206,4.64722,423,377560,0.0815625,0.04,1,68265,67842,423
1905701,16.7164,4.12944,439,377560,0.0403125,0.05,1,68285,67846,439
1908621,7.34328,16.8259,424,377560,0.0320625,0.04,1,68290,67866,424
1911521,5.46866,6.56518,425,377560,0.0464125,0.04,1,68295,67870,425
1914441,12.2937,13.313,424,377560,0.0332825,0,1,68309,67885,424
1916721,7.25875,5.86261,426,377560,0.0386565,0.03,1,68315,67889,426
1918801,4.65175,5.17252,425,377560,0.0077313,0.05,1,68319,67894,425
1920881,12.9303,13.0345,425,377560,0.00954626,0.03,1,68334,67909,425
1922961,7.38607,9.0069,423,377560,0.0419093,0.03,1,68340,67917,423
1925881,11.0772,10.6014,424,377560,0.0403819,0.01,1,68352,67928,424
1927541,19.8154,5.32028,442,377560,0.00807637,0.03,1,68374,67932,442
1930461,8.76309,17.8641,427,377560,0.00961527,0.07,1,68380,67953,427
1933361,4.15262,6.77281,426,377560,0.00992305,0.1,1,68383,67957,426
1936281,8.03052,9.35456,425,377560,0.00198461,0.09,1,68392,67967,425
1939201,4.8061,5.07091,425,377560,0.0323969,0.06,1,68396,67971,425
1941681,4.96122,4.21418,426,377560,0.0544794,0.06,1,68401,67975,426
1943761,16.1922,16.8428,425,377560,0.0508959,0.03,1,68420,67995,425
1945841,14.4384,14.5686,425,377560,0.0661792,0.05,1,68434,68009,425
1948761,12.4877,11.7137,426,377560,0.0212358,0.07,1,68446,68020,426
1951681,6.49754,5.54274,427,377560,0.0122472,0.07,1,68451,68024,427
1954161,4.49951,4.30855,427,377560,0.0184494,0.1,1,68455,68028,427
1957081,4.8999,5.66171,426,377560,0.0516899,0.11,1,68460,68034,426
1960001,5.77998,4.33234,428,377560,0.074338,0.07,1,68466,68038,428
1962921,6.756,4.06647,431,377560,0.0788676,0.1,1,68473,68042,431
1964561,3.7512,4.01329,430,377560,0.0717735,0.09,1,68476,68046,430
1966641,2.35024,3.20266,429,377560,0.0623547,0.14,1,68478,68049,429
1969561,6.87005,10.2405,425,377560,0.0764709,0.11,1,68486,68061,425
1972481,4.57401,5.24811,425,377560,0.0472942,0.08,1,68490,68065,425
1975401,4.1148,4.24962,425,377560,0.0654588,0.07,1,68494,68069,425
1978321,4.02296,4.04992,425,377560,0.0930918,0.07,1,68498,68073,425
1980161,3.20459,4.00998,424,377560,0.0826183,0.07,1,68501,68077,424
1983081,9.44092,8.802,425,377560,0.0725237,0.05,1,68512,68087,425
1985361,6.68818,4.9604,427,377560,0.0385047,0.06,1,68518,68091,427
1988281,6.93764,8.19208,425,377560,0.0637009,0.1,1,68525,68100,425
1991201,4.58753,4.83842,425,377560,0.0527402,0.08,1,68529,68104,425
1993061,5.71751,4.16768,427,377560,0.026548,0.07,1,68535,68108,427
1995981,5.1435,6.43354,425,377560,0.0533096,0.06,1,68540,68115,425
1998901,4.2287,4.48671,425,377560,0.0346619,0.03,1,68544,68119,425
2001821,4.84574,4.09734,426,377560,0.0309324,0.07,1,68549,68123,426
2003461,4.16915,4.01947,426,377560,0.0301865,0.08,1,68553,68127,426
2006381,4.03383,4.80389,425,377560,0.0140373,0.08,1,68557,68132,425
2008661,50.4068,4.16078,483,377560,0.00280746,0,1,68619,68136,483
2010741,15.6814,52.0322,426,377560,0.00856149,0,1,68626,68200,426
2012821,11.1363,14.4064,431,377560,0.0017123,0.11,1,68636,68205,431
2015741,6.22725,12.4813,424,377560,0.0163425,0.06,1,68641,68217,424
2018661,6.04545,5.69626,426,377560,0.00326849,0.02,1,68647,68221,426
2021141,10.8091,4.33925,434,377560,0.0326537,0.05,1,68659,68225,434
2023841,5.36182,9.66785,427,377560,0.0625307,0.08,1,68663,68236,427
2025921,9.07236,11.5336,425,377560,0.0685061,0.03,1,68673,68248,425
2028001,11.4145,9.50671,428,377560,0.0617012,0.12,1,68685,68257,428
2030921,9.48289,12.3013,424,377560,0.0603402,0.05,1,68694,68270,424
2033841,5.09658,5.66027,424,377560,0.0360681,0.01,1,68698,68274,424
2035701,15.4193,4.33205,438,377560,0.0872136,0.09,1,68716,68278,438
2038621,6.28386,15.2664,424,377560,0.0654427,0.07,1,68720,68296,424
2040901,4.45677,6.25328,424,377560,0.0290885,0.04,1,68724,68300,424
2042561,3.29135,3.65066,424,377560,0.00581771,0.06,1,68727,68303,424
2044641,9.45827,8.73013,425,377560,0.0651635,0.04,1,68738,68313,425
2047561,13.0917,12.946,425,377560,0.0530327,0.03,1,68752,68327,425
2049841,5.01833,5.78921,424,377560,0.0506065,0.08,1,68755,68331,424
2051921,7.40367,6.75784,425,377560,0.0181213,0.07,1,68763,68338,425
2054001,8.68073,10.1516,423,377560,0.0196243,0.01,1,68772,68349,423
2056081,9.73615,9.23031,424,377560,0.0359249,0.01,1,68782,68358,424
2059001,22.7472,21.8461,425,377560,0.031185,0.03,1,68808,68383,425
2061281,7.74945,7.56921,425,377560,0.014237,0.04,1,68812,68387,425
2064201,7.14989,8.71384,423,377560,0.0108474,0.07,1,68819,68396,423
2067121,5.42998,4.94277,424,377560,0.0181695,0.01,1,68824,68400,424
2070041,5.086,4.18855,425,377560,0.0116339,0.03,1,68829,68404,425
2072721,4.2172,4.03771,425,377560,0.0103268,0.1,1,68833,68408,425
2074801,15.2434,15.2075,425,377560,0.0100654,0.07,1,68851,68426,425
2076881,15.0487,15.8415,424,377560,0.0180131,0.04,1,68866,68442,424
2079801,14.2097,12.7683,426,377560,0.0116026,0.06,1,68880,68454,426
2082721,6.84195,5.75366,427,377560,0.0103205,0.06,1,68885,68458,427
2085201,3.76839,4.35073,426,377560,0.0340641,0.11,1,68888,68462,426
2088121,6.35368,6.47015,426,377560,0.0468128,0.08,1,68895,68469,426
2090401,4.47074,4.49403,426,377560,0.0493626,0.07,1,68899,68473,426
2093321,7.29415,7.29881,426,377560,0.0658725,0.1,1,68907,68481,426
2096241,6.25883,4.65976,428,377560,0.0931745,0.05,1,68913,68485,428
2099161,4.45177,4.13195,428,377560,0.122635,0.08,1,68917,68489,428
2101221,4.89035,4.02639,429,377560,0.104527,0.12,1,68922,68493,429
2104141,4.17807,6.40528,426,377560,0.0689054,0.09,1,68926,68500,426
2106001,3.23561,4.48106,425,377560,0.0617811,0.07,1,68929,68504,425
2108921,7.84712,7.29621,426,377560,0.0363562,0.07,1,68938,68512,426
2111201,4.76942,4.65924,426,377560,0.0312712,0.05,1,68942,68516,426
2114121,3.35388,4.93185,424,377560,0.0222542,0.09,1,68945,68521,424
2117041,4.67078,4.18637,425,377560,0.0364509,0.05,1,68950,68525,425
2119941,8.93416,4.03727,431,377560,0.0792902,0.08,1,68960,68529,431
2122861,4.98683,9.60745,424,377560,0.071858,0.05,1,68964,68540,424
2125141,5.79737,5.12149,426,377560,0.102372,0.06,1,68970,68544,426
2128061,5.95947,5.8243,426,377560,0.0364743,0.05,1,68976,68550,426
2130981,5.19189,4.36486,427,377560,0.0312949,0.05,1,68981,68554,427
2133901,5.03838,4.07297,428,377560,0.00625897,0.09,1,68986,68558,428
2135541,4.20768,4.01459,428,377560,0.0172518,0.11,1,68990,68562,428
2137201,4.04154,5.60292,426,377560,0.0434504,0,1,68994,68568,426
2140121,48.0083,49.9206,424,377560,0.00869007,0,1,69053,68629,424
2142821,14.4017,13.1841,426,377560,0.00173801,0.03,1,69059,68633,426
2144901,10.0803,7.43682,429,377560,0.0083476,0.03,1,69068,68639,429
2146561,6.01607,8.68736,425,377560,0.00166952,0.05,1,69073,68648,425
2149481,10.0032,8.13747,428,377560,0.000333904,0.08,1,69084,68656,428
2151141,9.20064,4.82749,433,377560,0.0320668,0.07,1,69093,68660,433
2154061,8.24013,11.3655,428,377560,0.0304134,0.03,1,69101,68673,428
2156961,4.84803,5.4731,428,377560,0.0620827,0.07,1,69105,68677,428
2159881,13.7696,13.8946,428,377560,0.0124165,0.06,1,69121,68693,428
2162581,5.95392,5.97892,428,377560,0.0264833,0.08,1,69125,68697,428
2164241,4.39078,5.19578,427,377560,0.0372967,0.06,1,69129,68702,427
2167161,18.4782,17.0392,429,377560,0.127459,0.01,1,69151,68722,429
2169441,6.09563,6.60783,428,377560,0.137492,0.08,1,69154,68726,428
2172361,4.41913,3.72157,429,377560,0.131498,0.12,1,69158,68729,429
2175061,6.48383,3.94431,432,377560,0.1223,0.11,1,69165,68733,432
2177141,19.6968,9.58886,444,377560,0.0324599,0.07,1,69188,68744,444
2180061,7.13935,21.1178,424,377560,0.014492,0.03,1,69192,68768,424
2182961,5.42787,7.42355,425,377560,0.0188984,0.04,1,69197,68772,425
2185041,7.48557,9.48471,423,377560,0.0197797,0.04,1,69205,68782,423
2187121,7.89711,7.49694,424,377560,0.00395594,0.04,1,69213,68789,424
2190041,29.5794,28.6994,425,377560,0.0247912,0.02,1,69248,68823,425
2192961,7.51588,8.93988,423,377560,0.0449582,0,1,69250,68827,423
2195881,6.30318,4.98798,425,377560,0.0249916,0.07,1,69256,68831,425
2198801,4.46064,4.1976,425,377560,0.00499833,0.03,1,69260,68835,425
2200641,2.49213,4.03952,423,377560,0.00899967,0.06,1,69262,68839,423
2203561,7.69843,6.4079,425,377560,0.00179993,0.03,1,69271,68846,425
2205221,3.93969,4.48158,424,377560,0.02436,0.03,1,69274,68850,424
2207301,19.1879,4.89632,442,377560,0.100872,0.03,1,69297,68855,442
2209381,15.0376,18.5793,434,377560,0.0761744,0.07,1,69311,68877,434
2212301,5.40752,14.1159,424,377560,0.0632349,0.07,1,69314,68890,424
2214581,5.0815,6.02317,425,377560,0.060647,0.04,1,69319,68894,425
2217501,5.8163,3.60463,428,377560,0.0521294,0.05,1,69325,68897,428
2219781,8.36326,3.92093,433,377560,0.0904259,0.1,1,69334,68901,433
2221441,3.27265,6.38419,428,377560,0.106085,0.15,1,69336,68908,428
2224361,5.45453,7.67684,426,377560,0.125217,0.13,1,69342,68916,426
2226641,4.29091,4.73537,426,377560,0.0970434,0.08,1,69346,68920,426
2229561,4.85818,6.54707,424,377560,0.0754087,0.06,1,69351,68927,424
2232481,4.17164,4.50941,424,377560,0.0870817,0.04,1,69355,68931,424
2235401,4.03433,4.10188,424,377560,0.0574163,0.05,1,69359,68935,424
2237041,4.00687,4.02038,424,377560,0.0434833,0.05,1,69363,68939,424
2239961,5.60137,4.00408,426,377560,0.0566967,0.05,1,69369,68943,426
2242241,4.32027,4.00082,426,377560,0.0513393,0.08,1,69373,68947,426
2245161,6.46405,5.60016,427,377560,0.0742679,0.1,1,69380,68953,427
2247441,5.29281,4.32003,428,377560,0.0548536,0.14,1,69385,68957,428
2250361,6.65856,9.66401,424,377560,0.0829707,0.11,1,69392,68968,424
2253281,3.73171,5.1328,423,377560,0.0725941,0.04,1,69395,68972,423
2255141,7.14634,4.22656,427,377560,0.110519,0.06,1,69403,68976,427
2258061,6.22927,5.64531,427,377560,0.0861038,0,1,69409,68982,427
2260341,6.04585,4.32906,429,377560,0.0892208,0.1,1,69415,68986,429
2263261,4.40917,7.26581,425,377560,0.0658441,0.07,1,69419,68994,425
2266181,4.88183,4.65316,426,377560,0.0611688,0.05,1,69424,68998,426
2268241,5.77637,4.13063,428,377560,0.0682338,0,1,69430,69002,428
2270321,41.9553,45.6261,423,377560,0.0136468,0.02,1,69481,69058,423
2273241,14.7911,14.7252,424,377560,0.0187294,0.03,1,69489,69065,424
2274901,11.7582,6.14504,431,377560,0.0197459,0.02,1,69500,69069,431
2277601,6.35164,10.829,424,377560,0.0119492,0.05,1,69505,69081,424
2279681,10.8703,10.9658,425,377560,0.0103898,0.03,1,69517,69092,425
2281761,7.77407,9.39316,423,377560,0.010078,0.02,1,69524,69101,423
2284681,13.5548,12.2786,425,377560,0.0100156,0.02,1,69539,69114,425
2287601,5.11096,5.65573,424,377560,0.0100031,0.01,1,69542,69118,424
2289461,8.22219,4.33115,429,377560,0.0180006,0.05,1,69551,69122,429
2291541,8.04444,4.86623,432,377560,0.00360012,0.11,1,69559,69127,432
2294461,4.80889,6.57325,429,377560,0.02472,0.15,1,69563,69134,429
2296741,17.7618,4.51465,446,377560,0.044944,0.17,1,69584,69138,446
2299661,5.95236,20.1029,425,377560,0.0249888,0.1,1,69587,69162,425
2302561,3.59047,7.22059,424,377560,0.0289978,0.09,1,69590,69166,424
2305481,3.11809,4.64412,423,377560,0.0137996,0.09,1,69593,69170,423
2307141,23.0236,4.12882,447,377560,0.0507599,0.06,1,69621,69174,447
2310061,7.80472,22.4258,424,377560,0.042152,0.05,1,69625,69201,424
2312981,6.36094,7.68515,426,377560,0.0324304,0.02,1,69631,69205,426
2315461,9.27219,4.73703,432,377560,0.0464861,0.1,1,69641,69209,432
2318161,5.05444,8.94741,426,377560,0.0572972,0.01,1,69645,69219,426
2321081,34.6109,36.1895,425,377560,0.0354594,0,1,69687,69262,425
2324001,8.52218,10.4379,423,377560,0.0310919,0.01,1,69689,69266,423
2326921,5.70444,5.28758,424,377560,0.00621838,0.06,1,69694,69270,424
2329841,5.14089,4.25752,425,377560,0.00124368,0.03,1,69699,69274,425
2332761,5.02818,4.0515,426,377560,0.000248735,0.03,1,69704,69278,426
2335681,5.80564,4.0103,428,377560,0.0320497,0.08,1,69710,69282,428
2337301,21.9611,4.00206,450,377560,0.03841,0.06,1,69736,69286,450
2340001,8.39223,24.0004,426,377560,0.055682,0.06,1,69741,69315,426
2342921,8.87845,10.4001,428,377560,0.0271364,0.09,1,69750,69322,428
2345841,5.77569,5.28002,429,377560,0.0294273,0.07,1,69755,69326,429
2348321,4.35514,4.256,429,377560,0.0458855,0.13,1,69759,69330,429
2351241,8.87103,10.4512,427,377560,0.0811771,0.09,1,69769,69342,427
2353941,4.97421,5.29024,427,377560,0.0322354,0.09,1,69773,69346,427
2356861,4.19484,5.05805,426,377560,0.0384471,0.1,1,69777,69351,426
2359141,7.23897,4.21161,430,377560,0.0636894,0.08,1,69785,69355,430
2362061,4.64779,7.24232,426,377560,0.0527379,0.1,1,69789,69363,426
2364981,4.92956,4.64846,427,377560,0.0505476,0.08,1,69794,69367,427
2367461,4.98591,4.12969,428,377560,0.0581095,0.09,1,69799,69371,428
2370381,4.19718,5.62594,426,377560,0.0596219,0.1,1,69803,69377,426
2373281,4.83944,4.32519,427,377560,0.0999244,0.06,1,69808,69381,427
2376201,7.36789,5.66504,429,377560,0.0679849,0.11,1,69816,69387,429
2378481,4.67358,4.33301,429,377560,0.053597,0.15,1,69820,69391,429
2381401,5.73472,7.2666,427,377560,0.0827194,0.13,1,69826,69399,427
2383681,4.34694,4.65332,427,377560,0.0725439,0.11,1,69830,69403,427
2386601,8.06939,8.13066,427,377560,0.0545088,0.1,1,69839,69412,427
2388881,4.81388,4.82613,427,377560,0.0509018,0.08,1,69843,69416,427
2391801,6.56278,6.56523,427,377560,0.0821804,0.1,1,69850,69423,427
2394081,4.51256,4.51305,427,377560,0.0724361,0.09,1,69854,69427,427
2397001,4.90251,3.30261,429,377560,0.0944872,0.09,1,69859,69430,429
2399281,3.3805,3.86052,428,377560,0.0828974,0.02,1,69862,69434,428
2402201,43.0761,46.3721,424,377560,0.0325795,0.01,1,69915,69491,424
2404901,17.4152,12.4744,431,377560,0.0145159,0,1,69926,69495,431
2406981,9.88304,12.0949,427,377560,0.00290318,0.02,1,69934,69507,427
2408641,4.37661,8.81898,422,377560,0.000580636,0.03,1,69937,69515,422
2411561,10.4753,10.5638,423,377560,0.000116127,0.04,1,69949,69526,423
2414261,22.0951,5.31276,444,377560,0.00802323,0,1,69974,69530,444
2417181,9.21901,19.4626,427,377560,0.00960464,0.01,1,69980,69553,427
2420081,5.0438,7.09251,427,377560,0.00992093,0.12,1,69984,69557,427
2423001,9.00876,11.0185,425,377560,0.00998419,0.11,1,69994,69569,425
2425281,4.20175,5.4037,424,377560,0.0419968,0.05,1,69997,69573,424
2428201,16.0404,13.8807,427,377560,0.0643994,0.01,1,70016,69589,427
2431121,7.20807,5.97615,428,377560,0.0608799,0.05,1,70021,69593,428
2434041,4.64161,4.39523,428,377560,0.060176,0.11,1,70025,69597,428
2435681,4.12832,4.07905,428,377560,0.0520352,0.07,1,70029,69601,428
2438601,19.2257,21.6158,425,377560,0.066407,0.05,1,70052,69627,425
2440881,7.84513,7.52316,426,377560,0.0772814,0.04,1,70057,69631,426
2443801,6.36903,7.10463,425,377560,0.0794563,0.09,1,70063,69638,425
2446081,3.67381,4.62093,424,377560,0.0558913,0.06,1,70066,69642,424
2449001,8.73476,9.72419,423,377560,0.0511783,0.03,1,70076,69653,423
2450661,33.747,5.14484,459,377560,0.0342357,0,1,70116,69657,459
2453581,11.5494,32.229,426,377560,0.0148471,0.01,1,70122,69696,426
2456501,5.50988,9.64579,426,377560,0.00296943,0.03,1,70126,69700,426
2459421,4.30198,5.12916,426,377560,0.00859389,0.09,1,70130,69704,426
2462341,4.8604,4.22583,427,377560,0.00171878,0.1,1,70135,69708,427
2465261,4.17208,4.04517,427,377560,0.0243438,0.09,1,70139,69712,427
2467301,25.6344,4.00903,454,377560,0.0208688,0.05,1,70170,69716,454
2470221,9.92688,27.2018,427,377560,0.00417375,0.05,1,70176,69749,427
2473121,6.78538,8.64036,429,377560,0.0168348,0.14,1,70182,69753,429
2476041,7.75708,11.3281,425,377560,0.0193669,0.09,1,70190,69765,425
2478961,6.35142,5.46561,427,377560,0.0758734,0.02,1,70196,69769,427
2481881,3.67028,4.29312,426,377560,0.103175,0.08,1,70199,69773,426
2484561,3.13406,4.05862,425,377560,0.108635,0.11,1,70202,69777,425
2487481,6.22681,5.61173,426,377560,0.037727,0.08,1,70209,69783,426
2489141,4.44536,4.32234,426,377560,0.0155454,0.06,1,70213,69787,426
2492061,4.88907,4.86447,426,377560,0.0431091,0.08,1,70218,69792,426
2494341,4.97781,4.17289,427,377560,0.0566218,0.06,1,70223,69796,427
2496001,4.19556,3.23458,428,377560,0.0753244,0.11,1,70227,69799,428
2498921,6.43911,7.84692,426,377560,0.0790649,0.1,1,70234,69808,426
2501201,4.48782,4.76938,426,377560,0.079813,0.12,1,70238,69812,426
2504121,8.89756,8.95388,426,377560,0.119963,0.12,1,70248,69822,426
2507041,4.17951,4.99078,425,377560,0.0959925,0.09,1,70251,69826,425
2509521,3.2359,4.19816,424,377560,0.0991985,0.07,1,70254,69830,424
2512441,3.84718,3.23963,425,377560,0.0838397,0.04,1,70258,69833,425
2514721,5.56944,3.84793,427,377560,0.0887679,0.07,1,70264,69837,427
2517641,8.31389,7.16959,428,377560,0.0817536,0.1,1,70273,69845,428
2519921,4.86278,4.63392,428,377560,0.0643507,0.09,1,70277,69849,428
2522001,3.37256,3.32678,428,377560,0.0448701,0.09,1,70280,69852,428
2524921,7.87451,10.2654,425,377560,0.072974,0.08,1,70289,69864,425
2527841,4.7749,5.25307,425,377560,0.0865948,0.08,1,70293,69868,425
2530321,4.95498,4.25061,426,377560,0.073319,0.01,1,70298,69872,426
2532401,40.991,43.2501,423,377560,0.0306638,0,1,70348,69925,423
2535321,15.3982,15.85,423,377560,0.0141328,0,1,70357,69934,423
2536981,11.0796,6.37,429,377560,0.0108266,0.03,1,70367,69938,429
2539681,7.01593,8.474,426,377560,0.00216531,0.08,1,70373,69947,426
2541761,6.20319,8.8948,423,377560,0.000433062,0.03,1,70379,69956,423
2544681,21.2406,21.779,423,377560,0.0320866,0,1,70404,69981,423
2547601,9.04813,7.55579,425,377560,0.00641732,0.01,1,70410,69985,425
2550521,6.60963,4.71116,427,377560,0.00928346,0.03,1,70416,69989,427
2552581,3.72193,4.14223,426,377560,0.00185669,0.09,1,70419,69993,426
2554661,9.54439,4.82845,432,377560,0.00837134,0.06,1,70430,69998,432
2556321,3.50888,8.16569,425,377560,0.0176743,0.07,1,70432,70007,425
2558401,10.3018,11.2331,425,377560,0.163535,0.06,1,70444,70019,425
2561321,8.46036,8.64663,425,377560,0.184707,0.06,1,70452,70027,425
2564241,4.89207,4.92933,425,377560,0.180941,0.07,1,70456,70031,425
2566721,4.97841,4.18587,426,377560,0.164188,0.09,1,70461,70035,426
2569641,19.3957,20.0372,425,377560,0.192838,0.1,1,70484,70059,425
2571921,6.27914,7.20743,424,377560,0.230568,0.07,1,70487,70063,424
2574841,10.0558,9.44149,425,377560,0.214114,0.04,1,70498,70073,425
2577121,6.01117,5.0883,426,377560,0.234823,0.06,1,70503,70077,426
2579201,4.40223,6.61766,423,377560,0.214965,0,1,70507,70084,423
2582121,36.8804,35.7235,425,377560,0.114993,0.01,1,70552,70127,425
2585041,8.97609,10.3447,423,377560,0.102999,0.01,1,70554,70131,423
2587961,5.79522,5.26894,424,377560,0.0845997,0.06,1,70559,70135,424
2590881,5.95904,4.25379,426,377560,0.0489199,0.03,1,70565,70139,426
2593801,5.19181,4.05076,427,377560,0.033784,0.05,1,70570,70143,427
2595841,3.43836,4.01015,426,377560,0.0227568,0.06,1,70573,70147,426
2598761,27.0877,27.202,426,377560,0.0125514,0.06,1,70606,70180,426
2601041,10.2175,8.64041,428,377560,0.0105103,0.03,1,70612,70184,428
2603961,5.24351,4.12808,429,377560,0.0101021,0.06,1,70616,70187,429
2605621,3.4487,4.02562,428,377560,0.0100204,0.12,1,70619,70191,428
2607701,5.48974,5.60512,428,377560,0.0100041,0.09,1,70625,70197,428
2610621,5.09795,7.52102,425,377560,0.0420008,0.04,1,70630,70205,425
2613541,5.01959,4.7042,426,377560,0.0564002,0.05,1,70635,70209,426
2616461,5.80392,4.14084,428,377560,0.05128,0.06,1,70641,70213,428
2619141,4.36078,4.02817,428,377560,0.034256,0.08,1,70645,70217,428
2622061,4.87216,4.80563,428,377560,0.0308512,0.09,1,70650,70222,428
2624341,4.97443,4.16113,429,377560,0.0621702,0.1,1,70655,70226,429
2627041,5.79489,5.63223,429,377560,0.076434,0.15,1,70661,70232,429
2629961,8.35898,9.92645,427,377560,0.0392868,0.16,1,70670,70243,427
2632241,3.2718,5.18529,425,377560,0.0398574,0.1,1,70672,70247,425
2635161,6.25436,5.03706,427,377560,0.00797147,0.1,1,70679,70252,427
2637441,5.25087,4.20741,428,377560,0.0335943,0.12,1,70684,70256,428
2640361,7.45017,10.4415,424,377560,0.0387189,0.1,1,70692,70268,424
2643281,4.69003,5.2883,424,377560,0.0477438,0.08,1,70696,70272,424
2646201,5.73801,4.25766,426,377560,0.0975488,0.06,1,70702,70276,426
2647841,5.1476,4.05153,427,377560,0.0995098,0.05,1,70707,70280,427
2650761,4.22952,4.01031,427,377560,0.091902,0.09,1,70711,70284,427
2653681,4.0459,4.00206,427,377560,0.0903804,0.12,1,70715,70288,427
2656581,6.40918,4.00041,430,377560,0.178076,0.1,1,70722,70292,430
2658241,3.68184,6.40008,426,377560,0.171615,0.1,1,70725,70299,426
2661161,10.3364,11.68,425,377560,0.090323,0.05,1,70737,70312,425
2662821,38.0673,5.536,466,377560,0.0180646,0,1,70782,70316,466
2665521,10.8135,38.7072,423,377560,0.00361292,0,1,70786,70363,423
2667601,8.56269,13.3414,424,377560,0.000722584,0.01,1,70794,70370,424
2670521,5.71254,5.06829,426,377560,0.000144517,0,1,70799,70373,426
2672181,13.1425,4.21366,437,377560,0.0080289,0.07,1,70814,70377,437
2674261,19.4285,13.6427,442,377560,0.00960578,0.03,1,70835,70393,442
2677181,7.0857,21.1285,423,377560,0.0179212,0,1,70839,70416,423
2679461,17.4171,7.42571,439,377560,0.0275842,0.04,1,70859,70420,439
2682381,6.68343,9.48514,433,5840,0.00551685,0.24,1,70863,70430,433
2684661,5.33669,5.09703,434,5840,0.00110337,0.21,1,70868,70434,434
2687361,4.26734,5.81941,432,5840,0.000220674,0.21,1,70872,70440,432
2689441,11.2535,9.96388,434,5840,0.00804413,0.24,1,70885,70451,434
2692361,11.8507,11.5928,434,5840,0.00960883,0.22,1,70897,70463,434
2695281,4.77014,5.51856,433,5840,0.00992176,0.23,1,70900,70467,433
2697761,4.95403,4.30371,434,5840,0.00198435,0.25,1,70905,70471,434
2700681,16.1908,14.4607,436,5840,0.00839687,0.21,1,70924,70488,436
2702961,4.83816,6.09215,434,5840,0.00167937,0.27,1,70926,70492,434
2705041,8.16763,7.61843,435,5840,0.0403359,0.23,1,70935,70500,435
2707961,6.43353,6.32369,435,5840,0.0240672,0.24,1,70941,70506,435
2709621,4.48671,4.46474,435,5840,0.0128134,0.25,1,70945,70510,435
2711701,29.6973,4.09295,467,5840,0.0265627,0.07,1,70981,70514,467
2714621,9.93947,38.4186,425,5840,0.0133125,0.06,1,70986,70561,425
2717541,4.38789,10.8837,424,5840,0.00266251,0.05,1,70989,70565,424
2720461,3.27758,5.37674,423,5840,0.0085325,0.07,1,70992,70569,423
2723141,9.45552,4.27535,430,5840,0.0017065,0.05,1,71003,70573,430
2726061,3.4911,8.05507,423,5840,0.0003413,0.06,1,71005,70582,423
2728341,27.8982,4.81101,453,5840,6.826e-05,0.03,1,71039,70586,453
2731261,10.3796,27.3622,426,5840,0.0160137,0,1,71045,70619,426
2734181,5.27593,8.67244,426,5840,0.0192027,0.05,1,71049,70623,426
2736241,4.25519,4.93449,426,5840,0.0198405,0.07,1,71053,70627,426
2739161,3.25104,4.9869,424,5840,0.0439681,0.07,1,71056,70632,424
2741441,3.05021,4.19738,423,5840,0.00879362,0.05,1,71059,70636,423
2744361,7.01004,4.83948,426,5840,0.00975872,0.03,1,71067,70641,426
2747281,7.00201,4.1679,429,5840,0.0179517,0.04,1,71074,70645,429
2749761,3.0004,4.03358,427,5840,0.0115903,0.05,1,71076,70649,427
2752681,2.20008,3.20672,426,5840,0.00231807,0.12,1,71078,70652,426
2754341,5.24002,3.84134,428,5840,0.000463614,0.07,1,71084,70656,428
2756421,9.048,6.36827,431,5840,9.27228e-05,0.05,1,71094,70663,431
2759341,6.6096,10.0737,426,5840,0.0160185,0.01,1,71100,70674,426
2761621,5.32192,5.21473,427,5840,0.00320371,0.08,1,71105,70678,427
2764541,5.06438,5.84295,426,5840,0.0246407,0.07,1,71110,70684,426
2767461,5.81288,4.36859,428,5840,0.00492815,0.06,1,71116,70688,428
2769941,5.16258,4.07372,429,5840,0.00898563,0.07,1,71121,70692,429
2772021,7.43252,3.21474,434,5840,0.00179713,0.14,1,71129,70695,434
2774941,6.2865,8.64295,430,5840,0.00835942,0.11,1,71135,70705,430
2776801,5.2573,4.92859,431,5840,0.00167188,0.09,1,71140,70709,431
2779721,5.85146,5.78572,431,5840,0.00833438,0.21,1,71146,70715,431
2782421,6.77029,4.35714,434,5840,0.00166688,0.13,1,71153,70719,434
2785341,4.55406,10.4714,426,5840,0.000333375,0.09,1,71157,70731,426
2788261,5.71081,5.29429,428,5840,0.00806667,0.09,1,71163,70735,428
2790741,3.54216,4.25886,427,5840,0.00961334,0.08,1,71166,70739,427
2792821,35.9084,3.25177,468,5840,0.00992267,0.01,1,71210,70742,468
2795741,11.1817,39.8504,424,5840,0.00998453,0.01,1,71215,70791,424
2798021,7.83634,11.1701,427,5840,0.00199691,0.03,1,71222,70795,427
2800721,4.76727,8.63401,423,5840,0.000399381,0.02,1,71226,70803,423
2802801,20.9535,20.9268,424,5840,0.00807988,0,1,71251,70827,424
2805721,19.3907,18.5854,425,5840,0.00961598,0.01,1,71270,70845,425
2808001,5.47814,6.91707,423,5840,0.0099232,0.01,1,71272,70849,423
2810921,339.496,338.183,425,5840,0.00998464,0.01,1,71695,71270,425
2813841,71.8991,70.8367,426,380480,0.00999693,0.01,1,71700,71274,426
2816761,348.78,350.967,423,380480,0.0979994,0.03,1,72118,71695,423
2819681,73.756,73.3935,424,380480,0.0915999,0.02,1,72123,71699,424
2822601,17.9512,17.8787,424,380480,0.07432,0.02,1,72127,71703,424
2825521,7.59024,6.77574,425,380480,0.062864,0.06,1,72132,71707,425
2828441,3.91805,4.55515,424,380480,0.0285728,0.06,1,72135,71711,424
2831361,3.98361,4.11103,424,380480,0.0617146,0.08,1,72139,71715,424
2834281,4.79672,4.02221,425,380480,0.0763429,0.04,1,72144,71719,425
2837201,4.15934,4.00444,425,380480,0.0872686,0.03,1,72148,71723,425
2840121,4.03187,4.00089,425,380480,0.0974537,0.06,1,72152,71727,425
2843041,4.80637,4.00018,426,380480,0.0834907,0.06,1,72157,71731,426
2845961,4.16127,4.00004,426,380480,0.0806981,0.07,1,72161,71735,426
2848881,4.83225,4.00001,427,380480,0.12014,0.1,1,72166,71739,427
2851801,3.36645,4,426,380480,0.128028,0.1,1,72169,71743,426
2854721,3.07329,4,425,380480,0.153606,0.13,1,72172,71747,425
2857641,4.61466,4,426,380480,0.126721,0.08,1,72177,71751,426
2860561,5.72293,4,428,380480,0.129344,0.07,1,72183,71755,428
2863481,5.94459,4,430,380480,0.177869,0.09,1,72189,71759,430
2866401,6.78892,4,433,380480,0.211574,0.16,1,72196,71763,433
2869321,4.55778,4,433,380480,0.210315,0.18,1,72200,71767,433
2872241,6.51156,4,436,380480,0.210063,0.23,1,72207,71771,436
2875161,6.90231,4,439,380480,0.266013,0.24,1,72214,71775,439
2878081,6.98046,4,442,380480,0.293203,0.28,1,72221,71779,442
2881001,3.79609,4,441,380480,0.29864,0.34,1,72224,71783,441
2883921,4.75922,4,442,380480,0.315728,0.39,1,72229,71787,442
2886841,4.95184,4,443,380480,0.359146,0.37,1,72234,71791,443
2889761,4.99037,4,444,380480,0.367829,0.38,1,72239,71795,444
2892681,4.99807,4,445,380480,0.401566,0.42,1,72244,71799,445
2895601,6.59961,4,448,380480,0.392313,0.46,1,72251,71803,448
2898521,7.71992,4,452,380480,0.454463,0.48,1,72259,71807,452
2901441,6.34398,4,454,380480,0.498893,0.54,1,72265,71811,454
2904361,5.2688,4,455,380480,0.467778,0.61,1,72270,71815,455
2907281,5.85376,4,457,380480,0.509556,0.64,1,72276,71819,457
2910201,6.77075,4,460,380480,0.525911,0.63,1,72283,71823,460
2913121,6.15415,4,462,380480,0.545182,0.67,1,72289,71827,462
2916041,6.03083,4,464,380480,0.573036,0.71,1,72295,71831,464
2918961,6.00617,4,466,380480,0.594607,0.75,1,72301,71835,466
2921881,4.40123,4,466,380480,0.606921,0.78,1,72305,71839,466
2924801,4.88025,4,467,380480,0.585384,0.83,1,72310,71843,467
2927721,4.17605,4,467,380480,0.621077,0.84,1,72314,71847,467
2930641,4.03521,4,467,380480,0.652215,0.88,1,72318,71851,467
2933561,5.60704,4,469,380480,0.682443,0.88,1,72324,71855,469
2936481,6.72141,4,472,380480,0.712489,0.89,1,72331,71859,472
2939401,5.34428,4,473,380480,0.694498,0.93,1,72336,71863,473
2942321,7.46886,4,477,380480,0.6989,1,1,72344,71867,477
2944241,5.49377,4,478,380480,0.64378,0.1,1,72349,71871,478
2947161,166.699,207.2,427,380480,0.720756,0.07,1,72556,72129,427
2950081,35.7398,44.64,426,380480,0.752151,0.11,2,72559,72133,426
2953001,11.1479,12.128,427,380480,0.71843,0.12,1,72564,72137,427
2955921,6.22959,5.6256,428,380480,0.687686,0.09,1,72569,72141,428
2958841,3.64592,4.32512,427,380480,0.649537,0.11,1,72572,72145,427
2961761,4.72918,4.06502,428,380480,0.673907,0.13,1,72577,72149,428
2964681,4.94584,4.013,429,380480,0.710781,0.12,1,72582,72153,429
2967601,5.78917,4.0026,431,380480,0.750156,0.12,2,72588,72157,431
2970521,4.35783,4.00052,431,380480,0.742031,0.14,1,72592,72161,431
2973441,3.27157,4.0001,430,380480,0.756406,0.18,2,72595,72165,430
2976361,2.25431,4.00002,428,380480,0.751281,0.17,2,72597,72169,428
2979281,6.05086,4,431,380480,0.702256,0.16,1,72604,72173,431
2982201,5.21017,4,432,380480,0.732451,0.13,1,72609,72177,432
2985121,5.04203,4,433,380480,0.73049,0.2,1,72614,72181,433
2987921,4.20841,4,433,380480,0.730098,0.24,1,72618,72185,433
2990841,7.24168,5.6,435,380480,0.74602,0.25,1,72626,72191,435
2993761,4.64834,4.32,435,380480,0.741204,0.23,1,72630,72195,435
2996681,5.72967,4.064,437,380480,0.740241,0.24,1,72636,72199,437
2998741,9.14593,4.0128,443,380480,0.780048,0.28,2,72646,72203,443
3001661,5.82919,8.00256,439,380480,0.77201,0.32,2,72651,72212,439
3003941,8.36584,4.80051,444,380480,0.826402,0.32,2,72660,72216,444
3005601,4.07317,6.5601,440,380480,0.83728,0.32,2,72663,72223,440
3008521,6.41463,6.11202,441,380480,0.751456,0.38,2,72670,72229,441
3011441,5.28293,4.4224,442,380480,0.758291,0.37,2,72675,72233,442
3014361,4.25659,4.08448,442,380480,0.751658,0.4,2,72679,72237,442
3016421,6.45132,4.0169,445,380480,0.726332,0.42,1,72686,72241,445
3019341,6.89026,4.80338,447,380480,0.737266,0.42,1,72693,72246,447
3022261,6.17805,4.16068,449,380480,0.755453,0.43,2,72699,72250,449
3024741,6.03561,4.03214,451,380480,0.831091,0.48,2,72705,72254,451
3026401,3.60712,6.40643,447,380480,0.854218,0.46,2,72708,72261,447
3029321,9.52142,8.48129,449,380480,0.834844,0.52,2,72719,72270,449
3032241,5.90428,4.89626,450,380480,0.846969,0.53,2,72724,72274,450
3035161,5.18086,4.17925,451,380480,0.817394,0.54,2,72729,72278,451
3037841,4.23617,4.03585,451,380480,0.851479,0.55,2,72733,72282,451
3040761,8.04723,6.40717,453,380480,0.834296,0.58,2,72742,72289,453
3043681,5.60945,4.48143,454,380480,0.830859,0.56,2,72747,72293,454
3045541,5.92189,4.09629,456,380480,0.822172,0.64,2,72753,72297,456
3048461,5.98438,5.61926,456,380480,0.820434,0.62,2,72759,72303,456
3050741,9.99688,4.32385,463,380480,0.860087,0.69,2,72770,72307,463
3053661,5.19938,6.46477,460,380480,0.844017,0.7,2,72774,72314,460
3055521,4.23988,4.49295,460,380480,0.848803,0.71,2,72778,72318,460
3058441,4.04797,4.89859,459,380480,0.849761,0.72,2,72782,72323,459
3060721,4.00959,4.17972,459,380480,0.833952,0.72,2,72786,72327,459
3063641,11.2019,10.4359,460,380480,0.81479,0.72,2,72799,72339,460
3066561,6.24038,5.28719,461,380480,0.834958,0.68,2,72804,72343,461
3069481,5.24808,4.25744,462,380480,0.838992,0.72,2,72809,72347,462
3072401,5.84962,4.05149,464,380480,0.767798,0.76,2,72815,72351,464
3075281,5.96992,4.0103,466,380480,0.80956,0.74,2,72821,72355,466
3078201,165.194,168.802,461,380480,0.873912,0.68,2,73026,72565,461
3081121,36.2388,36.9604,461,380480,0.902782,0.65,2,73030,72569,461
3084041,12.0478,10.5921,463,380480,0.892557,0.73,2,73036,72573,463
3086721,5.60955,5.31842,463,380480,0.882511,0.71,2,73040,72577,463
3089641,3.52191,3.46368,463,380480,0.864502,0.76,2,73043,72580,463
3091921,3.90438,3.89274,463,380480,0.8529,0.77,2,73047,72584,463
3094841,7.98088,8.77855,462,380480,0.86658,0.73,2,73056,72594,462
3097761,3.99618,4.95571,461,380480,0.877316,0.72,2,73059,72598,461
3100681,3.99924,4.19114,461,380480,0.903463,0.76,2,73063,72602,461
3103601,3.99985,4.03823,461,380480,0.932693,0.75,2,73067,72606,461
3113981,4,6,462,380480,0.9,0.79,2,73086,72624,462
3116901,4,4.4,462,380480,0.892,0.78,2,73090,72628,462
3119821,6.4,4.08,465,380480,0.8664,0.77,2,73097,72632,465
3122501,4.48,4.016,465,380480,0.86928,0.81,2,73101,72636,465
3125421,6.496,5.6032,466,380480,0.917856,0.82,2,73108,72642,466
3127281,2.8992,4.32064,464,380480,0.919571,0.86,2,73110,72646,464
3130201,6.17984,9.66413,460,380480,0.903914,0.87,2,73117,72657,460
3132481,5.23597,5.13283,461,380480,0.908783,0.75,2,73122,72661,461
3182821,8,9,470,380480,0.95,0.86,2,73246,72776,470
3185741,5.6,9.8,465,380480,0.95,0.82,2,73251,72786,465
3188641,5.92,5.16,467,380480,0.934,0.81,2,73257,72790,467
3191561,5.184,4.232,468,380480,0.8908,0.82,2,73262,72794,468
3193221,2.6368,4.0464,466,380480,0.91416,0.87,2,73264,72798,466
3195301,2.92736,4.00928,465,380480,0.942832,0.86,2,73267,72802,465
3196961,4.58547,5.60186,464,380480,0.932566,0.8,2,73272,72808,464
3319481,9,9,476,380480,0.9,0.96,2,73740,73264,476
3322401,5,5,476,380480,0.916,0.97,2,73744,73268,476
3325321,4.2,4.2,476,380480,0.9032,0.98,2,73748,73272,476
3328001,3.24,4.04,475,380480,0.90064,0.99,2,73751,73276,475
3330081,9.448,8.008,477,380480,0.900128,1,2,73762,73285,477
3333001,9.8896,8.0016,479,380480,0.916026,1,2,73772,73293,479
3346121,4,4,478,380480,0.92,1,2,73999,73521,478
3356921,8,10,477,380480,0.91,1,2,74024,73547,477
3359841,3.2,5.2,475,380480,0.91,1,2,74026,73551,475
3362761,3.04,4.24,474,380480,0.902,1,2,74029,73555,474
3365681,4.608,4.048,475,380480,0.9244,0.98,2,74034,73559,475
3368601,4.1216,4.0096,475,380480,0.92888,0.96,2,74038,73563,475
3371521,4.82432,4.00192,476,380480,0.913776,0.99,2,74043,73567,476
3373761,4.16486,4.00038,476,380480,0.886755,0.96,2,74047,73571,476
3376681,3.23297,3.20008,476,380480,0.921351,0.98,2,74050,73574,476
3379381,6.24659,3.84002,479,380480,0.89627,0.97,2,74057,73578,479
3381041,5.24932,4.768,479,380480,0.883254,1,2,74062,73583,479
3383961,6.64986,10.5536,474,380480,0.864651,0.97,2,74069,73595,474
3386881,5.32997,5.31072,475,380480,0.84493,0.93,2,74074,73599,475
3389361,3.46599,4.26214,474,380480,0.832986,0.98,2,74077,73603,474
3392281,8.6932,8.05243,475,380480,0.862597,0.96,2,74087,73612,475
3394561,4.13864,4.81049,474,380480,0.900519,0.96,2,74090,73616,474
3397481,4.82773,6.5621,472,380480,0.916104,0.97,2,74095,73623,472
3400401,4.96555,4.51242,473,380480,0.959221,0.93,2,74100,73627,473
3403301,5.79311,4.10248,475,380480,0.911844,0.94,2,74106,73631,475
3404961,4.35862,4.0205,475,380480,0.902369,0.98,2,74110,73635,475
3428901,6,4,473,380480,0.84,0.97,2,74171,73698,473
3431821,4.4,4,473,380480,0.84,0.93,2,74175,73702,473
3434081,4.08,4,473,380480,0.872,0.9,2,74179,73706,473
3437001,12.016,13.6,471,380480,0.8864,0.9,2,74193,73722,471
3439921,7.2032,5.92,473,380480,0.91328,0.9,2,74199,73726,473
3452601,6,8,471,380480,0.89,0.97,2,74224,73753,471
3455521,4.4,4.8,471,380480,0.866,0.94,2,74228,73757,471
3458441,4.08,4.16,471,380480,0.8452,0.93,2,74232,73761,471
3460501,8.016,4.032,476,380480,0.87304,0.93,2,74241,73765,476
3462581,8.8032,5.6064,479,380480,0.894608,1,2,74250,73771,479
3464661,7.36064,8.32128,477,380480,0.906922,1,2,74257,73780,477
3510441,6,4,471,380480,0.94,0.88,2,74538,74067,471
3512081,3.6,4,470,380480,0.948,0.92,2,74541,74071,470
3553501,4,4,469,380480,0.91,0.91,2,74644,74175,469
3556421,4.8,4,470,380480,0.934,0.89,2,74649,74179,470
3591961,12,12,473,380480,0.93,0.94,2,74728,74255,473
3594661,7.2,5.6,475,380480,0.938,0.93,2,74734,74259,475
3619001,4,3,478,380480,0.92,1,2,74986,74508,478
3621281,4,3.8,478,380480,0.928,0.97,2,74990,74512,478
3624201,6.4,9.56,474,380480,0.9376,0.96,2,74997,74523,474
3627121,6.08,5.112,476,380480,0.91552,0.92,2,75003,74527,476
3630041,5.216,4.2224,477,380480,0.919104,0.93,2,75008,74531,477
3632961,3.4432,4.04448,476,380480,0.887821,0.99,2,75011,74535,476
3635881,3.88864,4.0089,476,380480,0.857564,0.99,2,75015,74539,476
3638801,5.57773,4.00178,478,380480,0.835513,0.98,2,75021,74543,478
3641721,2.71555,4.00036,476,380480,0.863103,0.99,2,75023,74547,476
3644581,2.94311,4.00007,475,380480,0.90862,1,2,75026,74551,475
3646661,9.38862,4.00001,482,380480,0.917724,0.94,2,75037,74555,482
3649581,5.87772,8,478,380480,0.935545,1,2,75042,74564,478
3720081,4,4,474,380480,0.93,0.99,2,75198,74724,474
3723001,9.6,9.6,474,380480,0.922,0.98,2,75209,74735,474
3725281,5.12,5.12,474,380480,0.8884,1,2,75213,74739,474
3727361,11.424,9.824,476,380480,0.90568,1,2,75226,74750,476
3729441,9.4848,8.3648,477,380480,0.933136,1,2,75235,74758,477
3732361,165.897,168.073,474,380480,0.874627,1,2,75440,74966,474
3734021,35.5794,36.8146,473,380480,0.910925,0.92,2,75443,74970,473
3736941,10.3159,11.3629,472,380480,0.934185,0.96,2,75447,74975,472
3753401,2,4,468,380480,0.95,0.9,2,75473,75005,468
3756321,4.4,4,469,380480,0.95,0.87,2,75478,75009,469
3759241,5.68,4,471,380480,0.91,0.85,2,75484,75013,471
3762161,5.936,4,473,380480,0.886,0.87,2,75490,75017,473
3765081,5.1872,4,474,380480,0.8892,0.94,2,75495,75021,474
3768001,2.63744,4,472,380480,0.91384,0.98,2,75497,75025,472
3770921,5.32749,4,474,380480,0.942768,0.98,2,75503,75029,474
3773841,4.2655,4,474,380480,0.940554,0.94,2,75507,75033,474
3776661,8.8531,4,480,380480,0.876111,0.99,2,75517,75037,480
3779581,5.77062,9.6,474,380480,0.863222,0.99,2,75522,75048,474
3781861,3.55412,5.12,473,380480,0.860644,0.95,2,75525,75052,473
3783521,3.91082,3.424,474,380480,0.876129,0.98,2,75529,75055,474
3785601,5.58217,3.8848,476,380480,0.911226,1,2,75535,75059,476
3788521,5.11643,7.97696,472,380480,0.902245,1,2,75540,75068,472
3791441,5.82329,4.79539,474,380480,0.924449,0.97,2,75546,75072,474
3793921,4.36466,4.15908,474,380480,0.92089,0.96,2,75550,75076,474
3796841,3.27293,3.23182,474,380480,0.896178,0.99,2,75553,75079,474
3799761,4.65459,3.84636,475,380480,0.915236,1,2,75558,75083,475
3801621,6.53092,3.96927,478,380480,0.879047,1,2,75565,75087,478
3803701,7.70618,7.99385,477,380480,0.879809,0.97,2,75573,75096,477
3805781,22.3412,7.19877,496,380480,0.855962,1,2,75599,75103,496
3808701,6.06825,20.6398,474,380480,0.851192,0.96,2,75601,75127,474
3810981,7.61365,7.32795,478,380480,0.850239,0.99,2,75609,75131,478
3813901,3.12273,7.06559,473,380480,0.850048,1,2,75611,75138,473
3816181,5.42455,4.61312,475,380480,0.84201,0.99,2,75617,75142,475
3819101,4.28491,5.72262,473,380480,0.880402,0.95,2,75621,75148,473
3822021,4.05698,4.34452,473,380480,0.89608,0.96,2,75625,75152,473
3824941,4.8114,4.0689,474,380480,0.875216,0.98,2,75630,75156,474
3827861,4.96228,4.01378,475,380480,0.911043,0.97,2,75635,75160,475
3829701,4.99246,4.00276,476,380480,0.934209,0.98,2,75640,75164,476
3831781,5.79849,4.00055,478,380480,0.914842,1,2,75646,75168,478
3834701,4.3597,8.80011,472,380480,0.918968,1,2,75650,75178,472
3837621,4.07194,4.96002,472,380480,0.911794,0.94,2,75654,75182,472
3840541,4.01439,4.192,472,380480,0.926359,0.94,2,75658,75186,472
3850301,4,8,468,380480,0.89,0.9,2,75676,75208,468
3852581,9.6,4.8,475,380480,0.898,0.92,2,75687,75212,475
3855501,6.72,8.96,471,380480,0.9156,0.91,2,75693,75222,471
3857781,8.544,4.992,476,380480,0.91912,0.92,2,75702,75226,476
3859861,9.7088,6.5984,479,380480,0.919824,0.98,2,75712,75233,479
3860481,163.542,9.31968,671,380480,0.911965,0.92,2,75914,75243,671
3862561,35.9084,161.864,475,380480,0.950393,0.98,2,75918,75443,475
3875041,3,4,473,380480,0.92,0.96,2,75942,75469,473
3877961,4.6,5.6,472,380480,0.92,0.97,2,75947,75475,472
3880881,2.52,4.32,470,380480,0.912,0.91,2,75949,75479,470
3883801,6.104,4.064,473,380480,0.8944,0.92,2,75956,75483,473
3886721,6.8208,4.0128,476,380480,0.93888,0.88,2,75963,75487,476
3889601,3.76416,4.00256,475,380480,0.939776,0.97,2,75966,75491,475
3892521,4.75283,7.20051,472,380480,0.923955,0.96,2,75971,75499,472
3895441,4.15057,4.6401,472,380480,0.880791,0.94,2,75975,75503,472
3898361,4.03011,4.12802,472,380480,0.856158,0.89,2,75979,75507,472
3901281,3.20602,4.0256,471,380480,0.883232,0.9,2,75982,75511,471
3904161,3.8412,4.00512,471,380480,0.928646,0.87,2,75986,75515,471
3907081,11.1682,8.00102,475,380480,0.897729,0.89,2,75999,75524,475
3910001,4.63365,4.8002,474,380480,0.883546,0.92,2,76002,75528,474
3911861,4.92673,4.16004,475,380480,0.888709,0.93,2,76007,75532,475
3914561,4.18535,4.03201,475,380480,0.905742,0.94,2,76011,75536,475
3917481,6.43707,7.2064,474,380480,0.933148,0.92,2,76018,75544,474
3920181,5.28741,4.64128,475,380480,0.92263,0.94,2,76023,75548,475
3923101,4.25748,7.32826,471,380480,0.880526,0.94,2,76027,75556,471
3926021,4.8515,4.66565,472,380480,0.864105,0.88,2,76032,75560,472
3928501,4.9703,4.13313,473,380480,0.860821,0.9,2,76037,75564,473
3931421,3.39406,4.82663,471,380480,0.884164,0.9,2,76040,75569,471
3933701,8.67881,4.16533,477,380480,0.864833,0.9,2,76050,75573,477
3935781,23.3358,8.03307,495,380480,0.828966,0.86,2,76077,75582,495
3938701,8.66715,24.0066,472,380480,0.837793,0.85,2,76082,75610,472
3940981,5.73343,8.00132,473,380480,0.839559,0.91,2,76087,75614,473
3943901,5.14669,6.40026,472,380480,0.831912,0.91,2,76092,75620,472
3946821,5.82934,4.48005,474,380480,0.862382,0.9,2,76098,75624,474
3949741,4.36587,4.09601,474,380480,0.860476,0.91,2,76102,75628,474
3952661,4.07317,4.0192,474,380480,0.924095,0.95,2,76106,75632,474
3965521,3,4,473,380480,0.92,0.99,2,76127,75654,473
3968441,5.4,5.6,473,380480,0.936,0.97,2,76133,75660,473
3971361,5.08,4.32,474,380480,0.8912,0.94,2,76138,75664,474
3974281,4.216,4.064,474,380480,0.89024,0.93,2,76142,75668,474
3975921,2.4432,4.0128,472,380480,0.914048,0.95,2,76144,75672,472
3978841,5.28864,5.60256,472,380480,0.92681,0.94,2,76150,75678,472
3981121,4.25773,4.32051,472,380480,0.921362,0.94,2,76154,75682,472
3983201,7.25155,7.2641,472,380480,0.856272,0.94,2,76162,75690,472
3986121,11.0503,10.2528,473,380480,0.875255,0.92,2,76174,75701,473
3987781,8.61006,5.25056,477,380480,0.863051,0.97,2,76182,75705,477
3989861,8.92201,7.45011,478,380480,0.83661,0.96,2,76191,75713,478
3991521,158.584,11.09,662,380480,0.895322,1,2,76387,75725,662
3993601,37.3169,159.818,472,380480,0.891064,0.94,2,76394,75922,472
3996521,14.6634,38.3636,473,380480,0.914213,0.93,2,76403,75930,473
3999441,6.13268,10.8727,473,380480,0.894843,0.93,2,76407,75934,473
4002341,9.22653,5.37454,479,380480,0.882969,0.92,2,76417,75938,479
4005261,5.04531,9.07491,473,380480,0.880594,0.9,2,76421,75948,473
4008181,5.80906,5.01498,475,380480,0.920119,0.94,2,76427,75952,475
4011101,2.76181,4.203,473,380480,0.904024,0.94,2,76429,75956,473
4014021,2.15236,4.0406,471,380480,0.900805,0.97,2,76431,75960,471
4015861,2.03047,4.00812,469,380480,0.892161,0.93,2,76433,75964,469
4018781,5.20609,5.60162,469,380480,0.890432,0.88,2,76439,75970,469
4021701,5.84122,4.32032,471,380480,0.930086,0.87,2,76445,75974,471
4024181,7.56824,4.06406,475,380480,0.914017,0.96,2,76453,75978,475
4027101,3.91365,8.01281,469,380480,0.918803,0.95,2,76456,75987,469
4030021,3.18273,4.80256,468,380480,0.943761,0.94,2,76459,75991,468
4055381,4,4,470,380480,0.95,0.91,2,76506,76036,470
4058301,4,5.6,468,380480,0.926,0.91,2,76510,76042,468
4060581,6.4,4.32,471,380480,0.9212,0.89,2,76517,76046,471
4063501,4.48,7.264,467,380480,0.94424,0.86,2,76521,76054,467
4113241,5,4,470,380480,0.92,0.89,2,76633,76163,470
4115701,8.2,4,475,380480,0.936,0.89,2,76642,76167,475
4117781,13.64,11.2,477,380480,0.9472,0.86,2,76657,76180,477
