#Ack,ack_ewma(ms),send_ewma(ms),rtt_ratio,cwnd (Bytes),Last Router Ocupation Ack Arriaval(Packets),Last Router Ocupation Packet Sent(Packets),Network Situation,AckArrival(ms),TSInsideAck(ms),RTTAck(ms)
4381,2,0,425,16060,0.02,0,1,60845,60420,425
7301,2,0,427,18980,0.004,0,1,60847,60420,427
10221,2,0,429,21900,0.0088,0,1,60849,60420,429
13141,2,0,431,24820,0.00176,0,1,60851,60420,431
14601,161.2,0,632,27740,0.000352,0.04,1,61052,60420,632
17521,213.84,338.4,436,29200,0.0080704,0,1,61279,60843,436
20441,67.568,91.68,437,32120,0.00961408,0.03,1,61310,60873,437
23361,37.5136,42.336,437,35040,0.0179228,0.03,1,61340,60903,437
26281,32.3027,32.4672,438,37960,0.00358456,0,1,61371,60933,438
29201,29.6605,30.4934,437,40880,0.00871691,0,1,61400,60963,437
32121,29.9321,30.0987,437,43800,0.00174338,0,1,61430,60993,437
35041,29.1864,30.0197,436,46720,0.00834868,0,1,61459,61023,436
37961,29.8373,30.0039,436,49640,0.00166974,0,1,61489,61053,436
40881,29.9675,30.0008,436,52560,0.000333947,0,1,61519,61083,436
43801,30.7935,30.0002,437,55480,6.67894e-05,0.01,1,61550,61113,437
46721,138.159,138.8,436,58400,0.128013,0,1,61715,61279,436
49641,52.4317,51.76,437,61320,0.201603,0.02,1,61746,61309,437
52561,34.4863,34.352,437,64240,0.416321,0,1,61776,61339,437
55481,30.8973,30.8704,437,67160,0.651264,0.02,1,61806,61369,437
58401,30.1795,30.1741,437,70080,0.810253,0,2,61836,61399,437
61321,27.6359,29.2348,435,73000,0.858051,0,2,61863,61428,435
64241,25.5272,26.647,434,75920,0.61161,0,1,61888,61454,434
67161,20.3054,22.9294,431,78840,0.394322,0,1,61907,61476,431
70081,20.0611,20.5859,431,81760,0.102864,0.01,1,61927,61496,431
73001,20.0122,20.1172,431,84680,0.0285729,0,1,61947,61516,431
75921,20.0024,20.0234,431,87600,0.00571458,0,1,61967,61536,431
78841,20.0005,20.0047,431,90520,0.00114291,0.01,1,61987,61556,431
81761,20.0001,20.0009,431,93440,0.000228583,0,1,62007,61576,431
84681,20,20.0002,431,96360,0.00804572,0,1,62027,61596,431
87601,20,20,431,99280,0.00160914,0.01,1,62047,61616,431
90521,20,20,431,102200,0.00832183,0,1,62067,61636,431
93441,20,20,431,105120,0.0176644,0.01,1,62087,61656,431
96361,24.8,20,437,108040,0.00353287,0.12,1,62113,61676,437
99281,24.16,20,441,110960,0.0807066,0.18,1,62137,61696,441
102201,23.232,20,444,113880,0.112141,0.26,1,62160,61716,444
105121,24.6464,20,449,116800,0.182428,0.33,1,62185,61736,449
108041,22.5293,18.4,453,119720,0.292486,0.46,1,62207,61754,453
110961,21.3059,16.48,458,122640,0.338497,0.59,1,62228,61770,458
113881,21.8612,16.096,464,125560,0.435699,0.71,1,62250,61786,464
116801,17.9722,16.0192,465,128480,0.48714,0.7,1,62267,61802,465
119721,22.7944,16.0038,473,131400,0.505428,0.86,1,62291,61818,473
122641,21.3589,16.0008,478,134320,0.645086,0.96,1,62312,61834,478
125561,9.87178,16.0002,469,137240,0.665017,0.81,1,62319,61850,469
128481,6.77436,16,459,140160,0.741003,0.65,1,62325,61866,459
131401,7.75487,16,451,143080,0.724201,0.46,1,62333,61882,451
134321,4.75097,16,439,146000,0.68884,0.25,1,62337,61898,439
137241,5.75019,16,429,148920,0.665768,0,1,62343,61914,429
140161,13.15,16,428,151840,0.629154,0.01,1,62358,61930,428
143081,13.83,14.4,428,154760,0.541831,0.01,1,62372,61944,428
146001,13.966,14.08,428,157680,0.436366,0,1,62386,61958,428
148921,13.9932,14.016,428,160600,0.359273,0,1,62400,61972,428
151841,14.7986,14.0032,429,163520,0.143855,0,1,62415,61986,429
154761,13.3597,14.0006,428,166440,0.0287709,0,1,62428,62000,428
157681,13.8719,14.0001,428,169360,0.0137542,0.01,1,62442,62014,428
160601,13.1744,14,427,172280,0.0107508,0.01,1,62455,62028,427
163521,13.0349,12.4,428,175200,0.00215017,0,1,62468,62040,428
166441,12.207,12.08,428,178120,0.00843003,0,1,62480,62052,428
169361,12.0414,12.016,428,181040,0.033686,0.01,1,62492,62064,428
172281,9.60828,11.2032,426,183960,0.0227372,0.03,1,62501,62075,426
175201,10.7217,10.2406,427,186880,0.00454744,0.01,1,62512,62085,427
178121,9.34433,10.0481,426,189800,0.000909488,0.03,1,62521,62095,426
181041,12.2689,10.0096,429,192720,0.000181898,0.05,1,62534,62105,429
183961,13.6538,10.0019,433,195640,0.00803638,0.13,1,62548,62115,433
186881,9.13075,10.0004,431,198560,0.00160728,0.14,1,62556,62125,431
189801,11.4262,10.0001,433,201480,0.0163215,0.17,1,62568,62135,433
192721,10.2852,10,433,204400,0.0192643,0.2,1,62578,62145,433
195641,10.857,10,434,207320,0.0118529,0.16,1,62589,62155,434
198561,11.7714,10,436,210240,0.0903706,0.2,1,62601,62165,436
201481,11.1543,10,437,213160,0.0980741,0.23,1,62612,62175,437
204401,11.8309,10,439,216080,0.107615,0.23,1,62624,62185,439
207321,9.56617,8.4,440,219000,0.117523,0.32,1,62633,62193,440
210241,9.11323,8.08,441,221920,0.127505,0.34,1,62642,62201,441
213161,8.22265,8.016,441,224840,0.177501,0.35,1,62650,62209,441
216081,8.84453,8.0032,442,227760,0.1795,0.38,1,62659,62217,442
219001,12.1689,8.00064,447,230680,0.1639,0.35,1,62672,62225,447
221921,11.2338,8.00013,450,233600,0.14478,0.47,1,62683,62233,450
224841,6.24676,8.00003,447,236520,0.164956,0.49,1,62688,62241,447
227761,10.8494,8.00001,451,239440,0.192991,0.48,1,62700,62249,451
230681,9.36987,8,452,242360,0.182598,0.54,1,62709,62257,452
233601,8.27397,8,452,245280,0.22852,0.56,1,62717,62265,452
236521,8.05479,8,452,248200,0.221704,0.54,1,62725,62273,452
239441,11.211,8,456,251120,0.156341,0.56,1,62737,62281,456
242361,9.44219,8,457,254040,0.143268,0.6,1,62746,62289,457
245281,9.88844,8,459,256960,0.140654,0.65,1,62756,62297,459
248201,9.17769,8,460,259880,0.204131,0.68,1,62765,62305,460
251121,11.4355,8,464,262800,0.232826,0.73,1,62777,62313,464
254041,7.08711,8,462,265720,0.206565,0.77,1,62783,62321,462
255841,5.41742,8,459,268640,0.225313,0.68,1,62788,62329,459
258761,5.88348,8,457,270440,0.237063,0.67,1,62794,62337,457
261681,6.7767,6.4,458,273360,0.215413,0.64,1,62801,62343,458
264601,5.35534,6.08,457,276280,0.227083,0.65,1,62806,62349,457
267281,3.47107,6.016,454,279200,0.253417,0.62,1,62809,62355,454
270201,3.09421,6.0032,451,281880,0.234683,0.57,1,62812,62361,451
271861,8.61884,6.00064,455,284800,0.198937,0.43,1,62822,62367,455
273521,4.12377,15.6001,440,286460,0.199787,0.37,1,62825,62385,440
276441,2.42475,10.32,433,288120,0.207957,0.34,1,62827,62394,433
278101,1.28495,6.86401,428,291040,0.225591,0.21,1,62828,62400,428
279761,2.65699,7.7728,423,292700,0.245118,0,1,62831,62408,423
282681,12.5314,12.7546,424,294360,0.185024,0,1,62846,62422,424
284341,12.1063,7.35091,430,297280,0.117005,0.01,1,62858,62428,430
286421,8.02126,10.2702,426,298940,0.0394009,0.05,1,62865,62439,426
288081,6.40425,8.45404,424,301020,0.0158802,0,1,62871,62447,424
291001,10.0809,10.4908,424,302680,0.019176,0.01,1,62882,62458,424
292661,14.0162,6.89816,433,305600,0.00383521,0.01,1,62897,62464,433
294321,7.60323,13.3796,424,307260,0.000767041,0.04,1,62903,62479,424
297241,12.7206,13.0759,425,308920,0.00815341,0.01,1,62917,62492,425
298901,7.34413,7.41519,425,311840,0.00963068,0.05,1,62923,62498,425
301821,6.26883,7.08304,424,313500,0.00192614,0,1,62929,62505,424
304101,6.05377,6.21661,424,316420,0.0243852,0.01,1,62935,62511,424
305761,4.41075,5.24332,423,318700,0.044877,0,1,62939,62516,423
308681,6.48215,5.84866,424,320360,0.00897541,0.01,1,62946,62522,424
310341,10.8964,5.96973,430,323280,0.00179508,0.01,1,62958,62528,430
312001,6.97929,10.7939,424,324940,0.00835902,0.05,1,62964,62540,424
314921,16.5959,17.3588,424,326600,0.0496718,0.06,1,62983,62559,424
317201,8.91917,8.27176,425,329520,0.0259344,0.05,1,62990,62565,425
320121,11.3838,11.2544,425,331800,0.0131869,0.03,1,63002,62577,425
321781,7.87677,7.05087,426,334720,0.0106374,0.01,1,63009,62583,426
323441,6.37535,6.21017,426,336380,0.0261275,0.13,1,63015,62589,426
326361,10.0751,9.24203,427,338040,0.0212255,0.13,1,63026,62599,427
328641,6.01501,5.04841,428,340960,0.0362451,0.11,1,63031,62603,428
331561,15.603,14.6097,429,343240,0.039249,0.13,1,63049,62620,429
333221,8.7206,6.12194,432,346160,0.0638498,0.12,1,63056,62624,432
334881,3.34412,6.02439,428,347820,0.06077,0.15,1,63058,62630,428
337801,11.8688,8.40488,433,349480,0.044154,0.14,1,63072,62639,433
339461,11.1738,4.88098,440,352400,0.0808308,0.2,1,63083,62643,440
342381,6.23475,12.1762,431,354060,0.0801662,0.12,1,63088,62657,431
344661,6.84695,5.63524,434,356980,0.112033,0.16,1,63095,62661,434
346321,3.76939,8.32705,428,359260,0.0944066,0.16,1,63098,62670,428
349241,8.75388,6.46541,432,360920,0.0828813,0.16,1,63108,62676,432
350901,7.35078,4.49308,435,363840,0.0405763,0.2,1,63115,62680,435
353821,7.07015,7.29862,434,365500,0.0881153,0.14,1,63122,62688,434
355681,4.61403,4.65972,434,368420,0.089623,0.26,1,63126,62692,434
358601,11.3228,10.5319,435,370280,0.0899246,0.19,1,63139,62704,435
360261,3.06456,5.30639,432,370280,0.0819849,0.21,1,63140,62708,432
362341,12.6129,4.26128,443,370280,0.112397,0.22,1,63155,62712,443
364001,4.12258,12.8523,430,370280,0.110479,0.14,1,63157,62727,430
366921,9.62452,10.5705,431,370280,0.0940959,0.16,1,63168,62737,431
368581,5.9249,5.31409,432,370280,0.130819,0.19,1,63173,62741,432
370241,6.78498,5.86282,433,370280,0.0981638,0.17,1,63180,62747,433
373161,9.357,7.57256,435,370280,0.107633,0.24,1,63190,62755,435
374821,9.0714,4.71451,440,370280,0.141527,0.27,1,63199,62759,440
377741,4.21428,8.1429,434,370280,0.140305,0.26,1,63202,62768,434
380021,15.2429,4.82858,448,370280,0.148061,0.25,1,63220,62772,448
382941,6.24857,15.3657,434,370280,0.109612,0.26,1,63224,62790,434
384801,4.44971,6.27314,434,370280,0.0859224,0.24,1,63228,62794,434
387721,6.48994,6.05463,435,370280,0.113184,0.27,1,63235,62800,435
390421,6.09799,4.41093,437,370280,0.166637,0.27,1,63241,62804,437
392081,2.0196,4.08219,434,370280,0.153327,0.3,1,63242,62808,434
395001,5.20392,5.61644,434,370280,0.166665,0.26,1,63248,62814,434
397921,4.24078,4.32329,434,370280,0.201333,0.19,1,63252,62818,434
400401,4.04816,4.06466,434,370280,0.208267,0.21,1,63256,62822,434
403321,4.80963,4.81293,434,370280,0.177653,0.27,1,63261,62827,434
406021,7.36193,4.16259,438,370280,0.147531,0.21,1,63269,62831,438
408941,3.87239,10.4325,429,370280,0.125506,0.18,1,63272,62843,429
411861,2.37448,5.2865,427,370280,0.129101,0.17,1,63274,62847,427
414341,6.0749,4.2573,430,370280,0.14582,0.06,1,63281,62851,430
416421,8.41498,9.65146,428,370280,0.149164,0.01,1,63290,62862,428
418501,7.283,8.33029,427,370280,0.141833,0.01,1,63297,62870,427
420581,11.0566,7.26606,432,372360,0.116367,0.01,1,63309,62877,432
422661,15.8113,11.8532,436,372360,0.0232733,0.01,1,63326,62890,436
425361,6.36226,15.9706,423,372360,0.00465466,0.01,1,63330,62907,423
428281,16.4725,16.7941,425,372360,0.0249309,0.01,1,63349,62924,425
430981,10.4945,6.55883,430,372360,0.00498619,0.05,1,63358,62928,430
433901,5.2989,10.1118,423,372360,0.000997237,0.03,1,63362,62939,423
436801,4.25978,5.22235,423,372360,0.0161994,0.03,1,63366,62943,423
438881,9.65196,9.84447,423,375260,0.0112399,0.03,1,63377,62954,423
441801,14.7304,13.1689,425,377340,0.010248,0,1,63393,62968,425
444501,19.7461,5.83378,442,377340,0.0020496,0.02,1,63414,62972,442
447421,7.14922,19.5668,423,377340,0.0164099,0.03,1,63418,62995,423
449701,11.8298,7.11335,432,377340,0.027282,0,1,63431,62999,432
451781,11.166,11.0227,431,377340,0.0134564,0.06,1,63442,63011,431
454481,7.03319,10.2045,427,377340,0.0666913,0.03,1,63448,63021,427
456561,6.20664,7.64091,426,377340,0.0693383,0.07,1,63454,63028,426
459481,13.2413,13.5282,426,377340,0.109868,0.05,1,63469,63043,426
461141,9.84827,5.90564,431,377340,0.125974,0.08,1,63478,63047,431
463221,3.56965,9.98113,422,377340,0.113195,0.06,1,63480,63058,422
465921,5.51393,4.39623,425,377340,0.0866389,0.09,1,63486,63061,425
468001,21.9028,18.4792,429,377340,0.105328,0.12,1,63512,63083,429
470921,11.5806,13.2958,426,377340,0.117066,0.08,1,63521,63095,426
473201,5.51611,5.85917,426,377340,0.111413,0.08,1,63525,63099,426
476121,9.10322,8.37183,427,377340,0.158283,0.07,1,63535,63108,427
478821,9.82064,4.87437,433,377340,0.0876565,0.12,1,63545,63112,433
481741,5.16413,9.77487,426,377340,0.0895313,0.09,1,63549,63123,426
484641,5.03283,5.15497,427,377340,0.0739063,0.09,1,63554,63127,427
486721,8.20657,7.43099,428,377340,0.126781,0.11,1,63563,63135,428
489641,14.4413,12.6862,430,377340,0.129356,0.09,1,63579,63149,430
492341,6.88826,5.73724,431,377340,0.0818712,0.14,1,63584,63153,431
495041,6.17765,6.74745,430,377340,0.0803742,0.15,1,63590,63160,430
497121,10.8355,10.9495,430,377340,0.128075,0.12,1,63602,63172,430
500041,10.1671,9.3899,431,377340,0.105615,0.16,1,63612,63181,431
502741,10.0334,5.07798,437,377340,0.085123,0.16,1,63622,63185,437
504821,13.2067,9.0156,441,377340,0.113025,0.18,1,63636,63195,441
507741,5.04134,13.0031,430,377340,0.102605,0.14,1,63639,63209,430
510021,10.6083,5.80062,438,377340,0.044521,0.12,1,63651,63213,438
512941,6.92165,11.5601,431,377340,0.0729042,0.12,1,63657,63226,431
515221,9.38433,5.51202,437,377340,0.0625808,0.15,1,63667,63230,437
517921,6.67687,8.30241,434,377340,0.0685162,0.19,1,63673,63239,434
520841,3.73537,4.06048,434,377340,0.0937032,0.2,1,63676,63242,434
523121,3.14707,4.0121,433,377340,0.0827406,0.22,1,63679,63246,433
525201,3.82941,4.80242,432,377340,0.0645481,0.2,1,63683,63251,432
528121,7.96588,9.76048,430,377340,0.0929096,0.16,1,63692,63262,430
531041,4.79318,5.1521,430,377340,0.0505819,0.14,1,63696,63266,430
533521,4.15864,4.23042,430,377340,0.0101164,0.14,1,63700,63270,430
536441,4.03173,3.24608,431,377340,0.0340233,0.17,1,63704,63273,431
539361,4.00635,3.84922,431,377340,0.0548047,0.17,1,63708,63277,431
542281,4.00127,3.96984,431,377340,0.0189609,0.17,1,63712,63281,431
544341,4.00025,3.99397,431,377340,0.0117922,0.15,1,63716,63285,431
546421,4.80005,4.79879,431,377340,0.0103584,0.17,1,63721,63290,431
548501,3.36001,5.75976,428,377340,0.0100717,0.16,1,63724,63296,428
550581,7.072,3.55195,433,377340,0.0100143,0.1,1,63732,63299,433
552661,17.4144,11.9104,439,377340,0.00200287,0.01,1,63752,63313,439
555581,7.48288,18.3821,424,377340,0.0164006,0.01,1,63757,63333,424
557861,17.4966,6.87642,440,377340,0.0112801,0.01,1,63777,63337,440
559941,11.4993,17.3753,430,377340,0.00225602,0.04,1,63787,63357,430
562861,5.49986,12.2751,423,377340,0.000451205,0,1,63791,63368,423
565781,4.29997,5.65501,423,377340,9.02409e-05,0.01,1,63795,63372,423
567841,4.05999,4.331,423,377340,1.80482e-05,0.03,1,63799,63376,423
569921,5.612,5.6662,423,377340,3.60964e-06,0.02,1,63805,63382,423
572001,11.5224,11.5332,423,377340,0.0160007,0.02,1,63818,63395,423
574921,23.1045,21.5066,425,377340,0.0352001,0,1,63844,63419,425
577841,7.8209,7.50133,425,377340,0.03104,0,1,63848,63423,425
579701,9.56418,4.70027,431,377340,0.00620801,0.06,1,63858,63427,431
581781,15.5128,8.94005,438,377340,0.0092416,0.07,1,63875,63437,438
584701,8.70257,13.788,430,377340,0.00184832,0.07,1,63882,63452,430
586981,7.34051,5.9576,433,377340,0.0243697,0.18,1,63889,63456,433
589061,10.2681,7.59152,436,377340,0.0528739,0.14,1,63900,63464,436
591141,12.4536,11.9183,436,377340,0.106575,0.1,1,63913,63477,436
593841,5.69072,9.58366,431,377340,0.085315,0.1,1,63917,63486,431
596761,4.33814,4.31673,432,377340,0.081063,0.13,1,63921,63489,432
598421,20.0676,4.06335,452,377340,0.0882126,0.16,1,63945,63493,452
600501,9.61353,20.8127,434,377340,0.105643,0.13,1,63952,63518,434
602581,6.72271,8.96253,434,377340,0.125129,0.18,1,63958,63524,434
604241,4.54454,10.5925,427,377340,0.121026,0.07,1,63962,63535,427
607161,10.5089,10.1185,429,377340,0.144205,0.09,1,63974,63545,429
610081,6.90178,5.2237,431,377340,0.116841,0.09,1,63980,63549,431
612561,3.78036,4.24474,430,377340,0.135368,0.15,1,63983,63553,430
615481,8.75607,8.04895,431,377340,0.0990736,0.17,1,63993,63562,431
617141,3.35121,4.80979,429,377340,0.0998147,0.19,1,63995,63566,429
619221,15.8702,4.16196,444,377340,0.179963,0.1,1,64014,63570,444
622141,6.37405,16.0324,429,377340,0.139993,0.13,1,64018,63589,429
625061,6.07481,6.40648,431,377340,0.147999,0.15,1,64024,63593,431
627541,6.01496,4.4813,433,377340,0.0935997,0.19,1,64030,63597,433
629621,10.003,9.69626,433,377340,0.0907199,0.08,1,64041,63608,433
631701,9.2006,9.13925,433,377340,0.098144,0.13,1,64050,63617,433
633361,4.24012,9.02785,427,377340,0.107629,0.11,1,64053,63626,427
636281,12.048,13.8056,426,377340,0.0935258,0.07,1,64067,63641,426
638561,6.4096,5.96111,427,377340,0.122705,0.07,1,64072,63645,427
640641,7.68192,8.39222,426,377340,0.160541,0.07,1,64080,63654,426
643561,8.73638,8.87844,426,377340,0.152108,0.1,1,64089,63663,426
645221,9.74728,4.97569,432,377340,0.110422,0.1,1,64099,63667,432
648141,5.94946,8.99514,427,377340,0.134084,0.07,1,64104,63677,427
650421,7.58989,4.99903,431,377340,0.130817,0.09,1,64112,63681,431
653341,6.31798,10.5998,425,377340,0.146163,0.04,1,64118,63693,425
656241,5.2636,5.31996,426,377340,0.133233,0.04,1,64123,63697,426
659161,4.25272,6.66399,423,377340,0.130647,0.07,1,64127,63704,423
662081,4.05054,4.5328,423,377340,0.106129,0.01,1,64131,63708,423
665001,4.01011,4.10656,423,377340,0.109226,0.03,1,64135,63712,423
667921,4.00202,4.02131,423,377340,0.141845,0.03,1,64139,63716,423
670841,4.0004,4.00426,423,377340,0.164369,0.03,1,64143,63720,423
673761,4.00008,4.00085,423,377340,0.144874,0.03,1,64147,63724,423
676421,5.60002,4.00017,425,377340,0.124975,0.03,1,64153,63728,425
679121,4.32,5.60003,423,377340,0.128995,0.02,1,64157,63734,423
681201,11.264,10.72,424,377340,0.145799,0.01,1,64170,63746,424
684121,13.4528,13.344,424,377340,0.10916,0,1,64184,63760,424
686401,5.89056,5.8688,424,377340,0.069832,0.01,1,64188,63764,424
688481,17.9781,18.7738,423,377340,0.0219664,0,1,64209,63786,423
691401,10.7956,10.9548,423,377340,0.0123933,0.02,1,64218,63795,423
693681,5.35912,5.39095,423,377340,0.00247866,0,1,64222,63799,423
696601,5.87183,5.07819,424,377340,0.000495731,0.01,1,64228,63804,424
699521,4.37436,4.21564,424,377340,0.00809915,0,1,64232,63808,424
702421,18.4749,4.04313,442,377340,0.00961983,0.01,1,64254,63812,442
704501,15.695,18.4086,435,377340,0.025924,0.02,1,64269,63834,435
706581,11.939,16.4817,430,377340,0.00518479,0.04,1,64280,63850,430
709501,5.5878,12.0963,423,377340,0.017037,0.03,1,64284,63861,423
711781,21.9176,5.61927,445,377340,0.0114074,0.06,1,64310,63865,445
714701,9.98351,21.1239,427,377340,0.00228148,0.06,1,64317,63890,427
717601,6.7967,7.42477,429,377340,0.0084563,0.13,1,64323,63894,429
719681,15.7593,15.885,429,377340,0.0976913,0.09,1,64341,63912,429
722601,7.95187,9.57699,427,377340,0.0995383,0.13,1,64347,63920,427
725521,5.59037,5.1154,428,377340,0.0599077,0.13,1,64352,63924,428
728421,21.1181,4.22308,449,377340,0.0439815,0.13,1,64377,63928,449
730501,9.82361,19.2446,433,377340,0.0327963,0.14,1,64384,63951,433
732581,13.1647,11.0489,438,377340,0.0545593,0.16,1,64398,63960,438
735281,5.83294,11.8098,430,377340,0.0669118,0.11,1,64402,63972,430
737361,5.96659,8.76196,428,377340,0.0773824,0.11,1,64408,63980,428
740281,8.39332,8.95239,428,377340,0.103476,0.11,1,64417,63989,428
743201,5.67866,4.99048,429,377340,0.0846953,0.1,1,64422,63993,429
746121,7.53573,4.1981,433,377340,0.0489391,0.11,1,64430,63997,433
747761,3.90715,4.03962,432,377340,0.0257878,0.15,1,64433,64001,432
750681,15.9814,19.2079,428,377340,0.0691576,0.11,1,64452,64024,428
752961,6.39629,7.04158,428,377340,0.109832,0.12,1,64456,64028,428
755881,8.47926,8.60832,428,377340,0.141966,0.11,1,64465,64037,428
758801,5.69585,4.92166,429,377340,0.108393,0.09,1,64470,64041,429
761701,7.53917,4.18433,433,377340,0.0696787,0.13,1,64478,64045,433
763781,9.50783,8.03687,434,377340,0.0699357,0.13,1,64488,64054,434
765861,12.3016,8.80737,438,377340,0.109987,0.14,1,64501,64063,438
768781,7.26031,12.1615,431,377340,0.0619974,0.17,1,64507,64076,431
771061,6.25206,5.63229,433,377340,0.0523995,0.14,1,64513,64080,433
773141,6.85041,6.72646,433,377340,0.0664799,0.14,1,64520,64087,433
775221,10.1701,6.94529,437,377340,0.029296,0.18,1,64531,64094,437
777301,9.23402,10.9891,434,377340,0.0458592,0.14,1,64540,64106,434
778961,4.2468,8.59781,429,377340,0.0571718,0.13,1,64543,64114,429
781881,8.84936,8.91956,430,377340,0.0434344,0.15,1,64553,64123,430
784161,4.96987,4.98391,430,377340,0.0486869,0.11,1,64557,64127,430
787081,8.19397,7.39678,431,377340,0.0497374,0.18,1,64566,64135,431
790001,4.03879,4.67936,430,377340,0.0579475,0.18,1,64569,64139,430
792921,4.00776,4.13587,430,377340,0.0595895,0.16,1,64573,64143,430
795841,4.00155,4.02717,430,377340,0.0599179,0.15,1,64577,64147,430
798761,4.00031,4.00543,430,377340,0.0599836,0.16,1,64581,64151,430
801681,4.00006,4.00109,430,377340,0.0359967,0.18,1,64585,64155,430
803921,3.20001,4.00022,429,377340,0.0311993,0.15,1,64588,64159,429
806841,3.84,3.20004,430,377340,0.0142399,0.15,1,64592,64162,430
809761,3.968,3.84001,430,377340,0.026848,0.15,1,64596,64166,430
811621,3.1936,3.968,429,377340,0.0213696,0.16,1,64599,64170,429
813701,10.2387,3.9936,437,377340,0.0202739,0.02,1,64611,64174,437
816621,5.24774,15.1987,423,377340,0.0200548,0.01,1,64615,64192,423
818901,21.0495,6.23974,444,377340,0.00401096,0.03,1,64640,64196,444
820981,13.0099,20.4479,431,377340,0.00880219,0.03,1,64651,64220,431
823901,5.80198,13.6896,423,377340,0.00976044,0.01,1,64655,64232,423
826801,4.3604,5.93792,423,377340,0.00995209,0.03,1,64659,64236,423
829721,6.47208,6.78758,423,377340,0.00199042,0.03,1,64666,64243,423
831381,14.8944,4.55752,436,377340,0.00839808,0,1,64683,64247,436
833041,4.57888,12.9115,423,377340,0.00167962,0.03,1,64685,64262,423
835121,11.3158,12.1823,424,377340,0.0323359,0.02,1,64698,64274,424
837201,10.2632,9.63646,425,377340,0.00646718,0.03,1,64708,64283,425
840121,9.25263,10.7273,423,377340,0.00129344,0.03,1,64717,64294,423
841781,25.8505,5.34546,449,377340,0.00825869,0.03,1,64747,64298,449
844701,9.97011,21.8691,429,377340,0.00965174,0.05,1,64753,64324,429
846981,6.79402,7.57382,431,377340,0.0339303,0.09,1,64759,64328,431
848641,2.9588,5.51476,428,377340,0.0387861,0.1,1,64761,64333,428
850721,11.7918,12.303,428,377340,0.127757,0.11,1,64775,64347,428
853641,11.9584,14.4606,425,377340,0.105551,0.1,1,64787,64362,425
855921,4.79167,6.09212,424,377340,0.10111,0.04,1,64790,64366,424
858841,18.5583,17.2184,426,377340,0.132222,0.06,1,64812,64386,426
861121,6.91167,6.64368,426,377340,0.138444,0.12,1,64816,64390,426
864041,20.5823,20.5287,426,377340,0.139689,0.12,1,64840,64414,426
866961,6.51647,7.30575,425,377340,0.163938,0.09,1,64843,64418,425
869861,6.10329,4.66115,427,377340,0.136788,0.08,1,64849,64422,427
872781,6.02066,5.73223,427,377340,0.123358,0.04,1,64855,64428,427
875701,5.20413,4.34645,428,377340,0.104672,0.07,1,64860,64432,428
878181,9.04083,4.06929,434,377340,0.116934,0.13,1,64870,64436,434
880261,13.0082,8.01386,439,377340,0.143387,0.13,1,64884,64445,439
882341,10.6016,12.0028,436,377340,0.156677,0.08,1,64894,64458,436
885261,6.12033,15.2006,425,377340,0.135335,0.06,1,64899,64474,425
888181,6.02407,6.24011,427,377340,0.123067,0.05,1,64905,64478,427
890661,8.40481,4.44802,432,377340,0.128613,0.09,1,64914,64482,432
892321,3.28096,5.6896,428,377340,0.129723,0.14,1,64916,64488,428
894401,7.85619,9.93792,426,377340,0.161945,0.08,1,64925,64499,426
897321,11.9712,11.5876,427,377340,0.176389,0.08,1,64938,64511,427
899601,4.79425,5.51752,426,377340,0.163278,0.11,1,64941,64515,426
902521,8.15885,9.1035,425,377340,0.0886556,0.03,1,64950,64525,425
905221,10.4318,5.0207,432,377340,0.0497311,0.08,1,64961,64529,432
907301,10.8864,8.20414,434,377340,0.113946,0.11,1,64972,64538,434
910001,5.37727,10.4408,427,377340,0.102789,0.06,1,64976,64549,427
912081,5.87545,7.68817,426,377340,0.0525578,0.07,1,64982,64556,426
915001,7.57509,7.93763,426,377340,0.0665116,0.08,1,64990,64564,426
916661,7.91502,4.78753,430,377340,0.0213023,0.08,1,64998,64568,430
919581,3.183,8.15751,423,377340,0.0442605,0.09,1,65000,64577,423
922501,4.6366,4.8315,424,377340,0.0648521,0.06,1,65005,64581,424
925421,4.12732,4.1663,424,377340,0.0849704,0.03,1,65009,64585,424
928341,4.02546,4.03326,424,377340,0.104994,0.03,1,65013,64589,424
931261,4.00509,4.00665,424,377340,0.108999,0.06,1,65017,64593,424
934181,4.00102,4.00133,424,377340,0.1098,0.06,1,65021,64597,424
937101,4.0002,4.00027,424,377340,0.07796,0.06,1,65025,64601,424
940021,4.00004,4.00005,424,377340,0.023592,0.06,1,65029,64605,424
942241,4.00001,4.00001,424,377340,0.0127184,0.03,1,65033,64609,424
945161,7.2,8,423,377340,0.0105437,0.08,1,65041,64618,423
947441,4.64,4.8,423,377340,0.0261087,0.01,1,65045,64622,423
949521,24.128,23.36,424,377340,0.00522175,0.03,1,65074,64650,424
952441,12.8256,12.672,424,377340,0.00104435,0.03,1,65084,64660,424
955361,4.96512,5.7344,423,377340,0.00820887,0.01,1,65087,64664,423
958281,4.19302,4.34688,423,377340,0.0176418,0.06,1,65091,64668,423
959921,3.2386,4.06938,422,377340,0.00352835,0,1,65094,64672,422
962001,12.6477,11.2139,424,377340,0.000705671,0.04,1,65109,64685,424
964081,12.1295,12.6428,423,377340,0.000141134,0.02,1,65121,64698,423
967001,12.8259,12.9286,423,377340,0.0240282,0,1,65134,64711,423
969701,8.16518,5.78571,426,377340,0.00480565,0.03,1,65141,64715,426
971781,32.833,6.75714,458,377340,0.00896113,0.05,1,65180,64722,458
974701,11.3666,30.1514,428,377340,0.00979223,0.07,1,65186,64758,428
976981,8.67332,9.23029,432,377340,0.0339584,0.15,1,65194,64762,432
979681,4.13466,8.24606,427,377340,0.0467917,0.12,1,65197,64770,427
981761,8.82693,8.04921,429,377340,0.0973583,0.17,1,65207,64778,429
984681,16.9654,16.8098,429,377340,0.0914717,0.14,1,65226,64797,429
986961,6.59308,6.56197,429,377340,0.0742943,0.02,1,65230,64801,429
989881,18.9186,20.5124,427,377340,0.0868589,0.01,1,65252,64825,427
992161,10.1837,7.30248,431,377340,0.113372,0.14,1,65260,64829,431
995081,15.6367,16.6605,429,377340,0.134674,0.14,1,65277,64848,429
997361,7.12735,6.5321,430,377340,0.122935,0.1,1,65282,64852,430
1000281,7.82547,7.70642,430,377340,0.080587,0.17,1,65290,64860,430
1003201,4.76509,4.74128,430,377340,0.0321174,0.12,1,65294,64864,430
1005061,3.35302,4.14826,429,377340,0.0224235,0.13,1,65297,64868,429
1007981,6.2706,4.82965,431,377340,0.0204847,0.13,1,65304,64873,431
1010261,12.4541,4.16593,441,377340,0.0920969,0.17,1,65318,64877,441
1012341,10.4908,13.6332,435,377340,0.154419,0.13,1,65328,64893,435
1015261,5.29816,10.7266,429,377340,0.134884,0.15,1,65332,64903,429
1017541,9.85963,5.34533,436,377340,0.146977,0.15,1,65343,64907,436
1019201,5.17193,8.26907,431,377340,0.117395,0.17,1,65347,64916,431
1022121,6.63439,4.85381,434,377340,0.111479,0.18,1,65354,64920,434
1024821,5.32688,4.17076,435,377340,0.118296,0.24,1,65359,64924,435
1026901,16.2654,5.63415,448,377340,0.119659,0.09,1,65378,64930,448
1029821,8.05308,21.1268,429,377340,0.119932,0.09,1,65384,64955,429
1032721,5.61061,7.42537,430,377340,0.0719864,0.17,1,65389,64959,430
1035641,6.72212,11.0851,425,377340,0.0783973,0.11,1,65396,64971,425
1037301,6.94442,5.41701,428,377340,0.0956795,0.06,1,65403,64975,428
1040221,4.58888,5.8834,426,377340,0.131136,0.1,1,65407,64981,426
1042501,4.11778,4.37668,426,377340,0.114227,0.09,1,65411,64985,426
1044581,8.82356,4.87534,431,377340,0.134845,0.05,1,65421,64990,431
1046661,4.96471,7.37507,427,377340,0.122969,0.09,1,65425,64998,427
1048741,8.99294,3.87501,434,377340,0.128594,0.12,1,65435,65001,434
1051661,3.39859,9.575,425,377340,0.105719,0.13,1,65437,65012,425
1054581,2.27972,5.115,423,377340,0.0771438,0.12,1,65439,65016,423
1057501,3.65594,4.223,423,377340,0.0794287,0.08,1,65443,65020,423
1060421,3.93119,4.0446,423,377340,0.103886,0.03,1,65447,65024,423
1063301,3.98624,4.00892,423,377340,0.100777,0.03,1,65451,65028,423
1066221,4.79725,4.00178,424,377340,0.124155,0.03,1,65456,65032,424
1069141,4.15945,4.00036,424,377340,0.136831,0.02,1,65460,65036,424
1071621,6.43189,4.00007,427,377340,0.115366,0.03,1,65467,65040,427
1074541,5.28638,6.40001,425,377340,0.0870732,0.02,1,65472,65047,425
1076821,5.85728,4.48,427,377340,0.0734146,0.06,1,65478,65051,427
1078481,3.57146,6.496,423,377340,0.0786829,0.01,1,65481,65058,423
1080561,17.5143,17.2992,424,377340,0.0717366,0.01,1,65502,65078,424
1083481,14.7029,15.4598,423,377340,0.0143473,0.01,1,65516,65093,423
1086401,6.14057,6.29197,423,377340,0.00286946,0.01,1,65520,65097,423
1089321,5.22811,4.45839,424,377340,0.000573893,0.03,1,65525,65101,424
1090961,2.64562,4.09168,422,377340,0.000114779,0,1,65527,65105,422
1093041,13.3291,11.2183,425,377340,0.00802296,0.05,1,65543,65118,425
1095121,9.06582,10.2437,423,377340,0.00960459,0,1,65551,65128,423
1097201,9.01317,9.24873,423,377340,0.00192092,0.06,1,65560,65137,423
1100121,6.60263,6.64975,423,377340,0.0323842,0.04,1,65566,65143,423
1101781,38.9205,4.52995,466,377340,0.00647684,0.02,1,65613,65147,466
1104701,12.5841,35.306,429,377340,0.00929537,0.07,1,65619,65190,429
1106981,11.3168,10.2612,436,377340,0.0498591,0.13,1,65630,65194,436
1109901,5.46336,10.8522,429,377340,0.0899718,0.14,1,65634,65205,429
1112181,7.49267,5.37045,433,377340,0.0979944,0.13,1,65642,65209,433
1114261,11.8985,9.07409,436,377340,0.0915989,0.04,1,65655,65219,436
1117181,8.77971,14.6148,428,377340,0.0343198,0.01,1,65663,65235,428
1119461,17.7559,6.12296,444,377340,0.046864,0.13,1,65683,65239,444
1121541,8.35119,18.8246,428,377340,0.0173728,0.09,1,65689,65261,428
1123201,4.07024,6.16492,428,377340,0.0354746,0.07,1,65692,65264,428
1126121,18.414,22.033,424,377340,0.103095,0.04,1,65714,65290,424
1129041,6.88281,7.6066,424,377340,0.116619,0.03,1,65718,65294,424
1131961,6.17656,4.72132,426,377340,0.0953238,0.06,1,65724,65298,426
1134881,5.23531,4.14426,427,377340,0.0990648,0.03,1,65729,65302,427
1137141,5.04706,4.02885,428,377340,0.059813,0.07,1,65734,65306,428
1138801,5.00941,3.20577,430,377340,0.0999626,0.17,1,65739,65309,430
1140881,13.8019,11.8412,432,377340,0.0839925,0.17,1,65755,65323,432
1143801,10.7604,13.5682,428,377340,0.0647985,0.19,1,65765,65337,428
1146081,6.15208,5.91365,429,377340,0.0129597,0.13,1,65770,65341,429
1149001,7.63042,6.78273,430,377340,0.0745919,0.14,1,65778,65348,430
1151701,9.52608,4.55655,436,377340,0.0789184,0.15,1,65788,65352,436
1153781,4.30522,8.11131,430,377340,0.111784,0.17,1,65791,65361,430
1155441,4.86104,6.42226,429,377340,0.0863567,0.15,1,65796,65367,429
1157521,9.77221,10.8845,428,377340,0.121271,0.08,1,65807,65379,428
1160441,8.35444,9.37689,427,377340,0.104254,0.14,1,65815,65388,427
1162101,5.67089,5.07538,428,377340,0.0768509,0.1,1,65820,65392,428
1163761,5.13418,4.21508,429,377340,0.0633702,0.16,1,65825,65396,429
1166681,9.82684,8.84302,430,377340,0.068674,0.15,1,65836,65406,430
1169381,6.76537,4.9686,432,377340,0.0697348,0.15,1,65842,65410,432
1172301,4.55307,5.79372,430,377340,0.061947,0.16,1,65846,65416,430
1174581,5.71061,4.35874,432,377340,0.0923894,0.12,1,65852,65420,432
1176661,5.14212,4.87175,432,377340,0.0984779,0.15,1,65857,65425,432
1178741,9.02842,8.17435,433,377340,0.123696,0.1,1,65867,65434,433
1181661,5.80568,8.83487,429,377340,0.112739,0.13,1,65872,65443,429
1184581,5.16114,4.96697,430,377340,0.0785478,0.14,1,65877,65447,430
1187061,5.03223,4.19339,431,377340,0.0557096,0.14,1,65882,65451,431
1189981,3.40645,6.43868,427,377340,0.0511419,0.15,1,65885,65458,427
1192901,3.08129,4.48774,426,377340,0.0502284,0.12,1,65888,65462,426
1195821,3.81626,4.09755,426,377340,0.0340457,0.12,1,65892,65466,426
1198741,5.56325,4.01951,428,377340,0.0388091,0.1,1,65898,65470,428
1201661,4.31265,4.0039,428,377340,0.0477618,0.09,1,65902,65474,428
1204581,4.06253,4.00078,428,377340,0.0335524,0.11,1,65906,65478,428
1207501,4.01251,4.00016,428,377340,0.0307105,0.12,1,65910,65482,428
1209521,2.4025,4.00003,426,377340,0.0301421,0.02,1,65912,65486,426
1211601,18.8805,21.6,423,377340,0.0380284,0,1,65935,65512,423
1214521,14.9761,14.72,424,377340,0.0156057,0.01,1,65949,65525,424
1216801,5.39522,6.144,423,377340,0.0191211,0.06,1,65952,65529,423
1219721,9.07904,9.2288,423,377340,0.0118242,0.02,1,65962,65539,423
1222641,5.01581,5.04576,423,377340,0.0103648,0,1,65966,65543,423
1225541,8.20316,4.20915,428,377340,0.026073,0.03,1,65975,65547,428
1227621,9.64063,7.24183,430,377340,0.0292146,0.06,1,65985,65555,430
1229701,9.92813,10.2484,429,377340,0.0458429,0.04,1,65995,65566,429
1231781,37.1856,10.0497,463,377340,0.0171686,0.03,1,66039,65576,463
1233861,17.0371,36.4099,432,377340,0.00343372,0.05,1,66051,65619,432
1235521,5.80742,13.682,427,377340,0.00868674,0.11,1,66054,65627,427
1238441,9.96149,12.3364,426,377340,0.0337374,0.12,1,66065,65639,426
1240721,6.7923,5.66728,428,377340,0.0147475,0.07,1,66071,65643,428
1242801,3.75846,5.93346,425,377340,0.0509495,0.04,1,66074,65649,425
1244881,11.1517,10.7867,426,377340,0.13819,0.07,1,66087,65661,426
1247801,7.03034,7.75734,425,377340,0.115638,0.06,1,66093,65668,425
1249461,18.2061,4.75147,442,377340,0.0631276,0.05,1,66114,65672,442
1252161,8.44121,17.7503,427,377340,0.0286255,0.06,1,66120,65693,427
1254241,8.88824,9.15006,429,377340,0.0457251,0.09,1,66129,65700,429
1257161,19.3776,21.03,427,377340,0.033145,0.11,1,66151,65724,427
1260081,9.47553,7.406,430,377340,0.014629,0.08,1,66158,65728,430
1263001,5.09511,4.6812,430,377340,0.0269258,0.1,1,66162,65732,430
1265921,3.41902,4.13624,429,377340,0.0133852,0.16,1,66165,65736,429
1267761,3.8838,4.02725,429,377340,0.00267703,0.15,1,66169,65740,429
1269841,7.17676,8.80545,427,377340,0.0405354,0.09,1,66177,65750,427
1271921,9.43535,10.5611,426,377340,0.120107,0.1,1,66187,65761,426
1274841,13.8871,12.5122,428,377340,0.120021,0.11,1,66202,65774,428
1277121,5.17741,5.70244,427,377340,0.112004,0.09,1,66205,65778,427
1279201,9.03548,8.34049,428,377340,0.0944009,0.11,1,66215,65787,428
1282121,7.4071,6.4681,429,377340,0.0508802,0.12,1,66222,65793,429
1284401,3.88142,4.49362,428,377340,0.018176,0.11,1,66225,65797,428
1286481,4.77628,3.29872,430,377340,0.0436352,0.1,1,66230,65800,430
1288561,9.75526,12.6597,426,377340,0.016727,0.06,1,66241,65815,426
1291481,10.7511,10.5319,427,377340,0.0593454,0.08,1,66252,65825,427
1294181,5.35021,5.30639,427,377340,0.0358691,0.04,1,66256,65829,427
1296261,5.87004,5.06128,428,377340,0.0231738,0.07,1,66262,65834,428
1298341,13.974,5.81226,438,377340,0.0526348,0.11,1,66278,65840,438
1301261,7.5948,12.3625,430,377340,0.018527,0.1,1,66284,65854,430
1304181,4.71896,5.67249,430,377340,0.0357054,0.12,1,66288,65858,430
1307101,2.54379,4.3345,428,377340,0.0391411,0.15,1,66290,65862,428
1308741,2.10876,4.0669,426,377340,0.0318282,0.13,1,66292,65866,426
1310821,10.0218,4.81338,433,377340,0.110366,0.07,1,66304,65871,433
1313741,6.00435,11.3627,425,377340,0.0700731,0.06,1,66309,65884,425
1315601,3.60087,5.47254,424,377340,0.0620146,0.03,1,66312,65888,424
1318521,4.72017,4.29451,425,377340,0.0764029,0.07,1,66317,65892,425
1321441,4.14403,4.0589,425,377340,0.127281,0.07,1,66321,65896,425
1324361,4.02881,4.01178,425,377340,0.129456,0.07,1,66325,65900,425
1327281,3.20576,4.00236,424,377340,0.121891,0.07,1,66328,65904,424
1330201,4.64115,4.00047,425,377340,0.0963783,0.06,1,66333,65908,425
1333121,4.92823,4.00009,426,377340,0.0912757,0.05,1,66338,65912,426
1336041,4.18565,4.00002,426,377340,0.0902551,0.07,1,66342,65916,426
1338481,4.03713,4,426,377340,0.082051,0.09,1,66346,65920,426
1340561,5.60743,6.4,425,377340,0.0724102,0.06,1,66352,65927,425
1342641,9.92149,10.88,424,377340,0.062482,0,1,66363,65939,424
1345561,17.1843,17.376,424,377340,0.0604964,0.01,1,66382,65958,424
1348481,6.63686,6.6752,424,377340,0.0440993,0.01,1,66386,65962,424
1351381,7.72737,4.53504,428,377340,0.00881986,0.06,1,66394,65966,428
1353041,3.94547,7.30701,423,377340,0.017764,0.02,1,66397,65974,423
1355961,9.5891,8.6614,425,377340,0.0275528,0.02,1,66408,65983,425
1357621,5.91782,4.93228,426,377340,0.0215106,0.05,1,66413,65987,426
1359701,8.38356,5.78646,429,377340,0.0123021,0.04,1,66422,65993,429
1361781,42.4767,9.15729,470,377340,0.00246042,0.01,1,66473,66003,470
1363861,18.0953,41.8315,432,377340,0.00849209,0.06,1,66485,66053,432
1366561,10.0191,17.1663,429,377340,0.0336984,0.06,1,66493,66064,429
1369481,10.8038,10.6333,431,377340,0.0707397,0.13,1,66504,66073,431
1371761,5.36076,5.32665,431,377340,0.0861479,0.17,1,66508,66077,431
1374681,6.67215,10.6653,426,377340,0.0332296,0.13,1,66515,66089,426
1377381,11.7344,5.33307,435,377340,0.0226459,0.1,1,66528,66093,435
1379461,18.3469,11.4666,442,377340,0.0605292,0.08,1,66548,66106,442
1382381,6.06938,19.0933,424,377340,0.0521058,0.06,1,66551,66127,424
1384661,9.21388,7.01866,430,377340,0.0584212,0.05,1,66561,66131,430
1386741,19.4428,9.40373,442,377340,0.0836842,0.02,1,66583,66141,442
1389661,8.68856,20.2807,425,377340,0.0807368,0.01,1,66589,66164,425
1392581,8.13771,7.25615,429,377340,0.0481474,0.01,1,66597,66168,429
1395501,4.02754,4.65123,428,377340,0.0176295,0.08,1,66600,66172,428
1398181,5.60551,4.13025,430,377340,0.0275259,0.13,1,66606,66176,430
1400261,9.9211,3.22605,438,377340,0.0775052,0.15,1,66617,66179,438
1402961,5.18422,11.0452,429,377340,0.055501,0.12,1,66621,66192,429
1405881,14.6368,19.809,424,377340,0.0431002,0.07,1,66638,66214,424
1408801,7.72737,7.16181,426,377340,0.05662,0.04,1,66644,66218,426
1411701,10.3455,4.63236,433,377340,0.027324,0.03,1,66655,66222,433
1414621,6.06909,11.3265,425,377340,0.0294648,0.01,1,66660,66235,425
1417521,4.41382,5.46529,425,377340,0.029893,0.07,1,66664,66239,425
1419601,8.08276,9.09306,424,377340,0.0139786,0.06,1,66673,66249,424
1421681,5.61655,5.81861,424,377340,0.0347957,0.02,1,66678,66254,424
1424601,7.52331,5.96372,426,377340,0.0389591,0.03,1,66686,66260,426
1426261,10.3047,4.39274,433,377340,0.0477918,0.07,1,66697,66264,433
1428341,12.4609,11.2785,433,377340,0.0175584,0.05,1,66710,66277,433
1431261,8.89219,11.8557,429,377340,0.0115117,0.03,1,66718,66289,429
1433541,5.77844,5.57114,430,377340,0.0183023,0.12,1,66723,66293,430
1436461,5.95569,8.31423,427,377340,0.0116605,0.12,1,66729,66302,427
1439381,5.19114,4.86285,428,377340,0.0103321,0.07,1,66734,66306,428
1441441,4.23823,4.17257,428,377340,0.0500664,0.08,1,66738,66310,428
1444361,6.44765,4.83451,430,377340,0.0740133,0.12,1,66745,66315,430
1446641,2.88953,4.1669,428,377340,0.0628027,0.15,1,66747,66319,428
1449561,5.37791,6.43338,427,377340,0.0365605,0.12,1,66753,66326,427
1452481,4.27558,4.48668,427,377340,0.0473121,0.09,1,66757,66330,427
1454961,4.05512,4.09734,427,377340,0.0654624,0.1,1,66761,66334,427
1457881,2.41102,3.21947,426,377340,0.0850925,0.11,1,66763,66337,426
1460801,4.4822,3.84389,427,377340,0.0890185,0.1,1,66768,66341,427
1462661,4.89644,3.96878,428,377340,0.0818037,0.11,1,66773,66345,428
1465581,4.17929,6.39376,425,377340,0.0643607,0.11,1,66777,66352,425
1468501,4.03586,4.47875,425,377340,0.0208721,0.07,1,66781,66356,425
1471421,4.00717,4.09575,425,377340,0.0121744,0.07,1,66785,66360,425
1473061,6.40143,4.01915,428,377340,0.0264349,0.06,1,66792,66364,428
1475141,12.4803,6.40383,435,377340,0.029287,0.06,1,66806,66371,435
1477221,11.2961,13.2808,431,377340,0.0298574,0.02,1,66817,66386,431
1480141,5.45921,11.4562,424,377340,0.0219715,0,1,66821,66397,424
1483061,4.29184,5.49123,424,377340,0.0043943,0.03,1,66825,66401,424
1485541,14.4584,4.29825,437,377340,0.00887886,0.01,1,66842,66405,437
1488241,6.09167,13.6596,425,377340,0.00177577,0.07,1,66846,66421,425
1490321,6.81833,9.13193,424,377340,0.00835515,0,1,66853,66429,424
1492401,41.3637,41.0264,425,377340,0.00967103,0.05,1,66903,66478,425
1494481,17.8727,16.2053,427,377340,0.0259342,0.06,1,66915,66488,427
1497401,9.97455,9.64106,427,377340,0.0291868,0.1,1,66923,66496,427
1499061,15.5949,5.12821,440,377340,0.0298374,0.05,1,66940,66500,440
1501981,7.91898,17.0256,426,377340,0.00596747,0.02,1,66946,66520,426
1504881,4.7838,6.60513,426,377340,0.0331935,0.08,1,66950,66524,426
1507801,7.35676,8.52103,425,377340,0.0626387,0.05,1,66958,66533,425
1509461,16.6714,4.90421,440,377340,0.0445277,0.14,1,66977,66537,440
1512381,8.13427,16.1808,427,377340,0.0169055,0.08,1,66983,66556,427
1514661,6.42685,6.43617,429,377340,0.0273811,0.1,1,66989,66560,429
1516741,20.4854,6.08723,447,377340,0.0454762,0.08,1,67013,66566,447
1519661,7.29707,22.8174,424,377340,0.0810952,0.04,1,67017,66593,424
1521941,7.85941,7.76349,428,377340,0.056219,0.03,1,67025,66597,428
1524861,5.57188,6.3527,427,377340,0.0592438,0.04,1,67030,66603,427
1527141,8.31438,4.47054,432,377340,0.0118488,0.07,1,67039,66607,432
1528801,3.26288,10.4941,422,377340,0.0103698,0.03,1,67041,66619,422
1531721,8.65258,7.69882,425,377340,0.034074,0.03,1,67051,66626,425
1534001,4.13051,4.73976,424,377340,0.0628148,0.11,1,67054,66630,424
1536921,12.8261,12.948,424,377340,0.076563,0.11,1,67069,66645,424
1539201,5.76522,5.78959,424,377340,0.103313,0.05,1,67073,66649,424
1542121,7.55304,7.55792,424,377340,0.0846625,0.06,1,67081,66657,424
1543781,6.31061,4.71158,426,377340,0.0889325,0.01,1,67087,66661,426
1545441,2.86212,4.94232,423,377340,0.0657865,0.05,1,67089,66666,423
1548361,9.37242,8.18846,425,377340,0.0931573,0.05,1,67100,66675,425
1550641,5.07448,4.83769,425,377340,0.122631,0.06,1,67104,66679,425
1552721,5.0149,4.96754,425,377340,0.0965263,0.07,1,67109,66684,425
1554801,4.20298,4.99351,424,377340,0.0753053,0.03,1,67113,66689,424
1556881,16.8406,16.9987,424,377340,0.0470611,0.01,1,67133,66709,424
1558961,7.36812,7.39974,424,377340,0.0414122,0.02,1,67138,66714,424
1561881,14.2736,11.8799,427,377340,0.0322824,0.03,1,67154,66727,427
1564161,6.05472,5.57599,427,377340,0.0224565,0.13,1,67158,66731,427
1567081,6.81094,9.1152,424,377340,0.0204913,0.08,1,67165,66741,424
1570001,6.16219,5.02304,426,377340,0.0360983,0.04,1,67171,66745,426
1572921,6.03244,4.20461,428,377340,0.0712197,0.05,1,67177,66749,428
1575841,4.40649,4.04092,428,377340,0.0862439,0.09,1,67181,66753,428
1578761,3.2813,4.00818,427,377340,0.0732488,0.13,1,67184,66757,427
1581221,4.65626,4.00164,428,377340,0.0626498,0.11,1,67189,66761,428
1584141,2.53125,6.40033,423,377340,0.0765299,0.1,1,67191,66768,423
1587061,3.70625,4.48007,423,377340,0.039306,0.07,1,67195,66772,423
1589541,6.34125,4.09601,426,377340,0.0238612,0.03,1,67202,66776,426
1592461,4.46825,5.6192,424,377340,0.0127722,0.04,1,67206,66782,424
1595381,4.09365,4.32384,424,377340,0.0105544,0.04,1,67210,66786,424
1597861,4.01873,4.06477,424,377340,0.0101109,0.05,1,67214,66790,424
1600781,4.00375,4.01295,424,377340,0.0100222,0.05,1,67218,66794,424
1603061,6.40075,4.00259,427,377340,0.0260044,0.05,1,67225,66798,427
1605141,10.8802,6.40052,432,377340,0.00520089,0.07,1,67237,66805,432
1607221,10.176,10.8801,430,377340,0.0250402,0.02,1,67247,66817,430
1610141,5.23521,10.976,423,377340,0.021008,0.01,1,67251,66828,423
1613061,4.24704,5.3952,423,377340,0.0122016,0.01,1,67255,66832,423
1615541,9.64941,4.27904,430,377340,0.0264403,0,1,67266,66836,430
1617621,9.12988,8.85581,429,377340,0.00528806,0.01,1,67275,66846,429
1619281,5.02598,7.37116,426,377340,0.00905761,0.08,1,67279,66853,426
1621361,9.0052,10.2742,425,377340,0.0738115,0,1,67289,66864,425
1623441,36.201,38.0548,423,377340,0.0147623,0.02,1,67332,66909,423
1625521,14.4402,14.011,424,377340,0.00295246,0.05,1,67341,66917,424
1627601,10.888,10.0022,425,377340,0.000590492,0,1,67351,66926,425
1629681,17.3776,14.8004,428,377340,0.0241181,0.1,1,67370,66942,428
1632601,9.87552,10.9601,426,377340,0.00482362,0.09,1,67378,66952,426
1635521,5.1751,5.39202,426,377340,0.0249647,0.07,1,67382,66956,426
1638001,4.23502,4.2784,426,377340,0.0609929,0.03,1,67386,66960,426
1640921,22.447,23.2557,425,377340,0.0841986,0.06,1,67413,66988,425
1643201,8.4894,7.85114,426,377340,0.0808397,0.08,1,67418,66992,426
1645281,6.49788,7.97023,424,377340,0.0721679,0.08,1,67424,67000,424
1648201,19.6996,19.194,425,377340,0.0224336,0.06,1,67447,67022,425
1650481,5.53991,7.03881,423,377340,0.0124867,0.04,1,67449,67026,423
1653401,9.10798,9.40776,423,377340,0.0904973,0.01,1,67459,67036,423
1656321,6.6216,5.08155,425,377340,0.130099,0,1,67465,67040,425
1659221,16.5243,4.21631,440,377340,0.0340199,0.07,1,67484,67044,440
1662141,5.70486,12.8433,428,377340,0.00680398,0.11,1,67487,67059,428
1665041,5.94097,5.76865,430,377340,0.0093608,0.08,1,67493,67063,430
1667961,10.7882,15.5537,424,377340,0.0178722,0.11,1,67505,67081,424
1670881,6.95764,6.31075,426,377340,0.0275744,0.06,1,67511,67085,426
1673801,6.19153,4.46215,428,377340,0.0295149,0.05,1,67517,67089,428
1676481,3.63831,4.09243,427,377340,0.061903,0.13,1,67520,67093,427
1679401,8.72766,9.61849,426,377340,0.0843806,0.1,1,67530,67104,426
1681681,5.74553,5.1237,427,377340,0.0808761,0.11,1,67535,67108,427
1684601,6.74911,9.02474,424,377340,0.0801752,0.11,1,67542,67118,424
1687301,18.9498,5.00495,442,377340,0.080035,0.06,1,67564,67122,442
1690001,5.38996,17.001,424,377340,0.080007,0.01,1,67566,67142,424
1692921,17.878,18.6002,426,377340,0.0400014,0.02,1,67587,67161,426
1695841,8.3756,6.92004,428,377340,0.0160003,0.05,1,67593,67165,428
1698741,8.07512,4.58401,432,377340,0.0672001,0.13,1,67601,67169,432
1700401,4.01502,8.9168,425,377340,0.08544,0.07,1,67604,67179,425
1703321,6.403,8.18336,424,377340,0.081088,0.09,1,67611,67187,424
1706241,3.6806,4.83667,423,377340,0.0802176,0.03,1,67614,67191,423
1709161,3.93612,4.16733,423,377340,0.128044,0.07,1,67618,67195,423
1712081,3.98722,4.03347,423,377340,0.137609,0.03,1,67622,67199,423
1715001,3.99744,4.00669,423,377340,0.123522,0.03,1,67626,67203,423
1717921,3.99949,4.00134,423,377340,0.0967043,0.03,1,67630,67207,423
1720841,4.7999,4.00027,424,377340,0.131341,0.03,1,67635,67211,424
1723761,4.95998,4.00005,425,377340,0.138268,0.03,1,67640,67215,425
1726401,4.192,4.00001,425,377340,0.115654,0.03,1,67644,67219,425
1729321,4.0384,5.6,423,377340,0.111131,0.07,1,67648,67225,423
1731601,4.00768,4.32,423,377340,0.110226,0.03,1,67652,67229,423
1733681,5.60154,4.864,424,377340,0.0860452,0.06,1,67658,67234,424
1735761,9.92031,10.5728,423,377340,0.097209,0.05,1,67669,67246,423
1738681,8.38406,7.71456,424,377340,0.107442,0.03,1,67677,67253,424
1740961,4.87681,4.74291,424,377340,0.117488,0.03,1,67681,67257,424
1743881,7.37536,8.14858,423,377340,0.0874977,0.02,1,67689,67266,423
1745541,9.47507,4.82972,429,377340,0.0414995,0.03,1,67699,67270,429
1748241,5.89501,7.36594,426,377340,0.0242999,0.09,1,67704,67278,426
1750321,9.179,10.2732,425,377340,0.01286,0.06,1,67714,67289,425
1752401,9.0358,9.25464,425,377340,0.026572,0.03,1,67723,67298,425
1755321,38.6072,38.6509,425,377340,0.0053144,0.01,1,67769,67344,425
1758021,13.3214,10.9302,428,377340,0.00906288,0.05,1,67776,67348,428
1760101,25.0643,6.98604,450,377340,0.0178126,0.05,1,67804,67354,450
1762801,8.21286,23.7972,426,377340,0.0195625,0.08,1,67808,67382,426
1765721,9.64257,14.3594,424,377340,0.0359125,0.04,1,67818,67394,424
1768641,6.72851,6.07189,426,377340,0.0071825,0,1,67824,67398,426
1770501,22.1457,4.41438,448,377340,0.0334365,0.07,1,67850,67402,448
1773421,8.42914,24.0829,424,377340,0.0066873,0.04,1,67855,67431,424
1776321,4.08583,8.01658,423,377340,0.00133746,0.03,1,67858,67435,423
1779241,18.4172,13.6033,430,377340,0.0882675,0.07,1,67880,67450,430
1781521,6.08343,5.92066,429,377340,0.113653,0.15,1,67883,67454,429
1783601,3.61669,5.98413,426,377340,0.118731,0.16,1,67886,67460,426
1786521,3.92334,5.99683,424,377340,0.127746,0.11,1,67890,67466,424
1788181,26.3847,4.39937,452,377340,0.0975492,0.06,1,67922,67470,452
1791101,8.47693,25.6799,425,377340,0.0195098,0.06,1,67926,67501,425
1794021,4.89539,8.33597,425,377340,0.011902,0.06,1,67930,67505,425
1796081,4.17908,4.86719,425,377340,0.0423804,0.07,1,67934,67509,425
1799001,5.63582,5.77344,425,377340,0.0804761,0.08,1,67940,67515,425
1801281,5.12716,4.35469,426,377340,0.120095,0.03,1,67945,67519,426
1804201,5.82543,4.87094,427,377340,0.160019,0.06,1,67951,67524,427
1807121,4.36509,4.17419,427,377340,0.176004,0.1,1,67955,67528,427
1809601,4.87302,4.03484,428,377340,0.139201,0.08,1,67960,67532,428
1812521,7.3746,8.80697,426,377340,0.17184,0.09,1,67968,67542,426
1814181,5.47492,4.96139,427,377340,0.154368,0.06,1,67973,67546,427
1816261,17.095,5.79228,441,377340,0.102874,0.09,1,67993,67552,441
1819181,5.019,17.1585,423,377340,0.0765747,0.08,1,67995,67572,423
1821041,4.2038,6.63169,423,377340,0.0393149,0.01,1,67999,67576,423
1823121,17.6408,14.1263,428,377340,0.047863,0.09,1,68020,67592,428
1826041,11.5282,10.8253,428,377340,0.0495726,0.11,1,68030,67602,428
1828961,7.10563,5.36505,430,377340,0.00991452,0.1,1,68036,67606,430
1831441,4.62113,4.27301,430,377340,0.0019829,0.16,1,68040,67610,430
1834361,7.32423,8.0546,429,377340,0.0163966,0.16,1,68048,67619,429
1837281,6.26485,4.81092,431,377340,0.0112793,0.11,1,68054,67623,431
1840201,3.65297,4.16218,430,377340,0.0102559,0.14,1,68057,67627,430
1843121,2.33059,4.03244,428,377340,0.0340512,0.19,1,68059,67631,428
1846041,3.66612,4.00649,428,377340,0.0388102,0.15,1,68063,67635,428
1848961,3.93322,4.0013,428,377340,0.063762,0.12,1,68067,67639,428
1851881,3.98664,4.00026,428,377340,0.0127524,0.13,1,68071,67643,428
1854801,3.19733,4.00005,427,377340,0.0265505,0.13,1,68074,67647,427
1857721,5.43947,4.00001,429,377340,0.0293101,0.12,1,68080,67651,429
1859521,3.48789,4,428,377340,0.013862,0.13,1,68083,67655,428
1862441,5.49758,5.6,428,377340,0.0107724,0.14,1,68089,67661,428
1864721,5.09952,4.32,429,377340,0.0101545,0.14,1,68094,67665,429
1866801,6.6199,7.264,428,377340,0.0020309,0.12,1,68101,67673,428
1869721,8.52398,11.8528,424,377340,0.0404062,0.08,1,68110,67686,424
1872641,4.9048,5.57056,424,377340,0.0800812,0.05,1,68114,67690,424
1875541,13.781,4.31411,436,377340,0.0880162,0.01,1,68130,67694,436
1878461,5.95619,13.6628,424,377340,0.0896033,0.01,1,68134,67710,424
1881361,5.19124,5.93256,425,377340,0.0659207,0.06,1,68139,67714,425
1883441,13.8382,13.1865,426,377340,0.0211841,0.03,1,68155,67729,426
1886361,43.5676,44.2373,425,377340,0.00423683,0.01,1,68206,67781,425
1888641,11.9135,12.0475,425,377340,0.0168474,0.04,1,68210,67785,425
1891561,27.9827,28.8095,424,377340,0.0273695,0.03,1,68242,67818,424
1893841,8.79654,8.9619,424,377340,0.0134739,0.03,1,68246,67822,424
1896761,5.75931,5.79238,424,377340,0.0266948,0.03,1,68251,67827,424
1899041,5.15186,4.35848,425,377340,0.045339,0.06,1,68256,67831,425
1901961,30.6304,28.0717,428,377340,0.00906779,0.06,1,68293,67865,428
1904881,10.1261,8.81434,429,377340,0.0258136,0.06,1,68298,67869,429
1907361,3.62521,4.96287,427,377340,0.0211627,0.11,1,68300,67873,427
1910281,11.125,9.79257,429,377340,0.0122325,0.18,1,68313,67884,429
1913201,6.22501,5.15851,430,377340,0.0424465,0.17,1,68318,67888,430
1916101,9.245,4.2317,436,377340,0.0884893,0.11,1,68328,67892,436
1918181,19.449,12.0463,444,377340,0.129698,0,1,68350,67906,444
1920261,11.8898,19.2093,433,377340,0.0979396,0.09,1,68360,67927,433
1923181,6.37796,9.44185,431,377340,0.0675879,0.1,1,68365,67934,431
1926101,4.47559,5.08837,431,377340,0.0455176,0.13,1,68369,67938,431
1928581,4.09512,4.21767,431,377340,0.0171035,0.13,1,68373,67942,431
1930661,6.41902,3.24353,435,377340,0.0594207,0.19,1,68380,67945,435
1933581,4.4838,6.24871,432,377340,0.0598841,0.17,1,68384,67952,432
1935861,6.49676,4.44974,435,377340,0.0759768,0.2,1,68391,67956,435
1938781,4.49935,8.88995,429,377340,0.0791954,0.21,1,68395,67966,429
1940641,3.29987,4.97799,428,377340,0.103839,0.15,1,68398,67970,428
1943561,5.45997,4.9956,429,377340,0.0687678,0.14,1,68404,67975,429
1946261,20.292,4.19912,449,377340,0.0377536,0.02,1,68428,67979,449
1949181,8.8584,24.0398,426,377340,0.0155507,0.03,1,68434,68008,426
1952081,4.97168,8.00796,426,377340,0.0111101,0.05,1,68438,68012,426
1955001,16.1943,18.4016,424,377340,0.098222,0.01,1,68457,68033,424
1957701,8.83887,6.88032,427,377340,0.187644,0.06,1,68464,68037,427
1960621,5.76777,7.77606,424,377340,0.213529,0.04,1,68469,68045,424
1962481,4.35355,4.75521,424,377340,0.162706,0.03,1,68473,68049,424
1964561,4.87071,4.15104,425,377340,0.128541,0.04,1,68478,68053,425
1967481,8.17414,8.83021,424,377340,0.0977082,0.08,1,68487,68063,424
1970401,4.83483,4.96604,424,377340,0.107542,0.01,1,68491,68067,424
1973321,3.36697,4.19321,423,377340,0.109508,0.06,1,68494,68071,423
1976241,3.87339,4.03864,423,377340,0.149902,0.06,1,68498,68075,423
1979161,3.97468,4.00773,423,377340,0.15798,0.03,1,68502,68079,423
1982081,3.99494,4.00155,423,377340,0.167596,0.01,1,68506,68083,423
1985001,3.99899,4.00031,423,377340,0.153519,0.03,1,68510,68087,423
1987921,3.9998,4.00006,423,377340,0.102704,0.02,1,68514,68091,423
1990561,3.99996,4.00001,423,377340,0.0765408,0.02,1,68518,68095,423
1993481,5.59999,3.2,426,377340,0.0873082,0.03,1,68524,68098,426
1995761,5.92,3.84,428,377340,0.0814616,0.04,1,68530,68102,428
1997841,5.184,4.768,428,377340,0.0722923,0.11,1,68535,68107,428
2000761,10.6368,11.3536,427,377340,0.0224585,0.12,1,68547,68120,427
2003041,5.32736,5.47072,427,377340,0.0124917,0.1,1,68551,68124,427
2005961,5.86547,6.69414,426,377340,0.0584983,0.11,1,68557,68131,426
2007621,5.97309,4.53883,428,377340,0.0756997,0.07,1,68563,68135,428
2010541,5.19462,8.10777,424,377340,0.0711399,0.06,1,68568,68144,424
2012401,3.43892,4.82155,423,377340,0.086228,0.09,1,68571,68148,423
2014481,11.8878,10.5643,425,377340,0.0572456,0.01,1,68585,68160,425
2017401,45.5776,46.9129,423,377340,0.0114491,0.01,1,68639,68216,423
2019681,13.1155,12.5826,424,377340,0.00228982,0.02,1,68644,68220,424
2022601,27.4231,25.7165,426,377340,0.00845796,0.05,1,68675,68249,426
2024881,9.48462,8.3433,427,377340,0.00169159,0.11,1,68680,68253,427
2027801,7.49692,10.4687,423,377340,0.0723383,0.09,1,68687,68264,423
2030081,4.69938,5.29373,423,377340,0.0704677,0.01,1,68691,68268,423
2033001,28.9399,28.2587,424,377340,0.0140935,0.02,1,68726,68302,424
2035921,9.78798,8.85175,425,377340,0.0108187,0.01,1,68731,68306,425
2038401,5.15759,4.97035,425,377340,0.0181637,0.07,1,68735,68310,425
2041321,13.0315,9.79407,429,377340,0.0276327,0.09,1,68750,68321,429
2043601,7.4063,5.15881,431,377340,0.0295266,0.12,1,68756,68325,431
2046521,8.68126,8.23176,431,377340,0.0379053,0.18,1,68765,68334,431
2048181,12.9363,4.84635,441,377340,0.0155811,0.14,1,68779,68338,441
2050261,7.38725,16.1693,428,377340,0.0111162,0.07,1,68785,68357,428
2052341,9.47745,10.4339,429,377340,0.0422232,0.03,1,68795,68366,429
2055261,4.29549,7.68677,425,377340,0.0804446,0.06,1,68798,68373,425
2058181,5.6591,4.73735,427,377340,0.0800889,0.07,1,68804,68377,427
2060661,4.33182,4.14747,427,377340,0.0320178,0.06,1,68808,68381,427
2062741,4.06636,3.22949,428,377340,0.0144036,0.09,1,68812,68384,428
2064401,2.41327,3.0459,427,377340,0.0348807,0.08,1,68814,68387,427
2066481,5.28265,7.00918,425,377340,0.0149761,0.06,1,68820,68395,425
2069401,11.4565,13.4018,423,377340,0.0589952,0.05,1,68833,68410,423
2072321,5.49131,5.88037,423,377340,0.067799,0,1,68837,68414,423
2075221,17.0983,4.37607,439,377340,0.0295598,0.01,1,68857,68418,439
2078141,8.21965,16.0752,426,377340,0.013912,0.03,1,68863,68437,426
2081061,7.24393,6.41504,429,377340,0.00278239,0.05,1,68870,68441,429
2083121,5.44879,4.48301,430,377340,0.00855648,0.25,1,68875,68445,430
2085201,16.2898,15.2966,431,377340,0.0737113,0.12,1,68894,68463,431
2088121,12.858,15.0593,428,377340,0.0787423,0.12,1,68906,68478,428
2091041,7.37159,6.21186,430,377340,0.111748,0.11,1,68912,68482,430
2093961,5.47432,4.44237,431,377340,0.12635,0.12,1,68917,68486,431
2096881,5.09486,4.08847,432,377340,0.0812699,0.17,1,68922,68490,432
2099141,5.81897,4.01769,434,377340,0.024254,0.2,1,68928,68494,434
2102061,3.56379,8.80354,427,377340,0.0448508,0.17,1,68931,68504,427
2104981,4.71276,4.96071,428,377340,0.0729702,0.13,1,68936,68508,428
2107901,4.14255,4.19214,428,377340,0.086594,0.11,1,68940,68512,428
2110821,4.02851,4.03843,428,377340,0.0653188,0.13,1,68944,68516,428
2113741,2.4057,4.00769,426,377340,0.0530638,0.11,1,68946,68520,426
2115361,2.88114,4.00154,425,377340,0.0746128,0.08,1,68949,68524,425
2118281,4.57623,5.60031,424,377340,0.0789225,0.09,1,68954,68530,424
2121201,3.31525,4.32006,423,377340,0.0397845,0.07,1,68957,68534,423
2124121,3.86305,4.06401,423,377340,0.0559569,0.05,1,68961,68538,423
2127041,5.57261,4.0128,425,377340,0.0431914,0.03,1,68967,68542,425
2128881,3.51452,4.00256,424,377340,0.0326383,0.05,1,68970,68546,424
2131801,7.9029,5.60051,427,377340,0.0385277,0.08,1,68979,68552,427
2134721,4.78058,4.3201,427,377340,0.0717055,0.08,1,68983,68556,427
2137621,6.55612,4.06402,430,377340,0.0783411,0.1,1,68990,68560,430
2139701,8.51122,8.8128,429,377340,0.111668,0.05,1,68999,68570,429
2142621,4.90224,8.96256,424,377340,0.126334,0.07,1,69003,68579,424
2144901,13.7804,4.99251,436,377340,0.0892667,0.06,1,69019,68583,436
2146981,41.1561,13.7985,468,377340,0.0178533,0.01,1,69067,68599,468
2149901,10.6312,41.1597,423,377340,0.0115707,0,1,69070,68647,423
2152181,31.7262,11.4319,456,377340,0.0183141,0.09,1,69107,68651,456
2155101,9.54525,28.6864,427,377340,0.00366283,0.12,1,69111,68684,427
2157381,9.10905,8.93728,432,377340,0.0727326,0.09,1,69120,68688,432
2160301,6.62181,11.3875,426,377340,0.110547,0.05,1,69126,68700,426
2162581,23.7244,5.47749,450,377340,0.0461093,0.02,1,69154,68704,450
2165501,8.74487,25.8955,424,377340,0.0332219,0.01,1,69159,68735,424
2167781,8.94897,8.3791,429,377340,0.00664437,0.05,1,69168,68739,429
2170701,6.5898,8.87582,426,377340,0.00932887,0.02,1,69174,68748,426
2172981,8.51796,4.97516,431,377340,0.0258658,0.09,1,69183,68752,431
2174641,4.90359,8.99503,425,377340,0.0531732,0.09,1,69187,68762,425
2176721,8.18072,9.79901,424,377340,0.0186346,0.04,1,69196,68772,424
2179641,15.2361,13.1598,427,377340,0.0357269,0.06,1,69213,68786,427
2182341,15.0472,5.83196,438,377340,0.0151454,0.03,1,69228,68790,438
2185261,4.60945,14.7664,423,377340,0.0270291,0.03,1,69230,68807,423
2188181,4.12189,6.15328,423,377340,0.0294058,0.06,1,69234,68811,423
2191101,5.62438,4.43066,425,377340,0.0778812,0.03,1,69240,68815,425
2194021,5.12488,4.08613,426,377340,0.0715762,0.03,1,69245,68819,426
2196901,4.22498,4.01723,426,377340,0.0623152,0.08,1,69249,68823,426
2198981,10.445,4.00345,434,377340,0.068463,0.07,1,69261,68827,434
2201901,6.089,12.8007,424,377340,0.117693,0,1,69266,68842,424
2204181,17.2178,5.76014,440,377340,0.0555385,0.02,1,69286,68846,440
2207101,7.44356,17.952,424,377340,0.0191077,0.01,1,69291,68867,424
2210021,6.28871,6.79041,426,377340,0.0198215,0.03,1,69297,68871,426
2212081,4.45774,4.55808,426,377340,0.0119643,0.08,1,69301,68875,426
2214161,7.29155,4.91162,429,377340,0.00239286,0.15,1,69309,68880,429
2216241,18.2583,16.9823,430,377340,0.0644786,0.11,1,69330,68900,430
2218321,7.65166,9.79646,427,377340,0.0928957,0.13,1,69335,68908,427
2221241,7.93033,9.95929,425,377340,0.0665791,0.09,1,69343,68918,425
2224161,5.58607,5.19186,426,377340,0.0613158,0.05,1,69348,68922,426
2227081,5.11721,4.23837,427,377340,0.0682632,0.08,1,69353,68926,427
2229141,6.62344,4.04767,430,377340,0.0456526,0.1,1,69360,68930,430
2232061,5.32469,7.20953,427,377340,0.0491305,0.08,1,69365,68938,427
2234341,5.86494,4.64191,429,377340,0.0338261,0.11,1,69371,68942,429
2237261,5.17299,7.32838,426,377340,0.0147652,0.08,1,69376,68950,426
2240181,3.4346,4.66568,425,377340,0.026953,0.06,1,69379,68954,425
2243101,4.68692,4.13314,426,377340,0.0453906,0.08,1,69384,68958,426
2246021,4.13738,4.02663,426,377340,0.0410781,0.06,1,69388,68962,426
2248941,3.22748,4.00533,425,377340,0.0162156,0.08,1,69391,68966,425
2251861,5.4455,4.00107,427,377340,0.0272431,0.1,1,69397,68970,427
2254781,4.2891,4.00021,427,377340,0.0454486,0.07,1,69401,68974,427
2257701,4.05782,4.00004,427,377340,0.0650897,0.1,1,69405,68978,427
2259921,4.01156,4.00001,427,377340,0.0450179,0.08,1,69409,68982,427
2262841,4.80231,3.2,429,377340,0.0410036,0.11,1,69414,68985,429
2265121,4.96046,3.84,430,377340,0.0482007,0.12,1,69419,68989,430
2268041,5.79209,6.368,429,377340,0.0576401,0.16,1,69425,68996,429
2269701,5.95842,4.4736,431,377340,0.059528,0.17,1,69431,69000,431
2272621,5.19168,8.09472,427,377340,0.0519056,0.16,1,69436,69009,427
2274901,15.4383,4.81894,441,377340,0.0743811,0.11,1,69454,69013,441
2276981,37.4877,17.7638,463,377340,0.0148762,0.01,1,69497,69034,463
2279901,10.6975,37.9528,424,377340,0.00297524,0,1,69501,69077,424
2282181,32.5395,10.7906,458,377340,0.000595049,0.01,1,69539,69081,458
2285101,10.5079,28.5581,430,377340,0.024119,0.09,1,69544,69114,430
2287381,4.50158,8.91162,429,377340,0.0128238,0.14,1,69547,69118,429
2289461,7.30032,8.18232,429,377340,0.0345648,0.06,1,69555,69126,429
2291121,3.86006,8.03646,424,377340,0.0629129,0.02,1,69558,69134,424
2294041,23.972,24.8073,424,377340,0.0205826,0.01,1,69587,69163,424
2296321,7.9944,8.16146,424,377340,0.00411652,0.01,1,69591,69167,424
2298401,8.79888,7.23229,426,377340,0.0088233,0.06,1,69600,69174,426
2301321,10.5598,11.8465,424,377340,0.0257647,0.06,1,69611,69187,424
2304241,6.11196,5.56929,425,377340,0.0211529,0.02,1,69616,69191,425
2307141,13.2224,4.31386,436,377340,0.00423059,0.08,1,69631,69195,436
2309221,10.6445,13.6628,430,377340,0.0328461,0.02,1,69641,69211,430
2311301,18.9289,10.7326,441,377340,0.00656922,0.1,1,69662,69221,441
2314221,7.78578,16.5465,428,377340,0.00931384,0.11,1,69667,69239,428
2317141,3.95716,6.5093,427,377340,0.0338628,0.09,1,69670,69243,427
2320061,3.19143,4.50186,426,377340,0.0307726,0.12,1,69673,69247,426
2322981,5.43829,4.10037,428,377340,0.0141545,0.09,1,69679,69251,428
2325901,4.28766,4.02007,428,377340,0.0108309,0.09,1,69683,69255,428
2327521,2.45753,4.00401,426,377340,0.0341662,0.14,1,69685,69259,426
2330441,6.09151,7.2008,425,377340,0.0468332,0.13,1,69692,69267,425
2332721,4.4183,4.64016,425,377340,0.0413666,0.02,1,69696,69271,425
2335641,16.8837,18.528,423,377340,0.0722733,0.02,1,69716,69293,423
2338561,6.57673,6.90561,423,377340,0.0784547,0.01,1,69720,69297,423
2341041,4.51535,4.58112,423,377340,0.0796909,0.03,1,69724,69301,423
2343961,9.70307,9.71622,423,377340,0.0399382,0.01,1,69735,69312,423
2346661,26.7406,5.14324,450,377340,0.0159876,0.07,1,69766,69316,450
2349361,9.34812,23.4286,427,377340,0.0431975,0.08,1,69771,69344,427
2352281,10.6696,15.8857,424,377340,0.0566395,0.07,1,69782,69358,424
2355201,4.53392,6.37715,423,377340,0.0433279,0.05,1,69785,69362,423
2357681,4.90678,4.47543,424,377340,0.0406656,0.05,1,69790,69366,424
2360601,4.18136,3.29509,425,377340,0.0641331,0.02,1,69794,69369,425
2362881,4.03627,3.85902,425,377340,0.0208266,0.07,1,69798,69373,425
2365801,6.40725,7.1718,424,377340,0.0441653,0.06,1,69805,69381,424
2368721,4.48145,4.63436,424,377340,0.0568331,0.05,1,69809,69385,424
2371201,4.89629,4.12687,425,377340,0.0593666,0.05,1,69814,69389,425
2374121,6.57926,6.42537,425,377340,0.0438733,0.07,1,69821,69396,425
2377041,4.51585,4.48507,425,377340,0.0487747,0.08,1,69825,69400,425
2379961,4.10317,4.09701,425,377340,0.0497549,0.08,1,69829,69404,425
2382881,4.82063,4.0194,426,377340,0.017951,0.06,1,69834,69408,426
2385761,4.16413,4.00388,426,377340,0.0115902,0.05,1,69838,69412,426
2388681,5.63283,6.40078,425,377340,0.018318,0.09,1,69844,69419,425
2391601,4.32657,4.48016,425,377340,0.0356636,0.05,1,69848,69423,425
2394501,4.86531,4.09603,426,377340,0.0391327,0.07,1,69853,69427,426
2397421,4.17306,5.61921,424,377340,0.0638265,0.07,1,69857,69433,424
2400321,4.83461,4.32384,425,377340,0.0767653,0.05,1,69862,69437,425
2403241,7.36692,5.66477,427,377340,0.0473531,0.05,1,69870,69443,427
2404901,11.0734,4.33295,435,377340,0.0494706,0.14,1,69882,69447,435
2406981,39.0147,9.66659,470,377340,0.0178941,0,1,69928,69458,470
2409901,10.2029,41.9333,423,377340,0.00357882,0.01,1,69931,69508,423
2412181,34.0406,11.5867,459,377340,0.000715765,0.03,1,69971,69512,459
2415101,10.0081,31.9173,426,377340,0.000143153,0.08,1,69975,69549,426
2417381,7.60162,9.58347,429,377340,2.86306e-05,0.07,1,69982,69553,429
2420081,3.92032,7.51669,425,377340,0.0160057,0.1,1,69985,69560,425
2422161,4.78406,3.90334,427,377340,0.0112011,0.03,1,69990,69563,427
2425081,22.5568,25.5807,423,377340,0.0262402,0.02,1,70017,69594,423
2427361,9.31136,8.31613,425,377340,0.029248,0.03,1,70023,69598,425
2429441,7.46227,7.26323,425,377340,0.00584961,0.02,1,70030,69605,425
2431521,8.69245,10.2526,423,377340,0.0331699,0.02,1,70039,69616,423
2434441,11.3385,10.8505,424,377340,0.046634,0,1,70051,69627,424
2436101,10.2677,5.37011,430,377340,0.0333268,0.05,1,70061,69631,430
2439021,6.85354,8.27402,427,377340,0.0146654,0.04,1,70067,69640,427
2441301,22.1707,4.8548,449,377340,0.00293307,0.05,1,70093,69644,449
2444221,9.23414,24.971,425,377340,0.000586614,0.03,1,70099,69674,425
2447141,5.04683,8.19419,425,377340,0.00811732,0.03,1,70103,69678,425
2450061,4.20937,4.83884,425,377340,0.0176235,0.07,1,70107,69682,425
2452981,4.04187,4.16777,425,377340,0.00352469,0.08,1,70111,69686,425
2454821,8.80837,4.03355,431,377340,0.0407049,0.08,1,70121,69690,431
2457741,6.56168,8.80671,427,377340,0.040141,0.07,1,70127,69700,427
2460661,5.31233,4.96134,428,377340,0.0880282,0.07,1,70132,69704,428
2463581,4.26247,4.19227,428,377340,0.0816056,0.1,1,70136,69708,428
2465221,11.2525,4.03845,437,377340,0.0483211,0.04,1,70149,69712,437
2468141,5.4505,15.2077,423,377340,0.0336642,0.06,1,70153,69730,423
2471061,4.2901,6.24154,423,377340,0.0547328,0.03,1,70157,69734,423
2473981,4.05802,4.44831,423,377340,0.0429466,0.01,1,70161,69738,423
2475621,32.8116,4.08966,459,377340,0.0325893,0.1,1,70201,69742,459
2478541,10.5623,31.2179,426,377340,0.0225179,0.05,1,70206,69780,426
2480401,2.91246,9.44359,423,377340,0.0285036,0.09,1,70207,69784,423
2483321,8.58249,8.28872,425,377340,0.0137007,0.04,1,70217,69792,425
2486241,5.7165,4.85774,426,377340,0.0267401,0.03,1,70222,69796,426
2488721,4.3433,4.17155,426,377340,0.077348,0.06,1,70226,69800,426
2491641,7.26866,8.03431,425,377340,0.0714696,0.08,1,70234,69809,425
2494561,4.65373,4.80686,425,377340,0.0462939,0.04,1,70238,69813,425
2497481,4.13075,4.16137,425,377340,0.0492588,0.06,1,70242,69817,425
2500401,2.42615,4.03227,423,377340,0.0418518,0.07,1,70244,69821,423
2503321,3.68523,4.00645,423,377340,0.00837035,0.07,1,70248,69825,423
2505781,10.337,4.00129,431,377340,0.0256741,0.04,1,70260,69829,431
2508701,5.26741,8.80026,425,377340,0.0451348,0.04,1,70264,69839,425
2511621,5.05348,4.96005,426,377340,0.041027,0.07,1,70269,69843,426
2514541,5.0107,4.19201,427,377340,0.00820539,0.06,1,70274,69847,427
2517461,3.40214,4.0384,426,377340,0.0176411,0.09,1,70277,69851,426
2520341,3.88043,4.00768,426,377340,0.0275282,0.11,1,70281,69855,426
2523261,3.17609,4.00154,425,377340,0.0295056,0.08,1,70284,69859,425
2526181,4.63522,4.00031,426,377340,0.0299011,0.07,1,70289,69863,426
2529101,4.12704,4.00006,426,377340,0.0379802,0.07,1,70293,69867,426
2532021,3.22541,4.00001,425,377340,0.039596,0.09,1,70296,69871,425
2534901,11.0451,4,434,377340,0.00791921,0.08,1,70309,69875,434
2536981,46.209,11.2,476,377340,0.00158384,0.03,1,70364,69888,476
2539901,11.6418,47.04,423,377340,0.00831677,0.01,1,70367,69944,423
2542181,31.1284,12.608,455,377340,0.0336634,0.01,1,70403,69948,455
2545101,9.42567,30.5216,424,377340,0.0147327,0.03,1,70407,69983,424
2547381,9.88513,9.30432,430,377340,0.0109465,0.05,1,70417,69987,430
2550301,4.37703,8.26086,425,377340,0.0261893,0.06,1,70420,69995,425
2553201,2.47541,4.85217,423,377340,0.0372379,0.03,1,70422,69999,423
2556121,22.0951,21.7704,424,377340,0.119448,0.01,1,70449,70025,424
2558401,8.41902,7.55409,425,377340,0.11189,0.01,1,70454,70029,425
2560481,5.6838,5.51082,425,377340,0.142378,0.07,1,70459,70034,425
2562561,9.93676,9.10216,426,377340,0.124476,0.1,1,70470,70044,426
2564641,9.18735,11.4204,423,377340,0.120895,0.02,1,70479,70056,423
2566721,11.4375,10.2841,425,377340,0.120179,0,1,70491,70066,425
2569641,9.48749,8.45682,426,377340,0.120036,0.06,1,70500,70074,426
2571301,23.4975,4.89136,449,377340,0.0400072,0.02,1,70527,70078,449
2574221,9.4995,24.1783,426,377340,0.0160014,0,1,70533,70107,426
2577141,4.2999,8.03565,425,377340,0.00320029,0.03,1,70536,70111,425
2579621,3.25998,4.80713,424,377340,0.0246401,0.05,1,70539,70115,424
2582541,5.452,3.36143,427,377340,0.012928,0.08,1,70545,70118,427
2584821,6.6904,3.87229,430,377340,0.0105856,0.09,1,70552,70122,430
2586901,9.33808,6.37446,433,377340,0.0661171,0.1,1,70562,70129,433
2589821,5.86762,11.6749,425,377340,0.0612234,0.08,1,70567,70142,425
2592741,4.37352,5.53498,425,377340,0.0122447,0.04,1,70571,70146,425
2595221,4.0747,4.307,425,377340,0.00244894,0.07,1,70575,70150,425
2597301,9.61494,3.2614,433,377340,0.0484898,0.04,1,70586,70153,433
2600221,5.12299,11.0523,424,377340,0.041698,0.06,1,70590,70166,424
2603141,4.2246,5.41046,424,377340,0.0563396,0.05,1,70594,70170,424
2605621,29.6449,4.28209,456,377340,0.0272679,0.04,1,70630,70174,456
2608541,10.729,29.6564,426,377340,0.0214536,0.03,1,70636,70210,426
2611441,6.1458,9.13128,427,377340,0.00429072,0.05,1,70641,70214,427
2613521,6.02916,5.02626,429,377340,0.00885814,0.1,1,70647,70218,429
2616441,5.20583,8.20525,425,377340,0.0417716,0.12,1,70652,70227,425
2619361,4.24117,4.84105,425,377340,0.0643543,0.06,1,70656,70231,425
2621221,4.04823,4.16821,425,377340,0.0608709,0.07,1,70660,70235,425
2623301,4.00965,4.83364,424,377340,0.0281742,0.06,1,70664,70240,424
2624961,4.00193,3.36673,425,377340,0.00563483,0.02,1,70668,70243,425
2627881,4.80039,5.47335,424,377340,0.025127,0.09,1,70673,70249,424
2630801,5.76008,4.29467,426,377340,0.0130254,0.06,1,70679,70253,426
2633721,3.55202,4.05893,425,377340,0.0106051,0.05,1,70682,70257,425
2635781,3.9104,4.01179,425,377340,0.034121,0.08,1,70686,70261,425
2637861,11.1821,4.80236,433,377340,0.0308242,0.05,1,70699,70266,433
2640781,5.43642,11.3605,424,377340,0.0221648,0.05,1,70703,70279,424
2643701,5.08728,5.47209,425,377340,0.028433,0.05,1,70708,70283,425
2646621,3.41746,4.29442,424,377340,0.0296866,0.06,1,70711,70287,424
2649541,4.68349,4.05888,425,377340,0.00593732,0.05,1,70716,70291,425
2652461,2.5367,4.01178,423,377340,0.00118746,0.05,1,70718,70295,423
2655381,5.30734,4.00236,425,377340,0.0242375,0.08,1,70724,70299,425
2658301,5.86147,4.00047,427,377340,0.0448475,0.03,1,70730,70303,427
2661221,4.37229,4.00009,427,377340,0.0489695,0.07,1,70734,70307,427
2663861,4.87446,4.00002,428,377340,0.0657939,0.08,1,70739,70311,428
2665521,2.57489,6.4,423,377340,0.0531588,0.05,1,70741,70318,423
2668441,45.315,44.48,425,377340,0.0186318,0.03,1,70797,70372,425
2670721,13.063,12.096,426,377340,0.00372635,0.01,1,70802,70376,426
2673641,26.6126,28.0192,424,377340,0.0487453,0.06,1,70832,70408,424
2675921,10.1225,8.80384,426,377340,0.0257491,0.07,1,70838,70412,426
2678841,17.2245,10.5608,434,377340,0.0131498,0.04,1,70857,70423,434
2681761,5.8449,5.31215,433,5840,0.01063,0.2,1,70860,70427,433
2684241,4.36898,4.26243,433,5840,0.00212599,0.15,1,70864,70431,433
2687161,20.0738,23.2525,429,5840,0.0164252,0.15,1,70888,70459,429
2689441,7.21476,7.8505,429,5840,0.027285,0.17,1,70892,70463,429
2691521,4.64295,3.9701,430,5840,0.029457,0.14,1,70896,70466,430
2693601,8.92859,6.39402,433,5840,0.0458914,0.15,1,70906,70473,433
2695681,6.58572,7.6788,431,5840,0.0171783,0.15,1,70912,70481,431
2697761,10.1171,12.7358,428,5840,0.0114357,0.1,1,70923,70495,428
2699841,7.62343,8.94715,427,5840,0.0582871,0.01,1,70930,70503,427
2701921,22.3247,24.1894,425,5840,0.0356574,0.05,1,70956,70531,425
2704841,10.8649,12.8379,423,5840,0.0151315,0.03,1,70964,70541,423
2707761,6.17299,5.76758,424,5840,0.0350263,0.04,1,70969,70545,424
2710681,6.0346,4.35352,426,5840,0.0470053,0.01,1,70975,70549,426
2713361,4.40692,4.0707,426,5840,0.00940105,0.02,1,70979,70553,426
2715441,2.48138,3.21414,425,5840,0.00188021,0.06,1,70981,70556,425
2717521,8.49628,9.44283,424,5840,0.00837604,0,1,70991,70567,424
2720441,9.69926,7.48857,427,5840,0.00167521,0.05,1,71001,70574,427
2723361,4.33985,4.69771,426,5840,0.016335,0.08,1,71004,70578,426
2725841,4.86797,4.13954,427,5840,0.00326701,0.04,1,71009,70582,427
2727921,5.77359,7.22791,425,5840,0.0086534,0.07,1,71015,70590,425
2730841,9.15472,10.2456,424,5840,0.00173068,0.08,1,71025,70601,424
2733761,6.63094,5.24912,426,5840,0.000346136,0.07,1,71031,70605,426
2735621,27.7262,4.24982,455,5840,0.0320692,0.01,1,71064,70609,455
2738541,9.54524,28.05,426,5840,0.0624138,0.03,1,71069,70643,426
2741461,5.10905,8.80999,426,5840,0.0684828,0.06,1,71073,70647,426
2743941,6.62181,4.962,429,5840,0.0216966,0.06,1,71080,70651,429
2746861,4.52436,8.1924,424,5840,0.00433931,0.02,1,71084,70660,424
2749761,4.10487,4.83848,424,5840,0.00886786,0.03,1,71088,70664,424
2752681,8.02097,8.1677,424,5840,0.0417736,0.02,1,71097,70673,424
2755601,4.80419,4.83354,424,5840,0.0163547,0.03,1,71101,70677,424
2758521,4.96084,4.16671,425,5840,0.0112709,0.07,1,71106,70681,425
2761441,4.19217,4.03334,425,5840,0.00225419,0.05,1,71110,70685,425
2764361,3.23843,4.00667,424,5840,0.00845084,0.07,1,71113,70689,424
2766401,3.04769,4.00133,423,5840,0.00969017,0.05,1,71116,70693,423
2769321,15.0095,14.4003,424,5840,0.00193803,0.02,1,71134,70710,424
2772241,6.20191,6.08005,424,5840,0.00838761,0.01,1,71138,70714,424
2775161,5.24038,4.41601,425,5840,0.00967752,0.05,1,71143,70718,425
2776801,4.24808,4.0832,425,5840,0.0019355,0.05,1,71147,70722,425
2779721,5.64962,4.01664,427,5840,0.0083871,0.07,1,71153,70726,427
2782641,2.72992,4.00333,425,5840,0.00967742,0.06,1,71155,70730,425
2785561,3.74598,4.00067,425,5840,0.0179355,0.09,1,71159,70734,425
2788481,3.1492,4.00013,424,5840,0.0035871,0.06,1,71162,70738,424
2791401,3.82984,4.00003,424,5840,0.000717419,0.06,1,71166,70742,424
2794321,3.96597,4.00001,424,5840,0.000143484,0.05,1,71170,70746,424
2796561,3.99319,4,424,5840,2.86968e-05,0.04,1,71174,70750,424
2799481,49.5986,49.6,424,5840,0.0400057,0.01,1,71235,70811,424
2801761,13.1197,13.12,424,5840,0.0400012,0.04,1,71239,70815,424
2804681,27.4239,28.224,423,5840,0.0320002,0.04,1,71270,70847,423
2806961,8.68479,8.8448,423,5840,0.00640005,0.03,1,71274,70851,423
2809881,338.537,336.969,425,5840,0.02528,0,1,71695,71270,425
2812801,71.7074,70.5938,426,380260,0.029056,0.03,1,71700,71274,426
2815721,351.141,350.919,426,380260,0.101811,0.05,1,72121,71695,426
2818641,75.0283,73.3838,428,380260,0.108362,0.03,1,72127,71699,428
2821561,19.0057,17.8767,429,380260,0.0936724,0.09,1,72132,71703,429
2824481,6.20113,6.77535,428,380260,0.0587345,0.13,1,72135,71707,428
2827401,6.04023,4.55507,430,380260,0.0837469,0.13,1,72141,71711,430
2830321,5.20805,4.11101,431,380260,0.112749,0.12,1,72146,71715,431
2833241,4.24161,4.0222,431,380260,0.16655,0.16,1,72150,71719,431
2836161,4.84832,4.00444,432,380260,0.17731,0.17,1,72155,71723,432
2839081,4.16966,4.00089,432,380260,0.147462,0.17,1,72159,71727,432
2842001,2.43393,4.00018,430,380260,0.157492,0.19,1,72161,71731,430
2844921,4.48679,4.00004,431,380260,0.183498,0.2,1,72166,71735,431
2847841,4.89736,4.00001,432,380260,0.2047,0.18,1,72171,71739,432
2850761,4.97947,4,433,380260,0.20894,0.2,1,72176,71743,433
2853681,5.79589,4,435,380260,0.137788,0.21,1,72182,71747,435
2856601,5.95918,4,437,380260,0.179558,0.23,1,72188,71751,437
2859521,5.99184,4,439,380260,0.211912,0.27,1,72194,71755,439
2862441,7.59837,4,443,380260,0.242382,0.29,1,72202,71759,443
2865361,5.51967,4,444,380260,0.232476,0.33,1,72207,71763,444
2868281,3.50393,4,443,380260,0.278495,0.4,1,72210,71767,443
2871201,3.90079,4,443,380260,0.319699,0.44,1,72214,71771,443
2874121,7.18016,4,447,380260,0.35994,0.42,1,72222,71775,447
2877041,5.43603,4,448,380260,0.375988,0.42,1,72227,71779,448
2879961,5.88721,4,450,380260,0.403198,0.51,1,72233,71783,450
2882881,5.17744,4,451,380260,0.448639,0.54,1,72238,71787,451
2885801,5.83549,4,453,380260,0.425728,0.57,1,72244,71791,453
2888721,4.3671,4,453,380260,0.437146,0.58,1,72248,71795,453
2891641,6.47342,4,456,380260,0.415429,0.61,1,72255,71799,456
2894561,6.89468,4,459,380260,0.451086,0.62,1,72262,71803,459
2897481,5.37894,4,460,380260,0.474217,0.68,1,72267,71807,460
2900401,3.47579,4,459,380260,0.502843,0.71,1,72270,71811,459
2903321,6.29516,4,462,380260,0.532569,0.71,1,72277,71815,462
2906241,6.85903,4,465,380260,0.586514,0.73,1,72284,71819,465
2909161,5.37181,4,466,380260,0.541303,0.76,1,72289,71823,466
2912081,5.07436,4,467,380260,0.524261,0.81,1,72294,71827,467
2915001,5.81487,4,469,380260,0.536852,0.83,1,72300,71831,469
2917921,5.16297,4,470,380260,0.60337,0.86,1,72305,71835,470
2920841,4.23259,4,470,380260,0.608674,0.9,1,72309,71839,470
2923761,4.04652,4,470,380260,0.601735,0.93,1,72313,71843,470
2926681,4.8093,4,471,380260,0.624347,0.96,1,72318,71847,471
2929601,4.96186,4,472,380260,0.692869,0.97,1,72323,71851,472
2932521,5.79237,4,474,380260,0.690574,0.98,1,72329,71855,474
2935441,7.55847,4,478,380260,0.626115,0.98,1,72337,71859,478
2938361,10.3117,4,485,380260,0.725223,1,1,72348,71863,485
2941281,6.86234,4,487,380260,0.697045,1,1,72354,71867,487
2943201,3.77247,4,486,380260,0.683409,0.12,1,72357,71871,486
2946121,159.155,206.4,427,380260,0.744682,0.09,1,72555,72128,427
2949041,37.4309,44.48,430,380260,0.812936,0.04,2,72562,72132,430
2951961,10.6862,12.096,430,380260,0.842587,0.1,2,72566,72136,430
2954641,5.33724,5.6192,430,380260,0.808517,0.16,2,72570,72140,430
2957561,8.26745,6.72384,432,380260,0.833704,0.2,2,72579,72147,432
2960481,4.85349,4.54477,432,380260,0.822741,0.18,2,72583,72151,432
2963401,4.9707,4.10895,433,380260,0.844548,0.2,2,72588,72155,433
2966321,4.99414,4.02179,434,380260,0.85691,0.2,2,72593,72159,434
2968581,5.79883,4.00436,436,380260,0.891382,0.24,2,72599,72163,436
2971501,5.15977,8.80087,431,380260,0.882276,0.18,2,72604,72173,431
2974421,7.43195,4.96017,435,380260,0.856455,0.16,2,72612,72177,435
2977341,4.68639,4.19203,435,380260,0.819291,0.18,2,72616,72181,435
2980261,4.13728,4.03841,435,380260,0.811858,0.25,2,72620,72185,435
2983141,8.02746,4.00768,440,380260,0.890372,0.22,2,72629,72189,440
2986061,7.20549,8.00154,438,380260,0.866074,0.25,2,72636,72198,438
2988981,7.0411,4.80031,441,380260,0.893215,0.26,2,72643,72202,441
2991901,5.40822,4.16006,442,380260,0.906643,0.32,2,72648,72206,442
2994581,3.48164,4.03201,441,380260,0.885329,0.34,2,72651,72210,441
2997501,4.69633,3.2064,443,380260,0.881066,0.38,2,72656,72213,443
2999781,3.33927,3.84128,442,380260,0.880213,0.36,2,72659,72217,442
3001441,3.86785,3.16826,443,380260,0.896043,0.39,2,72663,72220,443
3004361,5.57357,3.83365,445,380260,0.891209,0.41,2,72669,72224,445
3006021,5.11471,3.96673,446,380260,0.866242,0.45,2,72674,72228,446
3007681,5.02294,6.39335,444,380260,0.837248,0.45,2,72679,72235,444
3010601,10.6046,10.8787,444,380260,0.87945,0.45,2,72691,72247,444
3013521,6.92092,5.37573,446,380260,0.91189,0.43,2,72697,72251,446
3016441,6.18418,4.27515,448,380260,0.902378,0.46,2,72703,72255,448
3019361,4.43684,4.05503,448,380260,0.868476,0.49,2,72707,72259,448
3022241,4.88737,4.01101,449,380260,0.869695,0.53,2,72712,72263,449
3025161,7.37747,4.0022,453,380260,0.853939,0.51,2,72720,72267,453
3026821,8.67549,4.00044,458,380260,0.874788,0.61,2,72729,72271,458
3029741,5.7351,11.2001,450,380260,0.918958,0.54,2,72734,72284,450
3044301,7,4,457,380260,0.94,0.62,2,72761,72304,457
3047221,5.4,4,458,380260,0.94,0.62,2,72766,72308,458
3050141,7.48,4,462,380260,0.94,0.65,2,72774,72312,462
3269761,6,4,487,380260,0.89,1,2,73646,73159,487
3272681,14,15.2,485,380260,0.93,1,2,73662,73177,485
3311361,6,8,495,380260,0.96,1,2,73757,73262,495
3332581,5,4,509,380260,0.89,1,2,73821,73312,509
3334241,8.2,12,504,380260,0.93,1,2,73830,73326,504
4469321,6,4,464,4294967295,0.48,0.77,1,79452,78988,464
4472241,5.2,4,465,4294967295,0.472,0.78,1,79457,78992,465
4475161,5.84,4,467,4294967295,0.4624,0.82,1,79463,78996,467
4478081,7.568,4,471,4294967295,0.50848,0.82,1,79471,79000,471
4481001,7.9136,4,475,4294967295,0.517696,0.86,1,79479,79004,475
4483921,5.58272,4,476,4294967295,0.519539,0.95,1,79484,79008,476
4486841,8.31654,4,481,4294967295,0.479908,1,1,79493,79012,481
4489761,8.06331,4,485,4294967295,0.551982,1,1,79501,79016,485
4492681,8.01266,4,489,4294967295,0.566396,1,1,79509,79020,489
4495601,8.80253,4,494,4294967295,0.633279,1,1,79518,79024,494
4497381,4.96051,4,494,4294967295,0.614656,1,1,79522,79028,494
4500301,7.3921,3.2,499,4294967295,0.618931,1,1,79530,79031,499
4503221,7.87842,3.84,503,4294967295,0.627786,1,1,79538,79035,503
4506141,7.97568,3.968,507,4294967295,0.669557,1,1,79546,79039,507
4509061,7.99514,3.9936,511,4294967295,0.669912,1,1,79554,79043,511
4511981,7.19903,3.99872,514,4294967295,0.645982,1,1,79561,79047,514
4514901,7.03981,3.99974,517,4294967295,0.673196,1,1,79568,79051,517
4517821,7.80796,3.99995,521,4294967295,0.718639,1,1,79576,79055,521
4520741,9.56159,3.99999,527,4294967295,0.719728,1,1,79586,79059,527
4659641,6,4,474,4294967295,0.62,0.82,1,80548,80074,474
4662561,6,4,476,4294967295,0.636,0.77,1,80554,80078,476
4665481,6,4,478,4294967295,0.6392,0.81,1,80560,80082,478
4668401,6,4,480,4294967295,0.66384,0.87,1,80566,80086,480
4671321,6.8,4,483,4294967295,0.732768,0.91,1,80573,80090,483
4674241,7.76,4,487,4294967295,0.778554,0.99,2,80581,80094,487
4677161,9.552,4,493,4294967295,0.811711,1,2,80591,80098,493
4680081,9.9104,4,499,4294967295,0.794342,1,2,80601,80102,499
4683001,9.18208,4,504,4294967295,0.830868,1,2,80610,80106,504
4685921,8.23642,4,508,4294967295,0.806174,1,2,80618,80110,508
4688841,6.44728,4,510,4294967295,0.737235,1,1,80624,80114,510
4691761,6.08946,4,512,4294967295,0.747447,1,1,80630,80118,512
4694681,7.61789,4,516,4294967295,0.773489,1,2,80638,80122,516
4697601,6.32358,4,518,4294967295,0.778698,1,2,80644,80126,518
4699761,6.06472,4,520,4294967295,0.77174,1,2,80650,80130,520
4702681,46.0129,38.4,529,4294967295,0.770348,1,2,80706,80177,529
4705601,18.0026,10.88,536,4294967295,0.79407,1,2,80717,80181,536
4708521,10.8005,5.376,541,4294967295,0.782814,1,2,80726,80185,541
4711441,10.9601,20.2752,528,4294967295,0.764563,1,2,80737,80209,528
4714361,10.192,7.25504,534,4294967295,0.800913,1,2,80747,80213,534
4716821,6.0384,4.65101,535,4294967295,0.728183,1,1,80752,80217,535
4719741,7.60768,4.9302,538,4294967295,0.753636,1,2,80760,80222,538
4722661,7.92154,4.18604,542,4294967295,0.790727,1,2,80768,80226,542
4724121,9.58431,4.03721,548,4294967295,0.806145,1,2,80778,80230,548
4760621,374.717,448.007,455,246600,0.161229,0.86,1,81244,80789,455
4854721,151.743,160.801,462,246600,0.480246,0,1,81340,80878,462
4857641,300.749,332.96,424,4294967295,0.0960492,0,1,81678,81254,424
4860561,63.3497,69.7921,424,4294967295,0.0192098,0.01,1,81682,81258,424
4863481,17.4699,17.1584,426,4294967295,0.011842,0.05,1,81688,81262,426
4866401,8.29399,6.63168,428,4294967295,0.0103684,0.05,1,81694,81266,428
4869321,7.2588,4.52634,431,4294967295,0.0100737,0.1,1,81701,81270,431
4872241,6.25176,4.10527,433,4294967295,0.0180147,0.13,1,81707,81274,433
4875161,6.05035,4.02105,435,4294967295,0.0436029,0.19,1,81713,81278,435
4878081,6.01007,4.00421,437,4294967295,0.0967206,0.24,1,81719,81282,437
4881001,6.80201,4.00084,440,4294967295,0.0273441,0.28,1,81726,81286,440
4883921,6.1604,4.00017,442,4294967295,0.0694688,0.31,1,81732,81290,442
4886841,6.03208,4.00003,444,4294967295,0.0778938,0.37,1,81738,81294,444
4889761,6.00642,4.00001,446,4294967295,0.151579,0.42,1,81744,81298,446
4892581,37.2013,4,487,4294967295,0.254316,0.46,1,81789,81302,487
4895501,10.6403,40,442,4294967295,0.274863,0.43,1,81793,81351,442
4898421,5.32805,11.2,442,4294967295,0.278973,0.41,1,81797,81355,442
4901341,4.26561,5.44,442,4294967295,0.303795,0.41,1,81801,81359,442
4904261,4.85312,4.288,443,4294967295,0.308759,0.41,1,81806,81363,443
4907181,4.17062,4.0576,443,4294967295,0.325752,0.41,1,81810,81367,443
4910101,4.03412,4.01152,443,4294967295,0.37715,0.43,1,81814,81371,443
4913021,4.00682,4.0023,443,4294967295,0.41943,0.44,1,81818,81375,443
4915941,5.60137,4.00046,445,4294967295,0.475886,0.44,1,81824,81379,445
4918861,5.92027,4.00009,447,4294967295,0.551177,0.44,1,81830,81383,447
4921781,5.98405,4.00002,449,4294967295,0.622235,0.48,1,81836,81387,449
4924701,5.99681,4,451,4294967295,0.716447,0.51,1,81842,81391,451
4927621,5.99936,4,453,4294967295,0.783289,0.55,2,81848,81395,453
4930541,5.99987,4,455,4294967295,0.852658,0.59,2,81854,81399,455
4994081,4,4,424,4294967295,0,0.01,1,82118,81694,424
4997001,8.8,6.4,427,4294967295,0,0.05,1,82128,81701,427
4998661,4.96,4.48,427,4294967295,0.008,0.07,1,82132,81705,427
5000321,4.192,4.096,427,4294967295,0.0096,0.11,1,82136,81709,427
5003241,8.0384,8.8192,426,4294967295,0.01792,0.08,1,82145,81719,426
5005521,5.60768,4.96384,427,5840,0.003584,0.08,1,82150,81723,427
5008441,8.32154,5.79277,430,5840,0.0007168,0.11,1,82159,81729,430
5011361,5.66431,4.35855,431,5840,0.00014336,0.09,1,82164,81733,431
5014281,3.53286,4.07171,430,5840,2.8672e-05,0.16,1,82167,81737,430
5016341,9.50657,4.01434,437,5840,5.7344e-06,0.16,1,82178,81741,437
5019261,7.50131,10.4029,432,5840,1.14688e-06,0.16,1,82185,81753,432
5021541,42.3003,5.28057,479,5840,2.29376e-07,0.33,1,82236,81757,479
5024461,14.0601,36.2561,442,5840,0.016,0.33,1,82243,81801,442
5027381,7.61201,10.4512,444,5840,0.0112,0.35,1,82249,81805,444
5030301,6.3224,5.29024,446,5840,0.00224,0.41,1,82255,81809,446
5033221,6.86448,4.25805,449,5840,0.008448,0.45,1,82262,81813,449
5036141,6.1729,4.05161,451,5840,0.0016896,0.49,1,82268,81817,451
5039061,6.03458,4.01032,453,5840,0.00033792,0.55,1,82274,81821,453
5041981,6.80692,4.00206,456,5840,0.00806758,0.6,1,82281,81825,456
5044901,6.96138,4.00041,459,5840,0.00961352,0.64,1,82288,81829,459
5047541,13.3923,4.00008,470,5840,0.0019227,0.76,1,82303,81833,470
5050461,9.07846,8.00002,469,5840,0.00838454,0.8,1,82311,81842,469
5052321,5.81569,4.8,470,5840,0.00167691,0.87,1,82316,81846,470
5055241,10.7631,7.36,474,5840,0.00833538,0.98,1,82328,81854,474
5058161,9.35263,4.672,479,5840,0.00966708,0.99,1,82337,81858,479
5060021,6.67053,4.1344,481,5840,0.00993341,1,1,82343,81862,481
5062941,8.53411,4.02688,486,5840,0.00198668,1,1,82352,81866,486
5065221,7.30682,4.00538,489,5840,0.000397337,1,1,82359,81870,489
5068141,8.66136,5.60108,492,5840,7.94673e-05,1,1,82368,81876,492
5071061,8.13227,4.32022,496,5840,1.58935e-05,1,1,82376,81880,496
5073121,8.02645,4.06404,500,5840,3.17869e-06,1,1,82384,81884,500
5075201,8.00529,5.61281,502,5840,6.35738e-07,1,1,82392,81890,502
5078121,5.60106,3.52256,504,5840,0.00800013,1,1,82397,81893,504
5079781,5.12021,3.90451,505,5840,0.00160003,1,1,82402,81897,505
5081441,8.22404,7.1809,506,5840,0.00832,1,1,82411,81905,506
5084361,7.24481,7.83618,505,5840,0.001664,1,1,82418,81913,505
5087281,8.64896,4.76724,510,5840,0.0003328,1,1,82427,81917,510
5090201,8.12979,4.15345,514,5840,0.00806656,1,1,82435,81921,514
5091661,7.22596,4.03069,517,5840,0.0176133,1,1,82442,81925,517
5130121,344.645,420.006,422,5840,0.00352266,0,1,82871,82449,422
5133041,158.529,168.801,428,5840,0.0807045,0,1,82983,82555,428
5143261,7,4,438,4294967295,0.02,0.19,1,83427,82989,438
5146181,7,4,441,4294967295,0.044,0.27,1,83434,82993,441
5149101,6.2,4,443,4294967295,0.0568,0.34,1,83440,82997,443
5152021,6.84,4,446,4294967295,0.05936,0.41,1,83447,83001,446
5154941,7.768,4,450,4294967295,0.035872,0.45,1,83455,83005,450
5157861,7.1536,4,453,4294967295,0.0071744,0.51,1,83462,83009,453
5160781,6.23072,4,455,4294967295,0.0254349,0.59,1,83468,83013,455
5163701,7.64614,4,459,4294967295,0.00508698,0.66,1,83476,83017,459
5166621,7.92923,4,463,4294967295,0.0250174,0.68,1,83484,83021,463
5169541,7.18585,4,466,4294967295,0.0370035,0.76,1,83491,83025,466
5172461,7.83717,4,470,4294967295,0.0074007,0.84,1,83499,83029,470
5175381,7.16743,4,473,4294967295,0.0414801,0.9,1,83506,83033,473
5178301,7.03349,4,476,4294967295,0.032296,0.98,1,83513,83037,476
5181221,9.4067,4,482,4294967295,0.0144592,1,1,83523,83041,482
5184141,8.28134,4,486,4294967295,0.00289184,1,1,83531,83045,486
5187061,7.25627,4,489,4294967295,0.00857837,1,1,83538,83049,489
5189981,8.65125,4,494,4294967295,0.00971567,1,1,83547,83053,494
5192901,8.13025,4,498,4294967295,0.0339431,1,1,83555,83057,498
5195821,8.82605,4,503,4294967295,0.0947886,1,1,83564,83061,503
5198741,6.56521,4,505,4294967295,0.0589577,1,1,83570,83065,505
5201661,5.31304,4,506,4294967295,0.0677915,1,1,83575,83069,506
5204581,5.06261,4,507,4294967295,0.0215583,1,1,83580,83073,507
5207501,4.21252,4,507,4294967295,0.0363117,1,1,83584,83077,507
5210421,4.0425,4,507,4294967295,0.0152623,1,1,83588,83081,507
5213341,4.8085,4,508,4294967295,0.00305247,1,1,83593,83085,508
5216261,4.1617,4,508,4294967295,0.0166105,1,1,83597,83089,508
5219181,4.83234,4,509,4294967295,0.0033221,1,1,83602,83093,509
5222101,4.16647,4,509,4294967295,0.00866442,1,1,83606,83097,509
5225021,8.03329,4,514,4294967295,0.00173288,1,1,83615,83101,514
5227941,6.40666,4,516,4294967295,0.0163466,1,1,83621,83105,516
5358081,347.681,420.8,424,238860,0.0112693,0,1,84054,83630,424
5361001,417.536,432.16,424,4294967295,0.0102539,0,1,84489,84065,424
5363921,85.9072,89.632,423,4294967295,0.00205077,0.01,1,84492,84069,423
5366841,21.1814,21.1264,424,4294967295,0.000410154,0.03,1,84497,84073,424
5369761,7.43629,7.42528,424,4294967295,0.00808203,0.03,1,84501,84077,424
5372681,5.48726,4.68506,425,4294967295,0.00961641,0.05,1,84506,84081,425
5375601,3.49745,4.13701,424,4294967295,0.0419233,0.05,1,84509,84085,424
5378521,3.09949,4.0274,423,4294967295,0.0163847,0.07,1,84512,84089,423
5381441,4.6199,4.00548,424,4294967295,0.0112769,0.05,1,84517,84093,424
5384361,4.92398,4.0011,425,4294967295,0.0262554,0.03,1,84522,84097,425
5387281,4.1848,4.00022,425,4294967295,0.0292511,0.05,1,84526,84101,425
5390201,3.23696,4.00004,424,4294967295,0.0458502,0.07,1,84529,84105,424
5393121,3.84739,4.00001,424,4294967295,0.03317,0.06,1,84533,84109,424
5396041,3.16948,4,423,4294967295,0.00663401,0.05,1,84536,84113,423
5398961,5.4339,4,425,4294967295,0.0253268,0.04,1,84542,84117,425
5401881,5.08678,4,426,4294967295,0.0290654,0.03,1,84547,84121,426
5404801,5.01736,4,427,4294967295,0.0138131,0.08,1,84552,84125,427
5407721,3.40347,4,426,4294967295,0.0267626,0.09,1,84555,84129,426
5410641,3.88069,4,426,4294967295,0.0293525,0.11,1,84559,84133,426
5413561,4.77614,4,427,4294967295,0.0138705,0.08,1,84564,84137,427
5416481,4.95523,4,428,4294967295,0.0267741,0.09,1,84569,84141,428
5419401,4.19105,4,428,4294967295,0.0453548,0.12,1,84573,84145,428
5422321,2.43821,4,426,4294967295,0.065071,0.13,1,84575,84149,426
5425241,2.88764,4,425,4294967295,0.0450142,0.12,1,84578,84153,425
5428161,4.57753,4,426,4294967295,0.0570028,0.09,1,84583,84157,426
5431081,4.91551,4,427,4294967295,0.0994006,0.07,1,84588,84161,427
5434001,4.9831,4,428,4294967295,0.0678801,0.09,1,84593,84165,428
5436921,3.39662,4,427,4294967295,0.069576,0.11,1,84596,84169,427
5439841,4.67932,4,428,4294967295,0.0699152,0.14,1,84601,84173,428
5442761,4.13586,4,428,4294967295,0.077983,0.1,1,84605,84177,428
5445681,5.62717,4,430,4294967295,0.0715966,0.12,1,84611,84181,430
5448601,5.92543,4,432,4294967295,0.0943193,0.13,1,84617,84185,432
5451521,4.38509,4,432,4294967295,0.0988639,0.17,1,84621,84189,432
5454441,5.67702,4,434,4294967295,0.0757728,0.2,1,84627,84193,434
5457361,4.3354,4,434,4294967295,0.0791546,0.22,1,84631,84197,434
5460281,4.86708,4,435,4294967295,0.103831,0.24,1,84636,84201,435
5463201,4.97342,4,436,4294967295,0.140766,0.25,1,84641,84205,436
5466121,4.19468,4,436,4294967295,0.156153,0.27,1,84645,84209,436
5469041,6.43894,4,439,4294967295,0.183231,0.29,1,84652,84213,439
5471961,5.28779,4,440,4294967295,0.180646,0.29,1,84657,84217,440
5474881,5.05756,4,441,4294967295,0.180129,0.33,1,84662,84221,441
5477801,6.61151,4,444,4294967295,0.204026,0.35,1,84669,84225,444
5480721,4.5223,4,444,4294967295,0.184805,0.38,1,84673,84229,444
5483641,5.70446,4,446,4294967295,0.220961,0.44,1,84679,84233,446
5486561,6.74089,4,449,4294967295,0.220192,0.46,1,84686,84237,449
5489121,6.14818,4,451,4294967295,0.220038,0,1,84692,84241,451
5491201,180.43,200.8,425,4294967295,0.0440077,0.01,1,84916,84491,425
5494121,40.0859,44.16,425,4294967295,0.00880154,0.04,1,84921,84496,425
5495781,12.8172,12.032,427,4294967295,0.00176031,0.05,1,84927,84500,427
5498701,6.56344,8.8064,424,4294967295,0.00835206,0.01,1,84932,84508,424
5501621,5.31269,4.96128,425,4294967295,0.0256704,0.01,1,84937,84512,425
5504541,4.26254,4.19226,425,4294967295,0.0371341,0.06,1,84941,84516,425
5507461,3.25251,4.03845,424,4294967295,0.0154268,0.06,1,84944,84520,424
5510341,6.2505,4.00769,427,4294967295,0.0350854,0.07,1,84951,84524,427
5513261,4.4501,5.60154,425,4294967295,0.0310171,0.04,1,84955,84530,425
5516181,3.29002,4.32031,424,4294967295,0.00620341,0.05,1,84958,84534,424
5519101,3.058,4.06406,423,4294967295,0.0172407,0.06,1,84961,84538,423
5522021,4.6116,4.01281,424,4294967295,0.0434481,0.05,1,84966,84542,424
5524941,4.12232,4.00256,424,4294967295,0.0486896,0.04,1,84970,84546,424
5526561,2.42446,4.00051,422,4294967295,0.0417379,0.04,1,84972,84550,422
5529481,4.48489,4.0001,423,4294967295,0.0323476,0.03,1,84977,84554,423
5532401,4.89698,4.00002,424,4294967295,0.0144695,0,1,84982,84558,424
5534881,5.7794,4,426,4294967295,0.0108939,0.03,1,84988,84562,426
5537801,6.75588,6.4,426,4294967295,0.0261788,0.09,1,84995,84569,426
5540721,5.35118,4.48,427,4294967295,0.0292358,0.07,1,85000,84573,427
5543641,5.07024,4.096,428,4294967295,0.0298472,0.09,1,85005,84577,428
5546561,3.41405,4.0192,427,4294967295,0.0299694,0.12,1,85008,84581,427
5549481,2.28281,4.00384,425,4294967295,0.0459939,0.12,1,85010,84585,425
5552401,4.45656,4.00077,426,4294967295,0.0651988,0.1,1,85015,84589,426
5555321,4.89131,4.00015,427,4294967295,0.0930398,0.07,1,85020,84593,427
5558241,3.37826,4.00003,426,4294967295,0.0986079,0.09,1,85023,84597,426
5561161,4.67565,4.00001,427,4294967295,0.0837216,0.1,1,85028,84601,427
5564081,5.73513,4,429,4294967295,0.0967443,0.08,1,85034,84605,429
5567001,3.54703,4,428,4294967295,0.0833489,0.11,1,85037,84609,428
5569921,3.10941,4,427,4294967295,0.0806698,0.13,1,85040,84613,427
5572841,3.82188,4,427,4294967295,0.072134,0.12,1,85044,84617,427
5575761,4.76438,4,428,4294967295,0.102427,0.11,1,85049,84621,428
5578681,4.15288,4,428,4294967295,0.0844854,0.12,1,85053,84625,428
5581601,6.43057,4,431,4294967295,0.128897,0.13,1,85060,84629,431
5584521,4.48611,4,431,4294967295,0.129779,0.13,1,85064,84633,431
5587441,4.89722,4,432,4294967295,0.113956,0.17,1,85069,84637,432
5590361,4.97944,4,433,4294967295,0.118791,0.18,1,85074,84641,433
5593281,2.59589,4,431,4294967295,0.111758,0.19,1,85076,84645,431
5596201,3.71918,4,431,4294967295,0.0943516,0.22,1,85080,84649,431
5597701,3.94384,4,431,4294967295,0.0668703,0.2,1,85084,84653,431
5599361,3.98877,4,431,4294967295,0.0613741,0.22,1,85088,84657,431
5602281,7.99775,5.6,434,4294967295,0.0602748,0.21,1,85097,84663,434
5605201,5.59955,4.32,435,4294967295,0.108055,0.2,1,85102,84667,435
5607061,7.51991,4.064,439,4294967295,0.165611,0.26,1,85110,84671,439
5609981,5.50398,8.8128,434,4294967295,0.169122,0.24,1,85115,84681,434
5612901,4.3008,4.96256,434,4294967295,0.161824,0.24,1,85119,84685,434
5615381,8.06016,4.19251,439,4294967295,0.192365,0.27,1,85128,84689,439
5618301,4.81203,8.0385,434,4294967295,0.174473,0.23,1,85132,84698,434
5620161,2.56241,4.8077,432,4294967295,0.186895,0,1,85134,84702,432
5623081,171.712,177.762,425,4294967295,0.0373789,0.01,1,85348,84923,425
5625781,42.3425,38.7523,431,4294967295,0.00747578,0.05,1,85358,84927,431
5628701,12.4685,17.3505,424,4294967295,0.00149516,0.02,1,85363,84939,424
5630981,8.8937,6.67009,428,4294967295,0.016299,0.06,1,85371,84943,428
5633901,4.97874,7.73402,424,4294967295,0.0272598,0.03,1,85375,84951,424
5636821,4.99575,4.7468,425,4294967295,0.045452,0.03,1,85380,84955,425
5639741,3.39915,4.14936,424,4294967295,0.0490904,0.03,1,85383,84959,424
5642661,3.87983,4.02987,424,4294967295,0.0178181,0.06,1,85387,84963,424
5645581,3.97597,4.00597,424,4294967295,0.0195636,0.05,1,85391,84967,424
5648501,3.19519,4.00119,423,4294967295,0.0119127,0.05,1,85394,84971,423
5650741,7.03904,4.00024,427,4294967295,0.0263825,0.01,1,85402,84975,427
5653661,4.60781,6.40005,424,4294967295,0.0292765,0,1,85406,84982,424
5656581,4.12156,4.48001,424,4294967295,0.0458553,0.04,1,85410,84986,424
5659501,3.22431,4.096,423,4294967295,0.0411711,0.03,1,85413,84990,423
5662421,4.64486,4.0192,424,4294967295,0.0242342,0.04,1,85418,84994,424
5665341,4.92897,4.00384,425,4294967295,0.00484684,0.03,1,85423,84998,425
5668261,4.98579,4.00077,426,4294967295,0.000969368,0.06,1,85428,85002,426
5671121,4.99716,4.00015,427,4294967295,0.0161939,0.07,1,85433,85006,427
5674041,4.99943,4.00003,428,4294967295,0.0192388,0.09,1,85438,85010,428
5676961,4.19989,4.00001,428,4294967295,0.0118478,0.11,1,85442,85014,428
5679881,4.83998,4,429,4294967295,0.0103696,0.12,1,85447,85018,429
5681941,2.568,4,427,4294967295,0.0100739,0.13,1,85449,85022,427
5684861,2.9136,3.2,427,4294967295,0.0260148,0.12,1,85452,85025,427
5687141,2.98272,3.84,426,4294967295,0.037203,0.11,1,85455,85029,426
5690061,4.59654,3.168,428,4294967295,0.0314406,0.09,1,85460,85032,428
5692981,4.11931,3.8336,428,4294967295,0.0142881,0.1,1,85464,85036,428
5695901,3.22386,3.96672,427,4294967295,0.00285762,0.13,1,85467,85040,427
5698581,6.24477,3.99334,430,4294967295,0.00857152,0.13,1,85474,85044,430
5701501,3.64895,4.79867,428,4294967295,0.0097143,0.08,1,85477,85049,428
5704421,5.52979,4.15973,430,4294967295,0.00994286,0.13,1,85483,85053,430
5707341,4.30596,4.03195,430,4294967295,0.0259886,0.13,1,85487,85057,430
5709601,3.26119,4.00639,429,4294967295,0.0611977,0.15,1,85490,85061,429
5712521,7.05224,9.60128,426,4294967295,0.0682395,0.11,1,85498,85072,426
5715441,4.61045,5.12026,426,4294967295,0.0856479,0.09,1,85502,85076,426
5717921,4.92209,4.22405,427,4294967295,0.10513,0.08,1,85507,85080,427
5720841,3.38442,3.24481,427,4294967295,0.101026,0.07,1,85510,85083,427
5723761,4.67688,3.84896,428,4294967295,0.108205,0.1,1,85515,85087,428
5726681,4.93538,3.96979,429,4294967295,0.117641,0.1,1,85520,85091,429
5729601,5.78708,3.99396,431,4294967295,0.135528,0.13,1,85526,85095,431
5731861,5.15742,3.99879,432,4294967295,0.131106,0.15,1,85531,85099,432
5733941,5.03148,4.79976,432,4294967295,0.122221,0.19,1,85536,85104,432
5735601,4.2063,4.95995,431,4294967295,0.120444,0.17,1,85540,85109,431
5738521,7.24126,6.59199,432,4294967295,0.104089,0.19,1,85548,85116,432
5740801,4.64825,4.5184,432,4294967295,0.132818,0.22,1,85552,85120,432
5743721,10.5297,8.90368,434,4294967295,0.114564,0.22,1,85564,85130,434
5746641,5.30593,4.98074,434,4294967295,0.102913,0.18,1,85568,85134,434
5749561,3.46119,4.19615,433,4294967295,0.140583,0.22,1,85571,85138,433
5751201,4.69224,4.03923,434,4294967295,0.148116,0,1,85576,85142,434
5753281,163.338,171.208,424,4294967295,0.0296233,0.02,1,85779,85355,424
5756201,39.8677,41.4416,424,4294967295,0.0139247,0.02,1,85788,85364,424
5759121,12.7735,11.4883,426,4294967295,0.00278493,0.01,1,85794,85368,426
5760981,4.15471,5.49766,424,4294967295,0.00855699,0.04,1,85796,85372,424
5763901,4.83094,5.09953,424,4294967295,0.0257114,0.08,1,85801,85377,424
5766821,3.36619,4.21991,423,4294967295,0.00514228,0.03,1,85804,85381,423
5769301,6.27324,4.04398,426,4294967295,0.0170285,0.04,1,85811,85385,426
5772221,3.65465,5.6088,423,4294967295,0.0114057,0.02,1,85814,85391,423
5774501,4.73093,4.32176,424,4294967295,0.00228114,0,1,85819,85395,424
5777421,4.94619,3.26435,426,4294967295,0.00845623,0.03,1,85824,85398,426
5780341,3.38924,3.85287,425,4294967295,0.0176912,0.07,1,85827,85402,425
5782821,8.67785,3.97057,431,4294967295,0.0195382,0.02,1,85837,85406,431
5785741,5.73557,10.3941,424,4294967295,0.0279077,0,1,85842,85418,424
5788661,4.34711,5.27882,424,4294967295,0.0375815,0.02,1,85846,85422,424
5791581,4.06942,4.25576,424,4294967295,0.0315163,0.05,1,85850,85426,424
5794501,3.21388,4.05115,423,4294967295,0.0463033,0.05,1,85853,85430,423
5797421,3.84278,4.01023,423,4294967295,0.0172607,0.06,1,85857,85434,423
5800341,4.76856,4.00205,424,4294967295,0.0354521,0.03,1,85862,85438,424
5803261,4.95371,4.00041,425,4294967295,0.0390904,0.04,1,85867,85442,425
5806181,2.59074,4.00008,423,4294967295,0.00781809,0.05,1,85869,85446,423
5808821,8.51815,4.00002,429,4294967295,0.0255636,0.04,1,85879,85450,429
5811741,5.70363,8.8,424,4294967295,0.0291127,0.03,1,85884,85460,424
5814661,3.54073,4.96,423,4294967295,0.0458225,0.03,1,85887,85464,423
5817581,3.90815,4.192,423,4294967295,0.0331645,0.04,1,85891,85468,423
5820501,4.78163,4.0384,424,4294967295,0.0146329,0.04,1,85896,85472,424
5823421,4.15633,4.00768,424,4294967295,0.0189266,0.03,1,85900,85476,424
5826341,6.43127,4.00154,427,4294967295,0.0437853,0.03,1,85907,85480,427
5829261,5.28625,4.00031,428,4294967295,0.0407571,0.05,1,85912,85484,428
5832181,4.25725,4.00006,428,4294967295,0.0321514,0.12,1,85916,85488,428
5835101,5.65145,4.00001,430,4294967295,0.0384303,0.12,1,85922,85492,430
5838021,2.73029,4,428,4294967295,0.0316861,0.13,1,85924,85496,428
5840641,2.94606,4,427,4294967295,0.0543372,0.14,1,85927,85500,427
5843561,6.98921,5.6,429,4294967295,0.0588674,0.12,1,85935,85506,429
5845841,3.79784,4.32,428,4294967295,0.0757735,0.1,1,85938,85510,428
5848761,4.75957,3.264,430,4294967295,0.0551547,0.1,1,85943,85513,430
5851041,3.35191,3.8528,429,4294967295,0.0510309,0.14,1,85946,85517,429
5853961,5.47038,5.57056,429,4294967295,0.0582062,0.15,1,85952,85523,429
5856881,4.29408,4.31411,429,4294967295,0.0516412,0.13,1,85956,85527,429
5858741,4.85882,4.06282,430,4294967295,0.0663282,0.13,1,85961,85531,430
5861661,4.97176,5.61256,429,4294967295,0.0452657,0.13,1,85966,85537,429
5863941,7.39435,4.32251,433,4294967295,0.0410531,0.15,1,85974,85541,433
5866641,5.47887,7.2645,430,4294967295,0.0642106,0.15,1,85979,85549,430
5869561,9.09577,8.6529,431,4294967295,0.0768421,0.16,1,85989,85558,431
5871841,5.01915,4.93058,431,4294967295,0.0633684,0.15,1,85993,85562,431
5874761,8.20383,6.58612,433,4294967295,0.0846737,0.17,1,86002,85569,433
5877681,5.64077,4.51722,434,4294967295,0.0729347,0.16,1,86007,85573,434
5880161,4.32815,4.10344,434,4294967295,0.110587,0.23,1,86011,85577,434
5882241,7.26563,7.22069,434,4294967295,0.0941174,0,1,86019,85585,434
5885161,161.453,168.644,425,4294967295,0.0268235,0.01,1,86219,85794,425
5887861,39.4906,36.9288,430,4294967295,0.0053647,0.04,1,86228,85798,430
5890781,11.0981,16.1858,423,4294967295,0.00907294,0.01,1,86232,85809,423
5893701,6.21962,6.43715,424,4294967295,0.0178146,0.03,1,86237,85813,424
5896621,3.64392,4.48743,423,4294967295,0.0115629,0.03,1,86240,85817,423
5899541,3.92878,4.09749,423,4294967295,0.00231258,0.03,1,86244,85821,423
5902461,3.98576,4.0195,423,4294967295,0.0244625,0.01,1,86248,85825,423
5905121,4.79715,4.0039,424,4294967295,0.0128925,0.01,1,86253,85829,424
5908041,4.15943,3.20078,425,4294967295,0.0105785,0.03,1,86257,85832,425
5910961,4.03189,3.84016,425,4294967295,0.0261157,0.05,1,86261,85836,425
5912821,4.00638,3.96803,425,4294967295,0.0132231,0.06,1,86265,85840,425
5914901,4.00128,3.99361,425,4294967295,0.0106446,0.08,1,86269,85844,425
5917821,5.60026,5.59872,425,4294967295,0.0341289,0.03,1,86275,85850,425
5919681,3.52005,4.31974,424,4294967295,0.0388258,0.05,1,86278,85854,424
5922601,5.50401,6.46395,423,4294967295,0.00776516,0.07,1,86284,85861,423
5925521,5.9008,4.49279,425,4294967295,0.041553,0,1,86290,85865,425
5928441,4.38016,4.09856,425,4294967295,0.0483106,0.03,1,86294,85869,425
5931361,4.07603,4.01971,425,4294967295,0.00966212,0.08,1,86298,85873,425
5934281,3.21521,4.00394,424,4294967295,0.0259324,0.06,1,86301,85877,424
5936321,3.04304,4.00079,423,4294967295,0.00518648,0.07,1,86304,85881,423
5939241,7.80861,6.40016,425,4294967295,0.0010373,0.03,1,86313,85888,425
5942161,4.76172,4.48003,425,4294967295,0.0162075,0.03,1,86317,85892,425
5945081,3.35234,4.09601,424,4294967295,0.0272415,0.08,1,86320,85896,424
5948001,3.87047,4.0192,424,4294967295,0.0454483,0.06,1,86324,85900,424
5950921,3.97409,4.00384,424,4294967295,0.0410897,0.05,1,86328,85904,424
5953841,3.99482,4.00077,424,4294967295,0.0322179,0.06,1,86332,85908,424
5955461,3.99896,4.00015,424,4294967295,0.0144436,0.05,1,86336,85912,424
5958381,4.79979,4.00003,425,4294967295,0.0348887,0.03,1,86341,85916,425
5961301,4.95996,4.00001,426,4294967295,0.0869777,0.05,1,86346,85920,426
5963781,7.39199,4,430,4294967295,0.0973955,0.08,1,86354,85924,430
5966701,3.0784,7.2,424,4294967295,0.115479,0.1,1,86356,85932,424
5969621,5.41568,4.64,426,4294967295,0.0950958,0.1,1,86362,85936,426
5972541,4.28314,4.128,426,4294967295,0.107019,0.06,1,86366,85940,426
5975461,3.25663,4.0256,425,4294967295,0.117404,0.09,1,86369,85944,425
5978381,4.65133,4.00512,426,4294967295,0.0714808,0.08,1,86374,85948,426
5980421,7.33027,4.00102,430,4294967295,0.0702962,0.07,1,86382,85952,430
5983341,5.46605,8.8002,425,4294967295,0.0700592,0.04,1,86387,85962,425
5986261,5.09321,4.96004,426,4294967295,0.0700118,0.03,1,86392,85966,426
5989181,5.01864,4.19201,427,4294967295,0.0380024,0.07,1,86397,85970,427
5992101,4.20373,4.0384,427,4294967295,0.0316005,0.08,1,86401,85974,427
5993941,5.64075,4.00768,429,4294967295,0.0383201,0.14,1,86407,85978,429
5996861,5.12815,6.40154,427,4294967295,0.031664,0.1,1,86412,85985,427
5999141,9.02563,4.48031,433,4294967295,0.0143328,0.11,1,86422,85989,433
6002061,7.40513,8.89606,430,4294967295,0.0668666,0.09,1,86429,85999,430
6004341,3.88103,4.97921,429,4294967295,0.101373,0.11,1,86432,86003,429
6006421,5.57621,4.99584,430,4294967295,0.0602747,0.13,1,86438,86008,430
6009341,4.31524,6.59917,427,4294967295,0.0760549,0.11,1,86442,86015,427
6011201,4.06305,4.51983,427,4294967295,0.079211,0.13,1,86446,86019,427
6013281,4.01261,5.70397,425,4294967295,0.0478422,0.01,1,86450,86025,425
6016201,168.003,168.341,425,4294967295,0.00956844,0.01,1,86659,86234,425
6019121,36.0005,36.8682,424,4294967295,0.00991369,0.01,1,86662,86238,424
6022041,9.6001,10.5736,423,4294967295,0.00998274,0.08,1,86665,86242,423
6024961,5.12002,5.31473,423,4294967295,0.00999655,0.06,1,86669,86246,423
6027881,4.224,4.26295,423,4294967295,0.0259993,0.01,1,86673,86250,423
6030801,4.0448,4.05259,423,4294967295,0.0291999,0.01,1,86677,86254,423
6033721,4.80896,4.01052,424,4294967295,0.02184,0.04,1,86682,86258,424
6036641,4.96179,4.0021,425,4294967295,0.012368,0.03,1,86687,86262,425
6039561,4.19236,4.00042,425,4294967295,0.0104736,0.05,1,86691,86266,425
6041361,2.43847,4.00008,423,4294967295,0.0260947,0.04,1,86693,86270,423
6044281,6.08769,4.80002,425,4294967295,0.0372189,0.04,1,86700,86275,425
6046981,4.41754,4.16,425,4294967295,0.0474438,0.04,1,86704,86279,425
6049901,2.48351,3.232,424,4294967295,0.0574888,0.05,1,86706,86282,424
6052181,10.0967,3.8464,432,4294967295,0.0434978,0.01,1,86718,86286,432
6055101,5.21934,11.1693,423,4294967295,0.0326996,0,1,86722,86299,423
6058021,5.04387,5.43386,424,4294967295,0.0465399,0.03,1,86727,86303,424
6060501,3.40877,4.28677,423,4294967295,0.033308,0.03,1,86730,86307,423
6063421,4.68175,3.25735,425,4294967295,0.0226616,0.01,1,86735,86310,425
6066341,4.93635,3.85147,426,4294967295,0.0125323,0.04,1,86740,86314,426
6069261,3.38727,3.97029,425,4294967295,0.0105065,0.07,1,86743,86318,425
6072181,2.27745,3.99406,423,4294967295,0.00210129,0.08,1,86745,86322,423
6074021,5.25549,3.99881,425,4294967295,0.000420258,0.05,1,86751,86326,425
6076941,5.0511,4.79976,425,4294967295,0.00808405,0.03,1,86756,86331,425
6079861,5.81022,4.15995,427,4294967295,0.0416168,0.03,1,86762,86335,427
6082781,4.36204,4.03199,427,4294967295,0.0163234,0.07,1,86766,86339,427
6085701,5.67241,4.0064,429,4294967295,0.0272647,0.1,1,86772,86343,429
6087541,1.93448,4.00128,426,4294967295,0.0294529,0.1,1,86773,86347,426
6090461,3.5869,4.00026,426,4294967295,0.0138906,0.13,1,86777,86351,426
6093381,5.51738,4.00005,428,4294967295,0.0427781,0.09,1,86783,86355,428
6095861,9.90348,4.00001,435,4294967295,0.0325556,0.13,1,86794,86359,435
6098781,4.3807,10.4,426,4294967295,0.0705111,0.07,1,86797,86371,426
6101701,4.87614,5.28,427,4294967295,0.0701022,0.09,1,86802,86375,427
6104621,3.37523,4.256,426,4294967295,0.0780204,0.08,1,86805,86379,426
6107541,3.07505,4.0512,425,4294967295,0.0876041,0.1,1,86808,86383,425
6110421,2.21501,4.01024,423,4294967295,0.0895208,0.08,1,86810,86387,423
6113341,5.243,4.00205,425,4294967295,0.0819042,0.07,1,86816,86391,425
6116261,4.2486,4.00041,425,4294967295,0.104381,0.02,1,86820,86395,425
6118741,7.24972,4.00008,429,4294967295,0.0688762,0.07,1,86828,86399,429
6121661,4.64994,8.80002,423,4294967295,0.0377752,0.02,1,86832,86409,423
6124581,7.32999,4.96,427,4294967295,0.015555,0.03,1,86840,86413,427
6127501,4.666,4.192,427,4294967295,0.043111,0.03,1,86844,86417,427
6129141,5.7332,4.0384,429,4294967295,0.0326222,0.12,1,86850,86421,429
6131221,9.94664,7.20768,432,4294967295,0.0145244,0.11,1,86861,86429,432
6134141,5.18933,10.2415,425,4294967295,0.0269049,0.1,1,86865,86440,425
6137061,6.63787,5.24831,428,4294967295,0.013381,0.07,1,86872,86444,428
6139981,4.52757,4.24966,428,4294967295,0.0266762,0.07,1,86876,86448,428
6142901,4.90551,4.04993,429,4294967295,0.0613352,0.12,1,86881,86452,429
6144321,162.581,4.00999,627,4294967295,0.012267,0.01,1,87083,86456,627
6147241,40.5162,172.002,423,4294967295,0.00245341,0.04,1,87093,86670,423
6150161,11.3032,37.6004,423,4294967295,0.000490682,0.03,1,87097,86674,423
6153081,5.46065,10.7201,423,4294967295,0.0240981,0.04,1,87101,86678,423
6156001,4.29213,5.34402,423,4294967295,0.0448196,0.04,1,87105,86682,423
6158921,4.85843,4.2688,424,4294967295,0.0569639,0.04,1,87110,86686,424
6161841,4.97169,4.05376,425,4294967295,0.0753928,0.04,1,87115,86690,425
6164761,4.99434,4.01075,426,4294967295,0.0550786,0.06,1,87120,86694,426
6167681,3.39887,4.00215,425,4294967295,0.0510157,0.07,1,87123,86698,425
6170601,3.87977,4.00043,425,4294967295,0.0342031,0.08,1,87127,86702,425
6173521,3.97595,4.00009,425,4294967295,0.0228406,0.07,1,87131,86706,425
6176441,3.99519,4.00002,425,4294967295,0.0125681,0.08,1,87135,86710,425
6179361,3.99904,4,425,4294967295,0.0105136,0.06,1,87139,86714,425
6182281,3.19981,4,424,4294967295,0.0261027,0.07,1,87142,86718,424
6184261,3.03996,4,423,4294967295,0.0292205,0.07,1,87145,86722,423
6185921,3.00799,3.2,423,4294967295,0.0618441,0.03,1,87148,86725,423
6188841,4.6016,4.64,423,4294967295,0.0603688,0.03,1,87153,86730,423
6190501,8.12032,4.128,428,4294967295,0.0120738,0.01,1,87162,86734,428
6193421,4.82406,8.0256,423,4294967295,0.00241475,0.03,1,87166,86743,423
6196341,5.76481,4.80512,425,4294967295,0.032483,0.01,1,87172,86747,425
6198821,6.75296,4.16102,428,4294967295,0.0704966,0.07,1,87179,86751,428
6201741,5.35059,8.03221,424,4294967295,0.0460993,0.01,1,87184,86760,424
6204661,3.47012,4.80644,423,4294967295,0.0412199,0.03,1,87187,86764,423
6207581,4.69402,4.16129,424,4294967295,0.032244,0.05,1,87192,86768,424
6210501,4.9388,4.03226,425,4294967295,0.00644879,0.04,1,87197,86772,425
6212961,4.98776,4.00645,426,4294967295,0.0252898,0.08,1,87202,86776,426
6215881,5.79755,5.60129,426,4294967295,0.013058,0.08,1,87208,86782,426
6218801,4.35951,4.32026,426,4294967295,0.0186116,0.05,1,87212,86786,426
6221721,4.0719,4.06405,426,4294967295,0.00372232,0.08,1,87216,86790,426
6224641,4.01438,4.01281,426,4294967295,0.00874446,0.09,1,87220,86794,426
6226481,4.00288,4.00256,426,4294967295,0.0337489,0.08,1,87224,86798,426
6229401,7.20058,6.40051,427,4294967295,0.0627498,0.11,1,87232,86805,427
6232321,5.44011,4.4801,428,4294967295,0.06055,0.08,1,87237,86809,428
6234181,3.48802,4.09602,427,4294967295,0.07611,0.13,1,87240,86813,427
6237101,2.2976,4.8192,424,4294967295,0.063222,0.12,1,87242,86818,424
6240021,2.85952,4.16384,423,4294967295,0.0446444,0.09,1,87245,86822,423
6242501,6.1719,4.03277,426,4294967295,0.0329289,0.05,1,87252,86826,426
6245421,5.23438,5.60655,425,4294967295,0.0145858,0.04,1,87257,86832,425
6248341,4.24688,4.32131,425,4294967295,0.00291715,0.05,1,87261,86836,425
6251261,3.24938,4.06426,424,4294967295,0.00858343,0.08,1,87264,86840,424
6253941,6.24987,4.01285,427,4294967295,0.00971669,0.04,1,87271,86844,427
6256861,5.24997,7.20257,424,4294967295,0.0419433,0.02,1,87276,86852,424
6259141,7.45,4.64051,428,4294967295,0.120389,0.05,1,87284,86856,428
6261841,5.49,8.1281,424,4294967295,0.104078,0.05,1,87289,86865,424
6264761,13.098,9.62562,429,4294967295,0.0368155,0.08,1,87304,86875,429
6267681,6.6196,5.12512,430,4294967295,0.103363,0.09,1,87309,86879,430
6269541,4.52392,4.22502,430,4294967295,0.108673,0.13,1,87313,86883,430
6272461,3.30478,4.845,428,4294967295,0.0777345,0.14,1,87316,86888,428
6273281,161.461,4.169,625,4294967295,0.0155469,0,1,87517,86892,625
6276201,34.6922,163.234,425,4294967295,0.00310938,0.01,1,87520,87095,425
6278901,14.1384,35.8468,430,4294967295,0.0246219,0.08,1,87529,87099,430
6281821,5.22769,12.7694,426,4294967295,0.00492438,0.08,1,87532,87106,426
6284741,3.44554,5.75387,425,4294967295,0.000984875,0.1,1,87535,87110,425
6287661,3.08911,4.35077,424,4294967295,0.00819698,0.11,1,87538,87114,424
6289921,3.81782,4.07015,424,4294967295,0.00963939,0.05,1,87542,87118,424
6292841,3.96356,4.81403,423,4294967295,0.00992788,0.03,1,87546,87123,423
6295761,4.79271,4.16281,424,4294967295,0.0339856,0.02,1,87551,87127,424
6298681,4.95854,4.03256,425,4294967295,0.0147971,0.03,1,87556,87131,425
6301361,4.19171,4.00651,425,4294967295,0.0109594,0.03,1,87560,87135,425
6304281,5.63834,4.8013,426,4294967295,0.0101919,0.05,1,87566,87140,426
6307201,3.52767,4.16026,425,4294967295,0.0100384,0.07,1,87569,87144,425
6309681,3.10553,4.03205,424,4294967295,0.0100077,0.08,1,87572,87148,424
6312601,6.22111,7.20641,423,4294967295,0.0340015,0.04,1,87579,87156,423
6315521,6.04422,4.64128,425,4294967295,0.0628003,0.02,1,87585,87160,425
6318441,5.20884,4.12826,426,4294967295,0.0365601,0.04,1,87590,87164,426
6321361,4.24177,4.02565,426,4294967295,0.015312,0.08,1,87594,87168,426
6324241,3.24835,4.00513,425,4294967295,0.0030624,0.11,1,87597,87172,425
6327161,5.44967,5.60103,425,4294967295,0.0246125,0.07,1,87603,87178,425
6328821,6.68993,4.32021,428,4294967295,0.0289225,0.06,1,87610,87182,428
6331741,4.53799,7.26404,424,4294967295,0.0377845,0.04,1,87614,87190,424
6334661,3.3076,4.65281,423,4294967295,0.0475569,0.05,1,87617,87194,423
6337581,3.86152,4.13056,423,4294967295,0.0655114,0.06,1,87621,87198,423
6339221,6.3723,4.02611,426,4294967295,0.0931023,0.03,1,87628,87202,426
6342141,5.27446,6.40522,424,4294967295,0.10662,0.04,1,87633,87209,424
6345061,5.05489,4.48104,425,4294967295,0.117324,0.01,1,87638,87213,425
6347981,5.01098,4.09621,426,4294967295,0.119465,0.05,1,87643,87217,426
6350901,5.0022,4.01924,427,4294967295,0.079893,0.06,1,87648,87221,427
6353821,3.40044,4.00385,426,4294967295,0.0239786,0.08,1,87651,87225,426
6355441,3.08009,4.00077,425,4294967295,0.0287957,0.08,1,87654,87229,425
6358361,5.41602,6.40015,424,4294967295,0.0297591,0.1,1,87660,87236,424
6361061,5.0832,4.48003,425,4294967295,0.0139518,0.04,1,87665,87240,425
6363981,3.41664,4.89601,423,4294967295,0.0187904,0.04,1,87668,87245,423
6366901,3.88333,4.1792,423,4294967295,0.0277581,0.04,1,87672,87249,423
6369821,3.97667,4.03584,423,4294967295,0.0135516,0.03,1,87676,87253,423
6372501,6.39533,4.00717,426,4294967295,0.0187103,0.01,1,87683,87257,426
6375421,5.27907,6.40143,424,4294967295,0.0117421,0,1,87688,87264,424
6378341,6.65581,4.48029,427,4294967295,0.0103484,0.03,1,87695,87268,427
6381261,5.33116,4.09606,428,4294967295,0.0260697,0.07,1,87700,87272,428
6384181,4.26623,4.01921,428,4294967295,0.0452139,0.11,1,87704,87276,428
6386021,4.85325,4.00384,429,4294967295,0.0650428,0.1,1,87709,87280,429
6388941,4.97065,8.80077,424,4294967295,0.0610086,0.03,1,87714,87290,424
6391221,5.79413,4.96015,426,4294967295,0.0682017,0.01,1,87720,87294,426
6392881,5.95883,3.39203,429,4294967295,0.0536403,0.08,1,87726,87297,429
6395801,11.5918,15.0784,424,4294967295,0.0107281,0.05,1,87739,87315,424
6398721,5.51835,6.21568,424,4294967295,0.0421456,0,1,87743,87319,424
6401621,8.30367,4.44314,429,4294967295,0.0644291,0.04,1,87752,87323,429
6403281,6.46073,8.88863,425,4294967295,0.0528858,0,1,87758,87333,425
6406201,154.892,156.978,423,4294967295,0.0185772,0.01,1,87950,87527,423
6407861,37.3784,34.5955,427,4294967295,0.0117154,0.03,1,87958,87531,427
6410781,11.4757,12.5191,425,4294967295,0.0103431,0.03,1,87963,87538,425
6413701,4.69514,5.70382,424,4294967295,0.0100686,0.05,1,87966,87542,424
6415761,3.33903,4.34076,423,4294967295,0.00201372,0.04,1,87969,87546,423
6418681,4.66781,4.86815,423,4294967295,0.00840274,0.03,1,87974,87551,423
6421601,4.13356,4.17363,423,4294967295,0.0416806,0.02,1,87978,87555,423
6424521,4.02671,4.03473,423,4294967295,0.0483361,0.03,1,87982,87559,423
6427441,4.80534,4.00695,424,4294967295,0.0256672,0.03,1,87987,87563,424
6430361,5.76107,4.00139,426,4294967295,0.00513344,0.03,1,87993,87567,426
6432401,4.35221,4.00028,426,4294967295,0.00102669,0.04,1,87997,87571,426
6435321,5.67044,7.20006,424,4294967295,0.0162053,0.11,1,88003,87579,424
6438241,3.53409,4.64001,423,4294967295,0.0432411,0.05,1,88006,87583,423
6440721,3.90682,4.128,423,4294967295,0.0406482,0.03,1,88010,87587,423
6443641,4.78136,4.8256,423,4294967295,0.0321296,0.01,1,88015,87592,423
6446561,4.95627,4.16512,424,4294967295,0.0304259,0,1,88020,87596,424
6449481,4.99125,4.03302,425,4294967295,0.00608519,0.04,1,88025,87600,425
6452401,4.19825,4.0066,425,4294967295,0.00121704,0.06,1,88029,87604,425
6455281,4.83965,4.00132,426,4294967295,0.00824341,0.07,1,88034,87608,426
6458201,4.96793,4.00026,427,4294967295,0.00964868,0.06,1,88039,87612,427
6460901,8.19359,4.00005,432,4294967295,0.0419297,0.09,1,88048,87616,432
6463821,6.43872,8.00001,429,4294967295,0.0403859,0.11,1,88054,87625,429
6466741,3.68774,4.8,428,4294967295,0.0640772,0.13,1,88057,87629,428
6469661,3.13755,4.16,427,4294967295,0.0768154,0.14,1,88060,87633,427
6471301,4.62751,4.032,428,4294967295,0.0713631,0.12,1,88065,87637,428
6474221,4.1255,7.2064,424,4294967295,0.0702726,0.07,1,88069,87645,424
6476081,3.2251,4.64128,423,4294967295,0.0860545,0.03,1,88072,87649,423
6479001,5.44502,4.92826,424,4294967295,0.0572109,0.03,1,88078,87654,424
6481921,5.089,4.18565,425,4294967295,0.0354422,0.06,1,88083,87658,425
6484401,3.4178,4.03713,424,4294967295,0.0230884,0.02,1,88086,87662,424
6487321,5.48356,5.60743,424,4294967295,0.0846177,0.07,1,88092,87668,424
6490241,5.09671,4.32149,425,4294967295,0.0809235,0.03,1,88097,87672,425
6493161,2.61934,4.0643,423,4294967295,0.0721847,0.05,1,88099,87676,423
6496081,3.72387,4.01286,423,4294967295,0.102437,0.06,1,88103,87680,423
6499001,3.94477,4.00257,423,4294967295,0.108487,0.03,1,88107,87684,423
6501921,4.78895,4.00051,424,4294967295,0.117697,0.03,1,88112,87688,424
6504841,5.75779,4.0001,426,4294967295,0.0955395,0.03,1,88118,87692,426
6507701,8.35156,4.00002,431,4294967295,0.0351079,0.07,1,88127,87696,431
6510621,5.67031,8.8,426,4294967295,0.0230216,0.08,1,88132,87706,426
6513541,4.33406,4.96,426,4294967295,0.0126043,0.08,1,88136,87710,426
6516461,4.06681,4.192,426,4294967295,0.0345209,0.08,1,88140,87714,426
6519381,4.01336,4.0384,426,4294967295,0.0709042,0.11,1,88144,87718,426
6521221,7.20267,4.00768,430,4294967295,0.0781808,0.09,1,88152,87722,430
6523921,5.44053,8.80154,425,4294967295,0.0876362,0.03,1,88157,87732,425
6526001,9.88811,8.96031,427,4294967295,0.0655272,0.07,1,88168,87741,427
6528921,5.97762,7.39206,425,4294967295,0.0611054,0.09,1,88173,87748,425
6530581,8.39552,4.67841,430,4294967295,0.0522211,0.09,1,88182,87752,430
6533501,4.0791,8.93568,423,4294967295,0.0584442,0.05,1,88185,87762,423
6535781,160.016,4.98714,618,4294967295,0.0116888,0.01,1,88384,87766,618
6538481,36.0032,160.197,424,4294967295,0.00233777,0.01,1,88389,87965,424
6541401,12.0006,36.8395,424,4294967295,0.000467554,0.06,1,88395,87971,424
6544321,4.80013,10.5679,423,4294967295,0.00809351,0.04,1,88398,87975,423
6547241,4.16003,5.31358,423,4294967295,0.0336187,0.07,1,88402,87979,423
6550161,4.03201,4.26272,423,4294967295,0.0227237,0.04,1,88406,87983,423
6553081,4.0064,4.05254,423,4294967295,0.0125447,0.04,1,88410,87987,423
6556001,4.80128,4.01051,424,4294967295,0.026509,0.03,1,88415,87991,424
6558241,4.96026,4.0021,425,4294967295,0.00530179,0.03,1,88420,87995,425
6561161,5.79205,6.40042,424,4294967295,0.00906036,0.05,1,88426,88002,424
6563441,4.35841,4.48008,424,4294967295,0.00181207,0.05,1,88430,88006,424
6566361,2.47168,3.29602,423,4294967295,0.0163624,0.03,1,88432,88009,423
6568641,3.69434,3.8592,423,4294967295,0.0192725,0.03,1,88436,88013,423
6571561,7.13887,6.37184,424,4294967295,0.0198545,0.01,1,88444,88020,424
6573841,3.82777,4.47437,423,4294967295,0.0359709,0.06,1,88447,88024,423
6576761,8.76555,7.29487,425,4294967295,0.00719418,0.03,1,88457,88032,425
6579681,5.75311,4.65897,426,4294967295,0.00143884,0,1,88462,88036,426
6582601,4.35062,4.13179,426,4294967295,0.000287767,0.08,1,88466,88040,426
6585521,4.07012,4.02636,426,4294967295,0.00805755,0.09,1,88470,88044,426
6588401,4.81402,4.00527,427,4294967295,0.00161151,0.07,1,88475,88048,427
6591321,7.36281,8.00105,426,4294967295,0.0243223,0.08,1,88483,88057,426
6594241,5.47256,4.80021,427,4294967295,0.0528645,0.07,1,88488,88061,427
6596101,3.49451,4.16004,426,4294967295,0.0985729,0.12,1,88491,88065,426
6599021,3.0989,4.83201,424,4294967295,0.123715,0.12,1,88494,88070,424
6601921,3.81978,4.1664,424,4294967295,0.112743,0.04,1,88498,88074,424
6604841,8.76396,6.43328,427,4294967295,0.0625486,0.03,1,88508,88081,427
6607761,5.75279,4.48666,428,4294967295,0.0685097,0.08,1,88513,88085,428
6610681,5.15056,4.09733,429,4294967295,0.0697019,0.09,1,88518,88089,429
6613601,5.03011,4.01947,430,4294967295,0.0859404,0.1,1,88523,88093,430
6616521,3.40602,4.00389,429,4294967295,0.105188,0.14,1,88526,88097,429
6618981,3.8812,4.00078,429,4294967295,0.0770376,0.14,1,88530,88101,429
6621901,3.17624,3.20016,429,4294967295,0.0874075,0.12,1,88533,88104,429
6623761,1.43525,3.84003,426,4294967295,0.0894815,0.14,1,88534,88108,426
6626681,5.08705,7.16801,424,4294967295,0.105896,0.11,1,88540,88116,424
6629601,5.01741,4.6336,425,4294967295,0.101179,0.04,1,88545,88120,425
6632521,3.40348,4.12672,424,4294967295,0.0602358,0.05,1,88548,88124,424
6635441,5.4807,4.02534,426,4294967295,0.0120472,0.07,1,88554,88128,426
6638321,5.09614,4.00507,427,4294967295,0.0264094,0.06,1,88559,88132,427
6641241,4.21923,4.00101,427,4294967295,0.0292819,0.1,1,88563,88136,427
6644161,4.84385,4.0002,428,4294967295,0.0218564,0.12,1,88568,88140,428
6646021,7.36877,4.00004,432,4294967295,0.0363713,0.13,1,88576,88144,432
6648941,4.67375,8.80001,426,4294967295,0.0712743,0.11,1,88580,88154,426
6651861,4.13475,4.96,426,4294967295,0.0622549,0.09,1,88584,88158,426
6654781,3.22695,4.192,425,4294967295,0.044451,0.1,1,88587,88162,425
6656421,6.24539,4.0384,428,4294967295,0.0808902,0.06,1,88594,88166,428
6658501,6.84908,6.40768,428,4294967295,0.088178,0.08,1,88601,88173,428
6660581,12.5698,7.68154,434,4294967295,0.0736356,0.05,1,88615,88181,434
6663501,4.91396,11.9363,424,4294967295,0.0787271,0.02,1,88618,88194,424
6665781,155.383,5.58726,613,4294967295,0.0157454,0,1,88811,88198,613
6667861,41.4766,155.517,433,4294967295,0.0111491,0.04,1,88824,88391,433
6670781,11.4953,41.5035,424,4294967295,0.0182298,0.03,1,88828,88404,424
6673701,4.69906,11.5007,423,4294967295,0.00364596,0.04,1,88831,88408,423
6676621,4.13981,5.50014,423,4294967295,0.0167292,0.05,1,88835,88412,423
6679541,4.02796,4.30003,423,4294967295,0.0113458,0.01,1,88839,88416,423
6682461,4.80559,4.06001,424,4294967295,0.0342692,0.01,1,88844,88420,424
6685381,4.16112,4.012,424,4294967295,0.0308538,0.01,1,88848,88424,424
6688301,4.03222,4.0024,424,4294967295,0.0301708,0.06,1,88852,88428,424
6691221,4.00644,4.00048,424,4294967295,0.0140342,0.06,1,88856,88432,424
6692821,4.00129,4.0001,424,4294967295,0.00280683,0.04,1,88860,88436,424
6695741,4.00026,4.80002,423,4294967295,0.000561366,0.03,1,88864,88441,423
6698661,4.00005,4.16,423,4294967295,0.0241123,0.03,1,88868,88445,423
6701141,4.80001,4.032,424,4294967295,0.0448225,0.02,1,88873,88449,424
6704061,4.16,4.8064,423,4294967295,0.0329645,0.01,1,88877,88454,423
6706341,6.432,4.16128,426,4294967295,0.0705929,0.03,1,88884,88458,426
6708421,7.6864,5.63226,428,4294967295,0.0461186,0.02,1,88892,88464,428
6711341,5.53728,7.52645,425,4294967295,0.0172237,0.01,1,88897,88472,425
6714261,6.70746,4.70529,428,4294967295,0.00344474,0.05,1,88904,88476,428
6717181,5.34149,4.14106,429,4294967295,0.0326889,0.07,1,88909,88480,429
6720101,4.2683,4.02821,429,4294967295,0.0705378,0.12,1,88913,88484,429
6722981,6.45366,4.00564,432,4294967295,0.0781076,0.11,1,88920,88488,432
6725901,5.29073,9.60113,426,4294967295,0.0156215,0.07,1,88925,88499,426
6728821,4.25815,5.12023,426,4294967295,0.0031243,0.07,1,88929,88503,426
6731741,4.05163,4.22405,426,4294967295,0.00862486,0.09,1,88933,88507,426
6734661,4.81033,4.04481,427,4294967295,0.00972497,0.08,1,88938,88511,427
6736501,8.96207,4.00896,433,4294967295,0.073945,0.14,1,88948,88515,433
6739421,5.79241,8.80179,428,4294967295,0.070789,0.08,1,88953,88525,428
6741281,4.35848,4.96036,428,4294967295,0.0701578,0.09,1,88957,88529,428
6744201,3.2717,4.99207,426,4294967295,0.110032,0.12,1,88960,88534,426
6747121,2.25434,4.19841,424,4294967295,0.102006,0.12,1,88962,88538,424
6750041,3.65087,4.03968,424,4294967295,0.124401,0.11,1,88966,88542,424
6752961,3.93017,4.00794,424,4294967295,0.14488,0.05,1,88970,88546,424
6755881,3.98603,4.00159,424,4294967295,0.124976,0.03,1,88974,88550,424
6758341,5.59721,4.00032,426,4294967295,0.0889952,0.01,1,88980,88554,426
6761261,5.11944,6.40006,424,4294967295,0.057799,0.02,1,88985,88561,424
6764181,5.82389,4.48001,426,4294967295,0.0195598,0.02,1,88991,88565,426
6767101,5.16478,4.096,427,4294967295,0.027912,0.03,1,88996,88569,427
6770021,3.43296,4.0192,426,4294967295,0.0295824,0.09,1,88999,88573,426
6772941,3.88659,4.00384,426,4294967295,0.0459165,0.12,1,89003,88577,426
6775861,4.77732,4.00077,427,4294967295,0.0491833,0.08,1,89008,88581,427
6778781,4.95546,4.00015,428,4294967295,0.0498367,0.09,1,89013,88585,428
6781221,6.59109,4.00003,431,4294967295,0.0499673,0.11,1,89020,88589,431
6784141,4.51822,4.80001,430,4294967295,0.0339935,0.13,1,89024,88594,430
6786421,4.10364,4.16,430,4294967295,0.0307987,0.16,1,89028,88598,430
6789121,4.82073,7.232,427,4294967295,0.0301597,0.09,1,89033,88606,427
6791201,8.96415,9.4464,427,4294967295,0.0700319,0.08,1,89043,88616,427
6794121,6.59283,9.08928,424,4294967295,0.0700064,0.07,1,89049,88625,424
6795781,157.319,5.01786,615,4294967295,0.0140013,0.01,1,89244,88629,615
6797861,37.8637,157.004,428,4294967295,0.0108003,0.05,1,89252,88824,428
6800781,11.5727,37.8007,425,4294967295,0.0101601,0.04,1,89257,88832,425
6803701,5.51455,10.7601,425,4294967295,0.00203201,0.05,1,89261,88836,425
6806181,5.90291,5.35203,427,4294967295,0.0084064,0.07,1,89267,88840,427
6809101,4.38058,7.47041,423,4294967295,0.00968128,0.03,1,89271,88848,423
6812021,4.07612,4.69408,423,4294967295,0.00193626,0.03,1,89275,88852,423
6814501,4.01522,4.13882,423,4294967295,0.0243873,0.02,1,89279,88856,423
6817421,4.80304,3.22776,425,4294967295,0.0128775,0.01,1,89284,88859,425
6820341,4.16061,3.84555,425,4294967295,0.0105755,0.04,1,89288,88863,425
6823261,4.83212,3.96911,426,4294967295,0.0101151,0.08,1,89293,88867,426
6826181,4.96642,3.99382,427,4294967295,0.018023,0.05,1,89298,88871,427
6829101,4.19328,3.99876,427,4294967295,0.0356046,0.09,1,89302,88875,427
6831141,4.03866,3.99975,427,4294967295,0.0151209,0.11,1,89306,88879,427
6834061,3.20773,5.59995,424,4294967295,0.0190242,0.1,1,89309,88885,424
6836341,7.04155,4.31999,428,4294967295,0.0118048,0.02,1,89317,88889,428
6839261,6.20831,8.064,425,4294967295,0.034361,0,1,89323,88898,425
6842161,4.44166,4.8128,425,4294967295,0.0148722,0.04,1,89327,88902,425
6845081,5.68833,6.56256,424,4294967295,0.00297444,0.08,1,89333,88909,424
6846741,3.53767,4.51251,423,4294967295,0.00859489,0.07,1,89336,88913,423
6849661,3.90753,4.1025,423,4294967295,0.00171898,0.07,1,89340,88917,423
6851941,8.78151,4.0205,429,4294967295,0.0643438,0.03,1,89350,88921,429
6854861,5.7563,8.0041,425,4294967295,0.0688688,0.03,1,89355,88930,425
6857781,5.95126,4.80082,427,4294967295,0.0617738,0.05,1,89361,88934,427
6859841,4.39025,4.16016,427,4294967295,0.0443547,0.12,1,89365,88938,427
6862761,9.67805,8.03203,429,4294967295,0.0408709,0.1,1,89376,88947,429
6865681,5.13561,4.80641,429,4294967295,0.0321742,0.07,1,89380,88951,429
6868601,5.82712,4.16128,431,4294967295,0.0224348,0.13,1,89386,88955,431
6871521,4.36542,4.03226,431,4294967295,0.044487,0.13,1,89390,88959,431
6873781,3.27308,4.00645,430,4294967295,0.0408974,0.17,1,89393,88963,430
6876701,3.05462,6.40129,426,4294967295,0.0641795,0.13,1,89396,88970,426
6879621,2.21092,4.48026,424,4294967295,0.100836,0.11,1,89398,88974,424
6882541,2.84218,4.09605,423,4294967295,0.140167,0.08,1,89401,88978,423
6885461,3.76844,4.01921,423,4294967295,0.164033,0.05,1,89405,88982,423
6888381,4.75369,4.00384,424,4294967295,0.120807,0.01,1,89410,88986,424
6891301,4.95074,4.00077,425,4294967295,0.0721613,0.03,1,89415,88990,425
6894221,4.19015,4.00015,425,4294967295,0.0384323,0.05,1,89419,88994,425
6896661,8.03803,4.00003,430,4294967295,0.0156865,0.07,1,89428,88998,430
6899581,4.80761,8.00001,425,4294967295,0.00313729,0.06,1,89432,89007,425
6902501,3.36152,4.8,424,4294967295,0.00862746,0.07,1,89435,89011,424
6904981,5.4723,4.16,426,4294967295,0.00972549,0.05,1,89441,89015,426
6907901,5.09446,5.632,425,4294967295,0.0099451,0.03,1,89446,89021,425
6910821,5.01889,4.3264,426,4294967295,0.025989,0.06,1,89451,89025,426
6913741,5.00378,4.06528,427,4294967295,0.0611978,0.07,1,89456,89029,427
6916661,3.40076,4.01306,426,4294967295,0.0922396,0.09,1,89459,89033,426
6918501,7.08015,4.00261,430,4294967295,0.138448,0.08,1,89467,89037,430
6920161,3.81603,7.20052,425,4294967295,0.13169,0.07,1,89470,89045,425
6923081,10.3632,10.2401,426,4294967295,0.114338,0.09,1,89482,89056,426
6925781,157.273,5.24802,616,4294967295,0.0228676,0.01,1,89676,89060,616
6928701,35.4545,158.65,424,4294967295,0.0125735,0,1,89681,89257,424
6931601,9.4909,34.9299,423,4294967295,0.0025147,0.03,1,89684,89261,423
6934521,6.69818,10.186,425,4294967295,0.000502941,0.05,1,89690,89265,425
6936181,8.53964,5.2372,430,4294967295,0.0161006,0.07,1,89699,89269,430
6939101,4.90793,9.84744,423,4294967295,0.00322012,0.01,1,89703,89280,423
6942021,4.98159,5.16949,424,4294967295,0.040644,0.03,1,89708,89284,424
6944941,4.19632,4.2339,424,4294967295,0.0241288,0.03,1,89712,89288,424
6946581,3.23926,4.04678,423,4294967295,0.0448258,0.03,1,89715,89292,423
6949501,4.64785,4.00936,424,4294967295,0.0329652,0.06,1,89720,89296,424
6952421,3.32957,4.00187,423,4294967295,0.00659303,0.02,1,89723,89300,423
6955341,3.86591,4.00037,423,4294967295,0.0173186,0.05,1,89727,89304,423
6958021,3.97318,4.00007,423,4294967295,0.0114637,0.03,1,89731,89308,423
6960941,3.99464,3.20002,424,4294967295,0.0342927,0.01,1,89735,89311,424
6963221,8.79893,3.84,430,4294967295,0.0148585,0.04,1,89745,89315,430
6966141,4.95979,8.768,424,4294967295,0.00297171,0.01,1,89749,89325,424
6968421,5.79196,4.9536,426,4294967295,0.0325943,0.03,1,89755,89329,426
6971341,5.15839,4.99072,426,4294967295,0.0305189,0.03,1,89760,89334,426
6973201,4.23168,4.19814,426,4294967295,0.00610377,0.06,1,89764,89338,426
6976121,4.04634,4.03963,426,4294967295,0.00922075,0.08,1,89768,89342,426
6979041,4.80927,4.00793,427,4294967295,0.00984415,0.1,1,89773,89346,427
6981941,2.56185,4.00159,425,4294967295,0.00196883,0.09,1,89775,89350,425
6984021,5.31237,4.00032,427,4294967295,0.0483938,0.07,1,89781,89354,427
6985681,3.46247,5.60006,424,4294967295,0.0656788,0.07,1,89784,89360,424
6988601,8.69249,8.32001,425,4294967295,0.0611358,0.09,1,89794,89369,425
6990881,4.1385,4.864,424,4294967295,0.0682271,0.06,1,89797,89373,424
6992961,6.4277,5.7728,425,4294967295,0.0776454,0.04,1,89804,89379,425
6995881,8.48554,5.95456,428,4294967295,0.0235291,0.05,1,89813,89385,428
6998801,8.09711,4.39091,432,4294967295,0.0527058,0.08,1,89821,89389,432
7000661,5.61942,4.07818,433,4294967295,0.0905412,0.18,1,89826,89393,433
7003581,2.72388,8.01564,426,4294967295,0.0981082,0.18,1,89828,89402,426
7006501,2.14478,4.80313,424,4294967295,0.107622,0.13,1,89830,89406,424
7009421,3.62896,4.16063,424,4294967295,0.0775243,0.07,1,89834,89410,424
7012341,3.92579,4.03213,424,4294967295,0.0715049,0.05,1,89838,89414,424
7015261,3.18516,4.00643,423,4294967295,0.078301,0.06,1,89841,89418,423
7018181,3.83703,4.00129,423,4294967295,0.0716602,0.05,1,89845,89422,423
7021101,3.96741,4.00026,423,4294967295,0.054332,0.03,1,89849,89426,423
7024021,3.99348,4.00005,423,4294967295,0.0348664,0.03,1,89853,89430,423
7026941,3.9987,4.00001,423,4294967295,0.0629733,0.03,1,89857,89434,423
7029861,4.79974,4,424,4294967295,0.0445947,0.03,1,89862,89438,424
7032781,4.95995,4,425,4294967295,0.00891893,0.03,1,89867,89442,425
7034981,8.19199,4,430,4294967295,0.00978379,0.05,1,89876,89446,430
7037901,5.6384,4.8,430,4294967295,0.00195676,0.1,1,89881,89451,430
7040181,4.32768,4.16,430,4294967295,0.0243914,0.11,1,89885,89455,430
7043101,3.26554,3.232,430,4294967295,0.0528783,0.15,1,89888,89458,430
7045381,4.65311,3.8464,431,4294967295,0.0505757,0.16,1,89893,89462,431
7047041,4.13062,6.36928,428,4294967295,0.0181151,0.11,1,89897,89469,428
7049961,9.62612,11.6739,426,4294967295,0.051623,0.17,1,89908,89482,426
7052661,11.5252,5.53477,434,4294967295,0.0743246,0.13,1,89920,89486,434
7054741,153.505,9.90695,612,4294967295,0.0148649,0,1,90109,89497,612
7057661,33.101,155.581,423,4294967295,0.010973,0.01,1,90112,89689,423
7060581,11.4202,34.3163,425,4294967295,0.0021946,0.03,1,90118,89693,425
7063501,4.68404,10.0633,424,4294967295,0.00843892,0.05,1,90121,89697,424
7066181,4.13681,5.21265,424,4294967295,0.00968778,0.05,1,90125,89701,424
7068261,5.62736,3.44253,427,4294967295,0.0179376,0.04,1,90131,89704,427
7071181,4.32547,6.28851,424,4294967295,0.0275875,0.07,1,90135,89711,424
7073041,4.06509,4.4577,424,4294967295,0.0375175,0.03,1,90139,89715,424
7075961,4.01302,4.89154,423,4294967295,0.0475035,0.05,1,90143,89720,423
7078661,8.8026,4.17831,429,4294967295,0.0255007,0.01,1,90153,89724,429
7081581,4.16052,8.03566,423,4294967295,0.0291001,0.04,1,90156,89733,423
7084501,4.0321,4.80713,423,4294967295,0.02982,0.04,1,90160,89737,423
7087421,4.80642,4.16143,424,4294967295,0.061964,0.03,1,90165,89741,424
7090341,4.16128,4.03229,424,4294967295,0.0763928,0.01,1,90169,89745,424
7093261,3.23226,4.00646,423,4294967295,0.0552786,0.03,1,90172,89749,423
7095301,5.44645,4.00129,425,4294967295,0.0510557,0.05,1,90178,89753,425
7098221,4.28929,5.60026,423,4294967295,0.0502111,0,1,90182,89759,423
7100501,6.45786,4.32005,426,4294967295,0.0100422,0.03,1,90189,89763,426
7103421,5.29157,5.66401,425,4294967295,0.0260084,0.02,1,90194,89769,425
7106321,5.05831,4.3328,426,4294967295,0.0372017,0.07,1,90199,89773,426
7109241,5.81166,5.66656,426,4294967295,0.00744034,0.09,1,90205,89779,426
7112161,4.36233,4.33331,426,4294967295,0.00148807,0.08,1,90209,89783,426
7115081,4.87247,4.06666,427,4294967295,0.0402976,0.11,1,90214,89787,427
7116721,3.37449,4.01333,426,4294967295,0.00805952,0.07,1,90217,89791,426
7118801,4.6749,5.60267,425,4294967295,0.0256119,0.08,1,90222,89797,425
7121721,6.53498,7.52053,424,4294967295,0.0371224,0.07,1,90229,89805,424
7124001,6.107,4.70411,426,4294967295,0.0154245,0.09,1,90235,89809,426
7126081,10.8214,8.94082,428,4294967295,0.0510849,0.1,1,90247,89819,428
7129001,8.56428,8.98816,427,4294967295,0.106217,0.09,1,90255,89828,427
7131281,3.31286,4.99763,425,4294967295,0.0612434,0.09,1,90257,89832,425
7134201,5.46257,4.99953,426,4294967295,0.0762487,0.08,1,90263,89837,426
7137121,2.69251,4.19991,424,4294967295,0.0712497,0.07,1,90265,89841,424
7140041,5.3385,4.03998,426,4294967295,0.0542499,0.07,1,90271,89845,426
7142961,3.4677,4.008,425,4294967295,0.04285,0.05,1,90274,89849,425
7145881,2.29354,4.0016,423,4294967295,0.05657,0.09,1,90276,89853,423
7148801,4.45871,4.00032,424,4294967295,0.099314,0.07,1,90281,89857,424
7151721,4.09174,4.00006,424,4294967295,0.107863,0.03,1,90285,89861,424
7154641,4.01835,4.00001,424,4294967295,0.117573,0.03,1,90289,89865,424
7157561,4.00367,4,424,4294967295,0.0795145,0.03,1,90293,89869,424
7160481,4.80073,4,425,4294967295,0.0319029,0.03,1,90298,89873,425
7163401,4.96015,4,426,4294967295,0.00638058,0.03,1,90303,89877,426
7164981,6.59203,4,429,4294967295,0.00927612,0.08,1,90310,89881,429
7167901,5.31841,8,425,4294967295,0.00985522,0.05,1,90315,89890,425
7170801,5.06368,4.8,426,4294967295,0.025971,0.05,1,90320,89894,426
7173721,5.81274,6.56,425,4294967295,0.0691942,0.07,1,90326,89901,425
7176641,5.16255,4.512,426,4294967295,0.101839,0.03,1,90331,89905,426
7179561,5.03251,4.1024,427,4294967295,0.0923678,0.07,1,90336,89909,427
7181621,15.4065,4.02048,441,4294967295,0.0424736,0.1,1,90354,89913,441
7183281,4.6813,15.2041,425,4294967295,0.0484947,0,1,90356,89931,425
7186201,148.936,151.841,424,4294967295,0.0176989,0.01,1,90541,90117,424
7189121,32.9873,33.5682,424,4294967295,0.0275398,0.01,1,90545,90121,424
7192041,10.5974,9.91363,425,4294967295,0.013508,0.05,1,90550,90125,425
7193681,5.31949,5.18273,425,4294967295,0.00270159,0.04,1,90554,90129,425
7196601,8.2639,9.03655,424,4294967295,0.000540318,0.06,1,90563,90139,424
7199521,4.85278,5.00731,424,4294967295,0.000108064,0,1,90567,90143,424
7202001,4.97056,4.20146,425,4294967295,0.0480216,0,1,90572,90147,425
7204921,3.39411,3.24029,425,4294967295,0.0576043,0.01,1,90575,90150,425
7207621,3.87882,3.84806,425,4294967295,0.0195209,0.06,1,90579,90154,425
7209281,3.97576,3.16961,426,4294967295,0.0279042,0.07,1,90583,90157,426
7212201,6.39515,7.03392,425,4294967295,0.0295808,0.09,1,90590,90165,425
7215121,4.47903,4.60678,425,4294967295,0.00591617,0.02,1,90594,90169,425
7216981,3.29581,4.12136,424,4294967295,0.0411832,0.05,1,90597,90173,424
7219901,3.85916,4.02427,424,4294967295,0.0642366,0.06,1,90601,90177,424
7222821,3.97183,4.00485,424,4294967295,0.0528473,0.03,1,90605,90181,424
7225741,4.79437,4.00097,425,4294967295,0.0105695,0.03,1,90610,90185,425
7228661,3.35887,4.00019,424,4294967295,0.0261139,0.03,1,90613,90189,424
7230501,7.87177,4.00004,429,4294967295,0.00522278,0.05,1,90622,90193,429
7233421,4.77435,7.20001,425,4294967295,0.00904456,0.03,1,90626,90201,425
7235701,8.15487,4.64,430,4294967295,0.00980891,0.04,1,90635,90205,430
7238621,5.63097,8.928,425,4294967295,0.0259618,0.04,1,90640,90215,425
7241541,3.52619,4.9856,424,4294967295,0.0211924,0.05,1,90643,90219,424
7244461,3.90524,4.19712,424,4294967295,0.00423847,0.05,1,90647,90223,424
7247381,5.58105,4.03942,426,4294967295,0.0248477,0.05,1,90653,90227,426
7250301,5.11621,4.00788,427,4294967295,0.0129695,0.05,1,90658,90231,427
7253221,4.22324,4.00158,427,4294967295,0.0345939,0.09,1,90662,90235,427
7255041,4.04465,4.00032,427,4294967295,0.0149188,0.1,1,90666,90239,427
7257961,14.4089,16.0001,425,4294967295,0.0429838,0.11,1,90683,90258,425
7260881,6.88179,6.40001,426,4294967295,0.0645967,0.08,1,90688,90262,426
7263801,5.37636,4.48,427,4294967295,0.0769193,0.06,1,90693,90266,427
7266721,4.27527,4.096,427,4294967295,0.0553839,0.08,1,90697,90270,427
7269641,4.85505,4.0192,428,4294967295,0.0830768,0.11,1,90702,90274,428
7272561,4.17101,4.00384,428,4294967295,0.0966154,0.1,1,90706,90278,428
7275481,2.4342,4.00077,426,4294967295,0.107323,0.14,1,90708,90282,426
7278341,2.08684,4.00015,424,4294967295,0.0934646,0.09,1,90710,90286,424
7281261,3.61737,4.80003,423,4294967295,0.0906929,0.07,1,90714,90291,423
7283541,4.72347,4.16001,424,4294967295,0.0421386,0.01,1,90719,90295,424
7286461,4.14469,4.832,423,4294967295,0.0164277,0.01,1,90723,90300,423
7289381,4.02894,4.1664,423,4294967295,0.0192855,0.01,1,90727,90304,423
7292301,4.80579,4.03328,424,4294967295,0.0118571,0.03,1,90732,90308,424
7295221,4.96116,4.00666,425,4294967295,0.0103714,0.01,1,90737,90312,425
7298141,7.39223,4.00133,429,4294967295,0.00207428,0.05,1,90745,90316,429
7300181,4.67845,4.00027,429,4294967295,0.0404149,0.07,1,90749,90320,429
7301841,2.53569,3.20005,428,4294967295,0.056083,0.09,1,90751,90323,428
7304761,7.70714,11.04,424,4294967295,0.0752166,0.09,1,90760,90336,424
7307041,3.94143,5.408,423,4294967295,0.0790433,0.08,1,90763,90340,423
7309961,4.78829,3.4816,425,4294967295,0.0798087,0.04,1,90768,90343,425
7311621,14.5577,3.89632,438,4294967295,0.0399617,0.04,1,90785,90347,438
7314321,6.91153,13.5793,427,4294967295,0.0399923,0.01,1,90790,90363,427
7317241,145.382,149.916,423,4294967295,0.0399985,0,1,90970,90547,423
7320161,32.2765,33.1832,423,4294967295,0.0479997,0.01,1,90974,90551,423
7322641,10.4553,9.83663,424,4294967295,0.0175999,0.03,1,90979,90555,424
7324721,5.29106,4.36733,425,4294967295,0.01952,0,1,90983,90558,425
7326801,6.65821,5.67347,426,4294967295,0.051904,0.06,1,90990,90564,426
7329721,6.93164,8.33469,424,4294967295,0.0903808,0.04,1,90997,90573,424
7332641,4.58633,4.86694,424,4294967295,0.0820762,0,1,91001,90577,424
7334501,7.31727,4.17339,428,4294967295,0.0964152,0.04,1,91009,90581,428
7337421,5.46345,6.43468,426,4294967295,0.051283,0.01,1,91014,90588,426
7340341,3.49269,4.48694,425,4294967295,0.0262566,0.07,1,91017,90592,425
7343261,2.29854,4.09739,423,4294967295,0.0292513,0.09,1,91019,90596,423
7346181,4.45971,4.01948,424,4294967295,0.00585026,0.08,1,91024,90600,424
7349101,4.09194,4.0039,424,4294967295,0.0171701,0.03,1,91028,90604,424
7350721,2.41839,4.00078,422,4294967295,0.027434,0.03,1,91030,90608,422
7353641,5.28368,4.80016,423,4294967295,0.0294868,0.03,1,91036,90613,423
7355921,4.25674,4.16003,423,4294967295,0.0138974,0,1,91040,90617,423
7358841,4.85135,4.83201,423,4294967295,0.0267795,0.01,1,91045,90622,423
7361761,4.17027,4.1664,423,4294967295,0.0293559,0,1,91049,90626,423
7364241,4.83405,4.03328,424,4294967295,0.0138712,0.05,1,91054,90630,424
7366321,8.96681,8.00666,425,4294967295,0.0267742,0.03,1,91064,90639,425
7369241,8.99336,9.60133,424,4294967295,0.00535485,0.06,1,91073,90649,424
7372161,4.19867,5.12027,423,4294967295,0.025071,0.01,1,91076,90653,423
7375081,4.03973,4.22405,423,4294967295,0.0530142,0.05,1,91080,90657,423
7377761,4.80795,4.04481,424,4294967295,0.0106028,0.03,1,91085,90661,424
7380681,6.56159,5.60896,425,4294967295,0.0341206,0.03,1,91092,90667,425
7383601,5.31232,4.32179,426,4294967295,0.00682411,0.04,1,91097,90671,426
7386081,5.06246,4.06436,427,4294967295,0.0253648,0.11,1,91102,90675,427
7389001,18.6125,16.8129,429,4294967295,0.069073,0.1,1,91124,90695,429
7391921,6.1225,6.56257,428,4294967295,0.0778146,0.09,1,91127,90699,428
7394841,2.8245,4.51251,426,4294967295,0.0715629,0.12,1,91129,90703,426
7397761,2.1649,4.1025,424,4294967295,0.0623126,0.12,1,91131,90707,424
7400681,3.63298,4.0205,424,4294967295,0.0604625,0.09,1,91135,90711,424
7403601,3.9266,4.0041,424,4294967295,0.0760925,0.05,1,91139,90715,424
7406521,3.18532,4.00082,423,4294967295,0.0632185,0.05,1,91142,90719,423
7408961,3.83706,4.00016,423,4294967295,0.0366437,0.02,1,91146,90723,423
7411881,3.96741,4.00003,423,4294967295,0.0633287,0.01,1,91150,90727,423
7414801,3.99348,4.00001,423,4294967295,0.0446657,0,1,91154,90731,423
7417281,3.9987,4,423,4294967295,0.0329331,0.01,1,91158,90735,423
7420201,4.79974,3.2,425,4294967295,0.0145866,0.01,1,91163,90738,425
7423121,4.95995,3.84,426,4294967295,0.0349173,0.03,1,91168,90742,426
7426041,4.19199,3.968,426,4294967295,0.00698347,0.07,1,91172,90746,426
7428721,4.8384,3.9936,427,4294967295,0.00939669,0.08,1,91177,90750,427
7431641,6.56768,6.39872,427,4294967295,0.0338793,0.11,1,91184,90757,427
7434341,9.31354,4.47974,433,4294967295,0.0627759,0.1,1,91194,90761,433
7437261,5.86271,11.2959,425,4294967295,0.108555,0.05,1,91199,90774,425
7440161,4.37254,5.45919,425,4294967295,0.125711,0.06,1,91203,90778,425
7442241,10.4745,9.09184,427,4294967295,0.137142,0.13,1,91215,90788,427
7445161,14.0949,13.0184,428,4294967295,0.0834284,0.1,1,91230,90802,428
7446821,137.219,5.80367,592,4294967295,0.0806857,0.03,1,91398,90806,592
7449741,32.2438,139.561,425,4294967295,0.0721371,0.04,1,91404,90979,425
7452021,9.64876,31.1121,425,4294967295,0.0624274,0,1,91408,90983,425
7454941,5.92975,8.62243,427,4294967295,0.0604855,0.07,1,91413,90986,427
7457841,4.38595,4.92449,427,4294967295,0.0360971,0.1,1,91417,90990,427
7459921,6.47719,7.3849,426,4294967295,0.00721942,0.11,1,91424,90998,426
7462841,7.69544,9.47698,424,4294967295,0.0254439,0.07,1,91432,91008,424
7464501,7.13909,5.0954,427,4294967295,0.0210888,0.03,1,91439,91012,427
7467421,3.82782,6.61908,423,4294967295,0.0282178,0,1,91442,91019,423
7470341,4.76556,4.52382,424,4294967295,0.0136436,0.05,1,91447,91023,424
7473261,3.35311,4.10476,423,4294967295,0.00272871,0.04,1,91450,91027,423
7476181,4.67062,4.02095,424,4294967295,0.0485457,0.06,1,91455,91031,424
7479101,4.13412,4.00419,424,4294967295,0.0257091,0.04,1,91459,91035,424
7481761,4.02682,4.00084,424,4294967295,0.0131418,0.03,1,91463,91039,424
7484681,4.80536,5.60017,423,4294967295,0.0266284,0.05,1,91468,91045,423
7487601,4.16107,4.32003,423,4294967295,0.0373257,0.02,1,91472,91049,423
7490521,4.03221,4.06401,423,4294967295,0.0154651,0.01,1,91476,91053,423
7492161,3.20644,4.0128,422,4294967295,0.00309303,0.03,1,91479,91057,422
7495081,8.64129,6.40256,425,4294967295,0.00861861,0.03,1,91489,91064,425
7497361,4.92826,4.48051,425,4294967295,0.00972372,0.09,1,91493,91068,425
7500281,8.98565,9.6961,424,4294967295,0.0499447,0.02,1,91503,91079,424
7502561,4.99713,5.13922,424,4294967295,0.041989,0.04,1,91507,91083,424
7505481,5.79943,5.82784,424,4294967295,0.0883978,0.06,1,91513,91089,424
7508401,4.35989,4.36557,424,4294967295,0.0976796,0,1,91517,91093,424
7511321,4.87198,4.07311,425,4294967295,0.0755359,0.05,1,91522,91097,425
7514001,4.1744,4.01462,425,4294967295,0.0711072,0.03,1,91526,91101,425
7516921,6.43488,6.40292,425,4294967295,0.0222214,0.07,1,91533,91108,425
7518581,21.287,4.48058,446,4294967295,0.0124443,0.1,1,91558,91112,446
7521501,8.25739,20.0961,427,4294967295,0.00248886,0.1,1,91563,91136,427
7524421,4.05148,7.21922,426,4294967295,0.0644978,0.08,1,91566,91140,426
7527341,2.4103,4.64384,424,4294967295,0.0928996,0.1,1,91568,91144,424
7530261,2.88206,4.12877,423,4294967295,0.10658,0.07,1,91571,91148,423
7533181,3.77641,4.02575,423,4294967295,0.101316,0.05,1,91575,91152,423
7536101,4.75528,4.00515,424,4294967295,0.116263,0.03,1,91580,91156,424
7539021,3.35106,4.00103,423,4294967295,0.119253,0.01,1,91583,91160,423
7541941,3.87021,4.00021,423,4294967295,0.119851,0.06,1,91587,91164,423
7544861,3.97404,4.00004,423,4294967295,0.11997,0.02,1,91591,91168,423
7547781,5.59481,4.00001,425,4294967295,0.103994,0.01,1,91597,91172,425
7550701,5.11896,4,426,4294967295,0.0767988,0.01,1,91602,91176,426
7553621,5.02379,4,427,4294967295,0.0553598,0.08,1,91607,91180,427
7556541,4.20476,4,427,4294967295,0.035072,0.09,1,91611,91184,427
7559461,4.84095,4,428,4294967295,0.00701439,0.11,1,91616,91188,428
7561221,5.76819,4,430,4294967295,0.0334029,0.13,1,91622,91192,430
7564141,5.15364,5.6,429,4294967295,0.0626806,0.14,1,91627,91198,429
7566421,3.43073,4.32,428,4294967295,0.108536,0.09,1,91630,91202,428
7569341,4.68615,3.264,430,4294967295,0.117707,0.1,1,91635,91205,430
7571201,3.33723,3.8528,429,4294967295,0.119541,0.18,1,91638,91209,429
7573281,11.0674,12.7706,427,4294967295,0.159908,0.15,1,91651,91224,427
7575361,14.2135,12.9541,429,4294967295,0.175982,0.06,1,91666,91237,429
7578281,135.643,139.391,424,4294967295,0.315196,0.08,1,91832,91408,424
7580561,30.3285,31.0782,424,4294967295,0.303039,0.02,1,91836,91412,424
7583481,10.0657,8.61563,426,4294967295,0.308608,0.02,1,91841,91415,426
7585761,4.41314,4.92313,425,4294967295,0.301722,0,1,91844,91419,425
7588681,4.08263,4.98463,424,4294967295,0.300344,0.07,1,91848,91424,424
7590341,4.81653,4.19693,425,4294967295,0.332069,0.02,1,91853,91428,425
7592421,10.5633,4.83938,432,4294967295,0.338414,0.03,1,91865,91433,432
7595121,6.11266,9.76788,426,4294967295,0.323683,0.06,1,91870,91444,426
7598041,8.42253,10.7536,424,4294967295,0.304737,0.06,1,91879,91455,424
7600961,5.68451,5.35072,425,4294967295,0.308947,0.04,1,91884,91459,425
7603441,3.5369,4.27014,424,4294967295,0.325789,0.03,1,91887,91463,424
7606361,5.50738,6.45403,423,4294967295,0.313158,0.04,1,91893,91470,423
7609281,4.30148,4.49081,423,4294967295,0.294632,0.01,1,91897,91474,423
7612201,4.0603,4.09816,423,4294967295,0.274926,0.04,1,91901,91478,423
7615121,4.01206,4.01963,423,4294967295,0.262985,0.03,1,91905,91482,423
7618041,4.80241,4.00393,424,4294967295,0.300597,0.01,1,91910,91486,424
7620961,4.96048,4.00079,425,4294967295,0.268119,0.01,1,91915,91490,425
7623881,4.1921,4.00016,425,4294967295,0.253624,0.05,1,91919,91494,425
7626801,6.43842,4.00003,428,4294967295,0.258725,0.07,1,91926,91498,428
7628401,2.88768,4.00001,426,4294967295,0.251745,0.12,1,91928,91502,426
7631321,7.77754,7.2,427,4294967295,0.242349,0.12,1,91937,91510,427
7633601,3.95551,4.64,426,4294967295,0.20047,0.07,1,91940,91514,426
7636521,6.3911,8.928,423,4294967295,0.136094,0.06,1,91947,91524,423
7639441,5.27822,4.9856,424,4294967295,0.179219,0.03,1,91952,91528,424
7642361,3.45564,4.19712,423,4294967295,0.179844,0.03,1,91955,91532,423
7645281,4.69113,4.03942,424,4294967295,0.187969,0.05,1,91960,91536,424
7647121,4.13823,4.00788,424,4294967295,0.181594,0.1,1,91964,91540,424
7650041,27.2276,23.2016,429,4294967295,0.196319,0.15,1,91997,91568,429
7652961,7.84553,7.84032,428,4294967295,0.191264,0.12,1,92000,91572,428
7655881,6.36911,4.76806,430,4294967295,0.246253,0.16,1,92006,91576,430
7658801,3.67382,4.15361,429,4294967295,0.265251,0.15,1,92009,91580,429
7661721,2.33476,4.03072,427,4294967295,0.23705,0.16,1,92011,91584,427
7664641,3.66695,4.00614,427,4294967295,0.23141,0.15,1,92015,91588,427
7667561,3.13339,4.00123,426,4294967295,0.254282,0.13,1,92018,91592,426
7670481,3.02668,4.00025,425,4294967295,0.266856,0.12,1,92021,91596,425
7673401,2.20534,4.00005,423,4294967295,0.261371,0.09,1,92023,91600,423
7675201,2.84107,4.00001,422,4294967295,0.220274,0.03,1,92026,91604,422
7678121,8.56821,6.4,425,4294967295,0.212055,0.01,1,92036,91611,425
7681041,6.51364,4.48,427,4294967295,0.186411,0.01,1,92042,91615,427
7683961,6.10273,4.096,429,4294967295,0.173282,0.07,1,92048,91619,429
7686881,4.42055,4.0192,429,4294967295,0.178656,0.11,1,92052,91623,429
7689801,4.08411,4.00384,429,4294967295,0.195731,0.13,1,92056,91627,429
7692721,4.01682,4.00077,429,4294967295,0.239146,0.14,1,92060,91631,429
7695641,4.80336,4.00015,430,4294967295,0.247829,0.14,1,92065,91635,430
7698561,4.96067,4.00003,431,4294967295,0.233566,0.16,1,92070,91639,431
7701481,4.99213,4.00001,432,4294967295,0.222713,0.18,1,92075,91643,432
7703701,12.1984,4,442,4294967295,0.284543,0.24,1,92089,91647,442
7705781,14.4397,10.4,445,4294967295,0.344909,0.25,1,92104,91659,445
7707861,141.288,11.68,606,4294967295,0.572982,0.31,1,92277,91671,606
7710781,33.0576,139.136,441,4294967295,0.626596,0.32,1,92283,91842,441
7713701,9.01152,31.0272,440,4294967295,0.645319,0.34,1,92286,91846,440
7716621,5.8023,9.40544,441,4294967295,0.641064,0.37,1,92291,91850,441
7718881,3.56046,5.08109,440,4294967295,0.616213,0.36,1,92294,91854,440
7720961,7.11209,6.61622,441,4294967295,0.643243,0.35,1,92302,91861,441
7723881,9.42242,10.1232,440,4294967295,0.720649,0.34,1,92312,91872,440
7726161,5.88448,5.22465,441,4294967295,0.72813,0.32,1,92317,91876,441
7728241,5.1769,5.04493,441,4294967295,0.761626,0.31,2,92322,91881,441
7731161,6.63538,10.609,436,4294967295,0.760325,0.29,2,92329,91893,436
7734081,5.32708,5.3218,437,4294967295,0.760065,0.29,2,92334,91897,437
7737001,3.46542,4.26436,436,4294967295,0.800013,0.28,2,92337,91901,436
7739921,3.89308,4.05287,436,4294967295,0.792003,0.32,2,92341,91905,436
7742841,3.17862,4.01057,435,4294967295,0.7824,0.3,2,92344,91909,435
7745761,3.83572,4.00211,435,4294967295,0.75648,0.29,2,92348,91913,435
7747381,3.16714,4.00042,434,4294967295,0.759296,0.28,2,92351,91917,434
7750301,4.63343,4.00008,435,4294967295,0.743859,0.27,1,92356,91921,435
7753221,3.32669,4.00002,434,4294967295,0.740772,0.28,1,92359,91925,434
7755701,5.46534,4,436,4294967295,0.780154,0.23,2,92365,91929,436
7758621,5.89307,8.8,432,4294967295,0.788031,0.17,2,92371,91939,432
7760901,5.97861,4.96,434,4294967295,0.829606,0.2,2,92377,91943,434
7763821,4.39572,5.792,432,4294967295,0.845921,0.21,2,92381,91949,432
7766101,4.87914,4.3584,433,4294967295,0.833184,0.18,2,92386,91953,433
7769021,3.37583,3.27168,433,4294967295,0.854637,0.19,2,92389,91956,433
7771301,4.67517,3.85434,434,4294967295,0.850927,0.23,2,92394,91960,434
7774221,4.93503,5.57087,433,4294967295,0.834185,0.23,2,92399,91966,433
7776081,4.18701,4.31417,433,4294967295,0.822837,0.19,2,92403,91970,433
7778161,6.4374,5.66283,434,4294967295,0.828567,0.21,2,92410,91976,434
7781081,23.6875,22.7326,435,4294967295,0.853714,0.27,2,92438,92003,435
7783361,8.7375,7.74651,436,4294967295,0.882743,0.3,2,92443,92007,436
7786281,8.1475,9.5493,434,4294967295,0.840549,0.29,2,92451,92017,434
7789201,4.8295,5.10986,434,4294967295,0.82411,0.24,2,92455,92021,434
7792121,3.3659,4.22197,433,4294967295,0.812822,0.22,2,92458,92025,433
7795041,3.07318,4.04439,432,4294967295,0.818564,0.23,2,92461,92029,432
7797961,3.01464,4.00888,431,4294967295,0.819713,0.21,2,92464,92033,431
7800881,4.60293,4.00178,432,4294967295,0.779943,0.2,2,92469,92037,432
7803801,4.92059,4.00036,433,4294967295,0.795989,0.19,2,92474,92041,433
7806721,4.98412,4.00007,434,4294967295,0.799198,0.2,2,92479,92045,434
7809641,5.79682,4.00001,436,4294967295,0.78384,0.22,2,92485,92049,436
7812561,4.35936,4,436,4294967295,0.812768,0.24,2,92489,92053,436
7815481,3.27187,4,435,4294967295,0.834554,0.28,2,92492,92057,435
7818401,3.85437,4,435,4294967295,0.814911,0.27,2,92496,92061,435
7821321,3.17087,4,434,4294967295,0.810982,0.27,2,92499,92065,434
7822881,3.03418,4,433,4294967295,0.850196,0.24,2,92502,92069,433
7825801,7.00684,4.8,436,4294967295,0.874039,0.25,2,92510,92074,436
7828721,6.20137,4.16,438,4294967295,0.894808,0.27,2,92516,92078,438
7830581,6.04027,4.032,440,4294967295,0.866962,0.32,2,92522,92082,440
7833501,6.00805,5.6064,440,4294967295,0.845392,0.32,2,92528,92088,440
7835781,19.6016,4.32128,459,4294967295,0.889078,0.36,2,92551,92092,459
7837861,156.72,19.2643,627,4294967295,0.905816,0.65,2,92742,92115,627
7840781,36.1441,143.853,458,4294967295,0.893163,0.63,2,92748,92290,458
7843701,12.8288,31.9706,461,4294967295,0.882633,0.64,2,92755,92294,461
7846621,4.96576,9.59411,460,4294967295,0.904527,0.69,2,92758,92298,460
7849541,3.39315,5.11882,459,4294967295,0.892905,0.75,2,92761,92302,459
7851381,3.87863,4.22376,459,4294967295,0.906581,0.77,2,92765,92306,459
7853461,7.97573,4.04475,464,4294967295,0.909316,0.75,2,92774,92310,464
7855541,7.19515,6.40895,464,4294967295,0.941863,0.79,2,92781,92317,464
7858461,6.23903,6.88179,463,4294967295,0.940373,0.78,2,92787,92324,463
7860741,7.64781,4.57636,467,4294967295,0.924074,0.82,2,92795,92328,467
7863661,6.32956,8.91527,463,4294967295,0.928815,0.8,2,92801,92338,463
7865941,6.06591,4.98305,465,4294967295,0.953763,0.79,2,92807,92342,465
7868861,5.21318,5.79661,464,4294967295,0.926753,0.79,2,92812,92348,464
7871781,5.04264,4.35932,465,4294967295,0.905351,0.76,2,92817,92352,465
7874701,3.40853,4.07186,464,4294967295,0.94907,0.79,2,92820,92356,464
7885701,5,4,468,4294967295,0.92,0.85,2,92840,92372,468
7888621,5.8,4.8,469,4294967295,0.936,0.85,2,92846,92377,469
7890901,5.16,4.16,470,4294967295,0.9312,0.87,2,92851,92381,470
7893821,4.232,6.432,467,4294967295,0.91424,0.89,2,92855,92388,467
7896741,4.0464,4.4864,467,4294967295,0.902848,0.85,2,92859,92392,467
7899661,4.00928,4.09728,467,4294967295,0.88457,0.85,2,92863,92396,467
7902581,3.20186,4.01946,466,4294967295,0.880914,0.86,2,92866,92400,466
7905041,4.64037,4.00389,467,4294967295,0.936183,0.83,2,92871,92404,467
7907121,6.52807,5.60078,468,4294967295,0.947237,0.86,2,92878,92410,468
7909201,7.70561,6.72016,469,4294967295,0.957447,0.89,2,92886,92417,469
7912121,24.7411,26.944,466,4294967295,0.911489,0.87,2,92915,92449,466
7914401,8.14822,8.58881,466,4294967295,0.918298,0.81,2,92919,92453,466
7917321,5.62964,6.51776,465,4294967295,0.89566,0.85,2,92924,92459,465
7920241,3.52593,4.50355,464,4294967295,0.891132,0.84,2,92927,92463,464
7923161,3.90519,4.10071,464,4294967295,0.906226,0.82,2,92931,92467,464
7926081,3.98104,4.02014,464,4294967295,0.877245,0.81,2,92935,92471,464
7929001,4.79621,4.00403,465,4294967295,0.879449,0.82,2,92940,92475,465
7931921,4.95924,4.00081,466,4294967295,0.83989,0.82,2,92945,92479,466
7934841,3.39185,4.00016,465,4294967295,0.831978,0.83,2,92948,92483,465
7937761,3.87837,4.00003,465,4294967295,0.830396,0.87,2,92952,92487,465
7940681,5.57567,4.00001,467,4294967295,0.870079,0.84,2,92958,92491,467
7943601,3.51513,4,466,4294967295,0.870016,0.83,2,92961,92495,466
7946521,3.90303,4,466,4294967295,0.902003,0.89,2,92965,92499,466
7949441,4.78061,4,467,4294967295,0.932401,0.89,2,92970,92503,467
7952361,4.15612,4,467,4294967295,0.94648,0.9,2,92974,92507,467
7955281,4.03122,4,467,4294967295,0.957296,0.92,2,92978,92511,467
7957461,7.20624,4,471,4294967295,0.927459,0.89,2,92986,92515,471
7960381,5.44125,8.8,466,4294967295,0.929492,0.85,2,92991,92525,466
7962661,9.88825,4.96,473,4294967295,0.937898,0.86,2,93002,92529,473
8157781,9,4,488,4294967295,0.96,1,2,93833,93345,488
8604841,4,4,532,32120,0.78,1,2,95980,95448,532
8607761,2.4,4,530,35040,0.78,1,2,95982,95452,530
8610681,2.08,4,528,37960,0.756,1,2,95984,95456,528
8613281,2.016,4,526,40880,0.7512,1,2,95986,95460,526
8616201,3.6032,35.2,487,43480,0.72624,1,1,95990,95503,487
8619121,3.12064,10.24,486,46400,0.721248,1,1,95993,95507,486
8622041,3.02413,5.248,485,49320,0.68025,1,1,95996,95511,485
8624961,3.80483,4.2496,485,52240,0.64805,1,1,96000,95515,485
8627881,3.96097,4.04992,485,55160,0.62561,0.97,1,96004,95519,485
8630801,3.99219,4.00998,485,58080,0.581122,0.9,1,96008,95523,485
8633721,4.79844,4.002,486,61000,0.540224,0.91,1,96013,95527,486
8636641,4.15969,4.0004,486,63920,0.500045,0.93,1,96017,95531,486
8639561,8.03194,4.00008,491,66840,0.388009,0.98,1,96026,95535,491
8642481,8.80639,4.00002,496,69760,0.333602,1,1,96035,95539,496
8645401,10.5613,4,503,72680,0.23472,1,1,96046,95543,503
8648321,8.51226,4,507,75600,0.198944,1,1,96054,95547,507
8651241,9.70245,4,513,78520,0.127789,1,1,96064,95551,513
8654161,10.7405,4,520,81440,0.0815578,1,1,96075,95555,520
8657081,10.1481,4,526,84360,0.0403116,1,1,96085,95559,526
8660001,7.62962,4,529,87280,0.00806231,1,1,96092,95563,529
8662921,4.72592,4,529,90200,0.0176125,1,1,96096,95567,529
8665841,4.14518,4,529,93120,0.00352249,1,1,96100,95571,529
8668761,108.029,4,659,96040,0.312705,1,1,96234,95575,659
8671681,30.4058,175.2,452,98960,0.462541,1,1,96245,95793,452
8674601,14.0812,38.24,458,101880,0.508508,1,1,96255,95797,458
8677521,10.8162,10.848,464,104800,0.637702,1,1,96265,95801,464
8680441,10.1632,5.3696,470,107720,0.73554,1,1,96275,95805,470
8683361,10.0326,4.27392,476,110640,0.739108,1,1,96285,95809,476
8686281,10.0065,4.05478,482,113560,0.707822,1,1,96295,95813,482
8689201,17.2013,4.01096,497,116480,0.725564,1,1,96314,95817,497
8692121,20.2403,4.00219,514,119400,0.841113,1,2,96335,95821,514
8695041,12.8481,4.00044,521,122320,0.840223,1,2,96346,95825,521
8697961,11.3696,4.00009,528,125240,0.880045,1,2,96357,95829,528
8700881,84.6739,4.00002,627,128160,0.800009,0.44,2,96460,95833,627
8703801,20.1348,151.2,443,131080,0.720002,0.34,1,96464,96021,443
8706721,6.42696,37.44,437,134000,0.696,0.32,1,96467,96030,437
8709641,6.08539,13.888,435,136920,0.6352,0.23,1,96473,96038,435
8712561,5.21708,9.1776,432,139840,0.59104,0.21,1,96478,96046,432
8715481,4.24342,8.23552,428,142760,0.550208,0.15,1,96482,96054,428
8718401,6.44868,8.0471,427,145680,0.550042,0.09,1,96489,96062,427
8721321,6.88974,8.00942,426,148600,0.534008,0.07,1,96496,96070,426
8724241,6.97795,8.00188,425,151520,0.482802,0.04,1,96503,96078,425
8727161,7.79559,8.00038,425,154440,0.42456,0.03,1,96511,96086,425
8730081,8.75912,8.00008,426,157360,0.348912,0,1,96520,96094,426
8733001,7.35182,8.00002,425,160280,0.269782,0.04,1,96527,96102,425
8735921,7.87036,8,425,163200,0.189956,0.03,1,96535,96110,425
8738841,8.77407,8,426,166120,0.125991,0.01,1,96544,96118,426
8741761,11.3548,8,430,169040,0.0491983,0.05,1,96556,96126,430
8744681,13.471,8,436,171960,0.0338397,0.16,1,96570,96134,436
8747601,9.89419,8,437,174880,0.0787679,0.24,1,96579,96142,437
8750521,10.7788,8,440,177800,0.0557536,0.28,1,96590,96150,440
8753441,10.1558,8,442,180720,0.0671507,0.34,1,96600,96158,442
8756361,8.43115,8,442,183640,0.0534301,0.38,1,96608,96166,442
8759281,11.2862,8,446,186560,0.034686,0.38,1,96620,96174,446
8762201,50.2572,8,498,189480,0.0309372,0.43,1,96680,96182,498
8765121,18.0514,46.4,452,192400,0.0141874,0.51,1,96690,96238,452
8768041,12.4103,15.68,455,195320,0.0108375,0.54,1,96701,96246,455
8770961,14.4821,9.536,462,198240,0.146168,0.63,1,96716,96254,462
8773881,10.8964,8.3072,464,201160,0.261234,0.75,1,96726,96262,464
8776801,7.77928,8.06144,463,204080,0.308247,0.75,1,96733,96270,463
8779721,6.35586,8.01229,461,207000,0.357649,0.77,1,96739,96278,461
8782641,6.87117,8.00246,460,209920,0.42353,0.74,1,96746,96286,460
8785561,7.77423,8.00049,460,212840,0.492706,0.71,1,96754,96294,460
8788481,11.1548,8.0001,464,215760,0.570541,0.75,1,96766,96302,464
8791401,11.031,8.00002,467,218680,0.562108,0.84,1,96777,96310,467
8794321,9.40619,8,468,221600,0.496422,0.86,1,96786,96318,468
8797241,9.08124,8,469,224520,0.419284,0.89,1,96795,96326,469
8800161,5.81625,8,466,227440,0.363857,0.87,1,96800,96334,466
8803081,9.96325,8,469,230360,0.256771,0.84,1,96811,96342,469
8806001,10.7927,8,472,233280,0.347354,0.92,1,96822,96350,472
8808921,10.9585,8,475,236200,0.477471,0.97,1,96833,96358,475
8811841,10.9917,8,478,239120,0.423494,0.99,1,96844,96366,478
8814761,10.9983,8,481,242040,0.340699,1,1,96855,96374,481
8817681,10.1997,8,483,244960,0.26814,1,1,96865,96382,483
8820601,9.23993,8,484,247880,0.213628,1,1,96874,96390,484
8823521,9.04799,8,485,250800,0.250726,1,1,96883,96398,485
8826441,32.2096,8,515,253720,0.514145,0.72,1,96921,96406,515
8828561,8.84192,48,460,256640,0.566829,0.62,1,96924,96464,460
8831481,5.76838,16.8,456,258760,0.617366,0.57,1,96929,96473,456
8834401,4.35368,9.76,452,261680,0.643473,0.55,1,96933,96481,452
8837321,4.87074,8.352,449,264600,0.664695,0.52,1,96938,96489,449
8840241,4.17415,8.0704,445,267520,0.692939,0.46,1,96942,96497,445
8843161,4.03483,8.01408,441,270411,0.722588,0.39,1,96946,96505,441
8846081,4.00697,8.00282,437,270411,0.760518,0.31,2,96950,96513,437
8849001,4.00139,8.00056,433,270411,0.808104,0.23,2,96954,96521,433
8851921,4.80028,8.00011,430,270411,0.873621,0.15,2,96959,96529,430
8854841,4.96006,8.00002,427,270411,0.918724,0.09,2,96964,96537,427
8866521,9,8,429,270411,0.75,0.07,2,96998,96569,429
8869441,7.4,8,428,270411,0.686,0.09,1,97005,96577,428
8872361,7.88,8,428,270411,0.6172,0.07,1,97013,96585,428
8875281,7.176,8,427,270411,0.54744,0.08,1,97020,96593,427
8878201,7.8352,8,427,270411,0.485488,0.06,1,97028,96601,427
8881121,7.16704,8,426,270411,0.425098,0.06,1,97035,96609,426
8884041,7.83341,8,426,270411,0.349019,0.01,1,97043,96617,426
8886961,9.56668,8,428,270411,0.237804,0.03,1,97053,96625,428
8889881,9.91334,8,430,270411,0.167561,0.08,1,97063,96633,430
8891381,37.9827,8,467,270411,0.0335122,0.01,1,97108,96641,467
8893041,13.1965,40.8,425,270411,0.0147024,0.01,1,97115,96690,425
8895961,17.8393,16.96,433,270411,0.0109405,0.09,1,97134,96701,433
8898241,14.7679,9.792,439,270411,0.0341881,0.31,1,97148,96709,439
8901161,19.7536,14.7584,444,270411,0.0308376,0.34,1,97169,96725,444
8904081,12.7507,9.35168,447,270411,0.0141675,0.42,1,97180,96733,447
8907001,12.1501,8.27034,451,270411,0.0588335,0.49,1,97192,96741,451
8909921,12.03,8.05407,455,270411,0.0997667,0.55,1,97204,96749,455
8912841,8.00601,8.01081,454,270411,0.0919533,0.61,1,97211,96757,454
8915761,6.4012,8.00216,452,270411,0.114391,0.6,1,97217,96765,452
8918681,5.28024,8.00043,449,270411,0.118878,0.53,1,97222,96773,449
8921601,4.25605,8.00009,445,270411,0.119776,0.49,1,97226,96781,445
8923621,1.65121,8.00002,438,270411,0.127955,0.43,1,97227,96789,438
8926541,2.73024,5.6,436,270411,0.121591,0.32,1,97230,96794,436
8929461,10.946,7.52,441,270411,0.0243182,0.25,1,97243,96802,441
8931941,16.5892,7.904,451,270411,0.0128636,0.38,1,97261,96810,451
8933601,9.71784,10.3808,448,270411,0.00257273,0.51,1,97269,96821,448
8936521,7.54357,10.0762,445,270411,0.00851455,0.46,1,97276,96831,445
8939441,4.70871,8.41523,441,270411,0.00170291,0.39,1,97280,96839,441
8941301,5.74174,8.08305,439,270411,0.0243406,0.33,1,97286,96847,439
8943381,5.14835,9.61661,434,270411,0.0448681,0.27,1,97291,96857,434
8945041,7.42967,6.72332,436,270451,0.00897362,0.23,1,97299,96863,436
8947961,13.4859,9.34466,441,270451,0.00979472,0.26,1,97314,96873,441
8950881,13.0972,8.26893,446,270451,0.0819589,0.37,1,97327,96881,446
8952741,13.0194,8.05379,451,270451,0.0563918,0.48,1,97340,96889,451
8954401,10.6039,9.61076,451,270451,0.0672784,0.67,1,97350,96899,451
8957321,35.7208,27.5222,461,270451,0.109456,0.71,1,97392,96931,461
8960241,16.7442,11.9044,465,270451,0.133891,0.77,1,97404,96939,465
8963161,13.7488,8.78089,470,270451,0.154778,0.85,1,97417,96947,470
8966081,12.3498,8.15618,474,270451,0.174956,0.95,1,97429,96955,474
8969001,6.46995,8.03124,471,270451,0.154991,1,1,97434,96963,471
8971921,4.49399,8.00625,467,270451,0.174998,0.93,1,97438,96971,467
8974841,4.8988,8.00125,464,270451,0.227,0.85,1,97443,96979,464
8977761,4.17976,8.00025,460,270451,0.2534,0.79,1,97447,96987,460
8980681,4.03595,8.00005,456,270451,0.21068,0.73,1,97451,96995,456
8983601,4.00719,8.00001,452,270451,0.162136,0.63,1,97455,97003,452
8986521,4.00144,8,448,270451,0.128427,0.56,1,97459,97011,448
8989441,4.80029,8,445,270451,0.0656854,0.49,1,97464,97019,445
8992361,4.16006,8,441,270451,0.0211371,0.41,1,97468,97027,441
8995281,4.03201,8,437,270451,0.0202274,0.33,1,97472,97035,437
8998201,4.0064,8,433,270451,0.00404548,0.26,1,97476,97043,433
9001121,4.80128,8,430,270451,0.000809097,0.17,1,97481,97051,430
9004041,4.16026,8,426,270451,0.000161819,0.11,1,97485,97059,426
9006961,6.43205,8,425,270451,3.23639e-05,0.03,1,97492,97067,425
9009881,7.68641,8,425,270451,6.47277e-06,0.01,1,97500,97075,425
9012801,7.93728,8,425,270451,1.29455e-06,0.01,1,97508,97083,425
9015721,7.98746,8,425,270451,2.58911e-07,0.01,1,97516,97091,425
9018641,7.99749,8,425,270451,5.17822e-08,0.01,1,97524,97099,425
9021381,9.5995,8,427,270451,0.00800001,0,1,97534,97107,427
9023461,7.5199,8.8,425,270451,0.0016,0.03,1,97541,97116,425
9025541,22.304,6.56,445,270451,0.02432,0.06,1,97567,97122,445
9027621,12.4608,23.712,427,270451,0.012864,0.04,1,97577,97150,427
9029281,8.09216,12.7424,424,270451,0.0585728,0.04,1,97584,97160,424
9031361,16.0184,13.7485,428,270451,0.179715,0.02,1,97602,97174,428
9034281,12.0037,9.1497,431,270451,0.227943,0.09,1,97613,97182,431
9035941,7.20074,8.22994,429,270451,0.269589,0.13,1,97619,97190,429
9037601,6.24015,7.24599,428,270451,0.317918,0.11,1,97625,97197,428
9040521,10.848,8.6492,431,270451,0.359584,0.13,1,97637,97206,431
9043441,9.36961,8.12984,432,270451,0.335917,0.14,1,97646,97214,432
9045301,5.07392,8.02597,428,270451,0.387183,0.13,1,97650,97222,428
9048221,5.81478,8.80519,425,270451,0.485437,0.03,1,97656,97231,425
9051141,7.56296,8.16104,425,270451,0.489087,0,1,97664,97239,425
9054061,7.91259,8.03221,425,270451,0.449817,0.01,1,97672,97247,425
9056981,7.98252,8.00644,425,270451,0.401964,0.01,1,97680,97255,425
9059901,7.9965,8.00129,425,270451,0.416393,0,1,97688,97263,425
9062821,8.7993,8.00026,426,270451,0.347279,0.01,1,97697,97271,426
9064641,7.35986,8.00005,425,270451,0.309456,0.03,1,97704,97279,425
9067561,7.07197,7.20001,425,270451,0.229891,0.02,1,97711,97286,425
9070481,7.81439,7.84,425,270451,0.189978,0.01,1,97719,97294,425
9073401,8.76288,7.968,426,270451,0.133996,0.01,1,97728,97302,426
9076081,10.5526,7.9936,429,270451,0.0427991,0.15,1,97739,97310,429
9079001,10.9105,12.7987,426,270451,0.0485598,0.03,1,97750,97324,426
9081281,10.9821,8.95974,429,270451,0.025712,0.09,1,97761,97332,429
9083361,15.7964,14.5919,430,270451,0.0611424,0.13,1,97778,97348,430
9085441,14.3593,14.9184,429,270451,0.0282285,0.16,1,97792,97363,429
9087521,30.0719,28.5837,431,270451,0.0296457,0.14,1,97826,97395,431
9090441,18.8144,16.9167,433,270451,0.0779291,0.17,1,97842,97409,433
9093361,10.1629,9.78335,433,270451,0.119586,0.18,1,97850,97417,433
9095221,10.8326,8.35667,436,270451,0.119917,0.18,1,97861,97425,436
9098141,10.1665,9.67133,436,270451,0.119983,0.24,1,97871,97435,436
9101061,3.6333,8.33427,430,270451,0.103997,0.2,1,97873,97443,430
9103981,3.92666,8.06685,426,270451,0.108799,0.12,1,97877,97451,426
9106901,6.38533,8.01337,425,270451,0.15776,0.03,1,97884,97459,425
9109821,7.67707,8.00267,425,270451,0.151552,0.01,1,97892,97467,425
9112741,7.93541,8.00053,425,270451,0.10231,0.01,1,97900,97475,425
9115661,7.98708,8.00011,425,270451,0.0284621,0.01,1,97908,97483,425
9118581,7.99742,8.00002,425,270451,0.0136924,0.01,1,97916,97491,425
9121501,7.99948,8,425,270451,0.0107385,0.01,1,97924,97499,425
9124421,7.9999,8,425,270451,0.0101477,0.01,1,97932,97507,425
9127341,7.99998,8,425,270451,0.0100295,0.01,1,97940,97515,425
9130261,8,8,425,270451,0.0100059,0.03,1,97948,97523,425
9133181,8,8,425,270451,0.0260012,0.01,1,97956,97531,425
9136101,8,8,425,270451,0.0292002,0.01,1,97964,97539,425
9139021,8.8,8,426,270451,0.02184,0.01,1,97973,97547,426
9141941,7.36,8,425,270451,0.028368,0.05,1,97980,97555,425
9144861,7.872,8,425,270451,0.0296736,0.03,1,97988,97563,425
9147781,11.1744,8,429,270451,0.0299347,0.05,1,98000,97571,429
9150701,10.2349,8,431,270451,0.0459869,0.12,1,98010,97579,431
9153621,11.647,8,435,270451,0.0731974,0.16,1,98022,97587,435
9156541,11.1294,8,438,270451,0.102639,0.22,1,98033,97595,438
9159461,9.42588,8,439,270451,0.148528,0.28,1,98042,97603,439
9162381,11.4852,8,443,270451,0.125706,0.31,1,98054,97611,443
9163861,7.09704,8,441,270451,0.0811411,0.37,1,98060,97619,441
9166781,9.41941,7.2,444,270451,0.104228,0.37,1,98070,97626,444
9168641,7.48388,7.84,443,270451,0.0928456,0.36,1,98077,97634,443
9170721,11.8968,7.168,449,270451,0.0825691,0.49,1,98090,97641,449
9173641,11.9794,10.2336,450,270451,0.160514,0.49,1,98102,97652,450
9176561,5.59587,8.44672,446,270451,0.176103,0.47,1,98106,97660,446
9179481,8.31917,8.08934,447,270451,0.131221,0.43,1,98115,97668,447
9182161,4.86383,8.01787,443,270451,0.114244,0.45,1,98119,97676,443
9185081,5.77277,7.20357,442,270451,0.126849,0.38,1,98125,97683,442
9188001,5.15455,7.84071,439,270451,0.16137,0.37,1,98130,97691,439
9190921,3.43091,7.96814,434,270451,0.168274,0.25,1,98133,97699,434
9193841,7.88618,7.99363,435,270451,0.137655,0.2,1,98142,97707,435
9195681,3.97724,7.99873,430,270451,0.131531,0.19,1,98145,97715,430
9198601,3.99545,7.99975,426,270451,0.162306,0.08,1,98149,97723,426
9201521,7.19909,7.99995,426,270451,0.112461,0.02,1,98157,97731,426
9204441,8.63982,7.99999,427,270451,0.0944922,0.04,1,98166,97739,427
9207361,8.92796,8,428,270451,0.0668985,0.06,1,98175,97747,428
9209201,7.38559,8,427,270451,0.0373797,0.1,1,98182,97755,427
9212121,9.47712,9.6,427,270451,0.0634759,0.06,1,98192,97765,427
9213781,13.0954,8.32,433,270451,0.0766952,0.07,1,98206,97773,433
9215861,14.6191,12.064,435,270451,0.103339,0.1,1,98221,97786,435
9217941,34.9238,13.6128,461,270451,0.108668,0.1,1,98261,97800,461
9220021,18.1848,33.1226,437,270451,0.149734,0.14,1,98275,97838,437
9222101,14.837,17.8245,437,270451,0.197947,0.16,1,98289,97852,437
9225021,10.9674,15.5649,432,270451,0.223589,0.11,1,98299,97867,432
9227301,7.79348,9.51298,431,270451,0.180718,0.19,1,98306,97875,431
9230221,6.3587,6.7026,431,270451,0.212144,0.16,1,98312,97881,431
9233141,4.47174,7.74052,427,270451,0.218429,0.12,1,98316,97889,427
9236061,5.69435,7.9481,425,270451,0.259686,0.05,1,98322,97897,425
9238981,7.53887,7.98962,425,270451,0.219937,0.01,1,98330,97905,425
9241901,7.90777,7.99792,425,270451,0.155987,0.01,1,98338,97913,425
9244821,7.98155,7.99958,425,270451,0.103197,0.01,1,98346,97921,425
9247741,7.99631,7.99992,425,270451,0.0286395,0.01,1,98354,97929,425
9250661,8.79926,7.99998,426,270451,0.0057279,0.01,1,98363,97937,426
9253581,8.15985,8,426,270451,0.00114558,0.02,1,98371,97945,426
9256501,8.03197,8,426,270451,0.000229116,0.04,1,98379,97953,426
9259421,8.00639,8,426,270451,4.58232e-05,0.02,1,98387,97961,426
9262341,8.00128,8,426,270451,9.16464e-06,0.02,1,98395,97969,426
9265261,8.80026,8,427,270451,1.83293e-06,0.02,1,98404,97977,427
9268181,7.36005,8,426,270451,3.66585e-07,0.06,1,98411,97985,426
9271101,8.67201,8,427,270451,7.33171e-08,0.04,1,98420,97993,427
9274021,8.9344,8,428,270451,0.00800002,0.06,1,98429,98001,428
9276941,9.78688,8,430,270451,0.0256,0.08,1,98439,98009,430
9279861,9.15738,8,431,270451,0.02912,0.1,1,98448,98017,431
9282421,9.03148,8,432,270451,0.093824,0.12,1,98457,98025,432
9285341,4.2063,7.2,428,270451,0.114765,0.18,1,98460,98032,428
9287201,8.84126,7.84,430,270451,0.126953,0.15,1,98470,98040,430
9290121,5.76825,7.168,428,270451,0.145391,0.14,1,98475,98047,428
9291781,7.55365,7.8336,428,270451,0.133078,0.08,1,98483,98055,428
9294481,8.71073,7.96672,429,270451,0.178616,0.14,1,98492,98063,429
9297401,23.3421,19.1933,434,270451,0.275723,0.11,1,98519,98085,434
9300321,10.2684,10.2387,433,270451,0.303145,0.19,1,98526,98093,433
9303221,6.85369,8.44773,431,270451,0.316629,0.23,1,98532,98101,431
9305301,11.7707,8.08955,436,270451,0.375326,0.15,1,98545,98109,436
9308221,8.75415,10.4179,433,270451,0.387065,0.19,1,98553,98120,433
9311141,8.15083,8.48358,433,270451,0.357413,0.15,1,98561,98128,433
9314061,9.63017,8.09672,435,270451,0.359483,0.15,1,98571,98136,435
9316981,4.32603,8.01934,430,270451,0.375897,0.17,1,98574,98144,430
9319901,6.46521,8.00387,429,270451,0.379179,0.12,1,98581,98152,429
9322821,6.09304,8.00077,427,270451,0.355836,0.1,1,98587,98160,427
9325741,6.81861,8.00015,426,270451,0.383167,0.08,1,98594,98168,426
9328661,8.56372,8.00003,427,270451,0.324633,0.03,1,98603,98176,427
9331581,10.5127,8.00001,430,270451,0.304927,0.11,1,98614,98184,430
9334501,7.70255,8,429,270451,0.236985,0.14,1,98621,98192,429
9337421,8.74051,8,430,270451,0.271397,0.12,1,98630,98200,430
9340341,9.7481,8,432,270451,0.310279,0.15,1,98640,98208,432
9343261,9.14962,8,433,270451,0.270056,0.17,1,98649,98216,433
9345861,5.82992,8,430,270451,0.246011,0.14,1,98654,98224,430
9347941,31.566,7.2,461,270451,0.289202,0.15,1,98692,98231,461
9350021,26.3132,31.04,449,270451,0.28984,0.25,1,98717,98268,449
9352101,10.8626,21.408,437,270451,0.337968,0.25,1,98724,98287,437
9354181,12.5725,10.6816,442,270451,0.299594,0.22,1,98737,98295,442
9357101,9.71451,11.7363,439,270451,0.331919,0.23,1,98746,98307,439
9359381,6.7429,8.74726,437,270451,0.354384,0.24,1,98752,98315,437
9362301,4.54858,10.5495,430,270451,0.366877,0.18,1,98756,98326,430
9365221,4.90972,8.50989,427,270451,0.337375,0.13,1,98761,98334,427
9368141,5.78194,8.10198,425,270451,0.291475,0.05,1,98767,98342,425
9371061,7.55639,8.0204,425,270451,0.234295,0.01,1,98775,98350,425
9373981,7.91128,8.00408,425,270451,0.182859,0.03,1,98783,98358,425
9376901,7.98226,8.00082,425,270451,0.108572,0.01,1,98791,98366,425
9379821,7.99645,8.00016,425,270451,0.0457144,0.01,1,98799,98374,425
9382741,7.99929,8.00003,425,270451,0.00914287,0.01,1,98807,98382,425
9385661,7.99986,8.00001,425,270451,0.00182857,0.01,1,98815,98390,425
9388581,7.99997,8,425,270451,0.000365715,0.01,1,98823,98398,425
9391501,7.99999,8,425,270451,7.3143e-05,0.01,1,98831,98406,425
9394421,8,8,425,270451,0.0160146,0.01,1,98839,98414,425
9397341,8.8,8,426,270451,0.0112029,0.03,1,98848,98422,426
9400261,8.96,8,427,270451,0.00224058,0.06,1,98857,98430,427
9403181,8.992,8,428,270451,0.0564481,0.07,1,98866,98438,428
9406101,11.3984,8,432,270451,0.0352896,0.1,1,98878,98446,432
9409021,7.87968,8,431,270451,0.0310579,0.12,1,98885,98454,431
9411941,10.3759,8,434,270451,0.0862116,0.15,1,98896,98462,434
9414861,7.67519,8,433,270451,0.113242,0.16,1,98903,98470,433
9417781,9.53504,8,435,270451,0.110648,0.19,1,98913,98478,435
9420701,7.50701,8,434,270451,0.12613,0.2,1,98920,98486,434
9423621,9.5014,8,436,270451,0.145226,0.17,1,98930,98494,436
9425521,10.7003,8,439,270451,0.125045,0.35,1,98941,98502,439
9428441,25.3401,21.6,443,270451,0.153009,0.33,1,98970,98527,443
9431361,13.868,10.72,446,270451,0.118602,0.39,1,98981,98535,446
9433841,7.5736,8.544,444,270451,0.0797204,0.35,1,98987,98543,444
9436761,15.9147,16.1088,444,270451,0.119944,0.39,1,99005,98561,444
9439681,9.58294,9.62176,444,270451,0.159989,0.39,1,99013,98569,444
9442601,9.11659,8.32435,445,270451,0.255998,0.38,1,99022,98577,445
9445521,5.82332,8.06487,442,270451,0.2752,0.4,1,99027,98585,442
9448441,6.76466,8.01297,441,270451,0.23904,0.34,1,99034,98593,441
9451361,6.15293,8.00259,439,270451,0.271808,0.37,1,99040,98601,439
9454281,5.23059,8.00052,436,270451,0.294362,0.28,1,99045,98609,436
9457201,11.4461,8.0001,441,270451,0.330872,0.25,1,99058,98617,441
9460121,8.68922,8.00002,441,270451,0.330174,0.29,1,99066,98625,441
9463041,7.33784,8,440,270451,0.402035,0.32,1,99073,98633,440
9465961,7.86757,8,440,270451,0.464407,0.26,1,99081,98641,440
9468881,9.57351,8,442,270451,0.444881,0.29,1,99091,98649,442
9471281,7.5147,8,441,270451,0.392976,0.36,1,99098,98657,441
9474201,9.50294,6.4,445,270451,0.494595,0.33,1,99108,98663,445
9476481,5.10059,7.68,441,270451,0.482919,0.29,1,99112,98671,441
9478561,23.4201,24.736,440,270451,0.448584,0.35,1,99140,98700,440
9481481,25.484,25.7472,440,270451,0.481717,0.3,1,99166,98726,440
9484181,21.8968,11.5494,453,270451,0.488343,0.38,1,99187,98734,453
9487101,9.17936,17.5099,440,270451,0.465669,0.33,1,99193,98753,440
9490021,5.83587,9.90198,437,270451,0.437134,0.31,1,99198,98761,437
9492941,4.36717,8.3804,433,270451,0.447427,0.23,1,99202,98769,433
9495861,4.07343,8.07608,429,270451,0.473485,0.18,1,99206,98777,429
9498781,4.81469,8.01522,426,270451,0.510697,0.11,1,99211,98785,426
9501701,6.56294,8.00304,425,270451,0.494139,0.03,1,99218,98793,425
9504621,8.51259,8.00061,426,270451,0.434828,0.01,1,99227,98801,426
9507541,7.30252,8.00012,425,270451,0.382966,0.04,1,99234,98809,425
9510461,7.8605,8.00002,425,270451,0.300593,0.01,1,99242,98817,425
9513381,7.9721,8,425,270451,0.228119,0.01,1,99250,98825,425
9516301,7.99442,8,425,270451,0.149624,0.01,1,99258,98833,425
9519221,7.99888,8,425,270451,0.0779248,0.01,1,99266,98841,425
9522141,10.3998,8,428,270451,0.0395849,0.01,1,99277,98849,428
9525061,6.87996,8,426,270451,0.00791699,0.09,1,99283,98857,426
9527981,7.77599,8,426,270451,0.0095834,0.03,1,99291,98865,426
9530901,8.7552,8,427,270451,0.0419167,0.08,1,99300,98873,427
9533821,10.551,8,430,270451,0.00838334,0.07,1,99311,98881,430
9536741,9.31021,8,431,270451,0.00967667,0.13,1,99320,98889,431
9539661,7.46204,8,430,270451,0.0259353,0.13,1,99327,98897,430
9542581,9.49241,8,432,270451,0.109187,0.14,1,99337,98905,432
9545121,7.49848,8,431,270451,0.0858374,0.13,1,99344,98913,431
9548041,6.2997,7.2,430,270451,0.121167,0.14,1,99350,98920,430
9550961,8.45994,7.84,431,270451,0.128233,0.12,1,99359,98928,431
9553881,12.092,7.968,436,270451,0.113647,0.16,1,99372,98936,436
9556561,9.6184,7.9936,437,270451,0.102729,0.11,1,99381,98944,437
9558641,25.1237,31.1987,429,270451,0.188546,0.1,1,99410,98981,429
9561561,11.4247,11.0397,431,270451,0.157709,0.11,1,99418,98987,431
9564481,11.0849,8.60795,434,270451,0.127542,0.18,1,99429,98995,434
9566341,11.817,8.12159,438,270451,0.161508,0.18,1,99441,99003,438
9568421,15.1634,8.82432,445,270451,0.128302,0.31,1,99457,99012,445
9571341,9.43268,12.9649,439,270451,0.18566,0.25,1,99465,99026,439
9574261,9.08654,8.99297,440,270451,0.205132,0.29,1,99474,99034,440
9577181,9.01731,8.19859,441,270451,0.265026,0.32,1,99483,99042,441
9580101,9.80346,8.03972,443,270451,0.261005,0.37,1,99493,99050,443
9583021,10.7607,8.00794,446,270451,0.260201,0.35,1,99504,99058,446
9584641,10.1521,8.00159,448,270451,0.26004,0.42,1,99514,99066,448
9587561,7.63043,7.20032,448,270451,0.260008,0.48,1,99521,99073,448
9590481,6.32609,7.84006,446,270451,0.340002,0.48,1,99527,99081,446
9593401,9.26522,7.96801,448,270451,0.372,0.42,1,99537,99089,448
9596321,8.25304,7.9936,448,270451,0.4424,0.48,1,99545,99097,448
9599241,7.25061,7.99872,447,270451,0.47248,0.48,1,99552,99105,447
9602161,10.2501,7.99974,450,270451,0.478496,0.49,1,99563,99113,450
9605081,9.25002,7.99995,451,270451,0.503699,0.53,1,99572,99121,451
9607521,5.85,7.99999,448,270451,0.58874,0.44,1,99577,99129,448
9609601,16.37,16,449,270451,0.645748,0.5,1,99596,99147,449
9611681,29.674,28,451,270451,0.80915,0.49,2,99629,99178,451
9614601,16.3348,15.2,452,270451,0.89783,0.47,2,99642,99190,452
9616261,9.66696,9.44,452,270451,0.923566,0.52,2,99650,99198,452
9619181,5.13339,8.288,448,270451,0.896713,0.52,2,99654,99206,448
9622101,5.02668,8.0576,445,270451,0.867343,0.47,2,99659,99214,445
9625021,4.20534,8.01152,441,270451,0.861469,0.4,2,99663,99222,441
9627941,4.04107,8.0023,437,270451,0.884294,0.31,2,99667,99230,437
9630861,4.80821,8.00046,434,270451,0.928859,0.24,2,99672,99238,434
9633781,4.16164,8.00009,430,270451,0.905772,0.17,2,99676,99246,430
9636701,5.63233,8.00002,428,270451,0.861154,0.1,2,99682,99254,428
9639621,5.92647,8,426,270451,0.812231,0.06,2,99688,99262,426
9642541,7.58529,8,426,270451,0.754446,0.02,2,99696,99270,426
9645461,9.51706,8,428,270451,0.702889,0.02,1,99706,99278,428
9648381,7.50341,8,427,270451,0.652578,0.09,1,99713,99286,427
9651301,7.10068,8,426,270451,0.610516,0.03,1,99720,99294,426
9654221,7.82014,8,426,270451,0.594103,0.02,1,99728,99302,426
9657141,7.96403,8,426,270451,0.558821,0.04,1,99736,99310,426
9660061,10.3928,8,429,270451,0.567764,0.06,1,99747,99318,429
9662981,10.0786,8,431,270451,0.545553,0.09,1,99757,99326,431
9665901,8.41571,8,431,270451,0.541111,0.13,1,99765,99334,431
9668821,8.88314,8,432,270451,0.572222,0.15,1,99774,99342,432
9671741,8.97663,8,433,270451,0.626444,0.15,1,99783,99350,433
9674661,6.59533,8,431,270451,0.637289,0.14,1,99789,99358,431
9677581,6.11907,8,429,270451,0.623458,0.12,1,99795,99366,429
9680501,11.6238,8,434,270451,0.612692,0.13,1,99808,99374,434
9683421,8.72476,8,434,270451,0.650538,0.23,1,99816,99382,434
9686341,8.94495,8,435,270451,0.658108,0.2,1,99825,99390,435
9689061,20.189,8,450,270451,0.747622,0.16,1,99848,99398,450
9691761,10.4378,21.6,433,270451,0.805524,0.17,2,99856,99423,433
9694681,7.68756,9.92,433,270451,0.801105,0.19,2,99863,99430,433
9696341,15.1375,8.384,442,270451,0.800221,0.17,2,99880,99438,442
9698421,14.2275,15.2768,439,270451,0.856044,0.2,2,99894,99455,439
9700501,11.6455,9.45536,442,270451,0.891209,0.21,2,99905,99463,442
9703421,9.5291,10.6911,440,270451,0.858242,0.29,2,99914,99474,440
9705281,8.30582,8.53821,440,270451,0.819648,0.29,2,99922,99482,440
9707361,6.46116,8.90764,437,270451,0.81993,0.28,2,99928,99491,437
9710281,10.0922,8.98153,439,270451,0.803986,0.27,2,99939,99500,439
9711941,9.21845,8.19631,440,270451,0.768797,0.3,2,99948,99508,440
9714861,9.84369,7.23926,443,270451,0.793759,0.34,2,99958,99515,443
9717141,11.5687,7.84785,447,270451,0.854752,0.37,2,99970,99523,447
9720061,10.3137,9.56957,447,270451,0.83495,0.44,2,99980,99533,447
9722981,10.8627,8.31391,450,270451,0.85499,0.46,2,99991,99541,450
9725901,10.1725,8.06278,452,270451,0.906998,0.49,2,100001,99549,452
9728581,10.0345,8.01256,454,270451,0.9254,0.54,2,100011,99557,454
9878961,11,8,487,270451,0.79,1,2,100625,100138,487
9881881,7,13.6,478,270451,0.79,1,2,100631,100153,478
9884801,10.2,9.12,481,270451,0.774,1,2,100642,100161,481
9887721,6.84,8.224,479,270451,0.7788,1,2,100648,100169,479
9890641,8.568,8.0448,480,270451,0.76376,1,2,100657,100177,480
9893561,8.9136,8.00896,481,270451,0.736752,1,1,100666,100185,481
9896481,8.18272,8.00179,481,270451,0.68335,0.96,1,100674,100193,481
9899401,8.03654,8.00036,481,270451,0.67267,0.99,1,100682,100201,481
9902321,8.80731,8.00007,482,270451,0.582534,1,1,100691,100209,482
9905241,8.16146,8.00001,482,270451,0.484507,1,1,100699,100217,482
9908161,8.83229,8,483,270451,0.376901,1,1,100708,100225,483
9911081,10.5665,8,486,270451,0.26738,1,1,100719,100233,486
9914001,9.31329,8,487,270451,0.173476,1,1,100728,100241,487
9916921,9.06266,8,488,270451,0.114695,1,1,100737,100249,488
9919841,6.61253,8,486,270451,0.022939,1,1,100743,100257,486
9922761,9.32251,8,488,270451,0.00458781,1,1,100753,100265,488
9925681,8.2645,8,488,270451,0.00891756,1,1,100761,100273,488
9928601,8.8529,8,489,270451,0.00178351,1,1,100770,100281,489
9931521,10.5706,8,492,270451,0.0083567,1,1,100781,100289,492
9934441,9.31412,8,493,270451,0.0256713,1,1,100790,100297,493
9937361,11.4628,8,497,270451,0.00513427,1,1,100802,100305,497
9938821,11.0926,8,500,270451,0.00902685,1,1,100813,100313,500
10069281,349.419,410.4,423,249240,0.00980537,0,1,101247,100824,423
10072201,417.884,426.88,427,135445,0.00996107,0.01,1,101682,101255,427
10075121,90.7767,93.376,426,138365,0.0339922,0.01,1,101691,101265,426
10078041,26.1553,26.6752,426,141285,0.0387984,0.03,1,101701,101275,426
10080961,13.2311,13.335,426,144205,0.0797597,0.01,1,101711,101285,426
10083881,10.6462,10.667,426,147125,0.143952,0.03,1,101721,101295,426
10086801,10.1292,10.1334,426,150045,0.15679,0.03,1,101731,101305,426
10089721,10.0258,10.0267,426,152965,0.167358,0.01,1,101741,101315,426
10092641,10.0052,10.0053,426,155885,0.185472,0.01,1,101751,101325,426
10095561,10.001,10.0011,426,158805,0.205094,0.01,1,101761,101335,426
10098481,10.8002,10.0002,427,161725,0.225019,0.03,1,101772,101345,427
10101401,10.96,10,428,164645,0.229004,0.03,1,101783,101355,428
10104321,9.39201,10,427,167565,0.341801,0.03,1,101792,101365,427
10107241,9.8784,10,427,170485,0.40436,0.03,1,101802,101375,427
10110161,9.97568,10,427,173405,0.520872,0.03,1,101812,101385,427
10113081,9.99514,10,427,176325,0.640174,0.06,1,101822,101395,427
10116001,9.99903,10,427,179245,0.760035,0.05,2,101832,101405,427
10118921,9.99981,10,427,182165,0.896007,0.05,2,101842,101415,427
10177321,10,10,426,240565,0.83,0.05,2,102041,101615,426
10180241,10,10,426,243485,0.83,0.05,2,102051,101625,426
10183161,10,10,426,246405,0.83,0.05,2,102061,101635,426
10186081,10.8,10,427,5840,0.83,0.05,2,102072,101645,427
10189001,10.16,10,427,5840,0.766,0.05,2,102082,101655,427
10191921,9.232,10,426,5840,0.6732,0.05,1,102091,101665,426
10194841,10.6464,10,427,5840,0.55864,0.05,1,102102,101675,427
10197761,10.1293,10,427,5840,0.439728,0.05,1,102112,101685,427
10200681,12.4259,10,430,5840,0.343946,0.12,1,102125,101695,430
10203601,12.0852,10,432,5840,0.268789,0.17,1,102137,101705,432
10206521,11.217,10,433,5840,0.221758,0.19,1,102148,101715,433
10209441,11.0434,10,434,5840,0.244352,0.19,1,102159,101725,434
10212361,11.0087,10,435,5840,0.24887,0.21,1,102170,101735,435
10215281,11.0017,10,436,5840,0.249774,0.24,1,102181,101745,436
10218201,11.0003,10,437,5840,0.233955,0.25,1,102192,101755,437
10221121,11.0001,10,438,5840,0.254791,0.28,1,102203,101765,438
10224041,13.4,10,442,5840,0.242958,0.33,1,102217,101775,442
10226961,13.88,10,446,5840,0.208592,0.44,1,102231,101785,446
10229881,15.576,10,452,5840,0.217718,0.53,1,102247,101795,452
10232801,15.9152,10,458,5840,0.259544,0.64,1,102263,101805,458
10235721,15.983,10,464,5840,0.323909,0.77,1,102279,101815,464
10238641,15.9966,10,470,5840,0.312782,0.9,1,102295,101825,470
10241561,15.9993,10,476,5840,0.350556,0.99,1,102311,101835,476
10244481,12.7999,10,478,5840,0.414111,1,1,102323,101845,478
10247401,12.16,10,480,5840,0.386822,1,1,102335,101855,480
10250321,12.032,10,482,5840,0.389364,1,1,102347,101865,482
10253241,9.6064,10,481,5840,0.397873,1,1,102356,101875,481
10256161,9.12128,10,480,5840,0.415575,1,1,102365,101885,480
10259081,8.22426,10,478,5840,0.411115,1,1,102373,101895,478
10262001,12.0449,10,481,5840,0.386223,1,1,102386,101905,481
10264921,16.009,10,488,5840,0.381245,1,1,102403,101915,488
10267841,11.2018,10,488,5840,0.372249,1,1,102413,101925,488
10270761,10.2404,10,488,5840,0.38645,1,1,102423,101935,488
10273681,10.8481,10,489,5840,0.38129,1,1,102434,101945,489
10276601,10.1696,10,489,5840,0.380258,1,1,102444,101955,489
10279521,8.43392,10,487,5840,0.372052,1,1,102452,101965,487
10282441,6.48678,10,483,5840,0.37841,1,1,102458,101975,483
10285361,7.69736,10,481,5840,0.395682,1,1,102466,101985,481
10288281,17.5395,10,491,5840,0.343136,1,1,102486,101995,491
10291201,9.10789,10,488,5840,0.356627,0.95,1,102493,102005,488
10294121,6.62158,10,484,5840,0.311325,0.87,1,102499,102015,484
10297041,6.92432,10,481,5840,0.294265,0.85,1,102506,102025,481
10299961,6.18486,10,477,5840,0.218853,0.84,1,102512,102035,477
10302881,6.83697,10,474,5840,0.179771,0.81,1,102519,102045,474
10305801,6.16739,10,470,5840,0.107954,0.17,1,102525,102055,470
10308721,339.633,373.2,429,5840,0.709591,0.11,1,102948,102519,429
10311641,74.3267,82.64,427,249143,0.805918,0.86,2,102956,102529,427
10525841,3,5,421,7300,0,0,1,105937,105516,421
10528761,343,339.4,426,16660,0,0.05,1,106365,105939,426
10531681,76.6,75.88,426,19580,0.008,0.01,1,106375,105949,426
10534601,23.32,23.176,426,22500,0.0016,0.03,1,106385,105959,426
10537521,13.464,12.6352,427,25420,0.00832,0.02,1,106396,105969,427
10540441,9.8928,10.527,426,28340,0.017664,0.04,1,106405,105979,426
10541901,166.779,10.1054,622,31260,0.0035328,0,1,106611,105989,622
10544821,178.156,302.821,427,32720,0.00070656,0.05,1,106792,106365,427
10547741,42.8311,68.5642,426,35640,0.000141312,0.01,1,106801,106375,426
10550661,16.5662,21.7128,426,38560,0.00802826,0.01,1,106811,106385,426
10553581,12.1132,12.3426,427,41480,0.00160565,0.06,1,106822,106395,427
10556501,9.62265,10.4685,426,44400,0.0243211,0.03,1,106831,106405,426
10559421,9.92453,10.0937,426,47320,0.0128642,0.03,1,106841,106415,426
10562341,9.98491,10.0187,426,50240,0.0105728,0.01,1,106851,106425,426
10565261,9.99698,10.0037,426,53160,0.0101146,0.03,1,106861,106435,426
10568181,10.7994,10.0007,427,56080,0.00202291,0.01,1,106872,106445,427
10571101,9.35988,10.0001,426,59000,0.000404583,0,1,106881,106455,426
10574021,127.472,126.8,427,61920,8.09165e-05,0,1,107038,106611,427
10576941,169.494,170.16,426,64840,1.61833e-05,0.03,1,107218,106792,426
10579861,41.8989,42.032,426,67760,0.00800324,0.02,1,107228,106802,426
10582781,16.3798,16.4064,426,70680,0.00160065,0.03,1,107238,106812,426
10585701,12.076,11.2813,427,73600,0.0323201,0.06,1,107249,106822,427
10588621,9.61519,10.2563,426,76520,0.038464,0.03,1,107258,106832,426
10591541,9.92304,10.0513,426,79440,0.0156928,0.03,1,107268,106842,426
10594461,10.7846,10.0103,427,77222,0.0111386,0.05,1,107279,106852,427
10597381,9.35692,10.002,426,77222,0.0342277,0.01,1,107288,106862,426
10600301,9.87138,10.0004,426,77222,0.0228455,0.01,1,107298,106872,426
10603221,11.5743,10.0001,428,77222,0.00456911,0.05,1,107310,106882,428
10606141,8.71486,10,426,77222,0.00891382,0.05,1,107318,106892,426
10609061,10.543,10,427,77222,0.0657828,0.01,1,107329,106902,427
10611981,10.1086,10,427,80142,0.109157,0.07,1,107339,106912,427
10614901,9.22172,10,426,83062,0.109831,0.01,1,107348,106922,426
10617821,10.6443,10,427,85982,0.0299663,0.03,1,107359,106932,427
10620741,10.9289,10,428,88902,0.0219933,0.05,1,107370,106942,428
10623661,8.58577,10,426,91822,0.00439865,0.03,1,107378,106952,426
10626581,11.3172,10,428,94742,0.0248797,0.05,1,107390,106962,428
10629501,9.46343,10,427,97662,0.0129759,0.07,1,107399,106972,427
10632421,9.09269,10,426,100582,0.0105952,0,1,107408,106982,426
10635341,48.2185,46.8,428,103502,0.010119,0.03,1,107466,107038,428
10638261,16.8437,17.36,427,106422,0.0260238,0,1,107475,107048,427
10641181,140.169,139.472,428,109342,0.0132048,0.03,1,107646,107218,428
10644101,34.4337,35.8944,426,112262,0.010641,0.02,1,107654,107228,426
10647021,14.8867,15.1789,426,115182,0.0101282,0.05,1,107664,107238,426
10649941,10.1773,9.43578,427,118102,0.0100256,0.04,1,107673,107246,427
10652861,7.63547,8.28716,426,121022,0.0260051,0.06,1,107680,107254,426
10655781,7.92709,8.05743,426,123942,0.013201,0.06,1,107688,107262,426
10658701,17.5854,8.01149,438,126862,0.0026402,0,1,107708,107270,438
10661621,30.7171,27.2023,440,129782,0.000528041,0.07,1,107742,107302,440
10664541,28.5434,31.0405,436,132702,0.136106,0,1,107770,107334,436
10667461,26.5087,28.6081,434,135622,0.251221,0.04,1,107796,107362,434
10670381,22.1017,24.1216,432,138542,0.354244,0.01,1,107817,107385,432
10673301,20.4203,21.6243,431,141462,0.446849,0.03,1,107837,107406,431
10676221,18.4841,19.5249,430,144382,0.44137,0.01,1,107855,107425,430
10679141,18.0968,18.305,430,147302,0.312274,0.01,1,107873,107443,430
10682061,18.0194,18.061,430,147361,0.118455,0.01,1,107891,107461,430
10684981,18.8039,18.0122,431,147361,0.031691,0,1,107910,107479,431
10687901,17.3608,18.0024,430,147361,0.0223382,0.03,1,107927,107497,430
10690821,19.4722,18.0005,432,147361,0.0284676,0.03,1,107947,107515,432
10693741,17.4944,18.0001,431,147361,0.0136935,0.01,1,107964,107533,431
10696661,17.0989,18,430,147361,0.0107387,0.01,1,107981,107551,430
10699581,18.6198,18,431,147361,0.0261477,0,1,108000,107569,431
10702501,17.324,18,430,147361,0.0212295,0.04,1,108017,107587,430
10705421,17.8648,18,430,147361,0.0122459,0.01,1,108035,107605,430
10708341,18.773,18,431,147361,0.00244918,0.03,1,108054,107623,431
10711261,18.1546,18,431,149077,0.000489836,0.01,1,108072,107641,431
10714181,17.2309,18,430,149077,9.79673e-05,0.05,1,108089,107659,430
10717101,16.2462,16.4,430,149077,0.0320196,0.01,1,108105,107675,430
10720021,16.0492,16.08,430,149077,0.0144039,0.03,1,108121,107691,430
10722941,13.6098,14.416,429,149077,0.0188808,0.03,1,108134,107705,429
10725861,13.922,14.0832,429,149077,0.0117762,0.03,1,108148,107719,429
10728781,14.7844,14.0166,430,149077,0.0183552,0.06,1,108163,107733,430
10731701,17.3569,14.0033,434,149077,0.011671,0.09,1,108181,107747,434
10734621,18.6714,14.0007,439,149077,0.0583342,0.22,1,108200,107761,439
10737541,17.3343,14.0001,442,146157,0.131667,0.3,1,108217,107775,442
10740461,17.0669,14,445,146157,0.114333,0.32,1,108234,107789,445
10743381,17.8134,14,449,146157,0.0868667,0.4,1,108252,107803,449
10746301,17.1627,14,452,149077,0.113373,0.5,1,108269,107817,452
10749221,13.0325,14,450,151084,0.0946747,0.48,1,108281,107831,450
10752141,11.4065,14,447,151084,0.0589349,0.44,1,108292,107845,447
10755061,7.8813,14,440,154004,0.083787,0.3,1,108299,107859,440
10757981,5.57626,14,431,156924,0.0567574,0.11,1,108304,107873,431
10760901,11.5153,14,430,158663,0.0113515,0.05,1,108317,107887,430
10763821,12.7031,14,429,161583,0.0102703,0,1,108330,107901,429
10766741,13.7406,14,429,164503,0.0100541,0.01,1,108344,107915,429
10769661,13.9481,14,429,167423,0.0260108,0.03,1,108358,107929,429
10772581,14.7896,14,430,168570,0.0132022,0,1,108373,107943,430
10775501,12.5579,14,428,168570,0.00264043,0.01,1,108385,107957,428
10778421,14.5116,14,429,168570,0.000528086,0.01,1,108400,107971,429
10781341,13.3023,14,428,168570,0.00810562,0.06,1,108413,107985,428
10784261,14.6605,14,429,168570,0.00962112,0,1,108428,107999,429
10787181,13.3321,14,428,168570,0.0179242,0.03,1,108441,108013,428
10790101,13.8664,14,428,168570,0.00358484,0,1,108455,108027,428
10793021,13.9733,14,428,168570,0.00871697,0.01,1,108469,108041,428
10795941,13.9947,14,428,168570,0.00174339,0.01,1,108483,108055,428
10798861,13.9989,14,428,168570,0.0243487,0.02,1,108497,108069,428
10801781,14.7998,14,429,171490,0.0128697,0.04,1,108512,108083,429
10804701,14.16,14,429,174410,0.0345739,0.03,1,108526,108097,429
10807621,14.032,14,429,177330,0.0309148,0.03,1,108540,108111,429
10810541,14.0064,14,429,180250,0.014183,0.02,1,108554,108125,429
10813461,13.2013,14,428,183170,0.0428366,0.03,1,108567,108139,428
10816381,15.4403,14,430,186090,0.0405673,0.04,1,108583,108153,430
10819301,13.4881,14,429,186959,0.0161135,0.02,1,108596,108167,429
10822221,16.2976,14,432,186959,0.0112227,0.1,1,108613,108181,432
10825141,15.2595,14,433,186959,0.0582445,0.14,1,108628,108195,433
10828061,22.2519,18,438,186959,0.0916489,0.12,1,108652,108214,438
10830981,25.2504,22.8,440,186959,0.10633,0.16,1,108678,108238,440
10833901,21.0501,23.76,436,186959,0.157266,0.03,1,108698,108262,436
10836821,22.61,23.952,435,186959,0.159453,0.05,1,108721,108286,435
10839741,22.122,23.1904,434,186959,0.151891,0.05,1,108743,108309,434
10842661,19.6244,22.2381,431,186959,0.134378,0.01,1,108762,108331,431
10845581,16.7249,17.2476,431,186959,0.0908756,0.04,1,108778,108347,431
10848501,15.345,16.2495,430,186959,0.0261751,0.04,1,108793,108363,430
10851421,15.869,16.0499,430,186959,0.00523502,0,1,108809,108379,430
10854341,15.1738,16.01,429,186959,0.001047,0.01,1,108824,108395,429
10857261,15.8348,16.002,429,186959,0.000209401,0.03,1,108840,108411,429
10860181,15.967,16.0004,429,186959,0.00804188,0.01,1,108856,108427,429
10863101,16.7934,16.0001,430,186959,0.00160838,0.03,1,108873,108443,430
10866021,15.3587,16,429,186959,0.00832168,0.03,1,108888,108459,429
10868941,17.4717,16,431,186959,0.0176643,0.02,1,108906,108475,431
10871861,14.6943,16,429,186959,0.00353287,0,1,108920,108491,429
10874781,14.9389,15.2,429,186959,0.0327066,0.01,1,108935,108506,429
10877701,14.1878,14.24,429,186959,0.00654131,0,1,108949,108520,429
10880621,14.0376,14.048,429,186959,0.00930826,0.03,1,108963,108534,429
10883541,14.8075,14.0096,430,186959,0.00186165,0.04,1,108978,108548,430
10886461,12.5615,14.0019,428,186959,0.00837233,0.02,1,108990,108562,428
10889381,14.5123,14.0004,429,186959,0.00967447,0.03,1,109005,108576,429
10892301,14.1025,14.0001,429,186959,0.0179349,0.03,1,109019,108590,429
10895221,14.8205,14,430,186959,0.011587,0.01,1,109034,108604,430
10898141,16.5641,14,433,186959,0.0263174,0.13,1,109051,108618,433
10901061,12.9128,14,431,186959,0.0852635,0.09,1,109063,108632,431
10903981,14.5826,14,432,186959,0.0890527,0.1,1,109078,108646,432
10906901,14.1165,14,432,186959,0.0658105,0.1,1,109092,108660,432
10909821,15.6233,14,434,186959,0.0451621,0.08,1,109108,108674,434
10912741,16.7247,14,437,186959,0.0810324,0.15,1,109125,108688,437
10915661,15.3449,14,438,186959,0.160206,0.19,1,109140,108702,438
10918581,13.469,14,437,186959,0.144041,0.22,1,109153,108716,437
10921501,12.2938,14,435,186959,0.204808,0.16,1,109165,108730,435
10924421,12.8588,14,434,186959,0.144962,0.14,1,109178,108744,434
10927341,10.5718,14,430,186959,0.116992,0.05,1,109188,108758,430
10930261,12.5144,14,429,186959,0.111398,0.05,1,109201,108772,429
10933181,12.9029,14,428,186959,0.10228,0.05,1,109214,108786,428
10936101,14.5806,14,429,186959,0.0684559,0.03,1,109229,108800,429
10939021,14.1161,14,429,186959,0.0376912,0,1,109243,108814,429
10941941,14.8232,14,430,186959,0.0155382,0.03,1,109258,108828,430
10944861,12.5646,14,428,186959,0.0111076,0.03,1,109270,108842,428
10947781,14.5129,14,429,186959,0.00222153,0.03,1,109285,108856,429
10950701,13.3026,14,428,186959,0.0404443,0.01,1,109298,108870,428
10953621,14.6605,14,429,186959,0.00808886,0.01,1,109313,108884,429
10956541,13.3321,14,428,186959,0.00961777,0,1,109326,108898,428
10959461,15.4664,14,430,186959,0.00992355,0.03,1,109342,108912,430
10962381,12.6933,14,428,186959,0.00998471,0,1,109354,108926,428
10965301,15.3387,14,430,186959,0.0179969,0.07,1,109370,108940,430
10968221,12.6677,14,428,186959,0.0275994,0.04,1,109382,108954,428
10971141,13.7335,14,428,186959,0.0455199,0.04,1,109396,108968,428
10974061,13.9467,14,428,186959,0.017104,0,1,109410,108982,428
10976981,14.7893,14,429,186959,0.0114208,0.05,1,109425,108996,429
10979901,14.1579,14,429,186959,0.0342842,0,1,109439,109010,429
10982821,14.0316,14,429,186959,0.0308568,0.05,1,109453,109024,429
10985741,14.8063,14,430,186959,0.0141714,0.03,1,109468,109038,430
10988661,18.1613,14,435,186959,0.0348343,0.16,1,109487,109052,435
10991581,13.2323,14,433,186959,0.0869669,0.07,1,109499,109066,433
10994501,13.0465,14,432,186959,0.0973934,0.12,1,109512,109080,432
10997421,12.2093,14,430,186959,0.0914787,0.06,1,109524,109094,430
11000341,17.6419,14,435,186959,0.130296,0.11,1,109543,109108,435
11003261,16.3284,14,437,186959,0.106059,0.17,1,109559,109122,437
11006181,12.8657,14,435,186959,0.109212,0.17,1,109571,109136,435
11009101,16.1731,14,438,186959,0.157842,0.24,1,109588,109150,438
11012021,12.0346,14,435,186959,0.159568,0.17,1,109599,109164,435
11014941,14.4069,14,436,186959,0.127914,0.12,1,109614,109178,436
11017861,12.4814,14,434,186959,0.129583,0.13,1,109626,109192,434
11020781,12.0963,14,432,186959,0.185917,0.11,1,109638,109206,432
11023701,12.0193,14,430,186959,0.165183,0.1,1,109650,109220,430
11026621,12.0039,14,428,186959,0.113037,0.01,1,109662,109234,428
11029541,14.4008,14,429,186959,0.110607,0.01,1,109677,109248,429
11032461,13.2802,14,428,186959,0.0541215,0.01,1,109690,109262,428
11035381,16.256,14,431,186959,0.0348243,0.03,1,109707,109276,431
11038301,12.8512,14,429,186959,0.00696486,0.03,1,109719,109290,429
11041221,13.7702,14,429,186959,0.025393,0.05,1,109733,109304,429
11044141,13.154,14,428,186959,0.0130786,0,1,109746,109318,428
11047061,14.6308,14,429,186959,0.00261572,0.01,1,109761,109332,429
11049981,14.9262,14,430,186959,0.00852314,0.01,1,109776,109346,430
11052901,13.3852,14,429,186959,0.00170463,0.01,1,109789,109360,429
11055821,13.077,14,428,182579,0.0243409,0.05,1,109802,109374,428
11058741,14.6154,14,429,182579,0.0368682,0.03,1,109817,109388,429
11061661,14.9231,14,430,182579,0.0473736,0.01,1,109832,109402,430
11064581,12.5846,14,428,182579,0.0334747,0,1,109844,109416,428
11067501,13.7169,14,428,182579,0.00669495,0.03,1,109858,109430,428
11070421,13.9434,14,428,182579,0.00933899,0.02,1,109872,109444,428
11073341,13.9887,14,428,182579,0.0098678,0.01,1,109886,109458,428
11076261,15.5977,14,430,182579,0.0419736,0.06,1,109902,109472,430
11079181,15.1195,14,431,182579,0.0403947,0.1,1,109917,109486,431
11082101,15.8239,14,433,182579,0.0160789,0.14,1,109933,109500,433
11085021,15.9648,14,435,182579,0.0192158,0.15,1,109949,109514,435
11087941,13.593,14,434,182579,0.0518432,0.16,1,109962,109528,434
11090861,13.1186,14,433,182579,0.0983686,0.15,1,109975,109542,433
11093781,14.6237,14,434,182579,0.0676737,0.13,1,109990,109556,434
11096701,15.7247,14,436,182579,0.0215347,0.17,1,110006,109570,436
11099621,14.3449,14,436,182579,0.060307,0.17,1,110020,109584,436
11102541,12.469,14,434,182579,0.0920614,0.17,1,110032,109598,434
11105461,15.2938,14,436,182579,0.0584123,0.13,1,110048,109612,436
11108381,14.2588,14,436,182579,0.0356825,0.18,1,110062,109626,436
11111301,12.4518,14,434,182579,0.0871365,0.17,1,110074,109640,434
11114221,12.8904,14,433,182579,0.137427,0.11,1,110087,109654,433
11117141,11.3781,14,430,182579,0.0754855,0.06,1,110098,109668,430
11120061,12.6756,14,429,182579,0.0390971,0.01,1,110111,109682,429
11122981,12.9351,14,428,182579,0.0158194,0.03,1,110124,109696,428
11125901,14.587,14,429,182579,0.0111639,0.03,1,110139,109710,429
11128821,13.3174,14,428,182579,0.00223278,0.03,1,110152,109724,428
11131741,14.6635,14,429,182579,0.0244466,0.01,1,110167,109738,429
11134661,14.1327,14,429,182579,0.00488931,0,1,110181,109752,429
11137581,14.0265,14,429,182579,0.00897786,0.01,1,110195,109766,429
11140501,14.8053,14,430,182579,0.00179557,0.01,1,110210,109780,430
11143421,14.1611,14,430,182579,0.00835911,0.03,1,110224,109794,430
11146341,14.8322,14,431,182579,0.0256718,0.06,1,110239,109808,431
11149261,13.3664,14,430,182579,0.0291344,0.04,1,110252,109822,430
11152181,12.2733,14,428,182579,0.0138269,0.02,1,110264,109836,428
11155101,15.2547,14,430,182579,0.0347654,0.03,1,110280,109850,430
11158021,12.6509,14,428,182579,0.0229531,0.03,1,110292,109864,428
11160941,15.3302,14,430,182579,0.0205906,0.03,1,110308,109878,430
11163861,13.466,14,429,182579,0.00411812,0.04,1,110321,109892,429
11166781,13.8932,14,429,182579,0.0328236,0.04,1,110335,109906,429
11169701,14.7786,14,430,182579,0.0305647,0.01,1,110350,109920,430
11172621,14.1557,14,430,182579,0.0381129,0.04,1,110364,109934,430
11175541,14.8311,14,431,182579,0.0556226,0.08,1,110379,109948,431
11178461,14.9662,14,432,182579,0.115125,0.12,1,110394,109962,432
11181381,12.5932,14,430,182579,0.0630249,0.06,1,110406,109976,430
11184301,13.7186,14,430,182579,0.020605,0.03,1,110420,109990,430
11187221,16.3437,14,433,182579,0.164121,0.12,1,110437,110004,433
11190141,12.8687,14,431,182579,0.200824,0.1,1,110449,110018,431
11193061,12.9737,14,430,182579,0.240165,0.06,1,110462,110032,430
11195981,12.9948,14,429,182579,0.216033,0.07,1,110475,110046,429
11198901,17.7989,14,434,182579,0.267207,0.14,1,110494,110060,434
11201821,14.7598,14,434,182579,0.293441,0.16,1,110508,110074,434
11204741,10.952,14,430,182579,0.282688,0.06,1,110518,110088,430
11207661,12.5904,14,429,182579,0.248538,0.03,1,110531,110102,429
11210581,12.9181,14,428,182579,0.281708,0.03,1,110544,110116,428
11213501,13.7836,14,428,182579,0.224342,0.01,1,110558,110130,428
11216421,13.9567,14,428,182579,0.156868,0.05,1,110572,110144,428
11219341,14.7913,14,429,182579,0.119374,0.04,1,110587,110158,429
11222261,14.1583,14,429,182579,0.0478747,0.01,1,110601,110172,429
11225181,13.2317,14,428,182579,0.0175749,0,1,110614,110186,428
11228101,14.6463,14,429,182579,0.00351499,0.01,1,110629,110200,429
11231021,14.1293,14,429,182579,0.008703,0.04,1,110643,110214,429
11233941,14.0259,14,429,182579,0.0017406,0.01,1,110657,110228,429
11236861,14.8052,14,430,182579,0.00834812,0.08,1,110672,110242,430
11239781,13.361,14,429,182579,0.00166962,0.06,1,110685,110256,429
11242701,13.8722,14,429,182579,0.0483339,0.03,1,110699,110270,429
11245621,13.9744,14,429,182579,0.0336668,0.01,1,110713,110284,429
11248541,13.9949,14,429,182579,0.0467334,0.01,1,110727,110298,429
11251461,13.999,14,429,182579,0.0173467,0.03,1,110741,110312,429
11254381,13.9998,14,429,182579,0.0114693,0.03,1,110755,110326,429
11257301,16.4,14,432,182579,0.0342939,0.08,1,110772,110340,432
11260221,14.48,14,432,182579,0.0628588,0.1,1,110786,110354,432
11263141,14.096,14,432,182579,0.0525718,0.08,1,110800,110368,432
11266061,12.4192,14,430,182579,0.0265144,0.09,1,110812,110382,430
11268981,12.8838,14,429,182579,0.0933029,0.06,1,110825,110396,429
11271901,14.5768,14,430,182579,0.114661,0.09,1,110840,110410,430
11274821,21.3154,14,439,182579,0.150932,0.2,1,110863,110424,439
11277741,17.0631,14,441,182579,0.0301864,0.23,1,110879,110438,441
11280661,14.6126,14,441,182579,0.0780373,0.25,1,110893,110452,441
11283581,16.5225,14,444,182579,0.0876075,0.3,1,110910,110466,444
11286501,12.9045,14,442,182579,0.0895215,0.28,1,110922,110480,442
11289421,13.7809,14,442,182579,0.137904,0.32,1,110936,110494,442
11292341,15.5562,14,444,185499,0.203581,0.32,1,110952,110508,444
11295261,11.9112,14,441,185499,0.200716,0.3,1,110963,110522,441
11298181,13.5822,14,441,185499,0.288143,0.28,1,110977,110536,441
11301101,9.91645,14,436,185499,0.265629,0.19,1,110986,110550,436
11304021,9.98329,14,432,185499,0.309126,0.12,1,110996,110564,432
11306941,11.5967,14,430,185499,0.309825,0.08,1,111008,110578,430
11309861,13.5193,14,430,185499,0.269965,0.06,1,111022,110592,430
11312781,12.3039,14,428,185499,0.229993,0,1,111034,110606,428
11315701,14.4608,14,429,185499,0.221999,0.01,1,111049,110620,429
11318621,14.0922,14,429,185499,0.1324,0.03,1,111063,110634,429
11321541,13.2184,14,428,185499,0.0504799,0.05,1,111076,110648,428
11324461,15.4437,14,430,185499,0.034096,0.01,1,111092,110662,430
11327381,14.2887,14,430,185499,0.0308192,0.03,1,111106,110676,430
11330301,14.0577,14,430,185499,0.0141638,0.01,1,111120,110690,430
11333221,14.8115,14,431,185499,0.0108328,0.07,1,111135,110704,431
11336141,12.5623,14,429,185499,0.0341666,0.06,1,111147,110718,429
11339061,13.7125,14,429,185499,0.0308333,0.03,1,111161,110732,429
11341981,13.9425,14,429,185499,0.0621667,0.05,1,111175,110746,429
11344901,13.9885,14,429,185499,0.0204333,0.05,1,111189,110760,429
11347821,17.9977,14,434,185499,0.0440867,0.14,1,111208,110774,434
11350741,11.5995,14,430,185499,0.0168173,0.07,1,111218,110788,430
11353661,15.9199,14,433,185499,0.107363,0.06,1,111235,110802,433
11356581,15.184,14,434,185499,0.117473,0.14,1,111250,110816,434
11359501,15.0368,14,435,185499,0.175495,0.14,1,111265,110830,435
11362421,15.8074,14,437,185499,0.139099,0.2,1,111281,110844,437
11365341,8.76147,14,430,185499,0.0998198,0.07,1,111288,110858,430
11368261,15.3523,14,433,185499,0.115964,0.11,1,111305,110872,433
11371181,16.6705,14,436,185499,0.111193,0.15,1,111322,110886,436
11374101,11.3341,14,432,185499,0.0942386,0.07,1,111332,110900,432
11377021,16.6668,14,436,188419,0.138848,0.14,1,111350,110914,436
11379941,16.1334,14,438,189928,0.18777,0.16,1,111366,110928,438
11382861,16.0267,14,440,189928,0.173554,0.27,1,111382,110942,440
11385781,12.0053,12.4,439,189928,0.194711,0.23,1,111393,110954,439
11388701,14.4011,12.08,442,189928,0.214942,0.3,1,111408,110966,442
11391621,13.2802,12.016,443,189928,0.250988,0.33,1,111421,110978,443
11394541,12.256,12.0032,443,189928,0.242198,0.31,1,111433,110990,443
11397461,8.05121,12.0006,438,189928,0.20844,0.27,1,111440,111002,438
11400381,10.4102,12.0001,437,189928,0.201688,0.27,1,111451,111014,437
11403301,12.482,12,438,189928,0.152338,0.26,1,111464,111026,438
11406221,10.4964,12,436,189928,0.182468,0.22,1,111474,111038,436
11409141,7.69928,12,431,189928,0.204494,0.13,1,111481,111050,431
11412061,7.93986,12,427,189928,0.216899,0.04,1,111489,111062,427
11414981,11.988,12,428,191153,0.13938,0.05,1,111502,111074,428
11417901,13.5976,12,430,191565,0.0838759,0.08,1,111516,111086,430
11420821,9.91952,12,427,191565,0.120775,0.03,1,111525,111098,427
11423741,14.7839,12,431,194485,0.080155,0.03,1,111541,111110,431
11426661,10.1568,12,428,196808,0.080031,0.03,1,111550,111122,428
11429581,11.6314,12,428,196808,0.136006,0.07,1,111562,111134,428
11432501,13.5263,12,430,196808,0.131201,0.06,1,111576,111146,430
11435421,12.3053,12,430,196808,0.16224,0.09,1,111588,111158,430
11438341,9.66105,12,427,196808,0.192448,0.08,1,111597,111170,427
11441261,12.3322,12,428,198519,0.17449,0.01,1,111610,111182,428
11444181,12.0664,12,428,201439,0.242898,0.05,1,111622,111194,428
11447101,12.0133,12,428,204225,0.24058,0.03,1,111634,111206,428
11450021,16.0027,12,433,204225,0.272116,0.1,1,111651,111218,433
11452941,13.6005,12,434,204225,0.294423,0.14,1,111664,111230,434
11455861,11.5201,12,433,204225,0.370885,0.17,1,111675,111242,433
11458781,13.504,12,435,205453,0.418177,0.19,1,111689,111254,435
11461701,10.7008,12,433,205453,0.491635,0.18,1,111699,111266,433
11464621,10.9402,12,432,205453,0.538327,0.12,1,111710,111278,432
11467541,11.788,12,432,205892,0.587665,0.15,1,111722,111290,432
11470461,10.3576,12,430,207667,0.605533,0.09,1,111732,111302,430
11473381,12.4715,12,431,207667,0.609107,0.12,1,111745,111314,431
11476301,14.4943,12,434,210587,0.609821,0.16,1,111760,111326,434
11479221,13.2989,12,435,211936,0.665964,0.15,1,111773,111338,435
11482141,13.8598,12,437,214234,0.725193,0.23,1,111787,111350,437
11485061,11.572,12,436,214234,0.769039,0.25,2,111798,111362,436
11487981,11.9144,12,436,214234,0.777808,0.22,2,111810,111374,436
11490901,15.9829,12,441,215688,0.803562,0.24,2,111827,111386,441
11493821,12.7966,12,441,215688,0.824712,0.24,2,111839,111398,441
11496741,10.5593,12,439,215688,0.844942,0.25,2,111849,111410,439
11499661,10.9119,12,438,215688,0.912988,0.25,2,111860,111422,438
11502581,10.1824,12,436,215688,0.926598,0.26,2,111870,111434,436
11505501,10.8365,12,435,215688,0.93732,0.22,2,111881,111446,435
11859121,42,44,485,230620,0,1,1,113674,113189,485
11860161,66,8.8,557,135445,0,1,1,113746,113189,557
11863081,18.8,61.76,489,136485,0.008,1,1,113753,113264,489
11866001,14.16,21.952,490,139405,0.0016,1,1,113766,113276,490
11868921,18.032,13.9904,497,142325,0.03232,1,1,113785,113288,497
11871841,15.6064,12.3981,500,145245,0.014464,1,1,113800,113300,500
11874761,11.1213,12.0796,498,148165,0.0028928,1,1,113810,113312,498
11877681,9.42426,12.0159,495,151085,0.00857856,1,1,113819,113324,495
11880601,10.6849,11.2032,495,154005,0.00171571,1,1,113830,113335,495
11883521,10.137,7.84064,498,156925,0.0243431,1,1,113840,113342,498
11886441,10.0274,11.1681,496,159845,0.0128686,1,1,113850,113354,496
11889361,10.0055,11.8336,494,162765,0.0105737,1,1,113860,113366,494
11892281,8.4011,11.9667,490,165685,0.0101147,1,1,113868,113378,490
11895201,9.68022,11.9933,488,168605,0.0100229,1,1,113878,113390,488
11898121,9.13604,11.9987,485,171525,0.0100046,1,1,113887,113402,485
11901041,9.02721,11.9997,482,174445,0.0100009,1,1,113896,113414,482
11903961,9.80544,11.9999,480,177365,0.0100002,1,1,113906,113426,480
11906881,11.5611,12,480,180285,0.034,1,1,113918,113438,480
11909801,11.9122,12,480,183205,0.0228,1,1,113930,113450,480
11912721,13.5824,12,482,186125,0.01256,1,1,113944,113462,482
11915641,9.91649,12,479,189045,0.034512,0.97,1,113953,113474,479
11918561,6.7833,12,473,191965,0.0629024,0.88,1,113959,113486,473
11921481,12.5567,12,475,194885,0.0365805,0.92,1,113973,113498,475
11924401,8.11133,12,470,197805,0.0713161,0.9,1,113980,113510,470
11927321,7.22227,12,465,200725,0.0542632,0.81,1,113987,113522,465
11930241,9.44445,12,463,203645,0.0108526,0.74,1,113997,113534,463
11933161,10.6889,12,462,206565,0.0341705,0.75,1,114008,113546,462
11936081,5.33778,12,454,209485,0.0148341,0.61,1,114012,113558,454
11939001,7.46756,12,450,212405,0.0189668,0.53,1,114020,113570,450
11941921,11.8935,12,451,215325,0.0117934,0.52,1,114033,113582,451
11944841,9.5787,12,448,218245,0.0103587,0.47,1,114042,113594,448
11947761,7.51574,12,443,221165,0.0260717,0.38,1,114049,113606,443
11950681,7.10315,12,438,224085,0.0132143,0.31,1,114056,113618,438
11953601,8.62063,12,435,227005,0.0186429,0.21,1,114065,113630,435
11956521,8.92413,12,432,229925,0.0117286,0.13,1,114074,113642,432
11959441,7.38483,12,427,232845,0.00234571,0.07,1,114081,113654,427
11962361,11.077,12,427,232947,0.00846914,0.03,1,114093,113666,427
11965281,11.8154,12,427,232947,0.00169383,0,1,114105,113678,427
11968201,13.5631,12,429,232947,0.00833877,0.02,1,114119,113690,429
11971121,11.5126,12,428,232947,0.00166775,0.04,1,114130,113702,428
11974041,11.1025,12,427,232947,0.00833355,0.01,1,114141,113714,427
11976961,11.8205,12,427,232947,0.00166671,0.01,1,114153,113726,427
11979881,11.9641,12,427,232947,0.000333342,0.04,1,114165,113738,427
11982801,11.9928,12,427,232947,6.66684e-05,0.03,1,114177,113750,427
11985721,12.7986,12,428,232947,0.00801333,0.01,1,114190,113762,428
11988641,12.9597,12,429,232947,0.00160267,0.03,1,114203,113774,429
11991561,10.5919,12,427,232947,0.000320533,0.05,1,114213,113786,427
11994481,11.7184,12,427,232947,0.00806411,0,1,114225,113798,427
11997401,11.9437,12,427,232947,0.00161282,0,1,114237,113810,427
12000321,11.9887,12,427,232947,0.000322564,0.04,1,114249,113822,427
12003241,11.9977,12,427,232947,0.00806451,0.04,1,114261,113834,427
12006161,11.9995,12,427,232947,0.0016129,0,1,114273,113846,427
12009081,12.7999,12,428,232947,0.00032258,0.01,1,114286,113858,428
12012001,11.36,12,427,232947,6.45161e-05,0.03,1,114297,113870,427
12014921,12.672,12,428,232947,1.29032e-05,0.01,1,114310,113882,428
12017841,12.1344,12,428,232947,2.58064e-06,0.01,1,114322,113894,428
12020761,11.2269,12,427,232947,5.16129e-07,0.08,1,114333,113906,427
12023681,12.6454,12,428,232947,1.03226e-07,0.06,1,114346,113918,428
12026601,12.9291,12,429,232947,2.06451e-08,0.03,1,114359,113930,429
12029521,12.9858,12,430,232947,0.008,0.05,1,114372,113942,430
12032441,9.79716,12,427,232947,0.0016,0.01,1,114381,113954,427
12035361,13.9594,12,430,232947,0.00032,0.09,1,114396,113966,430
12038281,10.7919,12,428,232947,6.4e-05,0.03,1,114406,113978,428
12041201,11.7584,12,428,232947,1.28e-05,0.04,1,114418,113990,428
12044121,11.9517,12,428,232947,2.56e-06,0.05,1,114430,114002,428
12047041,11.1903,12,427,232947,0.00800051,0,1,114441,114014,427
12049961,12.6381,12,428,232947,0.0016001,0.06,1,114454,114026,428
12052881,12.1276,12,428,232947,0.02432,0.04,1,114466,114038,428
12055801,11.2255,12,427,232947,0.012864,0,1,114477,114050,427
12058721,12.6451,12,428,232947,0.0025728,0.01,1,114490,114062,428
12061641,11.329,12,427,232947,0.00851456,0.02,1,114501,114074,427
12064561,11.8658,12,427,232947,0.00970291,0.05,1,114513,114086,427
12067481,11.9732,12,427,232947,0.00194058,0.02,1,114525,114098,427
12070401,12.7946,12,428,232947,0.000388116,0,1,114538,114110,428
12073321,11.3589,12,427,232947,7.76233e-05,0.01,1,114549,114122,427
12076241,11.8718,12,427,232947,0.0240155,0,1,114561,114134,427
12079161,12.7744,12,428,232947,0.0048031,0.02,1,114574,114146,428
12082081,11.3549,12,427,232947,0.000960621,0.02,1,114585,114158,427
12085001,11.871,12,427,232947,0.0161921,0.03,1,114597,114170,427
12087921,11.9742,12,427,232947,0.00323842,0,1,114609,114182,427
12090841,12.7948,12,428,232947,0.00864768,0,1,114622,114194,428
12093761,11.359,12,427,232947,0.0257295,0.01,1,114633,114206,427
12096681,11.8718,12,427,232947,0.0131459,0,1,114645,114218,427
12099601,11.9744,12,427,232947,0.00262918,0,1,114657,114230,427
12102521,12.7949,12,428,232947,0.000525836,0.02,1,114670,114242,428
12105441,11.359,12,427,232947,0.000105167,0.01,1,114681,114254,427
12108361,11.8718,12,427,232947,0.00802103,0,1,114693,114266,427
12111281,12.7744,12,428,232947,0.00160421,0,1,114706,114278,428
12114201,11.3549,12,427,232947,0.000320841,0.01,1,114717,114290,427
12117121,11.871,12,427,232947,0.00806417,0,1,114729,114302,427
12120041,12.7742,12,428,232947,0.00161283,0,1,114742,114314,428
12122961,11.3548,12,427,232947,0.000322567,0.02,1,114753,114326,427
12125881,11.871,12,427,232947,6.45133e-05,0.01,1,114765,114338,427
12128801,11.9742,12,427,232947,1.29027e-05,0,1,114777,114350,427
12131721,12.7948,12,428,232947,2.58053e-06,0,1,114790,114362,428
12134641,11.359,12,427,232947,5.16107e-07,0.01,1,114801,114374,427
12137561,11.8718,12,427,232947,0.0080001,0,1,114813,114386,427
12140481,11.9744,12,427,232947,0.00160002,0,1,114825,114398,427
12143401,11.9949,12,427,232947,0.000320004,0.02,1,114837,114410,427
12146321,11.999,12,427,232947,6.40008e-05,0.01,1,114849,114422,427
12149241,12.7998,12,428,232947,0.0240128,0.01,1,114862,114434,428
12152161,12.16,12,428,232947,0.00480256,0.01,1,114874,114446,428
12155081,11.232,12,427,232947,0.000960512,0.03,1,114885,114458,427
12158001,11.8464,12,427,232947,0.0241921,0.02,1,114897,114470,427
12160921,11.9693,12,427,232947,0.00483842,0,1,114909,114482,427
12163841,12.7939,12,428,232947,0.00896768,0.04,1,114922,114494,428
12166761,11.3588,12,427,232947,0.0177935,0.01,1,114933,114506,427
12169681,11.8718,12,427,232947,0.00355871,0.01,1,114945,114518,427
12172601,12.7744,12,428,232947,0.000711741,0.02,1,114958,114530,428
12175521,11.3549,12,427,232947,0.0241423,0.01,1,114969,114542,427
12178441,12.671,12,428,232947,0.0128285,0.01,1,114982,114554,428
12181361,11.3342,12,427,232947,0.00256569,0,1,114993,114566,427
12184281,11.8668,12,427,232947,0.000513139,0.04,1,115005,114578,427
12187201,12.7734,12,428,232947,0.000102628,0.04,1,115018,114590,428
12190121,12.1547,12,428,232947,0.00802053,0.02,1,115030,114602,428
12193041,12.8309,12,429,232947,0.0176041,0.01,1,115043,114614,429
12195961,10.5662,12,427,232947,0.0275208,0.01,1,115053,114626,427
12198881,11.7132,12,427,232947,0.0295042,0.01,1,115065,114638,427
12201801,11.9426,12,427,232947,0.0139008,0,1,115077,114650,427
12204721,11.9885,12,427,232947,0.00278017,0.02,1,115089,114662,427
12207641,12.7977,12,428,232947,0.00855603,0.03,1,115102,114674,428
12210561,11.3595,12,427,232947,0.0177112,0,1,115113,114686,427
12213481,12.6719,12,428,232947,0.00354224,0,1,115126,114698,428
12216401,11.3344,12,427,232947,0.00870845,0.01,1,115137,114710,427
12219321,11.8669,12,427,232947,0.00974169,0,1,115149,114722,427
12222241,11.9734,12,427,232947,0.00194834,0,1,115161,114734,427
12225161,11.9947,12,427,232947,0.000389668,0.02,1,115173,114746,427
12228081,11.9989,12,427,232947,7.79335e-05,0.01,1,115185,114758,427
12231001,11.9998,12,427,232947,0.00801559,0,1,115197,114770,427
12233921,12.8,12,428,232947,0.00160312,0,1,115210,114782,428
12236841,11.36,12,427,232947,0.000320623,0.01,1,115221,114794,427
12239761,11.872,12,427,232947,0.0160641,0,1,115233,114806,427
12242681,11.9744,12,427,232947,0.00321282,0,1,115245,114818,427
12245601,11.9949,12,427,232947,0.00864257,0.02,1,115257,114830,427
12248521,11.999,12,427,232947,0.00972851,0.01,1,115269,114842,427
12251441,11.9998,12,427,232947,0.0019457,0.01,1,115281,114854,427
12254361,12.8,12,428,232947,0.00038914,0.02,1,115294,114866,428
12257281,11.36,12,427,232947,7.78281e-05,0.01,1,115305,114878,427
12260201,12.672,12,428,232947,1.55656e-05,0.01,1,115318,114890,428
12263121,11.3344,12,427,232947,0.00800311,0,1,115329,114902,427
12266041,11.8669,12,427,232947,0.00160062,0.04,1,115341,114914,427
12268961,11.9734,12,427,232947,0.000320124,0.04,1,115353,114926,427
12271881,11.9947,12,427,232947,6.40249e-05,0,1,115365,114938,427
12274801,13.5989,12,429,232947,1.2805e-05,0.01,1,115379,114950,429
12277721,10.7198,12,427,232947,2.561e-06,0.01,1,115389,114962,427
12280641,11.744,12,427,232947,5.12199e-07,0.01,1,115401,114974,427
12283561,12.7488,12,428,232947,1.0244e-07,0.02,1,115414,114986,428
12286481,11.3498,12,427,232947,2.0488e-08,0.02,1,115425,114998,427
12289401,12.67,12,428,232947,4.09759e-09,0.03,1,115438,115010,428
12292321,12.134,12,428,232947,8.19518e-10,0.03,1,115450,115022,428
12295241,12.0268,12,428,232947,0.024,0.05,1,115462,115034,428
12298161,12.0054,12,428,232947,0.0288,0.06,1,115474,115046,428
12301081,11.2011,12,427,232947,0.01376,0,1,115485,115058,427
12304001,12.6402,12,428,232947,0.010752,0.01,1,115498,115070,428
12306921,11.328,12,427,232947,0.0261504,0.02,1,115509,115082,427
12309841,11.8656,12,427,232947,0.00523008,0.03,1,115521,115094,427
12312761,12.7731,12,428,232947,0.00904602,0.04,1,115534,115106,428
12315681,12.1546,12,428,232947,0.0258092,0,1,115546,115118,428
12318601,12.0309,12,428,232947,0.0451618,0.03,1,115558,115130,428
12321521,11.2062,12,427,232947,0.0250324,0,1,115569,115142,427
12324441,11.8412,12,427,232947,0.00500647,0.01,1,115581,115154,427
12327361,11.9682,12,427,232947,0.0090013,0.04,1,115593,115166,427
12330281,11.9936,12,427,232947,0.00180026,0.01,1,115605,115178,427
12333201,12.7987,12,428,235867,0.00836005,0.01,1,115618,115190,428
12336121,12.1597,12,428,235867,0.00967201,0.01,1,115630,115202,428
12339041,11.2319,12,427,235867,0.0099344,0.03,1,115641,115214,427
12341961,11.8464,12,427,235867,0.00998688,0.02,1,115653,115226,427
12344881,11.9693,12,427,235867,0.00999738,0,1,115665,115238,427
12347801,12.7939,12,428,235867,0.0339995,0.04,1,115678,115250,428
12350721,11.3588,12,427,235867,0.0147999,0.01,1,115689,115262,427
12353641,11.8718,12,427,235867,0.01096,0.03,1,115701,115274,427
12356561,11.9744,12,427,235867,0.034192,0.02,1,115713,115286,427
12359481,11.9949,12,427,235867,0.0148384,0,1,115725,115298,427
12362401,12.799,12,428,235867,0.00296768,0.01,1,115738,115310,428
12365321,11.3598,12,427,235867,0.00859354,0.01,1,115749,115322,427
12368241,11.872,12,427,235867,0.00971871,0.03,1,115761,115334,427
12371161,11.9744,12,427,235867,0.00994374,0.03,1,115773,115346,427
12374081,11.9949,12,427,235867,0.0339887,0,1,115785,115358,427
12377001,12.799,12,428,235867,0.00679775,0.03,1,115798,115370,428
12379921,11.3598,12,427,235867,0.0253596,0.01,1,115809,115382,427
12382841,11.872,12,427,235867,0.0130719,0.03,1,115821,115394,427
12385761,12.7744,12,428,235867,0.0106144,0.04,1,115834,115406,428
12388681,12.1549,12,428,235867,0.0101229,0.01,1,115846,115418,428
12391601,12.831,12,429,235867,0.0180246,0.03,1,115859,115430,429
12394521,11.3662,12,428,235867,0.0196049,0,1,115870,115442,428
12397441,11.8732,12,428,235867,0.027921,0.04,1,115882,115454,428
12400361,11.9746,12,428,235867,0.0055842,0.05,1,115894,115466,428
12403281,11.9949,12,428,235867,0.00111684,0.04,1,115906,115478,428
12406201,12.799,12,429,235867,0.000223368,0.06,1,115919,115490,429
12409121,11.3598,12,428,235867,0.00804467,0.04,1,115930,115502,428
12412041,11.072,12,427,235867,0.0256089,0.06,1,115941,115514,427
12414961,13.4144,12,429,235867,0.0211218,0.06,1,115955,115526,429
12417881,11.4829,12,428,235867,0.00422436,0.03,1,115966,115538,428
12420801,12.6966,12,429,235867,0.00884487,0.07,1,115979,115550,429
12423721,10.5393,12,427,235867,0.025769,0.01,1,115989,115562,427
12426641,11.7079,12,427,235867,0.0211538,0.04,1,116001,115574,427
12429561,11.9416,12,427,235867,0.0122308,0.06,1,116013,115586,427
12432481,12.7883,12,428,235867,0.00244615,0.01,1,116026,115598,428
12435401,9.75766,12,425,235867,0.00848923,0.02,1,116035,115610,425
12438321,8.35153,8.8,425,235867,0.00169785,0.03,1,116043,115618,425
12441241,8.07031,8.16,425,235340,0.000339569,0.01,1,116051,115626,425
12444161,8.01406,8.032,425,235340,0.00806791,0.03,1,116059,115634,425
12447081,8.80281,8.0064,426,235340,0.00161358,0,1,116068,115642,426
12450001,7.36056,8.00128,425,235340,0.00832272,0.04,1,116075,115650,425
12452921,7.87211,8.00026,425,235340,0.00166454,0.03,1,116083,115658,425
12455841,7.97442,8.00005,425,235340,0.0243329,0,1,116091,115666,425
12458761,7.99488,8.00001,425,235340,0.0128666,0.03,1,116099,115674,425
12461681,8.79898,8,426,235340,0.00257332,0.01,1,116108,115682,426
12464601,7.3598,8,425,235340,0.0245147,0.04,1,116115,115690,425
12467521,8.67196,8,426,235340,0.0129029,0.03,1,116124,115698,426
12470441,8.13439,8,426,235340,0.00258059,0.01,1,116132,115706,426
12473361,7.22688,8,425,238260,0.00851612,0.02,1,116139,115714,425
12476281,7.84538,8,425,239289,0.00170322,0.01,1,116147,115722,425
12479201,7.96908,8,425,239815,0.0243406,0.01,1,116155,115730,425
12482121,7.99382,8,425,242735,0.00486813,0.01,1,116163,115738,425
12485041,7.99876,8,425,245534,0.00897363,0.01,1,116171,115746,425
12487961,7.99975,8,425,246076,0.0177947,0,1,116179,115754,425
12490881,7.99995,8,425,248996,0.00355894,0.01,1,116187,115762,425
12493801,8.79999,8,426,251808,0.0247118,0,1,116196,115770,426
12496721,8.16,8,426,251808,0.0289424,0.01,1,116204,115778,426
12499641,7.232,8,425,254728,0.00578847,0.02,1,116211,115786,425
12502561,8.6464,8,426,256407,0.00915769,0.01,1,116220,115794,426
12505481,7.32928,8,425,256407,0.00183154,0.05,1,116227,115802,425
12507041,7.06586,8,424,259327,0.0243663,0.03,1,116234,115810,424
12509961,7.81317,7.2,425,260887,0.0128733,0,1,116242,115817,425
12512881,7.96263,7.84,425,261522,0.0105747,0.01,1,116250,115825,425
12514741,13.5925,7.968,432,264442,0.0501149,0.01,1,116265,115833,432
12517661,9.11851,12.7936,426,265734,0.010023,0.04,1,116273,115847,426
12519521,7.4237,8.95872,425,265734,0.0100046,0.03,1,116280,115855,425
12522441,10.2847,9.79174,426,265734,0.0100009,0.01,1,116291,115865,426
12524721,8.45695,8.35835,426,266710,0.0260002,0.06,1,116299,115873,426
12527641,10.4914,11.2717,425,266710,0.0372,0.01,1,116310,115885,425
12529301,12.4983,8.65433,430,266710,0.00744001,0.01,1,116323,115893,430
12532221,8.89966,11.3309,426,266710,0.025488,0.03,1,116331,115905,426
12534081,7.37993,8.66617,425,266710,0.0050976,0.03,1,116338,115913,425
12537001,8.67599,7.33323,427,266710,0.00101952,0.04,1,116347,115920,427
12538661,8.1352,7.86665,427,266710,0.0322039,0.04,1,116355,115928,427
12540741,9.62704,9.57333,427,266710,0.0224408,0.04,1,116365,115938,427
12542401,7.52541,9.11467,425,266710,0.0124882,0.03,1,116372,115947,425
12545321,15.1051,14.6229,426,266710,0.0264976,0.02,1,116389,115963,426
12546981,7.02102,9.32459,423,266710,0.0292995,0.05,1,116394,115971,423
12549901,7.8042,5.86492,426,266710,0.0298599,0.02,1,116402,115976,426
12551761,7.16084,7.57298,425,266710,0.013972,0.07,1,116409,115984,425
12553841,9.43217,9.5146,425,266710,0.0427944,0.05,1,116419,115994,425
12556761,11.4864,10.7029,426,266890,0.00855888,0.03,1,116431,116005,426
12558421,10.2973,8.54058,428,266890,0.0257118,0.02,1,116441,116013,428
12560081,6.05946,8.90812,424,266890,0.0451424,0,1,116446,116022,424
12563001,18.0119,17.7816,425,266890,0.00902847,0.02,1,116467,116042,425
12565921,10.0024,9.95632,425,266890,0.0178057,0.03,1,116475,116050,425
12568841,9.20048,8.39126,426,266890,0.0115611,0,1,116484,116058,426
12571761,8.2401,8.07825,426,266890,0.0103122,0.04,1,116492,116066,426
12574681,8.84802,8.01565,427,266890,0.0260624,0.02,1,116501,116074,427
12577601,7.3696,8.00313,426,266890,0.0212125,0.04,1,116508,116082,426
12580521,7.07392,8.00063,425,266890,0.0202425,0.04,1,116515,116090,425
12583441,8.61478,8.00013,426,266890,0.0120485,0,1,116524,116098,426
12586361,8.12296,8.00003,426,266890,0.0104097,0.06,1,116532,116106,426
12589281,8.82459,8.00001,427,266890,0.0100819,0.02,1,116541,116114,427
12592201,7.36492,8,426,266890,0.0260164,0.04,1,116548,116122,426
12595121,7.87298,8,426,266890,0.00520328,0.04,1,116556,116130,426
12598041,7.1746,8,425,266890,0.00104066,0.02,1,116563,116138,425
12600961,7.83492,8,425,266890,0.0322081,0.04,1,116571,116146,425
12603881,8.76698,8,426,266890,0.0224416,0.01,1,116580,116154,426
12606801,8.1534,8,426,266890,0.0124883,0.04,1,116588,116162,426
12609721,7.23068,8,425,266890,0.0664977,0.05,1,116595,116170,425
12612641,7.84614,8,425,266890,0.0212995,0.01,1,116603,116178,425
12615201,7.96923,8,425,266890,0.0122599,0.07,1,116611,116186,425
12618121,7.19385,7.2,425,266890,0.018452,0.01,1,116618,116193,425
12621041,7.83877,7.84,425,266890,0.0276904,0.03,1,116626,116201,425
12623961,8.76775,7.968,426,266890,0.0215381,0.01,1,116635,116209,426
12626881,7.35355,7.9936,425,266890,0.0283076,0.03,1,116642,116217,425
12629801,7.87071,7.99872,425,266890,0.0376615,0.03,1,116650,116225,425
12632721,8.77414,7.99974,426,266890,0.0315323,0.01,1,116659,116233,426
12635641,7.35483,7.99995,425,266890,0.0543065,0.04,1,116666,116241,425
12638561,8.67097,7.99999,426,266890,0.0268613,0.01,1,116675,116249,426
12641481,7.33419,8,425,266890,0.0293723,0.06,1,116682,116257,425
12644401,7.86684,8,425,266890,0.0458745,0.01,1,116690,116265,425
12646821,10.3734,8,428,266890,0.00917489,0.04,1,116701,116273,428
12649741,9.27467,10.4,426,266890,0.025835,0,1,116710,116284,426
12652641,7.45493,8.48,425,269245,0.029167,0.04,1,116717,116292,425
12655561,8.69099,8.096,426,269245,0.0218334,0.05,1,116726,116300,426
12657221,16.9382,8.0192,437,269245,0.0363667,0,1,116745,116308,437
12659301,11.3876,16.8038,428,269245,0.0312733,0.02,1,116755,116327,428
12662221,7.87753,11.3608,425,269245,0.0142547,0.02,1,116762,116337,425
12665121,8.77551,8.67215,426,269245,0.0268509,0.07,1,116771,116345,426
12667201,7.3551,8.13443,425,269245,0.00537019,0.03,1,116778,116353,425
12669281,11.871,9.62689,428,269245,0.00107404,0.01,1,116791,116363,428
12671361,7.9742,8.32538,427,269245,0.00821481,0.11,1,116798,116371,427
12673441,4.79484,6.46508,425,269245,0.00164296,0.03,1,116802,116377,425
12676361,16.159,16.493,425,269245,0.00832859,0.01,1,116821,116396,425
12679061,9.63179,9.6986,425,269245,0.0256657,0.01,1,116829,116404,425
12681981,8.32636,7.53972,426,269245,0.0291331,0.07,1,116837,116411,426
12684261,8.86527,7.90794,427,269245,0.0138266,0.04,1,116846,116419,427
12686341,10.5731,9.58159,428,269245,0.0107653,0.04,1,116857,116429,428
12688421,16.5146,9.91632,436,269245,0.00215307,0.01,1,116875,116439,436
12691121,8.90292,16.3833,425,269245,0.0164306,0.03,1,116882,116457,425
12693201,13.7806,13.6767,427,269245,0.0112861,0.02,1,116897,116470,427
12696121,9.15612,9.93533,426,269245,0.0262572,0.04,1,116905,116479,426
12697781,6.63122,8.38707,424,269245,0.00525144,0.01,1,116911,116487,424
12699441,6.92624,5.67741,426,269245,0.00905029,0.07,1,116918,116492,426
12702361,9.38525,9.93548,425,269245,0.00981006,0.02,1,116928,116503,425
12705281,8.27705,8.3871,425,269245,0.025962,0.01,1,116936,116511,425
12708201,9.65541,8.07742,427,269245,0.0051924,0.01,1,116946,116519,427
12711121,7.53108,8.01548,426,269245,0.00103848,0.04,1,116953,116527,426
12714041,7.90622,8.0031,426,269245,0.0162077,0.03,1,116961,116535,426
12716961,7.98124,8.00062,426,269245,0.0432415,0.06,1,116969,116543,426
12719881,7.99625,8.00012,426,269245,0.0166483,0.04,1,116977,116551,426
12721701,5.59925,8.00002,423,269245,0.00332966,0.05,1,116982,116559,423
12724621,7.51985,5.6,426,268637,0.0246659,0.05,1,116990,116564,426
12727541,7.10397,7.52,425,268637,0.0449332,0.04,1,116997,116572,425
12730461,10.2208,7.904,428,268637,0.0169866,0.04,1,117008,116580,428
12733381,6.04416,7.9808,425,268637,0.0433973,0.07,1,117013,116588,425
12736261,7.60883,7.99616,425,268637,0.0486795,0.01,1,117021,116596,425
12739181,9.52177,7.99923,427,268637,0.00973589,0.01,1,117031,116604,427
12742101,6.70435,7.99985,425,268637,0.0259472,0.05,1,117037,116612,425
12744581,7.74087,7.99997,425,268637,0.0451894,0.02,1,117045,116620,425
12747501,7.94817,7.19999,426,268637,0.0170379,0.04,1,117053,116627,426
12750421,7.98963,7.84,426,268637,0.0114076,0.04,1,117061,116635,426
12753341,7.99793,7.968,426,268637,0.0422815,0.01,1,117069,116643,426
12756261,8.79959,7.9936,427,268637,0.0324563,0.05,1,117078,116651,427
12759181,7.35992,7.99872,426,268637,0.0144913,0.04,1,117085,116659,426
12762101,7.87198,7.99974,426,268637,0.0348983,0.02,1,117093,116667,426
12765021,8.7744,7.99995,427,268637,0.0149796,0.08,1,117102,116675,427
12767941,7.35488,7.99999,426,268637,0.0109959,0.04,1,117109,116683,426
12770861,8.67098,8,427,268637,0.0261992,0.04,1,117118,116691,427
12773781,8.1342,8,427,268637,0.00523984,0.04,1,117126,116699,427
12776701,6.42684,8,425,268637,0.00104797,0.06,1,117132,116707,425
12778901,7.68537,8,425,268637,0.0322096,0.01,1,117140,116715,425
12781821,8.73707,8,426,268637,0.0304419,0.01,1,117149,116723,426
12783681,7.34741,8,425,268637,0.00608838,0.05,1,117156,116731,425
12785761,8.66948,7.2,427,268637,0.0252177,0.04,1,117165,116738,427
12787841,13.7339,14.24,426,268637,0.0370435,0.03,1,117180,116754,426
12790761,11.5468,11.648,426,268637,0.0394087,0.04,1,117191,116765,426
12793681,8.70936,8.7296,426,268637,0.0318817,0.02,1,117199,116773,426
12796601,8.14187,8.14592,426,268637,0.00637635,0.04,1,117207,116781,426
12798241,8.02837,8.02918,426,268637,0.00927527,0.06,1,117215,116789,426
12801161,13.6057,13.6058,426,268637,0.0498551,0.04,1,117230,116804,426
12804081,8.32113,9.12117,425,268637,0.00997101,0.04,1,117237,116812,425
12805941,14.4642,8.22423,433,268637,0.0099942,0.03,1,117253,116820,433
12808861,9.29285,14.4448,425,268637,0.00199884,0.03,1,117261,116836,425
12811781,9.85857,9.28897,427,268637,0.000399768,0.03,1,117271,116844,427
12814261,6.77171,8.25779,425,268637,7.99536e-05,0.05,1,117277,116852,425
12816341,10.1543,7.25156,429,268637,0.024016,0.02,1,117288,116859,429
12818421,12.4309,11.0503,430,268637,0.0288032,0.03,1,117301,116871,430
12820501,11.2862,12.6101,428,268637,0.00576064,0.04,1,117312,116884,428
12822161,8.65723,10.522,426,268637,0.0251521,0.03,1,117320,116894,426
12824241,9.73145,10.9044,425,268637,0.0130304,0.03,1,117330,116905,425
12827161,11.5463,11.7809,425,268637,0.0266061,0.06,1,117342,116917,425
12830081,8.70926,8.75618,425,268637,0.0293212,0.02,1,117350,116925,425
12832561,8.94185,8.15124,426,268637,0.0618642,0.03,1,117359,116933,426
12835481,11.3884,11.2302,426,268637,0.0123728,0.04,1,117371,116945,426
12837141,6.27767,8.64605,423,268637,0.0264746,0.03,1,117376,116953,423
12840061,7.65553,5.72921,426,268637,0.0292949,0.05,1,117384,116958,426
12842981,7.13111,7.54584,425,268637,0.013859,0.05,1,117391,116966,425
12845041,8.62622,7.90917,426,268637,0.0187718,0,1,117400,116974,426
12847961,8.92524,7.98183,427,268637,0.0357544,0.06,1,117409,116982,427
12850881,7.38505,7.99637,426,268637,0.0151509,0.05,1,117416,116990,426
12853781,8.67701,7.99927,427,268637,0.0350302,0.02,1,117425,116998,427
12856701,8.1354,7.99985,427,268637,0.031006,0.08,1,117433,117006,427
12859621,7.22708,7.99997,426,268637,0.0222012,0.03,1,117440,117014,426
12862541,7.84542,7.99999,426,268637,0.0124402,0.03,1,117448,117022,426
12865461,8.76908,8,427,268637,0.010488,0.05,1,117457,117030,427
12868341,6.55382,8,425,268637,0.0260976,0.04,1,117463,117038,425
12871261,7.71076,8,425,268637,0.0132195,0.03,1,117471,117046,425
12874181,9.54215,8,427,268637,0.0106439,0.01,1,117481,117054,427
12877101,7.50843,8,426,268637,0.0261288,0.03,1,117488,117062,426
12880021,7.10169,8,425,268637,0.0132258,0.05,1,117495,117070,425
12882901,8.62034,8,426,268637,0.0426451,0.03,1,117504,117078,426
12885821,7.32407,8,425,268637,0.024529,0.05,1,117511,117086,425
12888101,7.06481,8,424,268637,0.0129058,0.03,1,117518,117094,424
12891021,7.01296,6.4,425,268637,0.0265812,0.03,1,117525,117100,425
12893941,8.60259,7.68,426,268637,0.0373162,0.01,1,117534,117108,426
12896001,8.12052,7.936,426,268637,0.00746325,0.03,1,117542,117116,426
12898921,8.0241,7.9872,426,268637,0.00949265,0.02,1,117550,117124,426
12901841,8.00482,7.99744,426,268637,0.00989853,0.04,1,117558,117132,426
12904761,7.20096,7.99949,425,268637,0.0419797,0.05,1,117565,117140,425
12907681,8.64019,7.9999,426,268637,0.0323959,0,1,117574,117148,426
12910601,8.12804,7.99998,426,268637,0.00647919,0.06,1,117582,117156,426
12913521,8.82561,8,427,268637,0.00929584,0.05,1,117591,117164,427
12916441,8.16512,8,427,268637,0.0258592,0.04,1,117599,117172,427
12918261,8.03302,8,427,268637,0.0131718,0.06,1,117607,117180,427
12920341,12.0066,9.6,430,268637,0.0106344,0.05,1,117620,117190,430
12922421,12.8013,12.32,430,268637,0.0101269,0.01,1,117633,117203,430
12925341,9.76026,12.064,427,268637,0.00202537,0.06,1,117642,117215,427
12928261,7.55205,8.8128,426,268637,0.0324051,0.04,1,117649,117223,426
12931181,7.91041,8.16256,426,268637,0.00648101,0.06,1,117657,117231,426
12932821,5.58208,8.03251,423,268637,0.0012962,0.05,1,117662,117239,423
12934481,7.51642,6.4065,425,268637,0.0322592,0.04,1,117670,117245,425
12937401,18.3033,16.4813,427,268637,0.0304518,0.03,1,117691,117264,427
12940321,9.26066,9.69626,426,268637,0.0140904,0.03,1,117698,117272,426
12943241,8.25213,8.33925,426,268637,0.0108181,0.05,1,117706,117280,426
12944881,7.25043,8.06785,425,268637,0.0101636,0.03,1,117713,117288,425
12946961,8.65009,8.01357,426,268637,0.0100327,0,1,117722,117296,426
12949041,13.73,14.4027,425,268637,0.0260065,0.05,1,117737,117312,425
12951961,13.146,11.6805,427,268637,0.0132013,0,1,117750,117323,427
12954661,8.2292,8.73611,426,268637,0.00264026,0.08,1,117757,117331,426
12956741,8.84584,7.34722,428,268637,0.0245281,0.06,1,117766,117338,428
12958821,9.76917,9.46944,428,268637,0.0449056,0.08,1,117776,117348,428
12960481,7.55383,9.89389,425,268637,0.00898112,0.05,1,117783,117358,425
12963401,7.11077,5.97878,427,268637,0.00179622,0,1,117790,117363,427
12965061,6.22215,7.59576,425,268637,0.0323592,0.06,1,117796,117371,425
12967141,10.0444,7.11915,429,268637,0.0304719,0.02,1,117807,117378,429
12970061,9.20889,11.0238,426,268637,0.0140944,0.05,1,117816,117390,426
12972341,9.04178,8.60477,427,268637,0.0188189,0.02,1,117825,117398,427
12975261,6.60836,8.12095,425,268637,0.0117638,0.06,1,117831,117406,425
12978161,9.32167,8.02419,427,268637,0.0103528,0.06,1,117841,117414,427
12981081,9.06433,9.60484,426,268637,0.0100706,0.03,1,117850,117424,426
12984001,7.41287,8.32097,425,268637,0.00201411,0.04,1,117857,117432,425
12986921,8.68257,8.06419,426,268637,0.00840282,0.05,1,117866,117440,426
12989841,8.13651,8.01284,426,268637,0.0256806,0.03,1,117874,117448,426
12992761,7.2273,8.00257,425,268637,0.0131361,0.06,1,117881,117456,425
12995681,8.64546,8.00051,426,268637,0.0266272,0.03,1,117890,117464,426
12998601,7.32909,8.0001,425,268637,0.0373254,0.04,1,117897,117472,425
13001521,7.86582,8.00002,425,268637,0.0554651,0.05,1,117905,117480,425
13004441,8.77316,8,426,268637,0.051093,0,1,117914,117488,426
13007361,8.15463,8,426,268637,0.0502186,0.05,1,117922,117496,426
13010281,8.03093,8,426,268637,0.0500437,0.03,1,117930,117504,426
13013201,7.20619,8,425,268637,0.0260087,0.03,1,117937,117512,425
13016121,8.64124,8,426,268637,0.0132017,0.05,1,117946,117520,426
13019041,8.12825,8,426,268637,0.0106403,0.03,1,117954,117528,426
13021841,7.22565,8,425,268637,0.0341281,0.05,1,117961,117536,425
13024761,9.44513,8,427,268637,0.0308256,0.03,1,117971,117544,427
13027681,7.48903,8,426,268637,0.00616512,0.04,1,117978,117552,426
13030581,7.89781,8,426,268637,0.00923302,0.05,1,117986,117560,426
13032241,7.17956,8,425,268637,0.00984661,0.01,1,117993,117568,425
13035161,7.83591,8,425,268637,0.0259693,0.01,1,118001,117576,425
13038081,8.76718,8,426,268637,0.0371939,0.01,1,118010,117584,426
13041001,7.35344,8,425,268637,0.0154388,0.04,1,118017,117592,425
13043681,8.67069,8,426,268637,0.0270878,0.03,1,118026,117600,426
13046601,10.5341,10.4,426,268637,0.0134176,0.04,1,118037,117611,426
13048881,9.30683,8.48,427,268637,0.0186835,0.05,1,118046,117619,427
13050961,5.06137,6.496,425,268637,0.0117367,0.04,1,118050,117625,425
13053041,9.81227,10.0992,425,268637,0.00234734,0.01,1,118061,117636,425
13055961,9.16245,8.41984,426,268637,0.0164695,0.03,1,118070,117644,426
13057621,9.83249,8.08397,428,268637,0.0352939,0,1,118080,117652,428
13059281,5.9665,8.81679,424,268637,0.0310588,0.03,1,118085,117661,424
13062201,11.5933,10.5634,426,268637,0.00621176,0.02,1,118098,117672,426
13065121,8.71866,8.51267,426,268637,0.00124235,0.06,1,118106,117680,426
13066981,10.5437,8.10253,429,268637,0.00024847,0.02,1,118117,117688,429
13069061,13.3087,11.2205,431,268637,0.00804969,0.05,1,118131,117700,431
13071981,9.06175,12.6441,426,268637,0.0176099,0.03,1,118139,117713,426
13074901,8.21235,8.92882,426,268637,0.027522,0.06,1,118147,117721,426
13077821,8.84247,8.18576,427,268637,0.0135044,0.07,1,118156,117729,427
13079461,13.7685,8.03715,434,268637,0.0107009,0.03,1,118171,117737,434
13082161,9.9537,15.2074,426,268637,0.0101402,0.05,1,118180,117754,426
13085081,9.19074,10.2415,426,268637,0.010028,0.03,1,118189,117763,426
13086741,8.23815,8.4483,426,268637,0.00200561,0.03,1,118197,117771,426
13089661,8.84763,8.88966,426,268637,0.00840112,0.03,1,118206,117780,426
13091521,6.56953,8.17793,424,268637,0.00968022,0.04,1,118212,117788,424
13093601,8.51391,8.03559,425,268637,0.00993604,0.03,1,118221,117796,425
13096521,14.5028,13.6071,426,268637,0.0259872,0.05,1,118237,117811,426
13099441,9.30056,9.12142,426,268637,0.0371974,0.04,1,118245,117819,426
13102341,7.46011,8.22428,425,268637,0.0154395,0.05,1,118252,117827,425
13104421,7.09202,8.04486,424,268637,0.0110879,0.03,1,118259,117835,424
13107341,7.0184,6.40897,425,268637,0.0262176,0.03,1,118266,117841,425
13109201,7.80368,7.68179,425,268637,0.0372435,0.05,1,118274,117849,425
13112121,11.9607,11.1364,426,268637,0.0154487,0.02,1,118287,117861,426
13115041,8.79215,8.62727,426,268637,0.0270897,0.03,1,118295,117869,426
13117961,8.15843,8.12545,426,268637,0.0134179,0.04,1,118303,117877,426
13120881,7.23169,8.02509,425,268637,0.00268359,0.06,1,118310,117885,425
13123801,7.84634,8.00502,425,268637,0.0165367,0.01,1,118318,117893,425
13125841,8.76927,8.001,426,268637,0.0193073,0.04,1,118327,117901,426
13128761,7.35385,6.4002,427,268637,0.0278615,0.05,1,118334,117907,427
13131681,7.87077,7.68004,427,268637,0.0295723,0.06,1,118342,117915,427
13134601,7.17415,7.93601,426,268637,0.0139145,0.06,1,118349,117923,426
13137521,7.03483,7.9872,425,268637,0.0107829,0.06,1,118356,117931,425
13139781,7.00697,7.99744,424,268637,0.00215658,0.03,1,118363,117939,424
13142701,7.80139,6.39949,426,268637,0.0244313,0.04,1,118371,117945,426
13145621,7.16028,7.6799,425,268637,0.0288863,0.04,1,118378,117953,425
13148101,7.83206,7.93598,425,268637,0.0137773,0.07,1,118386,117961,425
13151021,7.16641,7.1872,425,268637,0.00275545,0.04,1,118393,117968,425
13153941,7.83328,7.83744,425,268637,0.00855109,0.05,1,118401,117976,425
13156861,8.76666,7.96749,426,268637,0.00971022,0.03,1,118410,117984,426
13159541,7.35333,7.9935,425,268637,0.00994204,0.05,1,118417,117992,425
13162461,7.87067,7.1987,426,268637,0.0179884,0.03,1,118425,117999,426
13165361,7.17413,7.83974,425,268637,0.0115977,0.04,1,118432,118007,425
13168281,9.43483,7.96795,427,268637,0.0263195,0.02,1,118442,118015,427
13169941,9.08697,7.99359,428,268637,0.0132639,0.04,1,118451,118023,428
13172861,8.21739,9.59872,426,268637,0.0266528,0.04,1,118459,118033,426
13175781,7.24348,8.31974,425,268637,0.0213306,0.03,1,118466,118041,425
13178261,11.0487,8.06395,429,268637,0.0122661,0.03,1,118478,118049,429
13181181,7.80974,10.4128,425,268637,0.0184532,0.06,1,118485,118060,425
13184081,7.96195,8.48256,425,268637,0.0116906,0.04,1,118493,118068,425
13186161,11.9924,11.2965,426,268637,0.0263381,0.04,1,118506,118080,426
13189081,11.9985,12.6593,425,268637,0.0372676,0,1,118518,118093,425
13192001,8.7997,8.93186,425,268637,0.0234535,0.01,1,118526,118101,425
13193861,8.95994,8.18637,426,268637,0.0126907,0.03,1,118535,118109,426
13195521,6.59199,8.03727,424,268637,0.00253814,0.03,1,118541,118117,424
13197601,6.1184,5.60745,425,268637,0.0245076,0.02,1,118547,118122,425
13199681,12.4237,12.3215,425,268637,0.0289015,0.03,1,118561,118136,425
13202601,10.4847,10.4643,425,268637,0.0137803,0.03,1,118571,118146,425
13204261,9.29695,8.49286,426,268637,0.0107561,0.01,1,118580,118154,426
13207181,7.45939,8.09857,425,268637,0.0101512,0.04,1,118587,118162,425
13209461,9.49188,8.01971,427,268637,0.0100302,0.03,1,118597,118170,427
13211541,9.09838,8.80394,427,268637,0.010006,0.02,1,118606,118179,427
13213201,6.61968,8.96079,424,268637,0.0260012,0,1,118612,118188,424
13216121,9.32393,8.99216,425,268637,0.0132002,0.03,1,118622,118197,425
13218821,9.06479,8.19843,426,268637,0.04264,0.04,1,118631,118205,426
13220481,8.21296,8.83969,425,268637,0.032528,0.03,1,118639,118214,425
13223401,12.8426,11.3679,427,268637,0.0225056,0.03,1,118653,118226,427
13226101,9.76852,8.67359,428,268637,0.0445011,0.06,1,118662,118234,428
13228181,10.7537,8.93472,430,268637,0.0489002,0.05,1,118673,118243,430
13231101,8.55074,10.5869,427,268637,0.01778,0.05,1,118681,118254,427
13232961,6.51015,8.51739,425,268637,0.027556,0.06,1,118687,118262,425
13235881,8.50203,8.10348,426,268637,0.0215112,0.03,1,118696,118270,426
13238801,8.90041,8.0207,427,268637,0.0683022,0.04,1,118705,118278,427
13241701,8.18008,8.00414,427,268637,0.0856605,0.03,1,118713,118286,427
13243781,9.63602,9.60083,427,268637,0.105132,0.01,1,118723,118296,427
13245441,7.5272,9.92017,424,268637,0.0690264,0,1,118730,118306,424
13248361,7.10544,5.98403,426,268637,0.0618053,0.03,1,118737,118311,426
13251281,7.82109,7.59681,426,268637,0.0203611,0.02,1,118745,118319,426
13254201,7.96422,7.91936,426,268637,0.0200722,0.03,1,118753,118327,426
13256881,7.19284,7.98387,425,268637,0.00401444,0.04,1,118760,118335,425
13259801,11.0386,11.1968,425,268637,0.000802888,0.03,1,118772,118347,425
13262721,9.40771,8.63935,426,268637,0.0401606,0.04,1,118781,118355,426
13265641,8.28154,8.12787,426,268637,0.0480321,0.05,1,118789,118363,426
13268561,7.25631,8.02557,425,268637,0.0176064,0.04,1,118796,118371,425
13271481,8.65126,8.00511,426,268637,0.0195213,0,1,118805,118379,426
13274401,8.13025,8.00102,426,268637,0.00390426,0.04,1,118813,118387,426
13277321,7.22605,8.0002,425,268637,0.0167809,0.06,1,118820,118395,425
13280241,7.84521,8.00004,425,268637,0.0113562,0.01,1,118828,118403,425
13283161,7.96904,8.00001,425,268637,0.0102712,0.05,1,118836,118411,425
13286081,8.79381,8,426,268637,0.0180542,0.02,1,118845,118419,426
13289001,8.15876,8,426,268637,0.0116108,0.03,1,118853,118427,426
13291921,8.03175,8,426,268637,0.0103222,0.05,1,118861,118435,426
13294841,7.20635,8,425,268637,0.0100644,0.01,1,118868,118443,425
13297761,8.64127,8,426,268637,0.0260129,0.03,1,118877,118451,426
13300561,8.12825,8,426,268637,0.0292026,0.04,1,118885,118459,426
13303481,12.0257,12,426,268637,0.00584052,0.05,1,118898,118472,426
13306401,8.80513,8.8,426,268637,0.0331681,0.03,1,118906,118480,426
13309321,8.16103,8.16,426,268637,0.0386336,0.03,1,118914,118488,426
13312001,8.03221,8.032,426,268637,0.0477267,0.03,1,118922,118496,426
13314921,7.20644,7.2064,426,268637,0.0335453,0.04,1,118929,118503,426
13317201,7.04129,7.84128,425,268637,0.00670907,0.03,1,118936,118511,425
13320121,15.0083,15.1683,425,268637,0.0333418,0,1,118953,118528,425
13323041,9.40165,9.43365,425,268637,0.0146684,0,1,118961,118536,425
13325961,9.08033,8.28673,426,268637,0.0189337,0.01,1,118970,118544,426
13328641,8.21607,8.05735,426,268637,0.0357867,0.05,1,118978,118552,426
13330721,9.64321,9.61147,426,268637,0.0231573,0.04,1,118988,118562,426
13332801,13.9286,14.7223,425,268637,0.0286315,0.01,1,119003,118578,425
13334881,9.98573,10.1445,425,268637,0.0377263,0.03,1,119012,118587,425
13337801,8.39715,8.42889,425,268637,0.0475453,0.06,1,119020,118595,425
13339461,8.87943,8.08578,426,268637,0.0415091,0.02,1,119029,118603,426
13341541,11.3759,7.21716,431,268637,0.0163018,0.02,1,119041,118610,431
13344241,7.87518,11.8434,425,268637,0.0192604,0.06,1,119048,118623,425
13346321,8.77504,7.96869,427,268637,0.00385207,0.05,1,119057,118630,427
13349241,8.95501,9.59374,426,268637,0.000770414,0.05,1,119066,118640,426
13351521,8.991,8.31875,427,268637,0.0241541,0.05,1,119075,118648,427
13353601,11.3982,12.8637,425,268637,0.0528308,0.05,1,119087,118662,425
13356521,11.0796,10.5727,426,268637,0.0105662,0.01,1,119098,118672,426
13358801,9.41593,8.51455,427,268637,0.0261132,0.05,1,119107,118680,427
13361721,7.48319,6.50291,428,268637,0.0132226,0.06,1,119114,118686,428
13364641,8.69664,7.70058,429,268637,0.0266445,0.07,1,119123,118694,429
13367541,10.5393,7.94012,432,268637,0.0133289,0.09,1,119134,118702,432
13370461,8.50787,11.988,427,268637,0.0346658,0.11,1,119142,118715,427
13372321,8.10157,8.7976,427,268637,0.0469332,0.11,1,119150,118723,427
13375241,7.22031,8.15952,426,268637,0.0733866,0.06,1,119157,118731,426
13377941,13.4441,8.0319,433,268637,0.0706773,0.02,1,119172,118739,433
13380861,9.08881,13.6064,426,268637,0.0541355,0.06,1,119180,118754,426
13383781,9.01776,9.12128,427,268637,0.0748271,0.04,1,119189,118762,427
13386701,8.20355,8.22426,427,268637,0.0549654,0.06,1,119197,118770,427
13389621,7.24071,8.04485,426,268637,0.0349931,0.04,1,119204,118778,426
13392541,7.84814,8.00897,426,268637,0.0229986,0.05,1,119212,118786,426
13394581,9.56963,8.00179,428,268637,0.0365997,0.05,1,119222,118794,428
13397501,8.31393,9.60036,426,268637,0.0393199,0.01,1,119230,118804,426
13400421,8.06279,8.32007,426,268637,0.00786399,0.02,1,119238,118812,426
13403341,8.01256,8.06401,426,268637,0.0095728,0.03,1,119246,118820,426
13406261,8.00251,8.0128,426,268637,0.0179146,0.03,1,119254,118828,426
13409181,8.0005,8.00256,426,268637,0.0195829,0.04,1,119262,118836,426
13412101,8.0001,8.00051,426,268637,0.0359166,0.03,1,119270,118844,426
13415021,8.00002,8.0001,426,268637,0.0231833,0.03,1,119278,118852,426
13417941,8,8.00002,426,268637,0.0366367,0.05,1,119286,118860,426
13420861,8,8,426,268637,0.0393273,0.05,1,119294,118868,426
13423781,7.2,8,425,268637,0.0158655,0.05,1,119301,118876,425
13426701,7.84,8,425,268637,0.0111731,0,1,119309,118884,425
13429621,8.768,8,426,268637,0.0262346,0.05,1,119318,118892,426
13432541,8.1536,8,426,268637,0.0212469,0.07,1,119326,118900,426
13435141,8.03072,8,426,268637,0.0122494,0.09,1,119334,118908,426
13438061,7.20614,7.2,426,268637,0.00244988,0.07,1,119341,118915,426
13439921,6.24123,7.84,424,268637,0.04849,0.05,1,119347,118923,424
13442841,6.84825,5.568,426,268637,0.033698,0.01,1,119354,118928,426
13444501,8.56965,7.5136,427,268637,0.0787396,0.05,1,119363,118936,427
13447421,7.31393,8.70272,425,268637,0.0237479,0.04,1,119370,118945,425
13449701,7.06279,8.14054,424,268637,0.0367496,0.04,1,119377,118953,424
13451781,15.0126,6.42811,435,268637,0.0153499,0.04,1,119394,118959,435
13454701,9.40251,14.8856,426,268637,0.00306998,0.01,1,119402,118976,426
13457621,8.2805,9.37712,426,268637,0.008614,0.04,1,119410,118984,426
13460541,8.0561,8.27542,426,268637,0.0257228,0.03,1,119418,118992,426
13463221,9.61122,8.05508,428,268637,0.0131446,0.04,1,119428,119000,428
13465301,11.5222,8.81102,431,268637,0.0106289,0.07,1,119440,119009,431
13467381,8.70445,11.3622,427,268637,0.0181258,0.05,1,119448,119021,427
13469461,6.54089,9.47244,424,268637,0.0436252,0.05,1,119454,119030,424
13471541,8.50818,6.69449,427,268637,0.032725,0.04,1,119463,119036,427
13473621,13.7016,9.3389,432,268637,0.00654501,0,1,119478,119046,432
13476541,9.14033,13.0678,426,268637,0.049309,0.04,1,119486,119060,426
13478821,7.42807,9.01356,425,268637,0.0338618,0.05,1,119493,119068,425
13480901,7.08561,6.60271,426,268637,0.0307724,0.07,1,119500,119074,426
13482561,5.41712,6.12054,425,268637,0.0141545,0.08,1,119505,119080,425
13484641,10.6834,10.0241,426,268637,0.0428309,0.02,1,119517,119091,426
13486721,11.7367,12.4048,425,268637,0.0325662,0.01,1,119529,119104,425
13489641,12.7473,12.881,425,268637,0.0145132,0.03,1,119542,119117,425
13492561,10.5495,8.97619,427,268637,0.00290265,0.02,1,119552,119125,427
13495041,8.50989,8.19524,427,268637,0.00858053,0.05,1,119560,119133,427
13497961,9.70198,7.23905,430,268637,0.0177161,0.05,1,119570,119140,430
13500881,8.3404,7.84781,430,268637,0.0115432,0.09,1,119578,119148,430
13502741,8.06808,7.96956,430,268637,0.0343086,0.13,1,119586,119156,430
13505441,7.21362,9.59391,427,268637,0.0468617,0.12,1,119593,119166,427
13508361,8.64272,7.51878,429,268637,0.0493723,0.1,1,119602,119173,429
13511281,7.32854,7.90376,428,268637,0.0498745,0.11,1,119609,119181,428
13513141,11.8657,7.98075,433,268637,0.0259749,0.05,1,119622,119189,433
13516061,8.77314,13.5962,426,268637,0.013195,0.02,1,119630,119204,426
13518981,8.15463,9.11923,426,268637,0.034639,0.05,1,119638,119212,426
13521901,7.23093,8.22385,425,268637,0.0149278,0.05,1,119645,119220,425
13524821,7.84619,8.04477,425,268637,0.0109856,0.03,1,119653,119228,425
13526661,7.96924,8.00895,425,268637,0.0101971,0.03,1,119661,119236,425
13529581,7.99385,6.40179,427,268637,0.0180394,0.03,1,119669,119242,427
13532501,7.99877,7.68036,427,268637,0.0356079,0.03,1,119677,119250,427
13535421,7.19975,7.93607,426,268637,0.0311216,0.04,1,119684,119258,426
13538101,7.83995,7.98721,426,268637,0.0622243,0.04,1,119692,119266,426
13541021,7.96799,7.19744,427,268637,0.0204449,0.06,1,119700,119273,427
13542881,6.3936,7.83949,425,268637,0.028089,0.05,1,119706,119281,425
13545801,9.27872,9.5679,425,268637,0.0296178,0.03,1,119716,119291,425
13548721,9.05574,8.31358,426,268637,0.0779236,0.02,1,119725,119299,426
13551641,7.41115,8.06272,425,268637,0.0635847,0.04,1,119732,119307,425
13554561,7.88223,8.01254,425,268637,0.0767169,0.02,1,119740,119315,425
13557481,7.97645,8.00251,425,268637,0.0153434,0,1,119748,119323,425
13560401,8.79529,8.0005,426,268637,0.0350687,0.03,1,119757,119331,426
13563321,8.15906,8.0001,426,268637,0.0150137,0.08,1,119765,119339,426
13566241,8.83181,8.00002,427,268637,0.0190027,0.07,1,119774,119347,427
13569161,6.56636,8,425,268637,0.0118005,0.09,1,119780,119355,425
13572081,8.51327,8,426,268637,0.0263601,0.05,1,119789,119363,426
13574501,7.30265,8,425,268637,0.013272,0.07,1,119796,119371,425
13577421,7.86053,7.2,426,268637,0.0106544,0.05,1,119804,119378,426
13579701,6.37211,7.84,424,268637,0.0101309,0.06,1,119810,119386,424
13581781,11.6744,6.368,431,268637,0.0420262,0.05,1,119823,119392,431
13583861,7.13488,11.6736,424,268637,0.0324052,0.05,1,119829,119405,424
13585521,7.02698,7.13472,425,268637,0.046481,0.03,1,119836,119411,425
13588441,7.0054,7.02694,425,268637,0.0412962,0.04,1,119843,119418,425
13590721,7.80108,7.80539,425,268637,0.0162592,0.05,1,119851,119426,425
13593641,10.3602,9.56108,426,268637,0.0272518,0.03,1,119862,119436,426
13595921,9.27204,8.31222,427,268637,0.00545037,0.07,1,119871,119444,427
13598001,6.65441,8.06244,425,268637,0.0330901,0.05,1,119877,119452,425
13600081,6.93088,6.41249,426,268637,0.046618,0.04,1,119884,119458,426
13602161,13.3862,12.4825,427,268826,0.0173236,0.07,1,119899,119472,427
13604241,10.6772,12.0965,425,268826,0.0274647,0.02,1,119909,119484,425
13607161,14.1354,13.6193,426,268826,0.0134929,0.01,1,119924,119498,426
13610081,9.22709,9.12386,426,268826,0.0266986,0.06,1,119932,119506,426
13613001,8.24542,8.22477,426,268826,0.0293397,0.05,1,119940,119514,426
13615681,8.04908,8.04495,426,268826,0.0298679,0.05,1,119948,119522,426
13617761,10.4098,10.409,426,268826,0.0299736,0.04,1,119959,119533,426
13619841,12.482,13.2818,425,268826,0.0539947,0.03,1,119972,119547,425
13622761,12.0964,12.2564,425,268826,0.0187989,0.04,1,119984,119559,425
13625681,9.61928,8.85127,426,268826,0.0197598,0,1,119993,119567,426
13627541,7.52386,8.17025,425,268826,0.011952,0.06,1,120000,119575,425
13630461,9.50477,7.23405,428,268826,0.00239039,0.05,1,120010,119582,428
13632741,8.30095,7.84681,428,268826,0.00847808,0.05,1,120018,119590,428
13635661,8.86019,8.76936,428,268826,0.00169562,0.05,1,120027,119599,428
13637941,8.17204,8.15387,428,268826,0.0243391,0.06,1,120035,119607,428
13640861,8.03441,9.63077,426,268826,0.0288678,0.03,1,120043,119617,426
13643141,7.20688,8.32615,425,268826,0.0617736,0.04,1,120050,119625,425
13645221,8.64138,6.46523,428,268826,0.0523547,0.04,1,120059,119631,428
13646881,7.32828,10.093,424,268826,0.0344709,0.02,1,120066,119642,424
13649801,10.2657,9.21861,426,268826,0.0308942,0.03,1,120077,119651,426
13652081,8.45313,8.24372,426,268826,0.0301788,0.04,1,120085,119659,426
13655001,6.49063,6.44874,426,268826,0.0140358,0.04,1,120091,119665,426
13657281,6.89813,7.68975,425,268826,0.0108072,0.06,1,120098,119673,425
13660201,8.57963,6.33795,428,268826,0.0101614,0.03,1,120107,119679,428
13663121,6.51593,7.66759,426,268826,0.0260323,0.06,1,120113,119687,426
13665601,7.70319,7.93352,426,268826,0.0292065,0.03,1,120121,119695,426
13668521,7.94064,7.1867,427,268826,0.0458413,0.04,1,120129,119702,427
13671441,9.58813,7.83734,429,268826,0.0251683,0.05,1,120139,119710,429
13674361,8.31763,7.96747,429,268826,0.0130337,0.08,1,120147,119718,429
13676001,7.26352,7.99349,428,268826,0.00260673,0.06,1,120154,119726,428
13678921,5.4527,7.9987,425,268826,0.0325213,0.06,1,120159,119734,425
13681841,8.29054,7.99974,426,268826,0.0305043,0.03,1,120168,119742,426
13684761,7.25811,7.99995,425,268826,0.0541009,0.04,1,120175,119750,425
13687681,8.65162,7.99999,426,268826,0.0348202,0,1,120184,119758,426
13690601,7.33032,8,425,268826,0.046964,0.02,1,120191,119766,425
13693521,8.66607,8,426,268826,0.0413928,0.03,1,120200,119774,426
13696441,7.33321,8,425,268826,0.0162786,0.05,1,120207,119782,425
13699361,7.86664,8,425,268826,0.0272557,0.03,1,120215,119790,425
13701381,8.77333,8,426,268826,0.0214511,0.03,1,120224,119798,426
13704301,8.95467,8,427,268826,0.0282902,0.04,1,120233,119806,427
13707221,7.39093,8,426,268826,0.037658,0.06,1,120240,119814,426
13710141,10.2782,8,429,268826,0.0315316,0.04,1,120251,119822,429
13711781,7.65564,8,428,268826,0.0303063,0.06,1,120258,119830,428
13714701,7.13113,8.8,426,268826,0.00606126,0.05,1,120265,119839,426
13717621,7.82623,8.16,426,268826,0.0172123,0.04,1,120273,119847,426
13720101,7.16524,8.032,425,268826,0.0274424,0.03,1,120280,119855,425
13723021,7.83305,7.2064,426,268826,0.0374885,0.02,1,120288,119862,426
13725301,11.1666,7.84128,430,268826,0.0554977,0.05,1,120300,119870,430
13726961,6.23332,10.3683,424,268826,0.0510995,0.05,1,120305,119881,424
13729881,10.8467,8.47365,428,268826,0.0342199,0.02,1,120317,119889,428
13732581,11.7693,8.09473,432,268826,0.022844,0,1,120329,119897,432
13734661,8.75387,12.8189,426,268826,0.0445688,0.03,1,120337,119911,426
13736741,12.9508,9.76379,431,268826,0.0249138,0.04,1,120351,119920,431
13738821,11.3902,12.3528,429,268826,0.0289828,0.04,1,120362,119933,429
13740481,7.87803,10.4706,426,268826,0.0137966,0.06,1,120369,119943,426
13743401,9.57561,8.49411,428,268826,0.0267593,0.05,1,120379,119951,428
13746321,7.51512,8.09882,427,268826,0.0453519,0.09,1,120386,119959,427
13748801,7.10302,8.01976,426,268826,0.0490704,0.05,1,120393,119967,426
13750881,7.8206,8.80395,425,268826,0.0498141,0.02,1,120401,119976,425
13753801,15.1641,14.5608,426,268826,0.00996281,0.03,1,120418,119992,426
13756081,9.43282,9.31216,426,268826,0.0259926,0.03,1,120426,120000,426
13758161,8.28656,8.26243,426,268826,0.141199,0.02,1,120434,120008,426
13761081,12.8573,12.8525,426,268826,0.14024,0.03,1,120448,120022,426
13764001,9.77146,8.9705,427,268826,0.140048,0.06,1,120457,120030,427
13766481,8.35429,8.1941,427,268826,0.10001,0.07,1,120465,120038,427
13769401,9.67086,9.63882,427,268826,0.116002,0.05,1,120475,120048,427
13772321,7.53417,8.32776,426,268826,0.1112,0.04,1,120482,120056,426
13775241,8.70683,8.06555,427,268826,0.11824,0.03,1,120491,120064,427
13777921,7.34137,8.01311,426,268826,0.111648,0.02,1,120498,120072,426
13780841,13.4683,14.4026,425,268826,0.0943296,0.02,1,120513,120088,425
13783121,9.09365,9.28052,425,268826,0.0748659,0.03,1,120521,120096,425
13786041,7.41873,6.6561,426,268826,0.0869732,0.04,1,120528,120102,426
13788961,9.48375,7.73122,428,268826,0.0733946,0.01,1,120538,120110,428
13791861,7.49675,7.94624,427,268826,0.0786789,0.07,1,120545,120118,427
13794781,7.89935,7.98925,427,268826,0.0957358,0.05,1,120553,120126,427
13797701,7.17987,7.99785,426,268826,0.0751472,0.04,1,120560,120134,426
13800621,8.63597,7.99957,427,268826,0.0790294,0.03,1,120569,120142,427
13803541,8.12719,7.99991,427,268826,0.0558059,0.05,1,120577,120150,427
13806461,8.02544,7.99998,427,268826,0.0591612,0.05,1,120585,120158,427
13809121,7.20509,8,426,268826,0.0438322,0.06,1,120592,120166,426
13812041,7.84102,8.8,425,268826,0.0327664,0.05,1,120600,120175,425
13814961,7.9682,8.16,425,268826,0.0385533,0.05,1,120608,120183,425
13816821,11.9936,8.032,430,268826,0.0397107,0.01,1,120621,120191,430
13819741,9.59873,12.0064,426,268826,0.0159421,0,1,120630,120204,426
13822661,8.31975,8.80128,426,268826,0.0191884,0.06,1,120638,120212,426
13825581,8.06395,8.16026,426,268826,0.0278377,0.04,1,120646,120220,426
13828501,8.81279,8.03205,427,268826,0.0295675,0.06,1,120655,120228,427
13831421,7.36256,8.00641,426,268826,0.0459135,0.05,1,120662,120236,426
13834341,8.67251,8.00128,427,268826,0.0411827,0.06,1,120671,120244,427
13837261,7.3345,8.00026,426,268826,0.0162365,0.04,1,120678,120252,426
13840181,7.8669,8.00005,426,268826,0.0272473,0.06,1,120686,120260,426
13843101,7.97338,8.00001,426,268826,0.0134495,0.05,1,120694,120268,426
13845521,7.99468,8,426,268826,0.0426899,0.07,1,120702,120276,426
13848441,8.79894,7.2,428,268826,0.032538,0.03,1,120711,120283,428
13851361,7.35979,7.84,427,268826,0.0465076,0.07,1,120718,120291,427
13853841,7.87196,7.968,427,268826,0.0173015,0.07,1,120726,120299,427
13855921,6.37439,7.1936,426,268826,0.0354603,0.04,1,120732,120306,426
13858001,10.0749,9.43872,427,268826,0.0630921,0.07,1,120743,120316,427
13860081,9.21498,9.88774,426,268826,0.0766184,0.05,1,120752,120326,426
13863001,11.443,10.7775,427,268826,0.0393237,0.03,1,120764,120337,427
13865281,7.8886,8.55551,426,268826,0.0558647,0.03,1,120771,120345,426
13867361,15.1777,15.3111,426,268826,0.059173,0.01,1,120788,120362,426
13870281,11.0355,9.46222,428,268826,0.0438346,0.04,1,120798,120370,428
13872981,8.60711,8.29244,428,268826,0.0407669,0.1,1,120806,120378,428
13875061,8.92142,8.85849,428,268826,0.0481534,0.09,1,120815,120387,428
13877981,8.18428,9.7717,426,268826,0.0336307,0.01,1,120823,120397,426
13880901,8.03686,8.35434,426,268826,0.0307261,0.01,1,120831,120405,426
13883381,20.8074,8.07087,442,268826,0.0541452,0.03,1,120855,120413,442
13886301,9.76147,13.6142,434,268826,0.042829,0.2,1,120862,120428,434
13888581,7.55229,9.12283,433,268826,0.0485658,0.2,1,120869,120436,433
13890661,14.3105,9.02457,440,268826,0.0497132,0.11,1,120885,120445,440
13893581,6.86209,13.8049,430,268826,0.0339426,0.13,1,120890,120460,430
13895861,8.57242,9.16098,431,268826,0.0307885,0.12,1,120899,120468,431
13898781,8.11448,9.8322,429,268826,0.00615771,0.13,1,120907,120478,429
13901061,10.4229,8.36644,432,268826,0.0812315,0.13,1,120918,120486,432
13903981,8.48458,10.4733,429,268826,0.104246,0.11,1,120926,120497,429
13906901,7.29692,8.49466,428,268826,0.108849,0.11,1,120933,120505,428
13908961,7.85938,8.09893,428,268826,0.11777,0.11,1,120941,120513,428
13911881,11.9719,11.2198,429,268826,0.103554,0.09,1,120954,120525,429
13914801,8.79438,8.64396,429,268826,0.108711,0.1,1,120962,120533,429
13917701,12.9589,8.12879,435,268826,0.141742,0.11,1,120976,120541,435
13920621,8.19177,12.0258,429,268826,0.156348,0.11,1,120983,120554,429
13923541,6.43836,8.80515,427,268826,0.16727,0.11,1,120989,120562,427
13926461,8.48767,8.16103,428,268826,0.153454,0.11,1,120998,120570,428
13929381,6.49753,8.03221,426,268826,0.166691,0.08,1,121004,120578,426
13932301,7.69951,8.00644,426,268826,0.169338,0.07,1,121012,120586,426
13935221,8.7399,8.00129,427,268826,0.185868,0.07,1,121021,120594,427
13938141,6.54798,8.00026,425,268826,0.149174,0.06,1,121027,120602,425
13941061,8.5096,8.00005,426,268826,0.157835,0.03,1,121036,120610,426
13943981,7.30192,8.00001,425,268826,0.183567,0.03,1,121043,120618,425
13946821,7.86038,8,425,268826,0.212713,0.05,1,121051,120626,425
13948901,10.3721,8,428,268826,0.194543,0.04,1,121062,120634,428
13951821,7.67442,8.8,426,268826,0.190909,0.06,1,121069,120643,426
13954741,7.93488,8.16,426,268826,0.222182,0.04,1,121077,120651,426
13957661,7.98698,8.032,426,268826,0.236436,0.06,1,121085,120659,426
13960581,7.9974,8.0064,426,268826,0.255287,0.03,1,121093,120667,426
13963501,7.99948,8.00128,426,268826,0.267057,0.04,1,121101,120675,426
13965121,6.3999,8.00026,424,268826,0.245411,0.03,1,121107,120683,424
13968041,10.08,8.00005,427,268826,0.257082,0.01,1,121118,120691,427
13970961,9.216,8.00001,428,268826,0.243416,0.05,1,121127,120699,428
13973441,6.6432,8,426,268826,0.232683,0.06,1,121133,120707,426
13976361,7.72864,7.2,427,268826,0.238537,0.04,1,121141,120714,427
13979281,8.74573,7.84,428,268826,0.231707,0.05,1,121150,120722,428
13982201,8.14915,7.968,428,268826,0.230341,0.07,1,121158,120730,428
13985121,8.82983,7.9936,429,268826,0.246068,0.06,1,121167,120738,429
13986961,4.96597,7.99872,425,268826,0.249214,0.09,1,121171,120746,425
13989881,9.79319,8.79974,427,268826,0.249843,0.03,1,121182,120755,427
13992581,9.15864,8.15995,428,268826,0.217969,0.07,1,121191,120763,428
13994661,6.63173,8.83199,425,268826,0.227594,0.08,1,121197,120772,425
13996321,7.72635,6.5664,427,268826,0.245519,0.04,1,121205,120778,427
13998401,16.7453,17.3133,426,268826,0.265104,0.06,1,121224,120798,426
14000481,9.74905,8.26266,428,268826,0.237021,0.05,1,121232,120804,428
14003401,9.14981,10.4525,426,268826,0.199404,0.05,1,121241,120815,426
14006321,7.42996,8.49051,425,268826,0.175881,0.04,1,121248,120823,425
14008801,7.88599,8.0981,425,268826,0.163176,0.03,1,121256,120831,425
14011721,12.7772,11.2196,427,268826,0.152635,0.03,1,121270,120843,427
14013381,11.3554,8.64392,430,268826,0.182527,0.06,1,121281,120851,430
14015461,7.87109,10.5288,426,268826,0.188505,0.04,1,121288,120862,426
14018381,8.77422,8.50576,427,268826,0.149701,0.03,1,121297,120870,427
14020661,23.3548,8.10115,446,268826,0.16594,0.01,1,121324,120878,446
14023581,13.471,24.0202,429,268826,0.129188,0.08,1,121335,120906,429
14026501,9.89419,11.204,430,268826,0.121838,0.11,1,121344,120914,430
14029421,9.17884,8.64081,431,268826,0.112368,0.14,1,121353,120922,431
14032341,8.23577,8.12816,431,268826,0.110474,0.13,1,121361,120930,431
14035261,7.24715,8.02563,430,268826,0.110095,0.15,1,121368,120938,430
14038181,8.64943,8.00513,431,268826,0.0860189,0.12,1,121377,120946,431
14040001,6.52989,8.00103,429,268826,0.0812038,0.13,1,121383,120954,429
14042081,10.106,7.2002,433,268826,0.0882408,0.13,1,121394,120961,433
14045001,6.8212,6.24004,433,268826,0.0816481,0.17,1,121400,120967,433
14046661,9.36424,7.64801,435,268826,0.12033,0.19,1,121410,120975,435
14049581,9.07285,10.3296,433,268826,0.128066,0.13,1,121419,120986,433
14052501,9.01457,8.46592,434,268826,0.137613,0.16,1,121428,120994,434
14055421,6.60291,8.09318,432,268826,0.147523,0.17,1,121434,121002,432
14058341,8.52058,8.01864,433,268826,0.149505,0.18,1,121443,121010,433
14061261,8.90412,8.00373,434,268826,0.165901,0.17,1,121452,121018,434
14064181,8.18082,8.00075,434,268826,0.15318,0.18,1,121460,121026,434
14067101,9.63616,8.00015,436,268826,0.142636,0.22,1,121470,121034,436
14070021,8.32723,8.00003,436,268826,0.164527,0.25,1,121478,121042,436
14072661,7.26545,8.00001,435,268826,0.208905,0.25,1,121485,121050,435
14075581,7.85309,7.2,436,268826,0.233781,0.25,1,121493,121057,436
14078501,9.57062,7.84,438,268826,0.262756,0.23,1,121503,121065,438
14080981,8.31412,7.968,438,268826,0.228551,0.26,1,121511,121073,438
14083901,9.66282,8.7936,439,268826,0.24571,0.25,1,121521,121082,439
14086821,7.53256,8.15872,438,268826,0.249142,0.26,1,121528,121090,438
14089741,9.50651,8.03174,440,268826,0.233828,0.26,1,121538,121098,440
14092421,10.7013,8.00635,443,268826,0.230766,0.28,1,121549,121106,443
14095341,6.94026,12.0013,436,268826,0.254153,0.26,1,121555,121119,436
14098261,7.78805,8.80025,436,268826,0.266831,0.24,1,121563,121127,436
14101181,7.95761,8.16005,436,268826,0.261366,0.3,1,121571,121135,436
14104101,8.79152,8.03201,437,268826,0.228273,0.29,1,121580,121143,437
14107021,8.1583,8.0064,437,268826,0.205655,0.26,1,121588,121151,437
14109681,9.63166,8.00128,439,268826,0.233131,0.27,1,121598,121159,439
14112601,7.52633,7.20026,439,268826,0.238626,0.29,1,121605,121166,439
14115521,6.30527,7.84005,437,268826,0.271725,0.25,1,121611,121174,437
14118001,6.86105,7.96801,436,268826,0.286345,0.24,1,121618,121182,436
14120081,8.57221,7.1936,438,268826,0.297269,0.23,1,121627,121189,438
14123001,8.91444,7.83872,439,268826,0.307454,0.28,1,121636,121197,439
14125281,8.98289,7.96774,440,268826,0.285491,0.31,1,121645,121205,440
14127361,8.99658,9.59355,439,268826,0.337098,0.23,1,121654,121215,439
14129441,11.3993,15.5187,434,268826,0.36342,0.19,1,121666,121232,434
14132361,15.0799,15.1037,435,268826,0.384684,0.18,1,121682,121247,435
14135061,7.01597,9.42075,432,268826,0.396937,0.19,1,121687,121255,432
14137981,8.60319,7.48415,434,268826,0.391387,0.17,1,121696,121262,434
14139841,6.52064,7.89683,432,268826,0.406277,0.2,1,121702,121270,432
14142761,13.3041,11.9794,434,268826,0.465255,0.19,1,121717,121283,434
14145461,6.66083,8.79587,431,268826,0.501051,0.19,1,121722,121291,431
14147541,11.7322,7.35917,437,268826,0.46821,0.16,1,121735,121298,437
14149201,8.74643,12.6718,431,268826,0.485642,0.16,1,121743,121312,431
14152121,16.1493,18.5344,429,268826,0.481128,0.14,1,121761,121332,429
14154401,9.62986,10.1069,429,268826,0.456226,0.11,1,121769,121340,429
14157321,13.126,12.4214,430,268826,0.499245,0.13,1,121783,121353,430
14158981,9.02519,8.88427,430,268826,0.539849,0.1,1,121791,121361,430
14161901,8.20504,8.97686,429,268826,0.54797,0.09,1,121799,121370,429
14164821,6.44101,8.19537,427,268826,0.581594,0.1,1,121805,121378,427
14167741,8.4882,8.03907,428,268826,0.588319,0.09,1,121814,121386,428
14170661,8.89764,8.00781,429,268826,0.549664,0.11,1,121823,121394,429
14173121,9.77953,8.00156,431,268826,0.565933,0.15,1,121833,121402,431
14176041,12.3559,11.2003,432,268826,0.633187,0.12,1,121846,121414,432
14178741,7.27118,8.64006,430,268826,0.670637,0.17,1,121852,121422,430
14181661,10.2542,7.32801,434,268826,0.694127,0.15,1,121863,121429,434
14184581,7.65085,7.8656,433,268826,0.690826,0.18,1,121870,121437,433
14187061,9.53017,7.97312,435,268826,0.714165,0.16,1,121880,121445,435
14189981,9.90603,10.3946,434,268826,0.678833,0.15,1,121890,121456,434
14192901,9.18121,8.47892,435,268826,0.671767,0.21,1,121899,121464,435
14195821,9.03624,8.09578,436,268826,0.710353,0.24,1,121908,121472,436
14198741,9.80725,8.01916,438,268826,0.710071,0.24,1,121918,121480,438
14201621,10.7614,8.00383,441,268826,0.742014,0.24,1,121929,121488,441
14204541,6.95229,10.4008,436,268826,0.788403,0.25,2,121935,121499,436
14207461,9.39046,8.48015,438,268826,0.765681,0.23,2,121945,121507,438
14210381,8.27809,8.09603,438,268826,0.785136,0.27,2,121953,121515,438
14213061,12.8556,8.01921,444,268826,0.789027,0.25,2,121967,121523,444
14215981,8.97112,12.0038,439,268826,0.805805,0.26,2,121975,121536,439
14218901,5.79422,8.80077,436,268826,0.833161,0.28,2,121980,121544,436
14221821,8.35885,8.16015,437,268826,0.854632,0.24,2,121989,121552,437
14224741,8.07177,8.03203,437,268826,0.850926,0.27,2,121997,121560,437
14227661,8.01435,8.00641,437,268826,0.890185,0.26,2,122005,121568,437
14230581,7.20287,8.00128,436,268826,0.938037,0.24,2,122012,121576,436
14495941,67,73,481,227280,0.21,1,1,123473,122992,481
14495981,32.6,14.6,505,225860,0.09,1,1,123497,122992,505
14513201,11.32,26.92,481,225860,0.026,1,1,123503,123022,481
14514041,58.264,5.384,551,225240,0.0052,1,1,123573,123022,551
14520481,16.4528,61.0768,482,225240,0.00104,1,1,123579,123097,482
14526721,25.6906,41.0154,474,225240,0.000208,0.24,1,123607,123133,474
14529641,31.5381,33.0031,476,135445,4.16e-05,0.87,1,123640,123164,476
14532561,12.7076,14.6006,474,138365,8.32e-06,0.82,1,123648,123174,474
14535481,8.94152,10.9201,472,141285,0.00800166,0.8,1,123656,123184,472
14538401,9.7883,10.184,472,144205,0.0496003,0.85,1,123666,123194,472
14541321,10.7577,10.0368,473,147125,0.0739201,0.94,1,123677,123204,473
14544241,12.5515,10.0074,476,150045,0.070784,1,1,123690,123214,476
14547161,11.3103,10.0015,477,152965,0.118157,1,1,123701,123224,477
14550081,12.6621,10.0003,480,155885,0.159631,1,1,123714,123234,480
14553001,12.1324,10.0001,482,158805,0.151926,1,1,123726,123244,482
14555921,12.0265,10,484,161725,0.150385,1,1,123738,123254,484
14558841,9.6053,10,483,164645,0.158077,1,1,123747,123264,483
14561761,8.32106,10,481,167565,0.119615,1,1,123755,123274,481
14564681,8.86421,10,480,170485,0.0879231,1,1,123764,123284,480
14567601,11.3728,10,482,173405,0.0175846,1,1,123776,123294,482
14570521,9.47457,10,481,176325,0.0115169,0.99,1,123785,123304,481
14573441,9.89491,10,481,179245,0.00230338,0.99,1,123795,123314,481
14576361,9.97898,10,481,182165,0.00846068,1,1,123805,123324,481
14579281,9.1958,10,480,185085,0.00969214,1,1,123814,123334,480
14582201,8.23916,10,478,188005,0.00993843,1,1,123822,123344,478
14585121,7.24783,10,475,190925,0.0259877,1,1,123829,123354,475
14588041,8.64957,10,474,193845,0.0131975,1,1,123838,123364,474
14590961,7.32991,10,471,196765,0.0106395,0.97,1,123845,123374,471
14593881,7.06598,10,468,199685,0.0021279,0.91,1,123852,123384,468
14596801,6.2132,10,464,202605,0.00042558,0.77,1,123858,123394,464
14599721,5.24264,10,459,205525,0.00808512,0.73,1,123863,123404,459
14602641,5.84853,10,455,208445,0.025617,0.64,1,123869,123414,455
14605561,5.16971,10,450,211365,0.0131234,0.55,1,123874,123424,450
14608481,5.83394,10,446,214285,0.00262468,0.46,1,123880,123434,446
14611401,5.96679,10,442,217205,0.000524936,0.4,1,123886,123444,442
14614321,5.99336,10,438,220125,0.000104987,0.29,1,123892,123454,438
14617241,5.99867,10,434,223045,2.09974e-05,0.21,1,123898,123464,434
14618241,4.39973,9.2,429,225965,4.19949e-06,0.16,1,123902,123473,429
14621161,8.07995,10.64,427,226965,0.00800084,0.09,1,123911,123484,427
14624081,8.81599,10.128,426,229885,0.00160017,0.01,1,123920,123494,426
14626561,6.5632,9.2256,423,232805,0.000320034,0.01,1,123926,123503,423
14629481,7.71264,5.04512,427,235285,0.00806401,0.03,1,123934,123507,427
14632401,9.54253,9.00902,427,238205,0.0096128,0.03,1,123944,123517,427
14635321,9.10851,9.8018,426,241125,0.00192256,0.01,1,123953,123527,426
14638241,9.8217,9.96036,426,244045,0.000384512,0.01,1,123963,123537,426
14641161,10.7643,9.99207,427,246965,0.0080769,0,1,123974,123547,427
14644081,22.9529,22.7984,427,249885,0.00961538,0.01,1,124000,123573,427
14645701,9.39057,13.3597,422,252805,0.00192308,0.01,1,124006,123584,422
14648621,9.87811,7.47194,426,254425,0.000384615,0,1,124016,123590,426
14651521,16.3756,15.0944,427,257345,0.00807692,0.03,1,124034,123607,427
14654441,10.4751,11.0189,426,260245,0.00161538,0,1,124043,123617,426
14657361,20.495,20.6038,426,263165,0.000323077,0.03,1,124066,123640,426
14660281,13.699,12.1208,428,265886,6.46154e-05,0.03,1,124078,123650,428
14663201,10.7398,10.4242,428,265886,1.29231e-05,0.07,1,124088,123660,428
14666121,10.948,10.0848,429,265886,0.00800258,0.1,1,124099,123670,429
14669041,10.9896,10.017,430,265886,0.00960052,0.11,1,124110,123680,430
14671961,10.1979,10.0034,430,265886,0.0099201,0.15,1,124120,123690,430
14673781,10.0396,10.0007,430,265886,0.00998402,0.15,1,124130,123700,430
14676701,10.0079,8.40014,432,265886,0.0099968,0.17,1,124140,123708,432
14679621,10.8016,9.68003,433,265886,0.00199936,0.16,1,124151,123718,433
14682101,9.36032,9.93601,432,265886,0.00839987,0.17,1,124160,123728,432
14685021,8.27206,8.3872,432,265886,0.00167997,0.17,1,124168,123736,432
14686881,8.05441,9.67744,430,265886,0.000335995,0.14,1,124176,123746,430
14688961,6.41088,8.33549,428,265886,6.7199e-05,0.07,1,124182,123754,428
14691881,10.8822,12.8671,426,265906,0.00801344,0.05,1,124194,123768,426
14694801,10.1764,10.5734,426,265906,0.00960269,0.03,1,124204,123778,426
14697721,10.8353,10.1147,427,265906,0.00992054,0.06,1,124215,123788,427
14700641,9.36706,10.0229,426,265906,0.00998411,0.05,1,124224,123798,426
14703561,9.87341,10.0046,426,265906,0.00999682,0.03,1,124234,123808,426
14706481,10.7747,10.0009,427,265906,0.00999936,0.05,1,124245,123818,427
14709401,9.35494,10.0002,426,265906,0.00999987,0.05,1,124254,123828,426
14712321,9.87099,10,426,265906,0.00999997,0.03,1,124264,123838,426
14715241,9.9742,10,426,265906,0.00999999,0.02,1,124274,123848,426
14718161,9.99484,10,426,265906,0.018,0.03,1,124284,123858,426
14721081,9.99897,10,426,265906,0.0116,0.01,1,124294,123868,426
14724001,9.99979,10,426,265906,0.01032,0.01,1,124304,123878,426
14726921,9.99996,10,426,265906,0.010064,0.03,1,124314,123888,426
14729841,9.99999,10,426,265906,0.0100128,0.01,1,124324,123898,426
14732761,10,10,426,265906,0.0100026,0.01,1,124334,123908,426
14735681,10,10,426,265906,0.0100005,0.03,1,124344,123918,426
14738601,10,10,426,265906,0.0100001,0.01,1,124354,123928,426
14741521,10,10,426,265906,0.01,0.01,1,124364,123938,426
14744441,10,10,426,265906,0.01,0.01,1,124374,123948,426
14747361,10,10,426,265906,0.01,0.01,1,124384,123958,426
14750281,10,10,426,265906,0.01,0.01,1,124394,123968,426
14753201,10,10,426,265906,0.01,0.01,1,124404,123978,426
14756121,10,10,426,265906,0.01,0.01,1,124414,123988,426
14759041,10,10,426,265906,0.01,0.01,1,124424,123998,426
14761961,10,10,426,265906,0.01,0.01,1,124434,124008,426
14764881,10,10,426,265906,0.01,0.01,1,124444,124018,426
14767801,10,10,426,265906,0.01,0.01,1,124454,124028,426
14770721,10,10,426,265906,0.01,0.01,1,124464,124038,426
14773641,10,10,426,265906,0.01,0.01,1,124474,124048,426
14776561,10,10,426,265906,0.01,0.01,1,124484,124058,426
14779481,10,10,426,265906,0.01,0.01,1,124494,124068,426
14782401,10,10,426,265906,0.01,0.01,1,124504,124078,426
14785321,10,10,426,265906,0.01,0.01,1,124514,124088,426
14788241,10,10,426,265906,0.01,0.01,1,124524,124098,426
14791161,10,10,426,265906,0.01,0.01,1,124534,124108,426
14794081,10,10,426,265906,0.01,0.01,1,124544,124118,426
14797001,10,10,426,265906,0.01,0.01,1,124554,124128,426
14799921,10,10,426,265906,0.01,0.01,1,124564,124138,426
14802841,10,10,426,265906,0.01,0.01,1,124574,124148,426
14805761,10,10,426,265906,0.01,0.03,1,124584,124158,426
14808681,10,10,426,265906,0.026,0.01,1,124594,124168,426
14811601,10,10,426,265906,0.0132,0.01,1,124604,124178,426
14814521,10,10,426,265906,0.01864,0.03,1,124614,124188,426
14817441,10,10,426,265906,0.027728,0.01,1,124624,124198,426
14820361,10,10,426,265906,0.0135456,0.03,1,124634,124208,426
14823281,10,10,426,265906,0.0107091,0.01,1,124644,124218,426
14826201,10,10,426,265906,0.0101418,0.01,1,124654,124228,426
14829121,10,10,426,265906,0.0100284,0.01,1,124664,124238,426
14832041,10,10,426,265906,0.0100057,0.01,1,124674,124248,426
14834961,10,10,426,265906,0.0100011,0.01,1,124684,124258,426
14837881,10,10,426,265906,0.0260002,0.01,1,124694,124268,426
14840801,10,10,426,265906,0.0132,0.01,1,124704,124278,426
14843721,10,10,426,265906,0.02664,0.01,1,124714,124288,426
14846641,10,10,426,265906,0.013328,0.01,1,124724,124298,426
14849561,10,10,426,265906,0.0106656,0.01,1,124734,124308,426
14852481,10,10,426,265906,0.0261331,0.01,1,124744,124318,426
14855401,10,10,426,265906,0.0132266,0.01,1,124754,124328,426
14858321,10,10,426,265906,0.0266453,0.01,1,124764,124338,426
14861241,10,10,426,265906,0.0133291,0.01,1,124774,124348,426
14864161,10,10,426,265906,0.0106658,0.01,1,124784,124358,426
14867081,10,10,426,265906,0.0101332,0.01,1,124794,124368,426
14870001,10,10,426,265906,0.0100266,0.01,1,124804,124378,426
14872921,10,10,426,265906,0.0100053,0.01,1,124814,124388,426
14875841,10,10,426,265906,0.0100011,0.01,1,124824,124398,426
14878761,10,10,426,265906,0.0100002,0.01,1,124834,124408,426
14881681,10,10,426,265906,0.01,0.01,1,124844,124418,426
14884601,10,10,426,265906,0.026,0.01,1,124854,124428,426
14887521,10,10,426,265906,0.0292,0.01,1,124864,124438,426
14890441,10,10,426,265906,0.01384,0.01,1,124874,124448,426
14893361,10,10,426,265906,0.026768,0.01,1,124884,124458,426
14896281,10,10,426,265906,0.0133536,0.01,1,124894,124468,426
14899201,10,10,426,265906,0.0266707,0.01,1,124904,124478,426
14902121,10,10,426,265906,0.0133341,0.01,1,124914,124488,426
14905041,10,10,426,265906,0.0106668,0.01,1,124924,124498,426
14907961,10,10,426,265906,0.0261334,0.01,1,124934,124508,426
14910881,10,10,426,265906,0.0132267,0.03,1,124944,124518,426
14913801,10,10,426,265906,0.0106453,0.01,1,124954,124528,426
14916721,10,10,426,265906,0.0101291,0.03,1,124964,124538,426
14919641,10,10,426,265906,0.0100258,0.01,1,124974,124548,426
14922561,10,10,426,265906,0.0100052,0.03,1,124984,124558,426
14925481,10,10,426,265906,0.010001,0.01,1,124994,124568,426
14928401,10.8,10,427,265906,0.0100002,0.01,1,125005,124578,427
14931321,9.36,10,426,265906,0.01,0.03,1,125014,124588,426
14934241,10.672,10,427,265906,0.00200001,0.01,1,125025,124598,427
14937161,10.1344,10,427,265906,0.000400002,0.01,1,125035,124608,427
14940081,9.22688,10,426,265906,0.04008,0.03,1,125044,124618,426
14943001,9.84538,10,426,265906,0.032016,0.01,1,125054,124628,426
14945921,9.96908,10,426,265906,0.0304032,0.02,1,125064,124638,426
14948841,9.99381,10,426,265906,0.0300806,0.01,1,125074,124648,426
14951761,9.99876,10,426,265906,0.0300161,0.04,1,125084,124658,426
14954681,9.99975,10,426,265906,0.0300032,0.03,1,125094,124668,426
14957601,10.8,10,427,265906,0.0380006,0.01,1,125105,124678,427
14960521,9.35999,10,426,265906,0.0476001,0.03,1,125114,124688,426
14963441,10.672,10,427,265906,0.02552,0.01,1,125125,124698,427
14966361,9.3344,10,426,265906,0.013104,0.03,1,125134,124708,426
14969281,9.86688,10,426,265906,0.0106208,0.03,1,125144,124718,426
14972201,10.7734,10,427,265906,0.0341242,0.01,1,125155,124728,427
14975121,9.35468,10,426,265906,0.0148248,0.03,1,125164,124738,426
14978041,10.6709,10,427,265906,0.018965,0.01,1,125175,124748,427
14980961,9.33419,10,426,265906,0.011793,0.02,1,125184,124758,426
14983881,9.86684,10,426,265906,0.0103586,0.03,1,125194,124768,426
14986801,9.97337,10,426,265906,0.0100717,0.01,1,125204,124778,426
14989721,9.99467,10,426,265906,0.0100143,0.01,1,125214,124788,426
14992641,9.99893,10,426,265906,0.0180029,0.03,1,125224,124798,426
14995561,9.99979,10,426,268826,0.0196006,0.01,1,125234,124808,426
14998481,9.99996,10,426,268826,0.00392011,0.03,1,125244,124818,426
15001401,9.99999,10,426,268826,0.00878402,0.01,1,125254,124828,426
15004321,10.8,10,427,268826,0.0017568,0.01,1,125265,124838,427
15007241,10.16,10,427,268826,0.0243514,0.01,1,125275,124848,427
15010161,9.232,10,426,268826,0.0208703,0.03,1,125284,124858,426
15013081,10.6464,10,427,268826,0.00417405,0.01,1,125295,124868,427
15016001,9.32928,10,426,268826,0.000834811,0.03,1,125304,124878,426
15018921,10.6659,10,427,268826,0.000166962,0.01,1,125315,124888,427
15021841,9.33317,10,426,268826,3.33924e-05,0.03,1,125324,124898,426
15024761,9.86663,10,426,268826,0.0160067,0.01,1,125334,124908,426
15027681,10.7733,10,427,268826,0.0192013,0.01,1,125345,124918,427
15030601,9.35467,10,426,268826,0.00384027,0.03,1,125354,124928,426
15033521,9.87093,10,426,268826,0.000768053,0.03,1,125364,124938,426
15036441,9.97419,10,426,268826,0.0241536,0.03,1,125374,124948,426
15039361,9.99484,10,426,268826,0.0208307,0.01,1,125384,124958,426
15042281,9.99897,10,426,268826,0.00416614,0.02,1,125394,124968,426
15045201,9.99979,10,426,268826,0.000833229,0.03,1,125404,124978,426
15048121,9.99996,10,426,268826,0.00816665,0.01,1,125414,124988,426
15051041,9.99999,10,426,268826,0.00163333,0.03,1,125424,124998,426
15053961,10,10,426,268826,0.000326666,0.01,1,125434,125008,426
15056881,10,10,426,268826,6.53332e-05,0.01,1,125444,125018,426
15059801,11.6,10,428,268826,1.30666e-05,0.01,1,125456,125028,428
15062721,9.52,10,427,268826,2.61333e-06,0.06,1,125465,125038,427
15065641,9.904,10,427,268826,0.00800052,0.05,1,125475,125048,427
15068561,9.9808,10,427,268826,0.0176001,0.02,1,125485,125058,427
15071481,9.99616,10,427,268826,0.00352002,0.03,1,125495,125068,427
15074401,9.99923,10,427,268826,0.056704,0.06,1,125505,125078,427
15077321,10.7998,10,428,268826,0.0353408,0.03,1,125516,125088,428
15080241,10.16,10,428,268826,0.0630682,0.03,1,125526,125098,428
15083161,9.23199,10,427,268826,0.0206136,0.05,1,125535,125108,427
15086081,9.0464,10,426,268826,0.0361227,0.03,1,125544,125118,426
15089001,9.80928,10,426,268826,0.0152245,0.03,1,125554,125128,426
15091921,11.5619,10,428,268826,0.0110449,0.01,1,125566,125138,428
15094841,8.71237,10,426,268826,0.010209,0.03,1,125574,125148,426
15097761,10.5425,10,427,268826,0.0100418,0.01,1,125585,125158,427
15100681,9.3085,10,426,268826,0.00200836,0.03,1,125594,125168,426
15103601,9.8617,10,426,268826,0.000401672,0.01,1,125604,125178,426
15106521,9.97234,10,426,268826,8.03344e-05,0.03,1,125614,125188,426
15109441,9.99447,10,426,268826,1.60669e-05,0.01,1,125624,125198,426
15112361,10.7989,10,427,268826,0.00800321,0.01,1,125635,125208,427
15115281,10.1598,10,427,268826,0.00160064,0.01,1,125645,125218,427
15118201,8.43196,10,425,268826,0.000320129,0,1,125653,125228,425
15121121,8.88639,8.4,426,268826,6.40257e-05,0.01,1,125662,125236,426
15124041,7.37728,8.08,425,268826,1.28051e-05,0.04,1,125669,125244,425
15126961,8.67546,8.016,426,268826,0.00800256,0.01,1,125678,125252,426
15129881,8.13509,8.0032,426,268826,0.0176005,0.02,1,125686,125260,426
15132801,8.02702,8.00064,426,268826,0.0355201,0.02,1,125694,125268,426
15135121,7.2054,8.00013,425,268826,0.031104,0.03,1,125701,125276,425
15138041,10.2411,10.4,425,268826,0.0062208,0,1,125712,125287,425
15140961,8.44822,8.48001,425,268826,0.00124416,0,1,125720,125295,425
15143881,8.08964,8.096,425,268826,0.000248832,0,1,125728,125303,425
15146561,8.01793,8.0192,425,268826,0.00804977,0.01,1,125736,125311,425
15149481,8.00359,7.20384,426,268826,0.00160995,0,1,125744,125318,426
15152401,8.00072,7.84077,426,268826,0.000321991,0.02,1,125752,125326,426
15154881,7.20014,7.96815,425,268826,0.0080644,0.01,1,125759,125334,425
15157801,19.04,18.3936,426,268826,0.00161288,0,1,125781,125355,426
15160721,10.208,10.0787,426,268826,0.000322576,0.02,1,125789,125363,426
15163641,8.4416,8.41575,426,268826,6.45152e-05,0.02,1,125797,125371,426
15165701,6.48832,8.08315,424,268826,1.2903e-05,0.05,1,125803,125379,424
15168621,6.89766,6.41663,425,268826,0.0240026,0.02,1,125810,125385,425
15170901,9.37953,7.68333,427,268826,0.00480052,0,1,125820,125393,427
15173821,8.27591,9.53667,425,268826,0.000960103,0,1,125828,125403,425
15176741,8.05518,8.30733,425,268826,0.000192021,0,1,125836,125411,425
15178801,8.01104,8.06147,425,268826,3.84041e-05,0,1,125844,125419,425
15181721,8.00221,8.01229,425,268826,7.68082e-06,0,1,125852,125427,425
15183381,8.00044,8.00246,425,268826,1.53616e-06,0.01,1,125860,125435,425
15185461,8.80009,7.20049,427,268826,0.00800031,0,1,125869,125442,427
15187121,7.36002,8.6401,425,268826,0.00160006,0,1,125876,125451,425
15190041,5.472,5.72802,425,268826,0.000320012,0,1,125881,125456,425
15191701,10.6944,7.5456,429,268826,0.016064,0.03,1,125893,125464,429
15193361,7.73888,10.3091,425,268826,0.0512128,0.02,1,125900,125475,425
15196281,11.1478,10.0618,427,268826,0.0662426,0.03,1,125912,125485,427
15197941,9.42956,8.41236,428,268826,0.0532485,0.08,1,125921,125493,428
15200861,8.28591,8.88247,427,268826,0.0426497,0.07,1,125929,125502,427
15203781,8.85718,8.17649,428,268826,0.0645299,0.06,1,125938,125510,428
15206701,6.57144,8.0353,426,268826,0.116906,0.07,1,125944,125518,426
15209381,6.91429,8.00706,425,268826,0.151381,0.05,1,125951,125526,425
15212301,7.78286,7.20141,426,268826,0.206276,0.07,1,125959,125533,426
15215221,7.15657,7.84028,425,268826,0.249255,0.06,1,125966,125541,425
15217701,19.0313,7.96806,439,268826,0.241851,0.03,1,125988,125549,439
15219361,8.60626,18.3936,424,268826,0.23237,0.05,1,125994,125570,424
15222281,11.3213,11.6787,426,268826,0.150474,0.01,1,126006,125580,426
15225201,7.86425,8.73574,425,268826,0.174095,0.02,1,126013,125588,425
15228121,7.97285,8.14715,425,268826,0.186819,0.01,1,126021,125596,425
15231041,8.79457,8.02943,426,268826,0.125364,0.01,1,126030,125604,426
15233961,7.35891,8.00589,425,268826,0.121073,0.01,1,126037,125612,425
15236881,7.87178,8.00118,425,268826,0.112215,0,1,126045,125620,425
15239801,7.97436,8.00024,425,268826,0.118443,0,1,126053,125628,425
15241621,7.99487,8.00005,425,268826,0.119689,0.01,1,126061,125636,425
15243281,6.39897,7.20001,424,268826,0.0959377,0,1,126067,125643,424
15245361,9.27979,8.64,425,268826,0.123188,0,1,126077,125652,425
15248281,9.85596,9.728,425,268826,0.104638,0,1,126087,125662,425
15249941,9.17119,8.3456,426,268826,0.132927,0.01,1,126096,125670,426
15252861,8.23424,8.06912,426,268826,0.138586,0.02,1,126104,125678,426
15255781,8.04685,8.01382,426,268826,0.139717,0.04,1,126112,125686,426
15258701,8.00937,8.00276,426,268826,0.163943,0.04,1,126120,125694,426
15261621,7.20187,8.00055,425,268826,0.144789,0.02,1,126127,125702,425
15264541,8.64037,8.00011,426,268826,0.132958,0,1,126136,125710,426
15267461,7.32807,8.00002,425,268826,0.0505915,0.02,1,126143,125718,425
15269701,6.26562,8,423,268826,0.0261183,0.03,1,126149,125726,423
15272621,7.65312,6.4,425,268826,0.0132237,0,1,126157,125732,425
15275541,7.93062,7.68,425,268826,0.0186447,0.01,1,126165,125740,425
15278461,7.98612,7.936,425,268826,0.0117289,0.01,1,126173,125748,425
15281141,7.19722,7.9872,424,268826,0.00234579,0.01,1,126180,125756,424
15282801,7.03944,7.19744,424,268826,0.000469158,0.01,1,126187,125763,424
15285721,6.20789,5.43949,425,268826,0.00809383,0.01,1,126193,125768,425
15287381,16.4416,7.4879,436,269862,0.00961877,0,1,126212,125776,436
15290301,10.4883,16.6976,426,269862,0.00992375,0,1,126221,125795,426
15293221,8.49766,9.73952,426,269862,0.00998475,0.02,1,126229,125803,426
15295701,6.49953,8.3479,424,269862,0.00999695,0.03,1,126235,125811,424
15298621,7.69991,7.26958,425,269862,0.00999939,0.01,1,126243,125818,425
15300901,7.93998,7.85392,425,269862,0.00199988,0.01,1,126251,125826,425
15303821,7.988,7.97078,425,269862,0.000399976,0.01,1,126259,125834,425
15306741,7.9976,7.99416,425,269862,7.99951e-05,0.01,1,126267,125842,425
15309661,8.79952,7.99883,426,269862,0.008016,0.01,1,126276,125850,426
15311301,5.7599,7.99977,423,269862,0.0016032,0.03,1,126281,125858,423
15313381,13.152,6.39995,432,269862,0.00832064,0,1,126296,125864,432
15316301,9.8304,13.28,426,269862,0.00166413,0.03,1,126305,125879,426
15319221,9.16608,9.056,427,269862,0.0163328,0.05,1,126314,125887,427
15322141,9.03322,8.2112,428,269862,0.0352666,0.06,1,126323,125895,428
15324401,7.40664,8.04224,427,269862,0.0550533,0.09,1,126330,125903,427
15326481,10.2813,9.60845,428,269862,0.0350107,0.06,1,126341,125913,428
15329401,15.6563,13.9217,430,269862,0.0470021,0.09,1,126358,125928,430
15332321,11.9313,9.18434,433,269862,0.0654004,0.15,1,126369,125936,433
15335241,10.3863,8.23687,435,269862,0.10908,0.2,1,126379,125944,435
15336881,9.27725,8.04737,436,269862,0.149816,0.27,1,126388,125952,436
15339801,10.6555,9.60947,437,269862,0.173963,0.24,1,126399,125962,437
15342721,7.73109,8.32189,436,269862,0.218793,0.24,1,126406,125970,436
15345641,7.94622,8.06438,436,269862,0.243759,0.22,1,126414,125978,436
15347701,11.9892,8.01288,441,269862,0.304752,0.18,1,126427,125986,441
15350401,8.79785,13.6026,434,269862,0.38895,0.17,1,126435,126001,434
15352481,5.75957,8.32051,432,269862,0.44579,0.19,1,126440,126008,432
15355401,11.5519,12.0641,432,269862,0.473158,0.15,1,126453,126021,432
15357061,7.91038,8.81282,431,269862,0.510632,0.13,1,126460,126029,431
15359981,7.98208,8.96256,430,269862,0.510126,0.12,1,126468,126038,430
15362901,7.99642,8.19251,430,269862,0.494025,0.1,1,126476,126046,430
15365821,7.99928,8.0385,430,269862,0.482805,0.11,1,126484,126054,430
15368741,7.99986,8.0077,430,269862,0.456561,0.11,1,126492,126062,430
15371661,8.79997,8.00154,431,269862,0.459312,0.1,1,126501,126070,431
15373701,6.55999,8.00031,429,269862,0.459862,0.16,1,126507,126078,429
15376401,7.712,6.40006,431,269862,0.467972,0.12,1,126515,126084,431
15378481,9.5424,8.48001,432,269862,0.469595,0.17,1,126525,126093,432
15380561,10.7085,9.696,433,269862,0.517919,0.14,1,126536,126103,433
15383481,8.5417,9.1392,432,269862,0.567584,0.17,1,126544,126112,432
15386401,7.30834,8.22784,431,269862,0.577517,0.15,1,126551,126120,431
15388261,6.26167,8.04557,429,269862,0.587503,0.14,1,126557,126128,429
15391181,6.85233,10.4091,425,269862,0.629501,0.05,1,126564,126139,425
15394101,7.77047,8.48182,425,269862,0.6859,0.02,1,126572,126147,425
15397021,7.95409,8.09636,425,269862,0.72918,0.03,1,126580,126155,425
15399941,7.99082,8.01927,425,269862,0.705836,0,1,126588,126163,425
15402861,7.99816,8.00385,425,269862,0.701167,0,1,126596,126171,425
15405781,7.99963,8.00077,425,269862,0.716233,0,1,126604,126179,425
15408701,7.99993,8.00015,425,269862,0.743247,0,1,126612,126187,425
15411621,7.99999,8.00003,425,269862,0.740649,0,1,126620,126195,425
15414541,8,8.00001,425,269862,0.73213,0.01,1,126628,126203,425
15417381,10.4,8,428,269862,0.682426,0,1,126639,126211,428
15419461,6.88,10.4,423,269862,0.688485,0.01,1,126645,126222,423
15422381,7.776,6.88,425,269862,0.681697,0.01,1,126653,126228,425
15424241,7.1552,7.776,424,269862,0.712339,0.01,1,126660,126236,424
15426321,7.83104,7.1552,425,269862,0.702468,0.01,1,126668,126243,425
15429241,7.16621,6.23104,426,269862,0.628494,0,1,126675,126249,426
15430901,6.23324,7.64621,424,269862,0.597699,0.03,1,126681,126257,424
15433821,7.64665,7.12924,425,269862,0.54354,0.01,1,126689,126264,425
15436101,10.3293,7.82585,428,269862,0.444708,0.02,1,126700,126272,428
15439021,8.46587,10.3652,425,269862,0.400942,0.01,1,126708,126283,425
15441921,8.09317,8.47303,425,269862,0.344188,0.01,1,126716,126291,425
15444001,8.81863,8.09461,426,269862,0.276838,0.01,1,126725,126299,426
15446921,8.96373,8.01892,427,269862,0.175368,0.03,1,126734,126307,427
15449841,8.19275,8.00378,427,269862,0.0830735,0.06,1,126742,126315,427
15452321,8.83855,8.00076,428,269862,0.0886147,0.07,1,126751,126323,428
15455241,9.76771,10.4002,427,269862,0.105723,0.07,1,126761,126334,427
15456901,9.15354,8.48003,428,269862,0.109145,0.06,1,126770,126342,428
15458981,13.8307,8.89601,434,269862,0.0778289,0.07,1,126785,126351,434
15461061,20.3661,12.1792,443,269862,0.0795658,0.16,1,126807,126364,443
15462721,9.67323,16.8358,432,269862,0.103913,0.18,1,126814,126382,432
15465641,10.7346,9.76717,435,269862,0.140783,0.2,1,126825,126390,435
15467921,10.1469,8.35343,437,269862,0.148157,0.24,1,126835,126398,437
15470001,8.42939,6.47069,439,269862,0.141631,0.31,1,126843,126404,439
15472921,13.6859,10.0941,443,269862,0.156326,0.34,1,126858,126415,443
15475841,11.5372,8.41883,446,269862,0.191265,0.39,1,126869,126423,446
15477701,12.7074,8.08377,451,269862,0.246253,0.47,1,126882,126431,451
15480621,9.74149,9.61675,450,269862,0.289251,0.49,1,126891,126441,450
15483521,9.1483,8.32335,451,269862,0.31385,0.53,1,126900,126449,451
15485601,8.22966,8.06467,451,269862,0.30277,0.51,1,126908,126457,451
15487681,9.64593,10.4129,450,269862,0.276554,0.5,1,126918,126468,450
15490601,13.1292,14.0826,449,269862,0.335311,0.47,1,126932,126483,449
15493521,9.02584,9.21652,449,269862,0.387062,0.48,1,126940,126491,449
15496441,8.20517,8.2433,449,269862,0.405412,0.48,1,126948,126499,449
15499361,8.04103,8.04866,449,269862,0.433082,0.49,1,126956,126507,449
15502281,8.80821,8.00973,450,269862,0.494616,0.49,1,126965,126515,450
15505201,10.5616,8.00195,453,269862,0.530923,0.53,1,126976,126523,453
15508121,9.31233,8.00039,454,269862,0.514185,0.56,1,126985,126531,454
15511041,9.06247,8.00008,455,269862,0.574837,0.6,1,126994,126539,455
15513061,9.01249,8.00002,456,269862,0.586967,0.63,1,127003,126547,456
15515981,9.8025,8,458,269862,0.605393,0.65,1,127013,126555,458
15518261,9.1605,8,459,269862,0.625079,0.69,1,127022,126563,459
15521181,8.2321,6.4,461,269862,0.621016,0.72,1,127030,126569,461
15523461,6.44642,7.68,459,269862,0.676203,0.74,1,127036,126577,459
15525121,6.88928,6.336,460,269862,0.679241,0.7,1,127043,126583,460
15528041,5.37786,5.2672,460,269862,0.679848,0.7,1,127048,126588,460
15530961,7.47557,7.45344,460,269862,0.65597,0.72,1,127056,126596,460
15533441,7.89511,7.89069,460,269862,0.643194,0.73,1,127064,126604,460
15536361,9.57902,8.77814,461,269862,0.632639,0.72,1,127074,126613,461
15539281,8.3158,8.15563,461,269862,0.630528,0.72,1,127082,126621,461
15541761,8.06316,8.03113,461,269862,0.638106,0.67,1,127090,126629,461
15544681,9.61263,9.60623,461,269862,0.615621,0.72,1,127100,126639,461
15547601,7.52253,8.32124,460,269862,0.627124,0.73,1,127107,126647,460
15550081,5.50451,8.06425,457,269862,0.629425,0.7,1,127112,126655,457
15553001,5.1009,7.21285,455,269862,0.621885,0.66,1,127117,126662,455
15555921,5.82018,7.84257,453,269862,0.628377,0.58,1,127123,126670,453
15558821,9.16404,7.96851,455,269862,0.605675,0.49,1,127133,126678,455
15561741,5.83281,13.5937,445,269862,0.593135,0.4,1,127138,126693,445
15564661,5.16656,9.11874,442,269862,0.590627,0.38,1,127143,126701,442
15567581,4.23331,8.22375,438,269862,0.558125,0.32,1,127147,126709,438
15570501,4.04666,8.04475,434,269862,0.543625,0.26,1,127151,126717,434
15573421,4.00933,8.00895,430,269862,0.492725,0.18,1,127155,126725,430
15575041,4.80187,8.00179,427,269862,0.466545,0.13,1,127160,126733,427
15577121,6.56037,6.40036,428,269862,0.469309,0.09,1,127167,126739,428
15580041,7.71207,6.08007,430,269862,0.461862,0.1,1,127175,126745,430
15581701,7.14241,7.61601,429,269862,0.444372,0.11,1,127182,126753,429
15584621,8.62848,7.9232,430,269862,0.496874,0.13,1,127191,126761,430
15586901,12.1257,7.98464,435,269862,0.515375,0.1,1,127204,126769,435
15588981,12.8251,13.5969,433,269862,0.543075,0.08,1,127217,126784,433
15591061,18.565,13.1194,440,269862,0.636615,0.11,1,127237,126797,440
15593141,14.113,16.2239,436,269862,0.703323,0.16,1,127250,126814,436
15595221,6.8226,12.8448,429,269862,0.732665,0.19,1,127255,126826,429
15597301,12.5645,7.36896,437,269862,0.754533,0.17,2,127269,126832,437
15600221,11.3129,11.8738,435,269862,0.726907,0.19,1,127280,126845,435
15602501,13.4626,8.77476,441,269862,0.753381,0.21,2,127294,126853,441
15604581,13.8925,12.155,442,269862,0.750676,0.27,2,127308,126866,442
15606241,8.3785,10.431,439,269862,0.758135,0.31,2,127315,126876,439
15608321,12.8757,10.8862,442,269862,0.799627,0.38,2,127329,126887,442
15611241,9.77514,10.9772,440,269862,0.791925,0.32,2,127338,126898,440
15612901,9.95503,8.59545,442,269862,0.798385,0.3,2,127348,126906,442
15615821,10.791,10.5191,442,269862,0.791677,0.32,2,127359,126917,442
15618721,9.3582,8.50382,443,269862,0.798335,0.37,2,127368,126925,443
15620801,9.87164,8.10076,445,269862,0.839667,0.43,2,127378,126933,445
15623721,14.7743,11.2202,449,269862,0.895933,0.45,2,127394,126945,449
15626641,12.5549,8.64403,453,269862,0.907187,0.5,2,127406,126953,453
15628501,5.71097,8.12881,449,269862,0.877437,0.53,2,127410,126961,449
15631421,7.54219,7.22576,450,269862,0.895487,0.54,2,127418,126968,450
15634341,9.50844,7.84515,452,269862,0.843097,0.54,2,127428,126976,452
15636821,9.90169,7.96903,454,269862,0.776619,0.65,2,127438,126984,454
15638481,8.38034,7.19381,455,269862,0.755324,0.65,2,127446,126991,455
15641401,6.47607,5.43876,456,269862,0.807065,0.61,2,127452,126996,456
15643681,6.89521,7.48775,455,269862,0.801413,0.63,2,127459,127004,455
15646601,18.979,15.8976,459,269862,0.752283,0.66,2,127481,127022,459
15649521,10.9958,9.57951,460,269862,0.750457,0.66,2,127490,127030,460
15652441,7.79916,8.3159,459,269862,0.790091,0.7,2,127497,127038,459
15654081,6.35983,8.06318,457,269862,0.798018,0.65,2,127503,127046,457
15657001,9.27197,9.61264,457,269862,0.807604,0.66,2,127513,127056,457
15659701,7.45439,8.32253,456,269862,0.833521,0.69,2,127520,127064,456
15662621,7.89088,7.26451,457,269862,0.814704,0.65,2,127528,127071,457
15664481,6.37818,7.8529,455,269862,0.842941,0.63,2,127534,127079,455
15667401,6.07564,5.57058,456,269862,0.848588,0.64,2,127540,127084,456
15670321,7.61513,7.51412,456,269862,0.857718,0.62,2,127548,127092,456
15673241,7.92303,7.90282,456,269862,0.875544,0.65,2,127556,127100,456
15674881,6.38461,7.98056,454,269862,0.839109,0.65,2,127562,127108,454
15677801,9.27692,7.99611,456,269862,0.879822,0.63,2,127572,127116,456
15680721,9.05538,7.99922,457,269862,0.871964,0.62,2,127581,127124,457
15683641,5.81108,7.99984,454,269862,0.862393,0.6,2,127586,127132,454
15686321,5.16222,7.99997,451,269862,0.844479,0.55,2,127591,127140,451
15689241,5.83244,7.19999,450,269862,0.832896,0.48,2,127597,127147,450
15692161,5.96649,7.84,448,269862,0.830579,0.46,2,127603,127155,448
15695081,7.5933,7.968,448,269862,0.814116,0.47,2,127611,127163,448
15698001,7.91866,7.9936,448,269862,0.770823,0.45,2,127619,127171,448
15700921,10.3837,7.99872,451,269862,0.738165,0.5,1,127630,127179,451
15703841,7.67675,7.99974,450,269862,0.707633,0.54,1,127637,127187,450
15706761,9.53535,7.99995,452,269862,0.757527,0.54,2,127647,127195,452
15709681,9.10707,7.99999,453,269862,0.799505,0.53,2,127656,127203,453
15712601,10.6214,8,456,269862,0.815901,0.55,2,127667,127211,456
15715521,10.1243,8,458,269862,0.83518,0.64,2,127677,127219,458
15718441,10.8249,8,461,269862,0.863036,0.63,2,127688,127227,461
15721061,18.165,8,473,269862,0.852607,0.75,2,127708,127235,473
15723981,10.833,14.4,466,269862,0.850521,0.77,2,127717,127251,466
15725841,6.1666,9.28,463,269862,0.834104,0.77,2,127722,127259,463
15728761,18.8333,17.056,466,269862,0.838821,0.73,2,127744,127278,466
15731041,12.5667,9.8112,469,269862,0.855764,0.79,2,127755,127286,469
15733121,14.5133,15.5622,467,269862,0.851153,0.78,2,127770,127303,467
15736041,10.1027,9.51245,468,269862,0.850231,0.76,2,127779,127311,468
15738741,18.0205,8.30249,480,269862,0.826046,0.81,2,127799,127319,480
15740821,14.8041,19.2605,472,269862,0.853209,0.84,2,127813,127341,472
15743521,9.36082,15.0521,466,269862,0.842642,0.83,2,127821,127355,466
15746441,12.2722,10.2104,470,269862,0.840528,0.81,2,127834,127364,470
15749361,8.85443,8.44208,470,269862,0.856106,0.86,2,127842,127372,470
15751221,6.57089,8.08842,468,269862,0.867221,0.89,2,127848,127380,468
15753301,14.9142,7.21768,478,269862,0.917444,0.91,2,127865,127387,478
15766621,8,7,466,269862,0.92,0.83,2,127910,127444,466
15768901,9.6,7.8,468,269862,0.952,0.85,2,127920,127452,468
15771821,7.52,9.56,465,269862,0.9424,0.83,2,127927,127462,465
15802001,8,8,469,269862,0.89,0.86,2,128030,127561,469
15804921,8,8,469,269862,0.906,0.87,2,128038,127569,469
15807841,8,8,469,269862,0.9252,0.88,2,128046,127577,469
15810761,6.4,8,467,269862,0.93704,0.86,2,128052,127585,467
15812581,4.48,8,463,269862,0.931408,0.84,2,128056,127593,463
15815501,5.696,5.6,464,269862,0.946282,0.84,2,128062,127598,464
15818421,5.9392,7.52,462,269862,0.933256,0.8,2,128068,127606,462
15821341,7.58784,7.904,462,269862,0.946651,0.75,2,128076,127614,462
15824261,6.31757,7.9808,460,269862,0.95733,0.75,2,128082,127622,460
15827181,10.8635,7.99616,464,269862,0.951466,0.73,2,128094,127630,464
15830101,10.1727,7.99923,466,269862,0.926293,0.79,2,128104,127638,466
15897441,9,8,479,269862,0.87,0.95,2,128399,127920,479
15900361,7.4,7.2,479,269862,0.918,0.98,2,128406,127927,479
15902641,5.48,7.84,476,269862,0.9036,0.98,2,128411,127935,476
15905561,10.696,8.768,479,269862,0.94072,0.98,2,128423,127944,479
16025361,9,8,476,269862,0.8,0.93,2,128879,128403,476
16028281,5.8,5.6,476,269862,0.8,0.94,2,128884,128408,476
16031201,7.56,7.52,476,269862,0.784,0.95,2,128892,128416,476
16034121,8.712,7.904,477,269862,0.7488,0.97,1,128901,128424,477
16035761,6.5424,7.9808,475,269862,0.71776,0.97,1,128907,128432,475
16037841,15.7085,14.3962,477,269862,0.703552,1,1,128925,128448,477
16040761,7.9417,10.0792,474,269862,0.69271,0.97,1,128931,128457,474
16043041,8.78834,8.41585,475,269862,0.658542,0.96,1,128940,128465,475
16045961,8.15767,8.08317,475,269862,0.603708,0.98,1,128948,128473,475
16048881,8.03153,8.01663,475,269862,0.536742,1,1,128956,128481,475
16051801,7.20631,8.00333,474,269862,0.539348,0.99,1,128963,128489,474
16053861,7.84126,8.00067,474,269862,0.46787,0.96,1,128971,128497,474
16055521,6.36825,6.40013,474,269862,0.413574,0.98,1,128977,128503,474
16058441,8.47365,9.28003,473,269862,0.410715,0.97,1,128986,128513,473
16061361,8.09473,8.25601,473,269862,0.378143,0.97,1,128994,128521,473
16063841,8.01895,8.0512,473,269862,0.331629,0.98,1,129002,128529,473
16066761,7.20379,7.21024,473,269862,0.274326,0.95,1,129009,128536,473
16069681,7.84076,7.84205,473,269862,0.238865,0.96,1,129017,128544,473
16072601,7.96815,7.96841,473,269862,0.223773,0.96,1,129025,128552,473
16075521,7.99363,7.99368,473,269862,0.204755,0.97,1,129033,128560,473
16078441,8.79873,7.99874,474,269862,0.152951,0.97,1,129042,128568,474
16081361,8.95975,7.99975,475,269862,0.0865902,0.93,1,129051,128576,475
16082981,8.19195,7.99995,475,269862,0.017318,0.96,1,129059,128584,475
16085901,7.23839,7.99999,474,269862,0.0434636,0.97,1,129066,128592,474
16088821,10.2477,8,477,269862,0.0566927,0.99,1,129077,128600,477
16091741,8.44954,8,477,269862,0.0433385,1,1,129085,128608,477
16094661,8.08991,8,477,269862,0.0486677,1,1,129093,128616,477
16097581,8.01798,8,477,269862,0.0497335,1,1,129101,128624,477
16100501,8.8036,8,478,269862,0.0179467,1,1,129110,128632,478
16103421,8.96072,8,479,269862,0.00358934,1,1,129119,128640,479
16105441,6.59214,8,477,269862,0.0487179,1,1,129125,128648,477
16108361,8.51843,7.2,479,269862,0.0177436,1,1,129134,128655,479
16110021,18.5037,7.84,492,269862,0.0115487,1,1,129155,128663,492
16112941,11.7007,19.968,479,269862,0.0263097,1,1,129165,128686,479
16115221,7.14015,10.3936,477,269862,0.0132619,1,1,129171,128694,477
16116881,8.62803,9.27872,477,269862,0.0266524,1,1,129180,128703,477
16119801,8.12561,7.45574,478,269862,0.0213305,1,1,129188,128710,478
16122501,8.82512,7.89115,479,269862,0.0362661,1,1,129197,128718,479
16124581,13.765,8.77823,485,269862,0.0232532,0.96,1,129212,128727,485
16126661,13.153,14.5556,482,269862,0.00465064,0.97,1,129225,128743,482
16128321,9.0306,11.7111,479,269862,0.000930129,1,1,129233,128754,479
16131241,25.8061,27.9422,477,269862,0.032186,1,1,129263,128786,477
16134161,11.5612,11.9884,477,269862,0.00643721,1,1,129271,128794,477
16137061,11.1122,8.79769,480,269862,0.00928744,1,1,129282,128802,480
16139141,11.8224,11.3595,480,269862,0.0498575,1,1,129294,128814,480
16141221,10.3645,11.0719,479,269862,0.0659715,1,1,129304,128825,479
16144141,6.8729,8.61438,477,269862,0.0851943,1,1,129310,128833,477
16147041,4.57458,8.12288,473,269862,0.0650389,0.92,1,129314,128841,473
16149121,10.5149,13.6246,470,269862,0.0290078,0.86,1,129326,128856,470
16152041,9.30298,11.5249,468,269862,0.0298016,0.8,1,129335,128867,468
16154321,7.4606,8.70498,467,269862,0.0299603,0.78,1,129342,128875,467
16156401,5.49212,6.541,466,269862,0.0219921,0.8,1,129347,128881,466
16159321,11.4984,11.7082,466,269862,0.0203984,0.72,1,129360,128894,466
16162241,6.29968,8.74164,463,269862,0.00407968,0.72,1,129365,128902,463
16165161,6.85994,8.14833,462,269862,0.0248159,0.71,1,129372,128910,462
16166801,6.17199,8.02967,460,269862,0.0129632,0.69,1,129378,128918,460
16168881,10.0344,12.0059,458,269862,0.0185926,0.65,1,129389,128931,458
16171801,5.20688,9.60119,453,269862,0.0117185,0.6,1,129393,128940,453
16174081,7.44138,8.32024,453,269862,0.0343437,0.55,1,129401,128948,453
16177001,7.08828,10.464,449,269862,0.0468687,0.49,1,129408,128959,449
16179921,6.21766,8.49281,447,269862,0.0173737,0.43,1,129414,128967,447
16182401,5.24353,8.09856,444,269862,0.00347475,0.42,1,129419,128975,444
16185321,5.84871,7.21971,443,269862,0.00869495,0.38,1,129425,128982,443
16188021,6.76974,7.84394,442,269862,0.00973899,0.35,1,129432,128990,442
16190941,6.15395,9.56879,438,269862,0.0019478,0.28,1,129438,129000,438
16193221,5.23079,8.31376,435,269862,0.0243896,0.27,1,129443,129008,435
16196141,5.84616,6.46275,435,269862,0.0128779,0.23,1,129449,129014,435
16199061,5.96923,7.69255,433,269862,0.0265756,0.2,1,129455,129022,433
16201541,4.39385,7.93851,429,269862,0.0293151,0.19,1,129459,129030,429
16204461,5.67877,7.1877,428,269862,0.013863,0.14,1,129465,129037,428
16206321,4.33575,7.83754,424,269862,0.0107726,0.09,1,129469,129045,424
16209241,7.26715,5.56751,427,269862,0.0101545,0.01,1,129477,129050,427
16211521,8.65343,7.5135,428,269862,0.0020309,0.07,1,129486,129058,428
16214441,9.73069,10.3027,427,269862,0.0484062,0.06,1,129496,129069,427
16217361,9.14614,8.46054,428,269862,0.0496812,0.04,1,129505,129077,428
16220281,9.02923,8.09211,429,269862,0.0259362,0.06,1,129514,129085,429
16221921,5.00585,8.01842,425,269862,0.00518725,0.1,1,129518,129093,425
16224841,5.80117,6.40368,425,269862,0.0330375,0.07,1,129524,129099,425
16226501,11.5602,7.68074,430,269862,0.0466075,0.01,1,129537,129107,430
16229421,7.11205,10.3361,425,269862,0.0973215,0.05,1,129543,129118,425
16232341,8.62241,8.46723,426,269862,0.123464,0.05,1,129552,129126,426
16235261,8.12448,8.09345,426,269862,0.104693,0.03,1,129560,129134,426
16237941,9.6249,8.01869,428,269862,0.0769386,0.01,1,129570,129142,428
16240021,13.925,9.60374,433,269862,0.0873877,0.05,1,129585,129152,433
16242101,10.785,14.7207,427,269862,0.0654775,0,1,129595,129168,427
16245021,7.757,9.34415,426,269862,0.0690955,0.05,1,129602,129176,426
16247921,7.9514,8.26883,426,269862,0.0618191,0.04,1,129610,129184,426
16250001,8.79028,8.05377,427,269862,0.0843638,0.02,1,129619,129192,427
16252921,10.5581,10.4108,427,269862,0.0408728,0.04,1,129630,129203,427
16254581,7.71161,8.48215,426,269862,0.00817455,0.06,1,129637,129211,426
16256661,19.9423,8.09643,441,269862,0.00963491,0.05,1,129660,129219,441
16259361,11.1885,20.0193,427,269862,0.00192698,0,1,129669,129242,427
16261441,23.8377,27.2039,425,269862,0.0403854,0.01,1,129696,129271,425
16264361,15.9675,14.2408,428,269862,0.0160771,0.02,1,129710,129282,428
16267281,10.3935,9.24815,429,269862,0.0192154,0.09,1,129719,129290,429
16269761,8.4787,8.24963,429,269862,0.0358431,0.11,1,129727,129298,429
16272681,9.69574,12.0499,426,269862,0.00716862,0.05,1,129737,129311,426
16274961,7.53915,8.80999,425,269862,0.0414337,0.04,1,129744,129319,425
16277881,8.70783,6.562,428,269862,0.0642867,0.07,1,129753,129325,428
16280161,7.34157,7.7124,427,269862,0.100857,0.03,1,129760,129333,427
16282241,7.86831,8.74248,426,269862,0.0761715,0.03,1,129768,129342,426
16285161,11.9737,12.1485,426,269862,0.0712343,0.03,1,129781,129355,426
16288081,7.99473,8.8297,425,269862,0.0942469,0.06,1,129788,129363,425
16291001,9.59895,8.16594,427,269862,0.0988494,0.03,1,129798,129371,427
16293921,7.51979,8.03319,426,269862,0.11577,0.06,1,129805,129379,426
16296841,9.50396,8.00664,428,269862,0.151154,0.05,1,129815,129387,428
16299761,7.50079,8.00133,427,269862,0.198231,0.09,1,129822,129395,427
16302681,6.30016,8.00027,425,269862,0.199646,0.05,1,129828,129403,425
16305121,7.66003,8.00005,425,269862,0.247929,0.02,1,129836,129411,425
16308041,7.13201,7.20001,425,269862,0.273586,0.02,1,129843,129418,425
16310321,7.8264,7.84,425,269862,0.262717,0.03,1,129851,129426,425
16313241,7.16528,6.368,426,269862,0.252543,0.02,1,129858,129432,426
16316161,7.83306,7.6736,426,269862,0.250509,0.04,1,129866,129440,426
16319081,7.96661,7.93472,426,269862,0.258102,0.04,1,129874,129448,426
16322001,7.99332,7.98694,426,269862,0.26762,0.04,1,129882,129456,426
16324921,7.99866,7.99739,426,269862,0.253524,0.04,1,129890,129464,426
16327841,7.99973,7.99948,426,269862,0.234705,0.04,1,129898,129472,426
16330761,8.79995,7.9999,427,269862,0.206941,0.04,1,129907,129480,427
16333681,8.95999,7.99998,428,269862,0.193388,0.06,1,129916,129488,428
16336601,6.592,8,426,269862,0.190678,0.07,1,129922,129496,426
16339521,7.7184,8,426,269862,0.206136,0.06,1,129930,129504,426
16342441,8.74368,8,427,269862,0.225227,0.04,1,129939,129512,427
16345361,8.94874,8,428,269862,0.197045,0.08,1,129948,129520,428
16348281,9.78975,8,430,269862,0.231409,0.06,1,129958,129528,430
16351201,9.15795,8,431,269862,0.286282,0.13,1,129967,129536,431
16354121,6.63159,8,429,269862,0.321256,0.13,1,129973,129544,429
16357041,7.72632,8,429,269862,0.352251,0.1,1,129981,129552,429
16359961,7.94526,8,429,269862,0.39845,0.11,1,129989,129560,429
16362881,8.78905,8,430,269862,0.35969,0.1,1,129998,129568,430
16365801,7.35781,8,429,269862,0.375938,0.11,1,130005,129576,429
16368561,6.27156,8,427,269862,0.387188,0.1,1,130011,129584,427
16370641,7.65431,7.2,428,269862,0.405437,0.06,1,130019,129591,428
16373561,10.3309,8.64,430,269862,0.393088,0.09,1,130030,129600,430
16375841,7.66617,8.128,429,269862,0.390617,0.11,1,130037,129608,429
16378761,4.73323,6.4256,427,269862,0.390124,0.1,1,130041,129614,427
16380421,3.34665,7.68512,422,269862,0.398025,0.06,1,130044,129622,422
16382501,11.8693,5.53702,431,269862,0.367605,0,1,130058,129627,431
16384581,8.77387,12.3074,425,269862,0.345521,0.03,1,130066,129641,425
16386661,21.7548,7.26148,444,269862,0.333104,0.01,1,130091,129647,444
16389581,12.351,20.6523,430,269862,0.234621,0.08,1,130101,129671,430
16391861,19.2702,10.5305,443,269862,0.174924,0.05,1,130122,129679,443
16393941,19.854,22.9061,437,269862,0.154985,0.08,1,130142,129705,437
16396021,11.1708,18.9812,428,269862,0.086997,0.04,1,130151,129723,428
16398941,9.43416,10.9962,428,269862,0.0493994,0.08,1,130160,129732,428
16401861,9.88683,8.59925,430,269862,0.0418799,0.12,1,130170,129740,430
16404781,8.37737,8.11985,430,269862,0.032376,0.11,1,130178,129748,430
16407461,7.27547,8.02397,429,269862,0.0544752,0.14,1,130185,129756,429
16409541,8.65509,7.20479,431,269862,0.042895,0.16,1,130194,129763,431
16412461,8.93102,9.44096,430,269862,0.040579,0.12,1,130203,129773,430
16414741,11.3862,8.28819,434,269862,0.0241158,0.13,1,130215,129781,434
16417661,10.2772,12.0576,431,269862,0.0208232,0.13,1,130225,129794,431
16419941,8.45545,8.81153,431,269862,0.00416463,0.14,1,130233,129802,431
16422861,9.69109,6.56231,435,269862,0.00883293,0.15,1,130243,129808,435
16424721,9.13822,7.71246,436,269862,0.0337666,0.22,1,130252,129816,436
16427641,7.42764,5.54249,438,269862,0.0467533,0.23,1,130259,129821,438
16429921,9.48553,7.5085,440,269862,0.0333507,0.31,1,130269,129829,440
16432841,9.89711,11.9017,437,269862,0.00667013,0.27,1,130279,129842,437
16435761,9.17942,8.78034,438,269862,0.025334,0.27,1,130288,129850,438
16438681,7.43588,8.15607,437,269862,0.0210668,0.25,1,130295,129858,437
16441601,7.88718,8.03121,437,269862,0.00421336,0.26,1,130303,129866,437
16444521,7.97744,8.00624,437,269862,0.00884267,0.27,1,130311,129874,437
16447441,7.19549,8.00125,436,269862,0.00176853,0.25,1,130318,129882,436
16450361,7.8391,8.00025,436,269862,0.00835371,0.25,1,130326,129890,436
16453281,6.36782,8.00005,434,269862,0.00167074,0.23,1,130332,129898,434
16456201,7.67356,8.00001,434,269862,0.0163341,0.22,1,130340,129906,434
16459121,7.93471,8,434,269862,0.00326683,0.21,1,130348,129914,434
16462041,10.3869,8,437,269862,0.00865337,0.23,1,130359,129922,437
16464961,8.47739,8,437,269862,0.0257307,0.26,1,130367,129930,437
16467881,6.49548,8,435,269862,0.0291461,0.24,1,130373,129938,435
16470801,10.0991,8,438,269862,0.0138292,0.22,1,130384,129946,438
16473721,10.8198,8,441,269862,0.0107658,0.28,1,130395,129954,441
16475681,9.36396,8,442,269862,0.0341532,0.33,1,130404,129962,442
16478601,10.6728,8.8,444,269862,0.0628306,0.39,1,130415,129971,444
16481521,8.53456,8.16,444,269862,0.0765661,0.38,1,130423,129979,444
16484441,8.10691,8.032,444,269862,0.0633132,0.34,1,130431,129987,444
16487361,8.82138,8.0064,445,269862,0.0126626,0.38,1,130440,129995,445
16490281,8.96428,8.00128,446,269862,0.0265325,0.39,1,130449,130003,446
16493201,8.19286,8.00026,446,269862,0.0133065,0.43,1,130457,130011,446
16496121,8.03857,8.00005,446,269862,0.0346613,0.39,1,130465,130019,446
16499041,7.20771,8.00001,445,269862,0.0949323,0.42,1,130472,130027,445
16501961,8.64154,8,446,269862,0.0189865,0.41,1,130481,130035,446
16504881,6.52831,8,444,269862,0.0357973,0.4,1,130487,130043,444
16507801,6.10566,8,442,269862,0.0311595,0.37,1,130493,130051,442
16510721,6.82113,8,441,269862,0.0222319,0.32,1,130500,130059,441
16512501,8.56423,8,442,269862,0.00444638,0.34,1,130509,130067,442
16515201,8.91285,9.6,441,269862,0.0248893,0.26,1,130518,130077,441
16517281,10.5826,17.92,432,269862,0.0529779,0.2,1,130529,130097,432
16520201,9.31651,9.984,433,269862,0.114596,0.15,1,130538,130105,433
16521861,14.6633,8.3968,441,269862,0.0629191,0.19,1,130554,130113,441
16523941,15.7327,15.2794,440,269862,0.0685838,0.07,1,130570,130130,440
16526021,11.9465,20.6559,429,269862,0.0537168,0,1,130581,130152,429
16528101,11.1893,12.1312,430,269862,0.0667434,0.06,1,130592,130162,430
16531021,8.63786,11.2262,427,269862,0.0613487,0.02,1,130600,130173,427
16533941,8.12757,8.64525,427,269862,0.0202697,0.07,1,130608,130181,427
16536861,8.82551,8.12905,428,269862,0.0280539,0.05,1,130617,130189,428
16539541,8.9651,8.02581,429,269862,0.0616108,0.04,1,130626,130197,429
16542461,8.99302,11.2052,426,269862,0.0683222,0.03,1,130635,130209,426
16545361,7.3986,8.64103,425,269862,0.0456644,0.02,1,130642,130217,425
16548281,17.4797,16.1282,427,269862,0.0171329,0.03,1,130662,130235,427
16551201,9.89594,9.62564,427,269862,0.0274266,0.05,1,130670,130243,427
16554121,6.77919,8.32513,425,269862,0.00548532,0.07,1,130676,130251,425
16555761,7.75584,8.06503,425,269862,0.0250971,0.04,1,130684,130259,425
16557841,6.35117,6.41301,425,269862,0.0610194,0.04,1,130690,130265,425
16560761,7.67023,6.0826,427,269862,0.0602039,0.03,1,130698,130271,427
16562421,7.13405,7.61652,426,269862,0.0280408,0.04,1,130705,130279,426
16564501,14.2268,7.9233,434,269862,0.0376082,0.02,1,130721,130287,434
16567421,10.0454,15.1847,426,269862,0.00752163,0,1,130730,130304,426
16570341,7.60907,9.43693,425,269862,0.00950433,0.02,1,130737,130312,425
16573261,8.72181,8.28739,426,269862,0.00990087,0.01,1,130746,130320,426
16576181,7.34436,8.05748,425,269862,0.00198017,0.03,1,130753,130328,425
16579101,7.86887,8.0115,425,269862,0.000396035,0.01,1,130761,130336,425
16582021,7.97377,8.0023,425,269862,7.92069e-05,0.01,1,130769,130344,425
16584941,8.79476,8.00046,426,269862,0.00801584,0,1,130778,130352,426
16587861,8.95895,8.00009,427,269862,0.0336032,0.04,1,130787,130360,427
16590781,7.39179,8.00002,426,269862,0.0307206,0.04,1,130794,130368,426
16593701,7.07836,8,425,269862,0.0301441,0.01,1,130801,130376,425
16596621,8.61567,8,426,269862,0.0300288,0.03,1,130810,130384,426
16599541,8.12313,8,426,269862,0.0380058,0.04,1,130818,130392,426
16602461,9.62463,8,428,269862,0.0156012,0.02,1,130828,130400,428
16605381,8.32493,8,428,269862,0.0271202,0.06,1,130836,130408,428
16608301,7.26498,8,427,269862,0.029424,0.08,1,130843,130416,427
16610261,10.253,8,430,269862,0.0138848,0.05,1,130854,130424,430
16613181,10.0506,12,427,269862,0.010777,0.03,1,130864,130437,427
16616101,7.61012,8.8,426,269862,0.00215539,0.04,1,130871,130445,426
16619021,10.322,8.16,429,269862,0.0404311,0.07,1,130882,130453,429
16621941,6.8644,8.032,427,269862,0.0320862,0.13,1,130888,130461,427
16624821,9.37288,8.0064,429,269862,0.0144172,0.02,1,130898,130469,429
16627741,7.47458,9.60128,426,269862,0.0348835,0.06,1,130905,130479,426
16630661,7.09492,8.32026,425,269862,0.0149767,0.04,1,130912,130487,425
16633581,9.41898,8.06405,427,269862,0.0269953,0,1,130922,130495,427
16636501,7.4838,8.01281,426,269862,0.0213991,0.04,1,130929,130503,426
16639421,9.49676,8.00256,428,269862,0.0202798,0.04,1,130939,130511,428
16642341,9.89935,8.00051,430,269862,0.036056,0.06,1,130949,130519,430
16644581,8.37987,8.0001,430,269862,0.0152112,0.14,1,130957,130527,430
16646241,4.87597,6.40002,428,269862,0.0110422,0.14,1,130961,130533,428
16649161,6.57519,6.88,428,269862,0.00220845,0.08,1,130968,130540,428
16651861,19.715,7.776,443,269862,0.00844169,0.06,1,130991,130548,443
16653941,11.943,20.7552,429,269862,0.00168834,0.08,1,131001,130572,429
16656021,8.7886,11.351,428,269862,0.000337668,0.09,1,131009,130581,428
16658101,12.1577,8.67021,433,269862,0.00806753,0.07,1,131022,130589,433
16661021,10.4315,14.534,427,269862,0.0256135,0.03,1,131032,130605,427
16663941,10.0863,9.30681,429,269862,0.0291227,0.05,1,131042,130613,429
16666421,9.21726,8.26136,430,269862,0.00582454,0.11,1,131051,130621,430
16668501,6.64345,8.85227,427,269862,0.00116491,0.1,1,131057,130630,427
16671421,6.12869,6.57045,427,269862,0.00823298,0.09,1,131063,130636,427
16674341,6.82574,7.71409,426,269862,0.0016466,0.05,1,131070,130644,426
16676401,7.76515,7.94282,426,269862,0.00832932,0.04,1,131078,130652,426
16679321,15.153,15.1886,426,269862,0.00966586,0.04,1,131095,130669,426
16682241,10.2306,9.43771,427,269862,0.0339332,0.08,1,131104,130677,427
16684721,8.44612,8.28754,427,269862,0.00678663,0.07,1,131112,130685,427
16687641,8.88922,9.65751,426,269862,0.00935733,0.04,1,131121,130695,426
16690561,7.37784,8.3315,425,269862,0.00987147,0.04,1,131128,130703,425
16693041,8.67557,8.0663,426,269862,0.00997429,0.01,1,131137,130711,426
16695121,12.9351,13.6133,425,269862,0.00999486,0.01,1,131151,130726,425
16698041,11.387,10.7227,426,269862,0.017999,0,1,131162,130736,426
16700961,8.6774,8.54453,426,269862,0.00359979,0.01,1,131170,130744,426
16703441,8.13548,8.10891,426,269862,0.000719959,0.04,1,131178,130752,426
16706361,9.6271,10.4218,425,269862,0.00814399,0,1,131188,130763,425
16709281,9.12542,8.48436,426,269862,0.0016288,0.02,1,131197,130771,426
16712201,8.22508,8.09687,426,269862,0.0163258,0.04,1,131205,130779,426
16715121,8.84502,8.01937,427,269862,0.00326515,0.04,1,131214,130787,427
16718041,7.369,8.00387,426,269862,0.00865303,0.06,1,131221,130795,426
16720961,7.8738,8.00077,426,269862,0.0177306,0.03,1,131229,130803,426
16723881,7.97476,8.00015,426,269862,0.0115461,0.06,1,131237,130811,426
16725701,6.39495,8.00003,424,269862,0.0183092,0.01,1,131243,130819,424
16728621,7.67899,5.60001,427,269862,0.0196618,0.05,1,131251,130824,427
16730481,6.3358,7.52,425,269862,0.0119324,0.01,1,131257,130832,425
16733401,11.6672,11.904,425,269862,0.0343865,0.02,1,131270,130845,425
16736321,9.53343,8.7808,426,269862,0.0388773,0.02,1,131279,130853,426
16739241,8.30669,8.15616,426,269862,0.0157755,0.04,1,131287,130861,426
16742161,8.06134,8.03123,426,269862,0.0271551,0.04,1,131295,130869,426
16745081,8.81227,8.00625,427,269862,0.013431,0.06,1,131304,130877,427
16747121,6.56245,8.00125,425,269862,0.0106862,0.05,1,131310,130885,425
16750041,6.91249,6.40025,426,269862,0.00213724,0.02,1,131317,130891,426
16752321,6.9825,7.68005,425,269862,0.0244274,0.06,1,131324,130899,425
16755241,6.9965,6.33601,426,269862,0.0368855,0,1,131331,130905,426
16756901,6.1993,7.6672,424,269862,0.0233771,0.03,1,131337,130913,424
16759821,8.43986,7.13344,426,269862,0.0126754,0.03,1,131346,130920,426
16762741,8.88797,7.82669,427,269862,0.0425351,0.02,1,131355,130928,427
16765661,7.37759,7.96534,426,269862,0.016507,0.05,1,131362,130936,426
16768341,7.07552,7.99307,425,269862,0.0033014,0.05,1,131369,130944,425
16771261,7.8151,7.19861,426,269862,0.000660281,0.03,1,131377,130951,426
16773121,6.36302,7.83972,424,269862,0.00813206,0.03,1,131383,130959,424
16776041,8.4726,7.16794,426,269862,0.0176264,0,1,131392,130966,426
16778741,7.29452,7.83359,425,269862,0.0115253,0.05,1,131399,130974,425
16780821,19.0589,7.16672,440,269862,0.0343051,0.01,1,131421,130981,440
16782481,10.2118,19.8333,425,269862,0.014861,0,1,131429,131004,425
16785401,7.64236,7.96667,427,269862,0.0029722,0.03,1,131436,131009,427
16788101,11.9285,7.99333,432,269862,0.00059444,0.04,1,131449,131017,432
16790181,11.1857,11.1987,431,269862,0.000118888,0.03,1,131460,131029,431
16791841,7.03714,12.6397,424,269862,0.00802378,0.01,1,131466,131042,424
16794761,8.60743,8.92795,425,269862,0.0496048,0.01,1,131475,131050,425
16796421,8.12149,8.18559,425,269862,0.017921,0.05,1,131483,131058,425
16799341,8.8243,8.03712,426,269862,0.0115842,0,1,131492,131066,426
16802261,8.16486,8.00742,426,269862,0.0263168,0.04,1,131500,131074,426
16805181,8.03297,8.00148,426,269862,0.00526337,0.06,1,131508,131082,426
16807441,8.00659,8.0003,426,269862,0.0490527,0.08,1,131516,131090,426
16809521,11.2013,11.2001,426,269862,0.0498105,0.06,1,131528,131102,426
16812441,11.0403,11.84,425,269862,0.0179621,0.01,1,131539,131114,425
16815361,8.60805,8.768,425,269862,0.0195924,0.01,1,131547,131122,425
16818281,8.92161,8.1536,426,269862,0.00391848,0.03,1,131556,131130,426
16820961,7.38432,8.03072,425,269822,0.000783697,0.03,1,131563,131138,425
16823881,7.87686,7.20614,426,269822,0.0321567,0,1,131571,131145,426
16826161,7.97537,7.84123,426,269822,0.0224313,0.01,1,131579,131153,426
16829081,11.9951,11.9682,426,269822,0.00448627,0.05,1,131592,131166,426
16831361,7.99901,8.79365,425,269822,0.00889725,0.03,1,131599,131174,425
16834281,9.5998,8.95873,426,269822,0.00977945,0.05,1,131609,131183,426
16835941,9.91996,8.19175,428,269822,0.0339559,0,1,131619,131191,428
16838861,9.18399,9.63835,427,269822,0.0387912,0.04,1,131628,131201,427
16841141,8.2368,8.32767,427,269822,0.0477582,0.05,1,131636,131209,427
16844061,7.24736,8.86553,425,269822,0.0175516,0.03,1,131643,131218,425
16846981,7.84947,8.17311,425,269822,0.00351033,0.03,1,131651,131226,425
16849901,7.96989,8.03462,425,269822,0.00870207,0.03,1,131659,131234,425
16852821,7.99398,8.00692,425,269822,0.0417404,0.03,1,131667,131242,425
16855701,9.5988,8.00138,427,269822,0.0403481,0.04,1,131677,131250,427
16858621,7.51976,8.00028,426,269822,0.0640696,0.04,1,131684,131258,426
16861521,7.10395,8.00006,425,269822,0.0208139,0.08,1,131691,131266,425
16863601,8.62079,8.00001,426,269822,0.0361628,0.01,1,131700,131274,426
16866521,10.5242,9.6,427,269822,0.0952326,0.01,1,131711,131284,427
16868181,9.30483,8.32,428,269822,0.171047,0.03,1,131720,131292,428
16871101,9.86097,10.464,427,269822,0.250209,0.01,1,131730,131303,427
16874021,7.57219,8.4928,426,269822,0.314042,0.06,1,131737,131311,426
16876941,7.91444,8.09856,426,269822,0.350808,0.04,1,131745,131319,426
16879861,7.98289,8.01971,426,269822,0.366162,0.05,1,131753,131327,426
16882781,7.19658,8.00394,425,269822,0.393232,0.05,1,131760,131335,425
16885701,7.83932,8.00079,425,269822,0.470646,0.03,1,131768,131343,425
16888621,9.56786,8.00016,427,269822,0.574129,0.03,1,131778,131351,427
16891541,7.51357,8.00003,426,269822,0.618826,0.05,1,131785,131359,426
16894461,7.90271,8.00001,426,269822,0.683765,0.03,1,131793,131367,426
16897381,7.98054,8,426,269822,0.728753,0.05,1,131801,131375,426
16900301,7.99611,8,426,269822,0.769751,0.05,2,131809,131383,426
16903221,7.99922,8,426,269822,0.83395,0.03,2,131817,131391,426
16906141,7.99984,8,426,269822,0.90279,0.04,2,131825,131399,426
16936201,8,7,426,269822,0.86,0.06,2,131945,131519,426
16939121,7.2,7.8,425,269822,0.852,0.05,2,131952,131527,425
16942021,11.84,7.96,430,269822,0.8424,0.03,2,131965,131535,430
16944101,15.168,10.392,435,269822,0.80848,0.01,2,131981,131546,435
16947021,8.6336,15.6784,425,269822,0.793696,0.04,2,131988,131563,425
16949941,8.12672,9.53568,425,269822,0.790739,0.02,2,131996,131571,425
16952861,9.62534,8.30714,427,269822,0.750148,0.02,2,132006,131579,427
16955781,6.72507,8.06143,425,269822,0.71803,0.03,1,132012,131587,425
16958701,7.74501,8.01229,425,269822,0.687606,0,1,132020,131595,425
16961621,8.749,8.00246,426,269822,0.609521,0.01,1,132029,131603,426
16963861,7.3498,8.00049,425,269822,0.561904,0.05,1,132036,131611,425
16965941,8.66996,6.4001,428,269822,0.520381,0.04,1,132045,131617,428
16968021,7.33399,10.08,424,269822,0.496076,0.01,1,132052,131628,424
16969681,7.8668,6.816,426,269822,0.491215,0.05,1,132060,131634,426
16972601,8.77336,9.3632,425,269822,0.474243,0.03,1,132069,131644,425
16975521,9.75467,8.27264,427,269822,0.454849,0.04,1,132079,131652,427
16978441,8.35093,8.05453,427,269822,0.45097,0.04,1,132087,131660,427
16981361,7.27019,8.01091,426,269822,0.434194,0.04,1,132094,131668,426
16983201,6.25404,8.00218,424,269822,0.414839,0.01,1,132100,131676,424
16986121,16.4508,13.6004,428,269822,0.378968,0.05,1,132119,131691,428
16989041,12.8902,9.12009,432,269822,0.363794,0.12,1,132131,131699,432
16991961,11.378,8.22402,435,269822,0.360759,0.17,1,132142,131707,435
16994881,11.8756,8.0448,439,269822,0.440152,0.22,1,132154,131715,439
16997801,12.7751,8.00896,444,269822,0.44003,0.3,1,132167,131723,444
17000261,11.355,8.00179,447,269822,0.472006,0.38,1,132178,131731,447
17003181,11.071,11.2004,446,269822,0.510401,0.34,1,132189,131743,446
17006101,11.0142,8.64007,449,269822,0.48608,0.41,1,132200,131751,449
17009021,11.8028,8.12801,453,269822,0.505216,0.5,1,132212,131759,453
17011941,11.1606,8.0256,456,269822,0.581043,0.56,1,132223,131767,456
17014861,11.0321,8.00512,459,269822,0.588209,0.66,1,132234,131775,459
17017781,11.8064,8.00102,463,269822,0.573642,0.7,1,132246,131783,463
17020701,10.3613,8.0002,465,269822,0.578728,0.76,1,132256,131791,465
17023621,10.0723,8.00004,467,269822,0.603746,0.81,1,132266,131799,467
17026541,10.8145,8.00001,470,269822,0.616749,0.85,1,132277,131807,470
17029461,10.9629,8,473,269822,0.64335,0.92,1,132288,131815,473
17032381,10.1926,8,475,269822,0.67267,0.97,1,132298,131823,475
17035301,10.0385,8,477,269822,0.686534,1,1,132308,131831,477
17037701,6.8077,8,475,269822,0.705307,1,1,132314,131839,475
17039361,7.76154,8,475,269822,0.741061,1,1,132322,131847,475
17042281,19.9523,20,475,269982,0.716212,1,1,132345,131870,475
17045201,11.1905,10.4,476,269982,0.711242,1,1,132354,131878,476
17048121,9.43809,8.48,477,269982,0.694248,1,1,132363,131886,477
17050801,7.48762,8.096,476,269982,0.68285,1,1,132370,131894,476
17053721,14.2975,15.2192,475,269982,0.74457,0.97,1,132386,131911,475
17056001,7.6595,9.44384,473,269982,0.764914,0.98,2,132392,131919,473
17058081,6.3319,6.68877,473,269982,0.760983,0.96,2,132398,131925,473
17061001,6.86638,6.13775,474,269982,0.744197,0.92,1,132405,131931,474
17062661,3.77328,7.62755,469,269982,0.740839,0.91,1,132408,131939,469
17065581,7.15466,7.12551,470,269982,0.700168,0.87,1,132416,131946,470
17068501,7.03093,7.8251,469,269982,0.708034,0.87,1,132423,131954,469
17070981,10.2062,7.96502,472,269982,0.677607,0.82,1,132434,131962,472
17072641,6.84124,11.993,465,269982,0.663521,0.81,1,132440,131975,465
17074721,6.16825,7.9986,464,269982,0.676704,0.86,1,132446,131982,464
17077641,7.63365,9.59972,462,269982,0.647341,0.78,1,132454,131992,462
17080561,7.12673,8.31994,461,269982,0.657468,0.76,1,132461,132000,461
17082421,9.42535,8.06399,463,269982,0.691494,0.66,1,132471,132008,463
17085341,6.68507,13.6128,454,269982,0.658299,0.62,1,132477,132023,454
17088261,5.33701,9.12256,451,269982,0.65166,0.57,1,132482,132031,451
17091181,5.8674,8.22451,449,269982,0.650332,0.5,1,132488,132039,449
17094101,8.37348,8.0449,450,269982,0.650066,0.53,1,132497,132047,450
17097021,8.0747,8.00898,450,269982,0.626013,0.5,1,132505,132055,450
17099941,6.41494,8.0018,448,269982,0.613203,0.48,1,132511,132063,448
17102181,5.28299,8.00036,445,269982,0.618641,0.49,1,132516,132071,445
17104261,8.2566,6.40007,448,269982,0.579728,0.47,1,132525,132077,448
17107181,7.25132,7.68001,447,269982,0.571946,0.44,1,132532,132085,447
17110101,6.25026,7.936,445,269982,0.562389,0.41,1,132538,132093,445
17113021,8.45005,7.9872,446,269982,0.560478,0.4,1,132547,132101,446
17115701,18.49,7.99744,459,269982,0.536096,0.38,1,132568,132109,459
17118621,12.498,19.9995,447,269982,0.587219,0.39,1,132579,132132,447
17120901,16.8996,10.3999,457,269982,0.637444,0.48,1,132597,132140,457
17122561,10.5799,15.68,449,269982,0.679489,0.44,1,132606,132157,449
17125481,6.91598,8.736,448,269982,0.679898,0.48,1,132612,132164,448
17128401,10.1832,8.1472,451,269982,0.66398,0.5,1,132623,132172,451
17130881,6.83664,8.02944,449,269982,0.660796,0.58,1,132629,132180,449
17133801,10.9673,9.60589,451,269982,0.636159,0.51,1,132641,132190,451
17135461,8.59347,8.32118,451,269982,0.615232,0.55,1,132649,132198,451
17137121,8.91869,8.06424,452,269982,0.651046,0.56,1,132658,132206,452
17139201,9.78374,8.01285,454,269982,0.650209,0.61,1,132668,132214,454
17142121,16.3567,16.8026,453,269982,0.658042,0.54,1,132686,132233,453
17143781,13.6714,9.76051,458,269982,0.651608,0.57,1,132699,132241,458
17146701,9.93427,10.7521,456,269982,0.666322,0.64,1,132708,132252,456
17149621,7.58685,8.55042,455,269982,0.669264,0.65,1,132715,132260,455
17152541,9.51737,8.11008,457,269982,0.677853,0.66,1,132725,132268,457
17155221,8.30347,8.02202,457,269982,0.775571,0.63,2,132733,132276,457
17156881,8.06069,7.2044,458,269982,0.755114,0.68,2,132741,132283,458
17159801,8.01214,7.04088,459,269982,0.783023,0.7,2,132749,132290,459
17161461,9.60243,7.80818,461,269982,0.796605,0.72,2,132759,132298,461
17164381,9.92049,8.76164,462,269982,0.791321,0.75,2,132769,132307,462
17166241,7.5841,8.15233,461,269982,0.782264,0.76,2,132776,132315,461
17168321,4.71682,5.63047,460,269982,0.796453,0.77,2,132780,132320,460
17170401,8.94336,7.52609,462,269982,0.831291,0.76,2,132790,132328,462
17173321,24.1887,25.5052,460,269982,0.758258,0.73,2,132818,132358,460
17176241,13.6377,11.501,463,269982,0.751652,0.74,2,132829,132366,463
17178721,7.52755,8.70021,461,269982,0.74233,0.79,1,132835,132374,461
17181641,8.70551,7.34004,463,269982,0.756466,0.74,2,132844,132381,463
17183301,4.9411,7.86801,459,269982,0.751293,0.77,2,132848,132389,459
17185381,8.98822,5.5736,464,269982,0.798259,0.77,2,132858,132394,464
17188301,7.39764,10.7147,459,269982,0.839652,0.74,2,132865,132406,459
17190581,7.07953,8.54294,458,269982,0.80793,0.73,2,132872,132414,458
17193281,7.81591,6.50859,460,269982,0.809586,0.71,2,132880,132420,460
17196201,6.36318,6.90172,459,269982,0.801917,0.69,2,132886,132427,459
17199121,7.67264,7.78034,459,269982,0.824383,0.68,2,132894,132435,459
17202041,7.13453,7.95607,458,269982,0.804877,0.69,2,132901,132443,458
17204961,7.82691,7.99121,458,269982,0.776975,0.69,2,132909,132451,458
17207841,7.16538,7.99824,457,269982,0.771395,0.68,2,132916,132459,457
17210761,7.83308,7.99965,457,269982,0.746279,0.69,1,132924,132467,457
17212421,6.36662,7.99993,455,269982,0.749256,0.68,1,132930,132475,455
17214501,5.27332,5.59999,455,269982,0.749851,0.7,1,132935,132480,455
17216161,6.65466,5.92,456,269982,0.74197,0.65,1,132942,132486,456
17219081,9.33093,9.984,455,269982,0.748394,0.62,1,132952,132497,455
17221361,8.26619,8.3968,455,269982,0.749679,0.63,1,132960,132505,455
17224281,5.65324,6.47936,454,269982,0.749936,0.62,1,132965,132511,454
17227201,7.53065,7.69587,454,269982,0.749987,0.6,1,132973,132519,454
17230121,7.90613,7.93917,454,269982,0.725997,0.57,1,132981,132527,454
17233041,7.98123,7.98783,454,269982,0.7292,0.56,1,132989,132535,454
17235961,7.19624,7.99757,453,269982,0.71384,0.57,1,132996,132543,453
17238881,7.83925,7.99951,453,269982,0.718768,0.58,1,133004,132551,453
17241801,7.16785,7.9999,452,269982,0.719754,0.56,1,133011,132559,452
17244661,11.8336,7.99998,457,269982,0.743951,0.58,1,133024,132567,457
17246321,8.76671,9.6,455,269982,0.75679,0.62,2,133032,132577,455
17249241,9.75334,7.52,458,269982,0.807358,0.63,2,133042,132584,458
17250901,14.7507,7.904,466,269982,0.849472,0.69,2,133058,132592,466
17253821,10.9501,16.7808,457,269982,0.889894,0.68,2,133068,132611,457
17255681,8.59003,9.75616,457,269982,0.889979,0.68,2,133076,132619,457
17267541,13,13,467,269982,0.91,0.62,2,133129,132662,467
17270241,9.8,13,463,269982,0.942,0.69,2,133138,132675,463
17273161,23.56,25,462,269982,0.8684,0.68,2,133165,132703,462
17276081,11.912,11.4,463,269982,0.87768,0.74,2,133174,132711,463
17279001,11.1824,8.68,466,269982,0.871536,0.74,2,133185,132719,466
17280641,7.83648,8.136,465,269982,0.926307,0.81,2,133192,132727,465
17563941,22,8,498,269982,0.91,1,2,134266,133768,498
17566641,14,21.6,485,269982,0.91,1,2,134278,133793,485
17569561,8.4,9.92,485,269982,0.926,1,2,134285,133800,485
17588921,8,8,480,269982,0.93,1,2,134346,133866,480
17591841,8,8,480,269982,0.97,1,2,134354,133874,480
17612241,7,8,477,269982,0.97,0.96,2,134407,133930,477
17668981,8,8,478,269982,0.9,0.98,2,134631,134153,478
17715601,9,8,475,269982,0.92,0.94,2,134819,134344,475
17718521,8.2,8,475,269982,0.936,0.95,2,134827,134352,475
17721441,7.24,8,474,269982,0.9472,0.96,2,134834,134360,474
17724101,7.848,8,474,269982,0.94144,0.99,2,134842,134368,474
17727021,7.1696,7.2,474,269982,0.924288,0.98,2,134849,134375,474
17729941,7.83392,7.84,474,269982,0.944858,0.96,2,134857,134383,474
17732421,6.36678,7.968,472,269982,0.948972,0.97,2,134863,134391,472
17735341,7.67336,7.1936,473,269982,0.957794,0.98,2,134871,134398,473
17738261,7.93467,7.83872,473,269982,0.943559,0.99,2,134879,134406,473
17741181,7.98693,7.96774,473,269982,0.932712,0.97,2,134887,134414,473
17744101,7.19739,7.99355,472,269982,0.906542,0.99,2,134894,134422,472
17746981,8.63948,7.99871,473,269982,0.909308,0.97,2,134903,134430,473
17749901,8.1279,7.99974,473,269982,0.909862,0.99,2,134911,134438,473
17752821,8.02558,7.99995,473,269982,0.925972,0.98,2,134919,134446,473
17755741,7.20512,7.99999,472,269982,0.945194,0.97,2,134926,134454,472
17780261,4,5,476,269982,0.94,1,2,135020,134544,476
17782341,8,5.8,479,269982,0.932,1,2,135029,134550,479
17806061,9,30,480,269982,0.94,0.96,2,135153,134673,480
17808341,20.2,12.4,495,269982,0.916,0.95,2,135176,134681,495
17811261,10.44,21.68,479,269982,0.9192,0.97,2,135184,134705,479
17814181,8.488,10.736,479,269982,0.94384,0.99,2,135192,134713,479
17817101,7.2976,8.5472,478,269982,0.908768,0.97,2,135199,134721,478
17820021,7.85952,8.10944,478,269982,0.917754,1,2,135207,134729,478
17822481,6.3719,8.02189,476,269982,0.911551,0.93,2,135213,134737,476
17824561,18.8744,19.2044,476,269982,0.90231,0.97,2,135235,134759,476
17827481,14.1749,13.4409,477,269982,0.884462,1,2,135248,134771,477
17830401,10.035,9.08818,478,269982,0.880892,0.99,2,135257,134779,478
17833301,10.007,8.21764,480,269982,0.848179,0.95,2,135267,134787,480
17836221,9.2014,13.6435,474,269982,0.881636,0.94,2,135276,134802,474
17839141,8.24028,9.12871,474,269982,0.864327,0.94,2,135284,134810,474
17842061,7.24806,8.22574,473,269982,0.836865,0.97,2,135291,134818,473
17844981,8.64961,8.04515,474,269982,0.855373,0.96,2,135300,134826,474
17847901,7.32992,8.00903,473,269982,0.875075,0.94,2,135307,134834,473
17850821,8.66598,8.00181,474,269982,0.903015,0.96,2,135316,134842,474
17853741,8.1332,8.00036,474,269982,0.924603,0.97,2,135324,134850,474
17856661,8.02664,8.00007,474,269982,0.936921,0.97,2,135332,134858,474
17859301,7.20533,8.00001,473,269982,0.907384,0.97,2,135339,134866,473
17862221,7.84107,7.2,474,269982,0.901477,0.93,2,135347,134873,474
17865141,7.96821,7.84,474,269982,0.916295,0.93,2,135355,134881,474
17868061,7.19364,7.968,473,269982,0.927259,0.92,2,135362,134889,473
17870981,7.03873,7.9936,472,269982,0.921452,0.93,2,135369,134897,472
17873901,8.60775,7.99872,473,269982,0.92029,0.93,2,135378,134905,473
17885101,8,7,474,269982,0.9,0.98,2,135410,134936,474
17888021,8.8,7.8,475,269982,0.884,0.98,2,135419,134944,475
17890501,12.16,7.96,480,269982,0.9048,1,2,135432,134952,480
17930861,7,11,474,269982,0.9,0.94,2,135598,135124,474
17933141,23.8,8.6,494,269982,0.844,0.92,2,135626,135132,494
17936061,11.96,24.92,474,269982,0.8408,0.89,2,135635,135161,474
17938341,15.192,11.384,482,269982,0.86416,0.94,2,135651,135169,482
17940421,11.8384,12.6768,480,269982,0.884832,0.96,2,135662,135182,480
17943341,10.3677,13.7354,476,269982,0.856966,0.91,2,135672,135196,476
17946261,7.67354,9.14707,475,269982,0.859393,0.92,2,135679,135204,475
17949181,6.33471,8.22941,473,269982,0.867879,0.88,2,135685,135212,473
17952101,9.26694,8.04588,475,269982,0.885576,0.85,2,135695,135220,475
17954981,17.8534,8.00918,487,269982,0.857115,0.9,2,135715,135228,487
17957061,14.7707,17.6018,481,269982,0.859423,0.89,2,135729,135248,481
17959981,10.9541,16.3204,475,269982,0.859885,0.88,2,135739,135264,475
17962901,6.99083,9.66407,473,269982,0.859977,0.89,2,135745,135272,473
17965381,6.99817,8.33281,472,269982,0.867995,0.86,2,135752,135280,472
17968301,8.59963,8.06656,473,269982,0.877599,0.86,2,135761,135288,473
17971221,8.11993,8.01331,473,269982,0.87152,0.9,2,135769,135296,473
17973701,8.82399,8.00266,474,269982,0.878304,0.9,2,135778,135304,474
17976621,8.1648,8.80053,473,269982,0.879661,0.92,2,135786,135313,473
17979541,8.03296,8.16011,473,269982,0.879932,0.94,2,135794,135321,473
17982461,8.00659,8.03202,473,269982,0.911986,0.93,2,135802,135329,473
17984721,7.20132,8.0064,472,269982,0.886397,0.95,2,135809,135337,472
17987641,7.04026,6.40128,473,269982,0.897279,0.96,2,135816,135343,473
17990561,7.80805,7.68026,473,269982,0.891456,0.96,2,135824,135351,473
17993041,7.96161,7.93605,473,269982,0.858291,0.94,2,135832,135359,473
17995961,7.19232,7.18721,473,269982,0.851658,0.92,2,135839,135366,473
17998881,7.83846,7.83744,473,269982,0.858332,0.93,2,135847,135374,473
18001361,7.96769,7.96749,473,269982,0.875666,0.92,2,135855,135382,473
18004281,9.59354,11.1935,471,269982,0.871133,0.9,2,135865,135394,471
18007201,8.31871,8.6387,471,269982,0.886227,0.9,2,135873,135402,471
18010121,8.06374,8.12774,471,269982,0.873245,0.9,2,135881,135410,471
18013041,8.01275,8.02555,471,269982,0.862649,0.92,2,135889,135418,471
18015961,9.60255,8.00511,473,269982,0.86053,0.94,2,135899,135426,473
18018881,8.32051,8.00102,473,269982,0.868106,0.98,2,135907,135434,473
18020501,8.0641,8.0002,473,269982,0.925621,0.98,2,135915,135442,473
18023421,9.61282,8.00004,475,269982,0.961124,1,2,135925,135450,475
18035101,9,8,473,269982,0.89,0.97,2,135955,135482,473
18037141,21,8,489,269982,0.914,0.96,2,135979,135490,489
18103741,8,8,471,269862,0.89,0.89,2,136256,135785,471
18105781,6.4,8,469,269862,0.914,0.95,2,136262,135793,469
18108701,7.68,6.4,471,269862,0.9188,0.92,2,136270,135799,471
18130741,14,8,476,5840,0.79,0.88,2,136337,135861,476
18133661,7.6,12.8,468,5840,0.758,0.87,2,136343,135875,468
18136581,7.92,8.96,468,5840,0.7196,0.86,1,136351,135883,468
18139501,7.984,8.192,468,5840,0.66392,0.86,1,136359,135891,468
18142421,10.3968,8.0384,471,5840,0.612784,0.87,1,136370,135899,471
18145301,8.47936,8.00768,471,5840,0.594557,0.94,1,136378,135907,471
18148221,9.69587,8.00154,473,5840,0.606911,0.93,1,136388,135915,473
18151141,9.93917,8.00031,475,5840,0.609382,0.94,1,136398,135923,475
18154061,7.58783,8.00006,474,5840,0.577876,0.95,1,136405,135931,474
18156981,7.11757,8.00001,473,5840,0.547575,0.94,1,136412,135939,473
18159901,8.62351,8,474,5840,0.477515,0.91,1,136421,135947,474
18162561,8.1247,8,474,5840,0.423503,0.94,1,136429,135955,474
18165481,8.02494,7.2,475,5840,0.404701,0.93,1,136437,135962,475
18167141,19.205,7.84,489,5840,0.25694,0.97,1,136459,135970,489
18169221,11.841,16.768,480,5840,0.251388,1,1,136469,135989,480
18172141,9.5682,11.3536,479,5840,0.250278,0.99,1,136478,135999,479
18175061,8.31364,8.67072,479,5840,0.218056,1,1,136486,136007,479
18177541,19.2627,8.13414,493,5840,0.171611,0.98,1,136508,136015,493
18180461,10.2525,20.8268,477,5840,0.138322,0.98,1,136516,136039,477
18183381,10.0505,10.5654,479,5840,0.0756644,0.98,1,136526,136047,479
18185861,6.8101,8.51307,477,5840,0.0551329,1,1,136532,136055,477
18187941,9.36202,7.30261,480,5840,0.0190266,1,1,136542,136062,480
18190021,16.2724,8.66052,489,5840,0.0438053,1,1,136560,136071,489
18192101,14.4545,13.7321,488,5840,0.0327611,1,1,136574,136086,488
18194181,21.2909,13.9464,497,5840,0.0305522,0.97,1,136597,136100,497
18197101,13.0582,24.3893,481,5840,0.00611044,0.92,1,136608,136127,481
18199381,8.21164,11.2779,480,5840,0.0252221,1,1,136615,136135,480
18201461,6.44233,7.05557,480,5840,0.0450444,1,1,136621,136141,480
18203541,21.2885,8.61111,496,5840,0.0250089,1,1,136646,136150,496
18206461,13.0577,23.3222,480,5840,0.0130018,0.99,1,136657,136177,480
18209381,9.81154,11.0644,481,5840,0.0106004,1,1,136666,136185,481
18212301,8.36231,8.61289,481,5840,0.00212007,1,1,136674,136193,481
18215221,10.4725,8.12258,484,5840,0.016424,1,1,136685,136201,484
18217061,11.6945,8.02452,488,5840,0.0272848,1,1,136697,136209,488
18219141,9.5389,12.0049,484,5840,0.029457,1,1,136706,136222,484
18222061,6.70778,13.601,476,5840,0.0538914,0.96,1,136712,136236,476
18224981,7.74156,9.1202,476,5840,0.0107783,0.94,1,136720,136244,476
18227901,7.14831,8.22404,475,5840,0.0261557,0.92,1,136727,136252,475
18230821,7.82966,8.04481,475,5840,0.0212311,0.92,1,136735,136260,475
18233741,7.96593,8.00896,475,5840,0.0122462,0.97,1,136743,136268,475
18236661,7.99319,8.00179,475,5840,0.0264492,0.98,1,136751,136276,475
18238121,164.799,8.00036,671,5840,0.14929,0.01,1,136955,136284,671
18241041,207.36,368.8,430,5840,0.029858,0.03,1,137173,136743,430
18242501,205.472,84.16,622,272782,0.365972,0.18,1,137378,136756,622
18243961,209.094,176.032,633,274242,0.769194,0,2,137588,136955,633
18246881,50.6189,209.606,426,275702,0.849839,0.06,2,137599,137173,426
18249801,18.9238,49.9213,427,278622,0.873968,0.05,2,137610,137183,427
18252721,10.9848,17.9843,426,281542,0.862794,0.04,2,137619,137193,426
18255641,11.797,11.5969,428,284462,0.844559,0.05,2,137631,137203,428
18258561,8.75939,10.3194,426,287382,0.840912,0.06,2,137639,137213,426
18261481,10.5519,10.0639,427,290302,0.816182,0.05,2,137650,137223,427
18264401,9.31038,10.0128,426,293222,0.843236,0.06,2,137659,137233,426
18267321,11.4621,10.0026,428,290787,0.832647,0.05,2,137671,137243,428
18270241,8.69242,10.0005,426,287730,0.774529,0.05,2,137679,137253,426
18273161,12.1385,10.0001,429,285284,0.746906,0.05,1,137692,137263,429
18276081,12.8277,10,432,283450,0.741381,0.12,1,137705,137273,432
18279001,11.3655,10,433,281616,0.716276,0.15,1,137716,137283,433
18281921,11.8731,10,435,280393,0.775255,0.19,2,137728,137293,435
18284841,14.3746,10,440,279170,0.803051,0.22,2,137743,137303,440
18287761,9.27492,10,438,278559,0.78461,0.24,2,137751,137313,438
18290681,12.255,10,441,277948,0.764922,0.33,2,137764,137323,441
18293601,12.051,10,443,277948,0.768984,0.33,2,137776,137333,443
18296521,11.2102,10,444,277948,0.793797,0.36,2,137787,137343,444
18299441,11.842,10,446,277948,0.758759,0.41,2,137799,137353,446
18302361,11.9684,10,448,277948,0.751752,0.46,2,137811,137363,448
18305281,11.9937,10,450,277948,0.79835,0.48,2,137823,137373,450
18308201,12.7987,10,453,277948,0.80767,0.56,2,137836,137383,453
18311121,12.1597,10,455,277948,0.761534,0.61,2,137848,137393,455
18314041,13.6319,10,459,277948,0.816307,0.68,2,137862,137403,459
18316961,11.5264,10,460,277948,0.875261,0.71,2,137873,137413,460
18319881,13.5053,10,464,277948,0.839052,0.75,2,137887,137423,464
18322801,13.1011,10,467,277948,0.82381,0.77,2,137900,137433,467
18325721,12.2202,10,469,277948,0.796762,0.8,2,137912,137443,469
18328641,12.044,10,471,277948,0.839352,0.79,2,137924,137453,471
18331561,9.60881,10,470,277948,0.807871,0.82,2,137933,137463,470
18334481,12.3218,10,473,277948,0.785574,0.87,2,137946,137473,473
18337401,12.8644,10,476,277948,0.821115,0.9,2,137959,137483,476
18340321,8.17287,10,473,277948,0.860223,0.96,2,137966,137493,473
18343241,12.0346,10,476,277948,0.828045,1,2,137979,137503,476
18346161,10.4069,10,476,277948,0.837609,0.92,2,137989,137513,476
18349081,13.2814,10,480,277948,0.807522,1,2,138003,137523,480
18352001,9.05628,10,478,277948,0.817504,1,2,138011,137533,478
18354921,8.21126,10,476,277948,0.843501,0.97,2,138019,137543,476
18357841,8.84225,10,475,277948,0.7847,0.91,2,138028,137553,475
18360761,8.96845,10,474,277948,0.74094,0.94,1,138037,137563,474
18363681,9.79369,10,474,277948,0.764188,0.91,2,138047,137573,474
18366601,9.95874,10,474,277948,0.704838,0.91,1,138057,137583,474
18369521,9.19175,10,473,277948,0.676968,0.88,1,138066,137593,473
18372441,9.03835,10,472,277948,0.647393,0.89,1,138075,137603,472
18375361,8.20767,10,470,277948,0.649479,0.88,1,138083,137613,470
18378281,8.04153,10,468,277948,0.657896,0.86,1,138091,137623,468
18381201,8.00831,10,466,277948,0.643579,0.83,1,138099,137633,466
18384121,11.2017,10,468,277948,0.624716,0.85,1,138111,137643,468
18387041,8.64033,10,466,277948,0.620943,0.86,1,138119,137653,466
18389961,8.12807,10,464,277948,0.636189,0.82,1,138127,137663,464
18392881,9.62561,10,464,277948,0.623238,0.77,1,138137,137673,464
18395801,9.12512,10,463,277948,0.588648,0.76,1,138146,137683,463
18398721,9.02502,10,462,277948,0.57373,0.76,1,138155,137693,462
18401641,10.605,10,463,277948,0.538746,0.75,1,138166,137703,463
18404561,12.521,10,466,277948,0.547749,0.83,1,138179,137713,466
18407481,9.7042,10,465,277948,0.55755,0.8,1,138188,137723,465
18410401,9.94084,10,465,277948,0.60751,0.83,1,138198,137733,465
18413321,9.98817,10,465,277948,0.617502,0.84,1,138208,137743,465
18416241,9.19763,10,464,277948,0.6435,0.79,1,138217,137753,464
18418401,7.43953,10,461,277948,0.6407,0.8,1,138224,137763,461
18421321,11.8879,9.2,465,277948,0.64814,0.77,1,138237,137772,465
18424241,9.57758,9.84,464,277948,0.649628,0.81,1,138246,137782,464
18426721,7.51552,9.968,461,277948,0.697926,0.76,1,138253,137792,461
18429641,11.1031,8.3936,465,277948,0.707585,0.78,1,138265,137800,465
18431301,14.2206,9.67872,470,277948,0.645517,0.84,1,138280,137810,470
18434221,10.0441,13.1357,465,277948,0.673103,0.79,1,138289,137824,465
18436081,8.40882,10.6271,463,277948,0.678621,0.78,1,138297,137834,463
18439001,8.88177,6.92543,466,277948,0.695724,0.78,1,138306,137840,466
18440661,10.5764,9.38509,467,277948,0.707145,0.84,1,138317,137850,467
18442741,11.7153,9.87702,469,277948,0.733429,0.86,1,138329,137860,469
18444401,7.14305,7.5754,468,277948,0.778686,0.85,2,138335,137867,468
18447321,14.2286,12.7151,470,277948,0.683737,0.86,1,138351,137881,470
18448981,7.64572,10.543,466,277948,0.664747,0.83,1,138357,137891,466
18451901,10.3291,8.5086,469,277948,0.62095,0.83,1,138368,137899,469
18454821,10.0658,9.70172,469,277948,0.67619,0.88,1,138378,137909,469
18457301,10.0132,9.94034,469,277948,0.703238,0.82,1,138388,137919,469
18458961,8.40263,11.5881,465,277948,0.732648,0.84,1,138396,137931,465
18461881,11.2805,8.71761,469,277948,0.77053,0.84,2,138408,137939,469
18464801,10.2561,9.74352,469,277948,0.738106,0.85,1,138418,137949,469
18466661,12.4512,9.9487,472,277948,0.739621,0.85,1,138431,137959,472
18469581,10.4902,13.1897,468,277948,0.771924,0.87,2,138441,137973,468
18472501,10.098,10.6379,468,277948,0.850385,0.86,2,138451,137983,468
18475421,6.81961,10.1276,464,277948,0.834077,0.82,2,138457,137993,464
18478341,11.7639,10.0255,467,277948,0.830815,0.86,2,138470,138003,467
18481261,7.95278,10.0051,464,277948,0.838163,0.82,2,138477,138013,464
18484181,8.79056,10.001,463,277948,0.799633,0.76,2,138486,138023,463
18487101,10.5581,10.0002,464,277948,0.815926,0.82,2,138497,138033,464
18489541,6.11162,10,459,277948,0.843185,0.79,2,138502,138043,459
18492461,9.22232,8.40001,461,277948,0.816637,0.72,2,138512,138051,461
18495381,9.04447,9.68,460,277948,0.803327,0.67,2,138521,138061,460
18498301,9.80889,9.936,460,277948,0.800665,0.67,2,138531,138071,460
18501221,9.16178,9.9872,459,277928,0.784133,0.7,2,138540,138081,459
18504141,9.03236,9.99744,458,277928,0.780827,0.64,2,138549,138091,458
18507061,9.00647,9.99949,457,280848,0.780165,0.66,2,138558,138101,457
18509981,9.80129,9.9999,457,280848,0.764033,0.63,2,138568,138111,457
18512901,9.96026,9.99998,457,280848,0.752807,0.65,2,138578,138121,457
18515821,9.19205,10,456,280848,0.798561,0.62,2,138587,138131,456
18518741,9.03841,10,455,280848,0.799712,0.63,2,138596,138141,455
18521661,9.80768,10,455,280848,0.807943,0.58,2,138606,138151,455
18524581,8.36154,10,453,280848,0.809589,0.58,2,138614,138161,453
18527501,9.67231,10,453,280848,0.777918,0.54,2,138624,138171,453
18530421,12.3345,10,456,280848,0.795583,0.61,2,138637,138181,456
18533341,12.0669,10,458,280848,0.839117,0.64,2,138649,138191,458
18536261,12.0134,10,460,280848,0.879823,0.65,2,138661,138201,460
18539181,10.4027,10,460,280848,0.871965,0.67,2,138671,138211,460
18542101,9.28054,10,459,280848,0.870393,0.69,2,138680,138221,459
18545021,11.4561,10,461,280848,0.910079,0.65,2,138692,138231,461
18547941,12.6912,10,464,280848,0.870016,0.71,2,138705,138241,464
18550861,10.5382,10,464,280848,0.846003,0.77,2,138715,138251,464
18553781,7.70765,10,461,280848,0.865201,0.68,2,138722,138261,461
18556701,10.3415,10,462,280848,0.85304,0.68,2,138733,138271,462
18559621,11.6683,10,464,280848,0.802608,0.7,2,138745,138281,464
18562541,11.9337,10,466,280848,0.824522,0.74,2,138757,138291,466
18565461,8.78673,10,464,280848,0.836904,0.73,2,138765,138301,464
18567121,8.95735,10,463,280848,0.815381,0.71,2,138774,138311,463
18570041,10.5915,8.4,466,280848,0.803076,0.78,2,138785,138319,466
18572741,14.1183,9.68,471,280848,0.864615,0.74,2,138800,138329,471
18575441,7.62366,16.336,459,280848,0.868923,0.67,2,138806,138347,459
18577521,11.9247,10.4672,463,280848,0.853785,0.63,2,138819,138356,463
18580441,11.1849,9.29344,465,280848,0.898757,0.7,2,138830,138365,465
18582721,10.237,9.85869,465,280848,0.843751,0.7,2,138840,138375,465
18585641,10.8474,8.37174,468,280848,0.83275,0.77,2,138851,138383,468
18587921,10.9695,9.67435,469,280848,0.82255,0.8,2,138862,138393,469
18590001,7.7939,11.5349,464,280848,0.83651,0.77,2,138869,138405,464
18592081,11.9588,11.107,466,280848,0.831302,0.74,2,138882,138416,466
18595001,11.9918,9.42139,469,280848,0.82226,0.79,2,138894,138425,469
18597281,12.7984,9.88428,472,280848,0.772452,0.78,2,138907,138435,472
18600201,8.15967,8.37686,471,280848,0.78649,0.89,2,138914,138443,471
18601861,8.03193,9.67537,469,280848,0.765298,0.82,2,138922,138453,469
18604781,10.4064,9.13507,471,280848,0.76106,0.86,2,138933,138462,471
18607061,10.0813,9.82701,471,280848,0.816212,0.84,2,138943,138472,471
18609981,10.0163,9.9654,471,280848,0.835242,0.88,2,138953,138482,471
18612901,10.0033,9.99308,471,280848,0.863048,0.9,2,138963,138492,471
18615821,8.40065,9.99862,469,280848,0.90061,0.83,2,138971,138502,469
18618741,7.28013,9.99972,466,280848,0.884122,0.84,2,138978,138512,466
18621661,8.65603,9.99994,465,280848,0.848824,0.79,2,138987,138522,465
18624581,9.73121,9.99999,465,280848,0.833765,0.82,2,138997,138532,465
18627501,9.14624,10,464,280848,0.822753,0.79,2,139006,138542,464
18630421,9.82925,10,464,280848,0.852551,0.79,2,139016,138552,464
18633341,8.36585,8.4,464,280848,0.84251,0.76,2,139024,138560,464
18636261,8.07317,8.08,464,280848,0.848502,0.77,2,139032,138568,464
18639181,8.81463,8.016,465,280848,0.8417,0.77,2,139041,138576,465
18642101,8.16293,8.0032,465,280848,0.84034,0.79,2,139049,138584,465
18645021,8.83259,8.00064,466,280848,0.848068,0.79,2,139058,138592,466
18647621,6.56652,8.00013,464,280848,0.833614,0.83,2,139064,138600,464
18649281,6.1133,7.20003,463,280848,0.814723,0.82,2,139070,138607,463
18652201,10.0227,9.44,464,280848,0.810945,0.78,2,139081,138617,464
18655121,8.40453,8.288,464,280848,0.818189,0.79,2,139089,138625,464
18657601,9.68091,8.0576,466,280848,0.835638,0.82,2,139099,138633,466
18660521,13.1362,9.61152,470,280848,0.815128,0.86,2,139113,138643,470
18663441,9.02724,8.3223,470,280848,0.859025,0.9,2,139121,138651,470
18665301,13.8054,8.06446,477,280848,0.851805,0.91,2,139136,138659,477
18666961,8.36109,14.4129,468,280848,0.850361,0.89,2,139143,138675,468
18669881,9.67222,10.0826,469,280848,0.818072,0.92,2,139153,138684,469
18672801,7.53444,8.41652,468,280848,0.843614,0.9,2,139160,138692,468
18675281,7.90689,8.0833,468,280848,0.848723,0.9,2,139168,138700,468
18678201,9.58138,7.21666,471,280848,0.841745,0.84,2,139178,138707,471
18679861,13.1163,7.84333,477,280848,0.832349,0.82,2,139192,138715,477
18682781,9.02325,16.7687,466,280848,0.86247,0.8,2,139200,138734,466
18685701,9.80465,9.75373,468,280848,0.868494,0.83,2,139210,138742,468
18688621,8.36093,8.35075,468,280848,0.869699,0.84,2,139218,138750,468
18691301,12.0722,8.07015,473,280848,0.94994,0.86,2,139231,138758,473
18694221,10.4144,12.014,470,280848,0.941988,0.84,2,139241,138771,470
18697141,8.48289,8.80281,470,280848,0.916398,0.86,2,139249,138779,470
18700061,8.09658,8.16056,470,280848,0.879279,0.85,2,139257,138787,470
18701701,13.6193,8.03211,477,280848,0.943856,0.9,2,139272,138795,477
18704621,9.12386,14.4064,469,280848,0.932771,0.87,2,139280,138811,469
18707541,9.82477,9.28128,471,280848,0.898554,0.93,2,139290,138819,471
18710021,13.965,8.25626,478,280848,0.907711,0.83,2,139305,138827,478
18712101,9.99299,14.4513,471,280848,0.941542,0.84,2,139314,138843,471
18715021,9.9986,10.8903,471,280848,0.948308,0.85,2,139324,138853,471
18717301,9.99972,8.57805,473,280848,0.925662,0.86,2,139334,138861,473
18718961,5.99994,9.71561,468,280848,0.921132,0.85,2,139339,138871,468
18721041,9.19999,9.14312,469,280868,0.928226,0.82,2,139349,138880,469
18723121,9.04,9.82862,468,280868,0.905645,0.76,2,139358,138890,468
18725201,12.208,11.5657,469,280868,0.917129,0.81,2,139371,138902,469
18728121,8.8416,9.51315,468,280868,0.911426,0.78,2,139379,138911,468
18729781,6.56832,8.30263,466,280868,0.894285,0.77,2,139385,138919,466
18731861,7.71366,7.26053,467,280868,0.930857,0.79,2,139393,138926,467
18733941,13.5427,6.25211,476,280868,0.906171,0.87,2,139408,138932,476
18735601,7.50855,11.6504,469,280868,0.901234,0.86,2,139414,138945,469
18737681,6.30171,6.33008,470,280868,0.900247,0.85,2,139420,138950,470
18740601,7.66034,6.06602,472,280868,0.900049,0.9,2,139428,138956,472
18742261,7.13207,7.6132,471,280868,0.90001,0.92,2,139435,138964,471
18743921,5.42641,9.52264,466,280868,0.892002,0.88,2,139440,138974,466
18746841,7.48528,7.50453,467,280868,0.8984,0.86,2,139448,138981,467
18749761,7.89706,7.90091,467,280868,0.93168,0.87,2,139456,138989,467
18752681,8.77941,7.98018,468,280868,0.914336,0.83,2,139465,138997,468
18755361,7.35588,7.99604,467,280868,0.870867,0.87,2,139472,139005,467
18758281,7.07118,7.19921,467,280868,0.878173,0.87,2,139479,139012,467
18761201,7.81424,7.83984,467,280868,0.887635,0.86,2,139487,139020,467
18763681,7.96285,7.96797,467,280868,0.905527,0.86,2,139495,139028,467
18766601,7.99257,7.19359,468,280868,0.909105,0.85,2,139503,139035,468
18769521,7.99851,7.83872,468,280868,0.901821,0.86,2,139511,139043,468
18771381,7.1997,7.96774,467,280868,0.868364,0.87,2,139518,139051,467
18774301,9.43994,8.79355,468,280868,0.869673,0.85,2,139528,139060,468
18777221,7.48799,8.15871,467,280868,0.885935,0.83,2,139535,139068,467
18780141,7.8976,8.03174,467,280868,0.881187,0.82,2,139543,139076,467
18782401,7.17952,8.00635,466,280868,0.848237,0.85,2,139550,139084,466
18785321,9.4359,9.60127,466,280868,0.841648,0.85,2,139560,139094,466
18786981,15.4872,8.32025,475,280868,0.85633,0.86,2,139577,139102,475
18788641,8.69744,12.8641,468,280868,0.867266,0.89,2,139584,139116,468
18791561,5.73949,6.57281,468,280868,0.861453,0.9,2,139589,139121,468
18793841,7.5479,7.71456,468,280868,0.892291,0.89,2,139597,139129,468
18796761,15.9096,14.3429,470,280868,0.890458,0.84,2,139615,139145,470
18799461,14.3819,9.26858,476,280868,0.914092,0.87,2,139629,139153,476
18802381,8.47638,12.2537,470,280868,0.934818,0.87,2,139636,139166,470
18804661,9.69528,8.85074,472,280868,0.930964,0.86,2,139646,139174,472
18807581,9.13906,8.97015,472,280868,0.938193,0.85,2,139655,139183,472
18818801,5,8,473,280868,0.94,0.96,2,139697,139224,473
18821721,12.2,13.6,472,280868,0.94,0.94,2,139711,139239,472
19225041,8,8,488,280868,0.94,1,2,141221,140733,488
19344421,15,8,491,280868,0.89,1,2,141673,141182,491
19347341,7,14.4,480,280868,0.882,0.99,2,141678,141198,480
19349621,8.6,9.28,481,280868,0.8404,0.99,2,141687,141206,481
19352321,8.92,8.256,482,280868,0.82408,0.96,2,141696,141214,482
19355241,9.784,9.6512,482,280868,0.748816,1,1,141706,141224,482
19356901,6.7568,8.33024,480,280868,0.717763,1,1,141712,141232,480
19358561,9.35136,7.26605,483,280868,0.719553,1,1,141722,141239,483
19361481,10.6703,15.0532,477,280868,0.67991,1,1,141733,141256,477
19364401,8.53405,9.41064,477,280868,0.647982,1,1,141741,141264,477
19367301,8.90681,8.28213,478,280868,0.617596,1,1,141750,141272,478
19368961,6.58136,8.05643,476,280868,0.603519,0.97,1,141756,141280,476
19371881,24.5163,24.0113,477,280868,0.616704,0.96,1,141785,141308,477
19374801,12.1033,11.2023,478,280868,0.587341,0.99,1,141794,141316,478
19377701,9.62065,8.64045,479,280868,0.629468,1,1,141803,141324,479
19380401,8.32413,10.5281,476,280868,0.613894,1,1,141811,141335,476
19383321,7.26483,7.70562,476,280868,0.610779,1,1,141818,141342,476
19384981,5.45297,7.94112,473,280868,0.634156,1,1,141823,141350,473
19386641,9.89059,7.98822,476,280868,0.702831,1,1,141834,141358,476
19389561,6.77812,7.19764,475,280868,0.724566,1,1,141840,141365,475
19391841,9.35562,7.83953,477,280868,0.728913,1,1,141850,141373,477
19394761,5.87112,7.96791,474,280868,0.737783,1,1,141855,141381,474
19396421,22.7742,7.99358,493,280868,0.715557,1,1,141882,141389,493
19399121,22.9548,21.5987,491,280868,0.695111,1,1,141905,141414,491
19402041,13.391,14.7197,489,280868,0.603022,1,1,141916,141427,489
19403701,6.67819,9.34395,486,280868,0.544604,1,1,141921,141435,486
19406621,10.9356,5.86879,493,280868,0.524921,1,1,141933,141440,493
19409541,10.1871,7.57376,495,280868,0.536984,1,1,141943,141448,495
19412461,10.8374,7.91475,498,280868,0.515397,1,1,141954,141456,498
19415141,10.1675,7.98295,500,280868,0.495079,1,1,141964,141464,500
19418061,10.0335,8.79659,501,280868,0.515016,1,1,141974,141473,501
19420981,10.0067,8.15932,503,280868,0.487003,1,1,141984,141481,503
19423901,10.0013,8.03186,505,280868,0.473401,1,1,141994,141489,505
19426581,6.80027,8.00637,503,280868,0.42268,1,1,142000,141497,503
19429501,8.56005,8.80127,503,280868,0.436536,1,1,142009,141506,503
19432421,8.91201,8.16025,504,280868,0.423307,1,1,142018,141514,504
19435341,8.9824,8.03205,505,280868,0.364661,1,1,142027,141522,505
19438261,8.99648,8.00641,506,280868,0.304932,1,1,142036,141530,506
19567221,354.599,415.201,430,244480,0.0609865,0.21,1,142477,142047,430
19568641,75.7199,86.2403,432,135445,0.0121973,0.01,1,142483,142051,432
19571561,355.144,360.448,428,136865,0.0184395,0.01,1,142908,142480,428
19574481,78.2288,80.0896,427,139785,0.0516879,0.06,1,142917,142490,427
19577401,24.4458,24.0179,428,142705,0.0503376,0.05,1,142928,142500,428
19580321,11.2892,12.8036,426,145625,0.0580675,0.03,1,142936,142510,426
19583241,11.0578,10.5607,427,148545,0.0836135,0.03,1,142947,142520,427
19586161,9.41157,10.1121,426,151465,0.104723,0.03,1,142956,142530,426
19589081,10.6823,10.0224,427,154385,0.148945,0.03,1,142967,142540,427
19592001,9.33646,10.0045,426,157305,0.165789,0.03,1,142976,142550,426
19594921,10.6673,10.0009,427,160225,0.185158,0.03,1,142987,142560,427
19597841,9.33346,10.0002,426,163145,0.197032,0.03,1,142996,142570,426
19600761,10.6667,10,427,166065,0.231406,0.03,1,143007,142580,427
19603681,9.33334,10,426,168985,0.222281,0.03,1,143016,142590,426
19606601,10.6667,10,427,171905,0.252456,0.03,1,143027,142600,427
19609521,9.33333,10,426,174825,0.266491,0.03,1,143036,142610,426
19612441,11.4667,10,428,177745,0.285298,0.02,1,143048,142620,428
19615361,8.69333,10,426,180665,0.29706,0.05,1,143056,142630,426
19618281,10.5387,10,427,183585,0.323412,0.01,1,143067,142640,427
19621201,9.30773,10,426,186505,0.336682,0.05,1,143076,142650,426
19624121,10.6615,10,427,189425,0.363336,0.03,1,143087,142660,427
19627041,9.33231,10,426,192345,0.376667,0.03,1,143096,142670,426
19629961,10.6665,10,427,195265,0.403333,0.03,1,143107,142680,427
19632881,9.33329,10,426,198185,0.416667,0.03,1,143116,142690,426
19635801,10.6667,10,427,201105,0.451333,0.01,1,143127,142700,427
19638721,9.33333,10,426,204025,0.450267,0.03,1,143136,142710,426
19641641,11.4667,10,428,206945,0.450053,0.01,1,143148,142720,428
19644561,8.69333,10,426,209865,0.418011,0.03,1,143156,142730,426
19647481,11.3387,10,428,212785,0.451602,0.01,1,143168,142740,428
19650401,9.46773,10,427,215705,0.48232,0.04,1,143177,142750,427
19653321,9.89355,10,427,218625,0.440464,0.03,1,143187,142760,427
19656241,9.17871,10,426,221545,0.448093,0.01,1,143196,142770,426
19659161,9.83574,10,426,224465,0.473619,0.03,1,143206,142780,426
19662081,9.96715,10,426,227385,0.486724,0.03,1,143216,142790,426
19665001,9.99343,10,426,230305,0.457345,0.01,1,143226,142800,426
19667921,9.99869,10,426,233225,0.419469,0.01,1,143236,142810,426
19670841,9.99974,10,426,236145,0.379894,0.01,1,143246,142820,426
19673761,10.7999,10,427,239065,0.331979,0.01,1,143257,142830,427
19676681,9.35999,10,426,241985,0.290396,0.02,1,143266,142840,426
19679601,9.872,10,426,244905,0.234079,0.03,1,143276,142850,426
19682521,9.9744,10,426,245174,0.222816,0.03,1,143286,142860,426
19685441,9.99488,10,426,245174,0.228563,0.03,1,143296,142870,426
19688361,9.99898,10,426,245174,0.237713,0.03,1,143306,142880,426
19691281,9.9998,10,426,245174,0.263543,0.03,1,143316,142890,426
19694201,10.8,10,427,248094,0.252709,0.02,1,143327,142900,427
19697121,10.16,10,427,251014,0.266542,0.05,1,143337,142910,427
19700041,10.832,10,428,253934,0.293308,0.06,1,143348,142920,428
19702961,11.7664,10,430,256666,0.298662,0.12,1,143360,142930,430
19705881,11.1533,10,431,256666,0.331732,0.11,1,143371,142940,431
19708801,11.0307,10,432,256666,0.346346,0.15,1,143382,142950,432
19711721,11.0061,10,433,256666,0.381269,0.18,1,143393,142960,433
19714641,11.0012,10,434,256666,0.396254,0.2,1,143404,142970,434
19717561,11.0002,10,435,256666,0.375251,0.21,1,143415,142980,435
19720481,11,10,436,256666,0.38705,0.24,1,143426,142990,436
19723401,11,10,437,256666,0.42141,0.25,1,143437,143000,437
19726321,11,10,438,256666,0.420282,0.26,1,143448,143010,438
19729241,10.2,10,438,256666,0.436056,0.28,1,143458,143020,438
19732161,11.64,10,440,256666,0.447211,0.29,1,143470,143030,440
19735081,10.328,10,440,256666,0.457442,0.32,1,143480,143040,440
19738001,11.6656,10,442,256666,0.443488,0.34,1,143492,143050,442
19740921,10.3331,10,442,256666,0.472698,0.35,1,143502,143060,442
19743841,11.6666,10,444,256666,0.51854,0.37,1,143514,143070,444
19746761,10.3333,10,444,256666,0.479708,0.4,1,143524,143080,444
19749681,11.6667,10,446,256666,0.455942,0.41,1,143536,143090,446
19752601,11.1333,10,447,256666,0.499188,0.43,1,143547,143100,447
19755521,11.0267,10,448,256666,0.523838,0.44,1,143558,143110,448
19758441,11.0053,10,449,256666,0.512768,0.48,1,143569,143120,449
19761361,9.40107,10,448,256666,0.518553,0.46,1,143578,143130,448
19764281,9.08021,10,447,256666,0.503711,0.43,1,143587,143140,447
19767201,9.81604,10,447,256666,0.524742,0.44,1,143597,143150,447
19770121,12.3632,10,450,256666,0.504948,0.44,1,143610,143160,450
19773041,8.87264,10,448,256666,0.48499,0.49,1,143618,143170,448
19775961,10.5745,10,449,256666,0.472998,0.46,1,143629,143180,449
19778881,10.9149,10,450,256666,0.4946,0.51,1,143640,143190,450
19781801,10.983,10,451,256666,0.48292,0.5,1,143651,143200,451
19784721,8.5966,10,449,256666,0.496584,0.49,1,143659,143210,449
19787641,8.11932,10,447,256666,0.515317,0.46,1,143667,143220,447
19790561,8.02386,10,445,256666,0.527063,0.42,1,143675,143230,445
19793481,7.20477,10,442,256666,0.505413,0.35,1,143682,143240,442
19796401,7.84095,10,440,256666,0.485083,0.32,1,143690,143250,440
19799321,7.16819,10,437,256666,0.481017,0.27,1,143697,143260,437
19802241,9.43364,10,437,256666,0.432203,0.22,1,143707,143270,437
19805161,10.6867,10,438,256666,0.366441,0.23,1,143718,143280,438
19808081,9.33735,10,437,256666,0.337288,0.25,1,143727,143290,437
19811001,11.4675,10,439,256666,0.347458,0.29,1,143739,143300,439
19813921,8.69349,10,437,256666,0.349492,0.27,1,143747,143310,437
19816841,11.3387,10,439,256666,0.365898,0.28,1,143759,143320,439
19819761,10.2677,10,439,256666,0.38518,0.28,1,143769,143330,439
19822681,11.6535,10,441,256666,0.373036,0.3,1,143781,143340,441
19825601,10.3307,10,441,256666,0.402607,0.32,1,143791,143350,441
19828521,10.8661,10,442,256666,0.448521,0.37,1,143802,143360,442
19831441,10.9732,10,443,256666,0.433704,0.39,1,143813,143370,443
19834361,10.9946,10,444,256666,0.422741,0.39,1,143824,143380,444
19837281,10.9989,10,445,256666,0.420548,0.42,1,143835,143390,445
19840201,9.39979,10,444,256666,0.44411,0.41,1,143844,143400,444
19843121,10.68,10,445,256666,0.464822,0.42,1,143855,143410,445
19846041,10.936,10,446,256666,0.444964,0.43,1,143866,143420,446
19848401,10.9872,10,447,256666,0.464993,0.44,1,143877,143430,447
19851321,12.5974,10.8,449,256666,0.476999,0.44,1,143890,143441,449
19854241,10.5195,10.16,449,256666,0.4954,0.45,1,143900,143451,449
19857161,10.1039,10.032,449,256666,0.50708,0.48,1,143910,143461,449
19859841,10.0208,10.0064,449,256666,0.501416,0.46,1,143920,143471,449
19862761,10.8042,9.20128,451,256666,0.508283,0.5,1,143931,143480,451
19865681,10.9608,9.84026,452,256666,0.493657,0.51,1,143942,143490,452
19868601,10.9922,9.96805,453,256666,0.498731,0.57,1,143953,143500,453
19871281,7.79843,9.99361,450,256666,0.531746,0.51,1,143960,143510,450
19874201,8.75969,9.19872,450,256666,0.514349,0.48,1,143969,143519,450
19877121,10.5519,9.83974,451,256666,0.48687,0.49,1,143980,143529,451
19878981,5.31039,9.96795,445,256666,0.473374,0.52,1,143984,143539,445
19880641,7.46208,6.79359,447,256666,0.494675,0.55,1,143992,143545,447
19882721,8.69242,6.15872,450,256666,0.498935,0.53,1,144001,143551,450
19885641,8.93848,6.83174,452,256666,0.459787,0.54,1,144010,143558,452
19887301,8.9877,9.36635,451,256666,0.499957,0.53,1,144019,143568,451
19888961,9.79754,9.87327,451,256666,0.523991,0.57,1,144029,143578,451
19891881,10.7595,11.5747,450,256666,0.544798,0.56,1,144040,143590,450
19894801,10.9519,10.3149,451,256666,0.55696,0.52,1,144051,143600,451
19897721,10.1904,10.063,451,256666,0.559392,0.51,1,144061,143610,451
19900401,8.43808,10.0126,449,256666,0.543878,0.49,1,144069,143620,449
19903321,12.0876,9.20252,453,256666,0.572776,0.53,1,144082,143629,453
19906241,9.61752,9.8405,452,256666,0.570555,0.52,1,144091,143639,452
19909161,11.5235,9.9681,454,256666,0.554111,0.52,1,144103,143649,454
19911841,8.7047,9.99362,452,256666,0.566822,0.53,1,144111,143659,452
19914761,8.14094,9.19872,451,256666,0.569364,0.52,1,144119,143668,451
19917681,8.82819,9.83974,450,256666,0.561873,0.51,1,144128,143678,450
19920601,8.16564,9.96795,448,256666,0.568375,0.48,1,144136,143688,448
19923521,8.03313,9.99359,446,256666,0.529675,0.44,1,144144,143698,446
19926441,7.20663,9.99872,443,256666,0.521935,0.37,1,144151,143708,443
19929361,9.44132,9.99974,443,256666,0.488387,0.35,1,144161,143718,443
19932281,10.6883,9.99995,444,256666,0.497677,0.37,1,144172,143728,444
19935201,10.1377,9.99999,444,256666,0.475536,0.37,1,144182,143738,444
19938121,11.6275,10,446,256666,0.455107,0.39,1,144194,143748,446
19941041,10.3255,10,446,256666,0.459021,0.41,1,144204,143758,446
19943961,10.0651,10,446,256666,0.467804,0.4,1,144214,143768,446
19946881,10.813,10,447,256666,0.485561,0.41,1,144225,143778,447
19949801,10.1626,10,447,256106,0.489112,0.46,1,144235,143788,447
19952721,10.0325,10,447,256106,0.505822,0.47,1,144245,143798,447
19955641,10.0065,10,447,256106,0.501164,0.45,1,144255,143808,447
19958561,10.0013,10,447,256106,0.500233,0.43,1,144265,143818,447
19961481,10.0003,10,447,256106,0.516047,0.45,1,144275,143828,447
19964401,10.0001,10,447,256106,0.527209,0.45,1,144285,143838,447
19967321,11.6,10,449,256106,0.545442,0.47,1,144297,143848,449
19970241,9.52,10,448,256106,0.581088,0.47,1,144306,143858,448
19973161,11.504,10,450,256106,0.620218,0.5,1,144318,143868,450
19976081,10.3008,10,450,256106,0.604044,0.49,1,144328,143878,450
19979001,10.8602,10,451,256106,0.616809,0.53,1,144339,143888,451
19980901,10.972,10,452,256106,0.691362,0.53,1,144350,143898,452
19983821,9.39441,10.8,450,256106,0.706272,0.51,1,144359,143909,450
19986741,11.4789,10.16,452,256106,0.757254,0.54,2,144371,143919,452
19989661,10.2958,10.032,452,256106,0.719451,0.53,1,144381,143929,452
19992581,10.8592,10.0064,453,256106,0.71989,0.54,1,144392,143939,453
19995501,10.1718,10.0013,453,256106,0.663978,0.56,1,144402,143949,453
19997541,11.6344,10.0003,455,256106,0.684796,0.53,1,144414,143959,455
20000461,10.3269,11.6001,453,256106,0.704959,0.51,1,144424,143971,453
20003381,10.0654,10.32,453,256106,0.716992,0.51,1,144434,143981,453
20006301,9.21308,10.064,452,256106,0.687398,0.52,1,144443,143991,452
20009221,10.6426,10.0128,453,256106,0.64948,0.52,1,144454,144001,453
20012141,10.1285,10.0026,453,256106,0.665896,0.54,1,144464,144011,453
20015061,10.8257,10.0005,454,256106,0.669179,0.59,1,144475,144021,454
20017301,9.36514,10.0001,453,256106,0.677836,0.57,1,144484,144031,453
20020221,9.87303,8.40002,455,256106,0.711567,0.56,1,144494,144039,455
20022081,9.17461,9.68,454,256106,0.710313,0.57,1,144503,144049,454
20025001,9.83492,9.136,455,256106,0.662063,0.55,1,144513,144058,455
20027921,10.767,9.8272,456,256106,0.644413,0.62,1,144524,144068,456
20030841,7.7534,9.96544,453,256106,0.656882,0.59,1,144531,144078,453
20033521,9.55068,9.99309,453,256106,0.683376,0.59,1,144541,144088,453
20036441,14.7101,11.5986,457,256106,0.688675,0.59,1,144557,144100,457
20039361,9.34203,10.3197,455,256106,0.673735,0.59,1,144565,144110,455
20042281,9.86841,10.0639,455,256106,0.654747,0.57,1,144575,144120,455
20044961,7.57368,10.0128,452,256106,0.658949,0.55,1,144582,144130,452
20047881,9.51474,10.8026,451,256106,0.64379,0.54,1,144592,144141,451
20050801,9.90295,10.1605,451,256106,0.656758,0.52,1,144602,144151,451
20053721,9.18059,10.0321,450,256106,0.603352,0.51,1,144611,144161,450
20056641,9.83612,10.0064,450,256106,0.57667,0.49,1,144621,144171,450
20059561,9.96722,10.0013,450,256106,0.539334,0.48,1,144631,144181,450
20062481,9.99344,10.0003,450,256106,0.587867,0.51,1,144641,144191,450
20065401,9.99869,10.0001,450,256106,0.573573,0.5,1,144651,144201,450
20068321,9.99974,10,450,256106,0.562715,0.54,1,144661,144211,450
20071241,11.5999,10,452,256106,0.592543,0.53,1,144673,144221,452
20074161,9.51999,10,451,259026,0.614509,0.55,1,144682,144231,451
20077081,11.504,10,453,259026,0.626902,0.54,1,144694,144241,453
20080001,11.1008,10,454,259026,0.65338,0.57,1,144705,144251,454
20082921,11.8202,10,456,259026,0.698676,0.56,1,144717,144261,456
20085841,10.364,10,456,259026,0.723735,0.56,1,144727,144271,456
20088761,9.27281,10,455,259026,0.720747,0.53,1,144736,144281,455
20091681,10.6546,10,456,259026,0.712149,0.61,1,144747,144291,456
20094601,11.7309,10,458,259026,0.67843,0.64,1,144759,144301,458
20097521,9.54618,10,457,259026,0.711686,0.64,1,144768,144311,457
20100441,11.5092,10,459,259026,0.718337,0.62,1,144780,144321,459
20103201,10.3018,10,459,259026,0.727667,0.64,1,144790,144331,459
20106121,10.8604,9.2,461,259026,0.785533,0.77,2,144801,144340,461
20109041,10.1721,9.84,461,259026,0.789107,0.78,2,144811,144350,461
20111521,10.0344,9.968,461,259026,0.765821,0.78,2,144821,144360,461
20114441,8.40688,9.1936,460,259026,0.769164,0.75,2,144829,144369,460
20116101,10.4814,9.83872,461,259026,0.753833,0.72,2,144840,144379,461
20119021,9.29628,9.96774,460,259026,0.718767,0.72,1,144849,144389,460
20121301,9.85925,9.99355,460,259026,0.775753,0.69,2,144859,144399,460
20124221,9.17185,8.39871,461,259026,0.723151,0.76,1,144868,144407,461
20127141,10.6344,9.67974,462,259026,0.65663,0.74,1,144879,144417,462
20129621,11.7269,9.93595,464,259026,0.675326,0.69,1,144891,144427,464
20132541,11.1454,14.7872,459,259026,0.703065,0.67,1,144902,144443,459
20135461,11.8291,10.9574,461,259026,0.748613,0.68,1,144914,144453,461
20138381,9.56582,10.1915,460,259026,0.733723,0.7,1,144923,144463,460
20141301,11.5132,10.0383,462,259026,0.786745,0.7,2,144935,144473,462
20144221,11.1026,10.0077,463,259026,0.805349,0.74,2,144946,144483,463
20147141,7.82053,10.0015,460,259026,0.80107,0.75,2,144953,144493,460
20150061,7.96411,10.0003,458,259026,0.824214,0.69,2,144961,144503,458
20152501,8.79282,10.0001,457,259026,0.820843,0.65,2,144970,144513,457
20155421,12.1586,8.40001,462,259026,0.804169,0.7,2,144983,144521,462
20158321,8.83171,9.68,460,259026,0.784834,0.73,2,144991,144531,460
20161241,9.76634,9.936,460,259026,0.788967,0.67,2,145001,144541,460
20164161,9.15327,9.9872,459,259026,0.797793,0.7,2,145010,144551,459
20166021,13.8307,9.99744,464,259026,0.823559,0.68,2,145025,144561,464
20168941,9.96613,13.9995,458,259026,0.812712,0.68,2,145034,144576,458
20171861,9.19323,10.7999,457,259026,0.794542,0.68,2,145043,144586,457
20174781,9.83865,10.16,457,259026,0.790908,0.65,2,145053,144596,457
20177701,7.56773,10.032,454,259026,0.806182,0.63,2,145060,144606,454
20180621,9.51355,10.0064,454,259026,0.817236,0.57,2,145070,144616,454
20183541,10.7027,10.0013,455,259026,0.827447,0.61,2,145081,144626,455
20186461,10.9405,10.0003,456,259026,0.821489,0.62,2,145092,144636,456
20189381,10.1881,10.0001,456,259026,0.852298,0.63,2,145102,144646,456
20192301,10.0376,10,456,259026,0.87446,0.59,2,145112,144656,456
20195221,10.8075,10,457,259026,0.910892,0.62,2,145123,144666,457
20198141,10.9615,10,458,259026,0.926178,0.61,2,145134,144676,458
20201061,10.1923,8.4,460,259026,0.905236,0.66,2,145144,144684,460
20203981,9.23846,8.08,461,259026,0.909047,0.65,2,145153,144692,461
20206901,9.84769,8.016,463,259026,0.925809,0.66,2,145163,144700,463
20209821,7.56954,8.0032,462,259026,0.929162,0.72,2,145170,144708,462
20211781,12.7139,8.00064,468,259026,0.929832,0.75,2,145184,144716,468
20214701,7.34278,12.8001,460,259026,0.873967,0.72,2,145190,144730,460
20217621,8.66856,8.96003,461,259026,0.862793,0.72,2,145199,144738,461
20219681,8.93371,8.19201,462,259026,0.868559,0.74,2,145208,144746,462
20221761,7.38674,6.4384,463,259026,0.805712,0.73,2,145215,144752,463
20224681,9.47735,9.28768,463,259026,0.769142,0.7,2,145225,144762,463
20226341,8.29547,8.25754,463,259026,0.769828,0.72,2,145233,144770,463
20228001,8.05909,7.25151,464,259026,0.769966,0.74,2,145241,144777,464
20230921,6.41182,5.4503,465,259026,0.777993,0.77,2,145247,144782,465
20232581,9.28236,7.49006,467,259026,0.779599,0.8,2,145257,144790,467
20235501,6.65647,7.89801,465,259026,0.79592,0.83,2,145263,144798,465
20237781,11.7313,7.9796,470,259026,0.831184,0.77,2,145276,144806,470
20239441,7.14626,12.7959,462,259026,0.822237,0.78,2,145282,144820,462
20242361,11.0293,11.3592,463,259446,0.748447,0.76,1,145294,144831,463
20245281,9.40585,8.67184,464,259446,0.781689,0.75,2,145303,144839,464
20248181,11.4812,8.13437,468,259446,0.796338,0.78,2,145315,144847,468
20251101,9.49623,12.0269,464,259446,0.791268,0.71,2,145324,144860,464
20253381,12.2992,8.80537,469,259446,0.814253,0.67,2,145337,144868,469
20255041,8.85985,12.1611,464,259446,0.818851,0.69,2,145345,144881,464
20257961,8.17197,9.63222,463,259446,0.80377,0.73,2,145353,144890,463
20259621,11.2344,8.32644,467,259446,0.832754,0.78,2,145365,144898,467
20262541,9.44688,10.4653,465,259446,0.838551,0.74,2,145374,144909,465
20265461,9.88938,8.49306,467,259446,0.82371,0.79,2,145384,144917,467
20267941,9.97788,8.09861,469,259446,0.828742,0.85,2,145394,144925,469
20270861,7.59557,9.61972,466,259446,0.845748,0.82,2,145401,144935,466
20273141,14.3191,8.32394,474,259446,0.87315,0.83,2,145417,144943,474
20274801,7.66382,12.8648,466,259446,0.89463,0.85,2,145423,144957,466
20277721,9.53276,8.97296,468,259446,0.874926,0.86,2,145433,144965,468
20280641,7.50655,8.19459,467,259446,0.854985,0.84,2,145440,144973,467
20283121,7.90131,8.03892,467,259446,0.866997,0.78,2,145448,144981,467
20286041,11.1803,9.60778,469,259446,0.829399,0.84,2,145460,144991,469
20287701,6.23605,8.32156,466,259446,0.79788,0.82,2,145465,144999,466
20290621,8.44721,7.26431,468,259446,0.831576,0.8,2,145474,145006,468
20293541,7.28944,7.85286,467,259446,0.830315,0.84,2,145481,145014,467
20296021,8.65789,7.97057,468,259446,0.838063,0.81,2,145490,145022,468
20298101,14.5316,8.79411,475,259446,0.879613,0.8,2,145506,145031,475
20301021,10.1063,14.5588,468,259446,0.927923,0.81,2,145515,145047,468
20303941,9.22126,9.31176,469,259446,0.937585,0.84,2,145524,145055,469
20316841,8,8,470,259446,0.95,0.87,2,145567,145097,470
20340121,10,9,469,259446,0.92,0.88,2,145651,145182,469
20342401,8.4,8.2,469,259446,0.92,0.89,2,145659,145190,469
20345321,7.28,6.44,470,259446,0.92,0.89,2,145666,145196,470
20346981,5.456,7.688,467,259446,0.936,0.83,2,145671,145204,467
20349901,7.4912,7.9376,467,259446,0.9152,0.78,2,145679,145212,467
20352181,8.69824,7.98752,468,259446,0.91904,0.77,2,145688,145220,468
20354881,7.33965,9.5975,465,259446,0.935808,0.78,2,145695,145230,465
20675201,8,8,491,259446,0.91,1,2,146918,146427,491
20678121,4.8,8,487,259446,0.91,1,2,146922,146435,487
20679781,4.16,8,483,259446,0.894,0.97,2,146926,146443,483
20681861,6.432,5.6,485,259446,0.9548,1,2,146933,146448,485
20780241,12,14,481,259446,0.94,1,2,147305,146824,481
20820181,9,8,482,259446,0.91,1,2,147455,146973,482
20822881,10.6,10.4,482,259446,0.918,1,2,147466,146984,482
20860961,8,8,482,259446,0.92,1,2,147606,147124,482
20863881,11.2,8,486,259446,0.944,1,2,147618,147132,486
20865521,10.24,8,488,259446,0.9008,1,2,147628,147140,488
20867601,7.648,8.8,486,259446,0.90816,1,2,147635,147149,486
20870521,7.1296,8.16,485,259446,0.909632,1,2,147642,147157,485
20873441,8.62592,8.032,486,259446,0.917926,1,2,147651,147165,486
20876361,8.12518,8.0064,486,259446,0.927585,1,2,147659,147173,486
20878001,7.22504,8.00128,485,259446,0.937517,1,2,147666,147181,485
20880921,6.24501,7.20026,484,259446,0.907503,1,2,147672,147188,484
20882581,4.449,7.84005,480,259446,0.893501,1,2,147676,147196,480
20885501,8.0898,8.76801,480,259446,0.9147,1,2,147685,147205,480
20887361,6.41796,8.1536,478,259446,0.92694,1,2,147691,147213,478
20897141,11,8,480,259446,0.87,0.99,2,147734,147254,480
20900061,9.4,12.8,475,259446,0.878,0.95,2,147743,147268,475
20902961,8.28,8.96,475,259446,0.8476,0.95,2,147751,147276,475
20905881,14.456,15.392,474,259446,0.72152,0.93,1,147767,147293,474
20908581,11.6912,9.4784,477,259446,0.688304,0.99,1,147778,147301,477
20910661,10.3382,7.49568,480,259446,0.665661,0.97,1,147788,147308,480
20913361,9.26765,10.2991,478,259446,0.661132,0.96,1,147797,147319,478
20916281,12.2535,12.4598,478,259446,0.644226,0.94,1,147810,147332,478
20919201,8.05071,8.89197,477,259446,0.648845,0.96,1,147817,147340,477
20921681,8.81014,8.17839,478,259446,0.601769,1,1,147826,147348,478
20924601,10.562,10.4357,478,259446,0.560354,1,1,147837,147359,478
20926881,8.51241,8.48714,478,259446,0.496071,0.99,1,147845,147367,478
20929801,24.1025,26.4974,475,259446,0.355214,0.94,1,147873,147398,475
20932721,13.6205,11.6995,478,259446,0.287043,0.96,1,147884,147406,478
20935621,14.7241,8.7399,485,259446,0.225409,0.98,1,147899,147414,485
20938541,7.74482,15.348,474,259446,0.173082,0.94,1,147905,147431,474
20941461,7.94896,9.4696,474,259446,0.138616,0.9,1,147913,147439,474
20944381,7.98979,8.29392,474,259446,0.139723,0.94,1,147921,147447,474
20947061,12.798,8.05878,480,259446,0.123945,0.92,1,147935,147455,480
20949981,10.5596,10.4118,479,259446,0.0647889,0.97,1,147945,147466,479
20952901,8.51192,8.48235,479,259446,0.0449578,1,1,147953,147474,479
20955821,11.3024,8.09647,483,259446,0.0169916,1,1,147965,147482,483
20957461,7.06048,8.01929,481,259446,0.0273983,1,1,147971,147490,481
20960381,7.8121,8.80386,480,259446,0.0134797,1,1,147979,147499,480
20963301,8.76242,8.16077,481,259446,0.00269593,1,1,147988,147507,481
20965361,8.15248,8.03215,481,259446,0.000539186,1,1,147996,147515,481
20967441,5.6305,8.00643,478,259446,0.0161078,1,1,148001,147523,478
20970361,5.1261,8.00129,475,259446,0.0112216,1,1,148006,147531,475
20973061,11.4252,8.00026,480,259446,0.0102443,0.94,1,148019,147539,480
20974721,6.28504,11.2001,473,259446,0.0260489,1,1,148024,147551,473
20977641,8.45701,7.84001,475,259446,0.00520977,0.99,1,148033,147558,475
20979301,10.4914,7.968,478,259446,0.017042,0.95,1,148044,147566,478
20982001,9.29828,11.9936,474,259446,0.0194084,0.93,1,148053,147579,474
20984081,9.85966,9.59872,475,259446,0.0278817,0.96,1,148063,147588,475
20987001,12.3719,10.7197,477,259446,0.0455763,0.97,1,148076,147599,477
20989701,8.87439,8.54395,477,259446,0.0331153,0.97,1,148084,147607,477
20991361,7.37488,9.70879,474,259446,0.00662305,0.93,1,148091,147617,474
20994281,11.875,13.1418,473,259446,0.0253246,0.9,1,148104,147631,473
20997201,7.97499,9.02835,472,259446,0.0130649,0.93,1,148111,147639,472
21000101,8.795,8.20567,473,259446,0.00261298,0.94,1,148120,147647,473
21002181,11.359,8.04113,477,259446,0.000522597,0.92,1,148132,147655,477
21005101,10.2718,12.8082,473,259446,0.000104519,0.92,1,148142,147669,473
21008021,10.0544,8.96165,475,259446,2.09039e-05,0.94,1,148152,147677,475
21010941,9.21087,8.19233,476,259446,0.0160042,0.98,1,148161,147685,476
21013861,8.24217,8.03847,476,259446,0.00320084,1,1,148169,147693,476
21016781,6.44843,8.00769,474,259446,0.0166402,0.94,1,148175,147701,474
21019701,7.68969,8.00154,474,259446,0.035328,0.95,1,148183,147709,474
21021941,7.93794,8.00031,474,259446,0.00706561,0.95,1,148191,147717,474
21024861,7.98759,9.60006,472,259446,0.0254131,0.9,1,148199,147727,472
21027141,10.3975,8.32001,475,259446,0.0450826,0.87,1,148210,147735,475
21029221,10.0795,11.264,473,259446,0.0170165,0.76,1,148220,147747,473
21032141,7.6159,14.2528,465,259446,0.0354033,0.69,1,148227,147762,465
21034001,6.32318,9.25056,463,259446,0.00708066,0.73,1,148233,147770,463
21036921,7.66464,9.85011,461,259446,0.00141613,0.66,1,148241,147780,461
21039841,6.33293,8.37002,459,259446,0.0242832,0.68,1,148247,147788,459
21042741,10.8666,8.074,463,259446,0.0288566,0.68,1,148259,147796,463
21044401,5.37332,12.8148,453,259446,0.0297713,0.64,1,148263,147810,453
21046481,5.07466,6.56296,453,259446,0.0379543,0.63,1,148268,147815,453
21049401,5.01493,6.11259,452,259446,0.0155909,0.58,1,148273,147821,452
21051061,6.60299,7.62252,451,259446,0.0351182,0.54,1,148280,147829,451
21053981,7.7206,9.5245,449,259446,0.0150236,0.48,1,148288,147839,449
21056261,5.54412,8.3049,446,259446,0.0190047,0.46,1,148293,147847,446
21057921,6.70882,8.86098,444,259446,0.0278009,0.27,1,148300,147856,444
21060001,17.3418,24.1722,436,259446,0.0295602,0.24,1,148320,147884,436
21062921,11.4684,15.2344,433,259446,0.021912,0.16,1,148330,147897,433
21065841,8.69367,9.44689,433,259446,0.00438241,0.13,1,148338,147905,433
21068761,7.33873,8.28938,432,259446,0.0328765,0.14,1,148345,147913,432
21071681,6.26775,8.05788,430,259446,0.0065753,0.15,1,148351,147921,430
21074561,6.85355,8.01158,429,259446,0.00931506,0.09,1,148358,147929,429
21077481,10.1707,12.8023,426,259446,0.033863,0.06,1,148369,147943,426
21079141,6.03414,8.96046,423,259446,0.0467726,0.05,1,148374,147951,423
21082061,7.60683,5.79209,426,259446,0.0493545,0.04,1,148382,147956,426
21084981,7.12137,7.55842,425,259446,0.0418709,0.04,1,148389,147964,425
21087461,14.2243,7.91168,433,259446,0.0563742,0.03,1,148405,147972,433
21090381,8.44485,12.7823,426,259446,0.0512748,0.04,1,148412,147986,426
21093301,7.28897,8.95647,425,259446,0.010255,0.03,1,148419,147994,425
21096221,7.85779,8.19129,425,259446,0.00205099,0.02,1,148427,148002,425
21099141,8.77156,8.03826,426,259446,0.0324102,0.03,1,148436,148010,426
21102021,8.95431,8.00765,427,259446,0.014482,0.03,1,148445,148018,427
21104941,8.99086,9.60153,426,259446,0.0108964,0.01,1,148454,148028,426
21107221,6.59817,8.32031,424,259446,0.0101793,0.05,1,148460,148036,424
21109301,12.5196,6.46406,432,258864,0.0100359,0.02,1,148474,148042,432
21111381,8.90393,11.6928,427,258864,0.0420072,0.04,1,148482,148055,427
21113041,6.58079,9.53856,424,258864,0.0164014,0.05,1,148488,148064,424
21115121,7.71616,7.50771,425,258281,0.0192803,0.01,1,148496,148071,425
21117201,10.3432,9.50154,426,258281,0.0278561,0.03,1,148507,148081,426
21120121,11.6686,11.5003,426,258281,0.0295712,0.01,1,148519,148093,426
21123041,7.93373,8.70006,425,258281,0.0219142,0.03,1,148526,148101,425
21125941,9.58675,8.14001,427,258281,0.0123828,0.02,1,148536,148109,427
21128861,8.31735,9.628,425,258281,0.00247657,0.03,1,148544,148119,425
21130721,7.26347,8.3256,424,258281,0.0244953,0.03,1,148551,148127,424
21132801,8.65269,7.26512,426,258281,0.0128991,0.02,1,148560,148134,426
21135721,12.1305,11.853,426,258281,0.0265798,0.03,1,148573,148147,426
21137381,11.2261,8.7706,429,258281,0.021316,0.03,1,148584,148155,429
21140301,9.44522,11.3541,426,258281,0.0442632,0.04,1,148593,148167,426
21143221,7.48904,8.67082,425,258281,0.0248526,0.04,1,148600,148175,425
21146141,9.49781,8.13416,427,258281,0.00497053,0.01,1,148610,148183,427
21149061,8.29956,8.02683,427,258281,0.000994105,0.03,1,148618,148191,427
21151981,7.25991,8.00537,426,258281,0.000198821,0.03,1,148625,148199,426
21154901,7.85198,8.00107,426,258281,0.0160398,0.02,1,148633,148207,426
21157761,7.1704,8.00021,425,258281,0.011208,0.04,1,148640,148215,425
21160681,17.4341,17.6,425,258281,0.0182416,0.03,1,148660,148235,425
21163601,9.88682,9.92001,425,258281,0.0196483,0.03,1,148668,148243,425
21166521,8.37736,8.384,425,258281,0.00392966,0.05,1,148676,148251,425
21169441,8.07547,8.0768,425,258281,0.000785933,0.05,1,148684,148259,425
21172361,8.01509,8.01536,425,258281,0.00815719,0.05,1,148692,148267,425
21175281,8.00302,8.00307,425,258281,0.00963144,0.04,1,148700,148275,425
21178201,8.0006,8.00061,425,258281,0.0259263,0.05,1,148708,148283,425
21181121,8.00012,8.00012,425,258281,0.0291853,0.05,1,148716,148291,425
21184041,8.80002,8.00002,426,258281,0.0858371,0.03,1,148725,148299,426
21186961,8.16,8,426,258281,0.0651674,0.05,1,148733,148307,426
21188961,7.232,8,425,258281,0.0530335,0,1,148740,148315,425
21191881,16.6464,16,426,258281,0.0506067,0.01,1,148759,148333,426
21194581,8.12928,9.6,424,258281,0.0501213,0.05,1,148765,148341,424
21196241,7.22586,7.52,424,260981,0.0340243,0.04,1,148772,148348,424
21199161,11.0452,8.704,427,261633,0.0388049,0.06,1,148784,148357,427
21202081,8.60903,8.1408,427,261633,0.039761,0.06,1,148792,148365,427
21205001,7.32181,8.02816,426,261633,0.0159522,0.06,1,148799,148373,426
21207921,8.66436,8.00563,427,261633,0.0191904,0.04,1,148808,148381,427
21210841,8.13287,8.00113,427,261633,0.0198381,0.06,1,148816,148389,427
21213761,8.02657,8.00023,427,261633,0.0119676,0.06,1,148824,148397,427
21216681,6.40531,8.00005,425,262865,0.0343935,0.06,1,148830,148405,425
21219541,9.28106,8.00001,427,262865,0.0148787,0.01,1,148840,148413,427
21222461,7.45621,8,426,263027,0.0429757,0.05,1,148847,148421,426
21225381,7.09124,8,425,263027,0.0405952,0.04,1,148854,148429,425
21228301,8.61825,8,426,263027,0.048119,0.01,1,148863,148437,426
21230981,8.12365,8,426,263027,0.0496238,0.02,1,148871,148445,426
21233901,8.02473,8.8,425,263027,0.0499248,0.03,1,148879,148454,425
21236821,8.00495,8.16,425,263217,0.057985,0.02,1,148887,148462,425
21239301,10.401,8.032,428,265052,0.051597,0,1,148898,148470,428
21241381,7.6802,8.8064,426,265052,0.0503194,0.02,1,148905,148479,426
21243461,7.13604,8.16128,425,267017,0.0100639,0.04,1,148912,148487,425
21245541,7.02721,8.03226,424,268440,0.0340128,0.01,1,148919,148495,424
21247621,11.8054,6.40645,431,268440,0.00680255,0.02,1,148932,148501,431
21249701,11.1611,11.6813,429,268440,0.0173605,0.04,1,148943,148514,429
21251781,14.2322,11.9363,432,268440,0.0114721,0.03,1,148958,148526,432
21254701,8.44644,12.7873,426,268440,0.00229442,0.04,1,148965,148539,426
21256561,6.48929,8.95745,424,268440,0.00845888,0.03,1,148971,148547,424
21259481,8.49786,8.19149,425,268440,0.00169178,0.03,1,148980,148555,425
21261761,8.89957,8.0383,426,268440,0.000338355,0.03,1,148989,148563,426
21263841,6.57991,6.40766,426,268440,0.0320677,0.04,1,148995,148569,426
21265921,9.31598,8.48153,427,268440,0.0384135,0.06,1,149005,148578,427
21268841,11.4632,12.8963,425,268440,0.0156827,0.04,1,149017,148592,425
21271121,8.69264,8.97926,425,268440,0.00313654,0.01,1,149025,148600,425
21274041,12.9385,12.1959,426,268440,0.0166273,0,1,149039,148613,426
21276321,8.18771,8.83917,425,268440,0.0193255,0.04,1,149046,148621,425
21279241,6.43754,6.56783,425,268440,0.0278651,0.01,1,149052,148627,425
21282161,7.68751,7.71357,425,268440,0.045573,0.03,1,149060,148635,425
21285081,7.9375,7.94271,425,268440,0.0331146,0.03,1,149068,148643,425
21288001,7.9875,7.98854,425,268440,0.0386229,0.03,1,149076,148651,425
21290261,18.3975,7.99771,438,268440,0.0637246,0.01,1,149097,148659,438
21293181,9.2795,17.5995,425,268440,0.0367449,0.02,1,149104,148679,425
21296101,9.0559,9.91991,426,268440,0.023349,0.01,1,149113,148687,426
21299021,9.01118,8.38398,427,268440,0.0366698,0.05,1,149122,148695,427
21301701,9.00224,8.0768,428,268440,0.015334,0.07,1,149131,148703,428
21304621,8.20045,7.21536,429,268440,0.0270668,0.09,1,149139,148710,429
21307541,7.24009,7.84307,428,268440,0.0134134,0.08,1,149146,148718,428
21310461,7.04802,7.96861,427,268440,0.0346827,0.09,1,149153,148726,427
21313381,7.0096,7.99372,426,268440,0.0309365,0.08,1,149160,148734,426
21316301,7.80192,7.99874,426,268440,0.0141873,0.06,1,149168,148742,426
21319221,7.96038,7.99975,426,268440,0.0108375,0.07,1,149176,148750,426
21321461,13.5921,7.99995,433,268440,0.0101675,0.03,1,149191,148758,433
21324381,9.11842,13.6,426,268440,0.0260335,0.01,1,149199,148773,426
21327281,8.22368,9.12,426,268440,0.0212067,0.05,1,149207,148781,426
21329361,8.84474,9.824,425,268440,0.0442413,0.04,1,149216,148791,425
21332281,15.3689,13.9648,427,268440,0.0408483,0.03,1,149233,148806,427
21335201,9.47379,9.19296,427,268440,0.00816965,0.06,1,149241,148814,427
21338121,8.29476,8.23859,427,268440,0.0256339,0.06,1,149249,148822,427
21341041,8.05895,8.04772,427,268440,0.0451268,0.06,1,149257,148830,427
21343961,7.21179,8.00954,426,268440,0.0170254,0.06,1,149264,148838,426
21346881,8.64236,8.00191,427,268440,0.0354051,0.06,1,149273,148846,427
21349801,7.32847,8.00038,426,268440,0.031081,0.06,1,149280,148854,426
21352721,10.2657,8.00008,429,268440,0.0222162,0.08,1,149291,148862,429
21355641,8.45314,8.00002,429,268440,0.0204432,0.06,1,149299,148870,429
21358561,7.29063,8,428,268440,0.0280886,0.08,1,149306,148878,428
21361481,7.85813,8,428,268440,0.0296177,0.05,1,149314,148886,428
21364401,6.37163,8,426,268440,0.0299235,0.04,1,149320,148894,426
21367321,8.47433,8,427,268440,0.0299847,0.04,1,149329,148902,427
21370241,7.29486,8,426,268440,0.0219969,0.05,1,149336,148910,426
21373161,7.05897,8,425,268440,0.0283994,0.05,1,149343,148918,425
21375541,7.81179,8,425,268440,0.0376799,0.03,1,149351,148926,425
21377621,11.1624,8,429,268440,0.039536,0.01,1,149363,148934,429
21379701,8.63247,10.4,426,268440,0.0399072,0.02,1,149371,148945,426
21381781,13.7265,9.28,432,268440,0.0239814,0,1,149386,148954,432
21383861,12.3453,13.056,430,268440,0.00479629,0,1,149398,148968,430
21386781,9.66906,12.2112,427,268440,0.000959257,0.01,1,149407,148980,427
21389701,8.33381,8.84224,427,268440,0.000191851,0.06,1,149415,148988,427
21392621,8.06676,8.16845,427,268440,3.83703e-05,0.05,1,149423,148996,427
21394881,6.41335,8.03369,425,268440,7.67406e-06,0.03,1,149429,149004,425
21397801,14.0827,13.6067,426,268440,0.00800154,0.05,1,149445,149019,426
21400501,10.0165,9.12135,427,268440,0.00960031,0.04,1,149454,149027,427
21402161,6.80331,9.02427,424,268440,0.00992006,0.03,1,149460,149036,424
21404241,10.9607,9.00485,427,268440,0.025984,0.04,1,149472,149045,427
21407161,8.59213,9.80097,425,268440,0.0131968,0.03,1,149480,149055,425
21410081,8.91843,8.36019,426,268440,0.0106394,0.04,1,149489,149063,426
21413001,7.38369,8.07204,425,268440,0.0261279,0.05,1,149496,149071,425
21415681,9.47674,8.01441,427,268440,0.0132256,0.01,1,149506,149079,427
21418601,7.49535,7.20288,427,268440,0.00264511,0.05,1,149513,149086,427
21420261,11.8991,7.84058,432,268440,0.040529,0.03,1,149526,149094,432
21422341,7.97981,12.7681,425,268440,0.0241058,0.03,1,149533,149108,425
21424001,5.59596,7.35362,424,268440,0.0128212,0.05,1,149538,149114,424
21426921,6.71919,5.47072,426,268440,0.0185642,0,1,149545,149119,426
21429201,7.74384,7.49414,426,268440,0.0197128,0.05,1,149553,149127,426
21432121,9.54877,8.69883,427,268440,0.0199426,0.04,1,149563,149136,427
21433781,5.10975,8.13977,423,268440,0.0119885,0.05,1,149567,149144,423
21435441,5.82195,5.62795,424,267833,0.0023977,0.06,1,149573,149149,424
21438361,6.76439,5.12559,426,267833,0.0164795,0.03,1,149580,149154,426
21440641,6.95288,7.42512,425,267833,0.0272959,0.05,1,149587,149162,425
21443561,6.99058,6.28502,426,267833,0.0294592,0.02,1,149594,149168,426
21446481,6.99811,7.657,425,267833,0.0138918,0.05,1,149601,149176,425
21449401,8.59962,7.9314,426,267833,0.00277837,0.05,1,149610,149184,426
21452081,8.11992,7.98628,426,267833,0.00855567,0.07,1,149618,149192,426
21455001,11.224,11.1973,426,267833,0.0257111,0.05,1,149630,149204,426
21457921,8.6448,8.63945,426,267833,0.0291422,0.07,1,149638,149212,426
21460401,8.12896,8.12789,426,267833,0.0218284,0,1,149646,149220,426
21463321,20.0258,19.2256,427,268455,0.0123657,0.02,1,149669,149242,427
21466241,10.4052,10.2451,427,268455,0.00247314,0.04,1,149677,149250,427
21468721,8.48103,8.44902,427,268455,0.00849463,0.05,1,149685,149258,427
21471641,6.49621,7.2898,426,268455,0.0176989,0.04,1,149691,149265,426
21474561,7.69924,7.85796,426,268455,0.00353978,0.05,1,149699,149273,426
21477481,7.93985,7.97159,426,268455,0.016708,0.06,1,149707,149281,426
21480161,7.98797,7.99432,426,268455,0.0353416,0.07,1,149715,149289,426
21483081,7.19759,7.19886,426,268455,0.0390683,0.06,1,149722,149296,426
21484741,10.2395,7.83977,429,268455,0.0478137,0.02,1,149733,149304,429
21487661,8.4479,10.368,426,268455,0.0495627,0.05,1,149741,149315,426
21490581,7.28958,8.47359,425,268455,0.0339125,0.05,1,149748,149323,425
21493501,7.85792,8.09472,425,268455,0.0307825,0.01,1,149756,149331,425
21496421,8.77158,8.01894,426,268455,0.0221565,0.03,1,149765,149339,426
21499341,8.15432,8.00379,426,268455,0.0284313,0.06,1,149773,149347,426
21502261,8.83086,8.00076,427,268455,0.0136863,0.06,1,149782,149355,427
21505181,6.56617,8.00015,425,268455,0.0267373,0.06,1,149788,149363,425
21508101,8.51323,8.00003,426,268455,0.0133475,0.03,1,149797,149371,426
21510321,7.30265,8.00001,425,268455,0.0186695,0.02,1,149804,149379,425
21512401,11.8605,11.2,426,268455,0.0117339,0.04,1,149817,149391,426
21514481,10.3721,10.24,426,268455,0.0263468,0.02,1,149827,149401,426
21517401,14.0744,14.848,425,268455,0.0212694,0.04,1,149842,149417,425
21520321,10.0149,9.3696,426,268455,0.0282539,0.01,1,149851,149425,426
21522801,7.60298,8.27392,425,268455,0.00565077,0.02,1,149858,149433,425
21525721,8.7206,8.85478,425,268455,0.00113015,0.02,1,149867,149442,425
21528001,8.14412,8.17096,425,268455,0.00822603,0,1,149875,149450,425
21530921,11.2288,11.2342,425,268455,0.00964521,0.02,1,149887,149462,425
21533201,8.64576,8.64684,425,268455,0.025929,0.01,1,149895,149470,425
21536121,12.9292,11.3294,427,268455,0.0291858,0.01,1,149909,149482,427
21538821,8.98583,8.66587,427,268455,0.0298372,0.03,1,149917,149490,427
21541741,8.19717,9.73317,425,268455,0.0139674,0.02,1,149925,149500,425
21544661,10.4394,8.34663,428,268455,0.0267935,0,1,149936,149508,428
21547581,6.88789,8.06933,426,268455,0.0133587,0.06,1,149942,149516,426
21550261,9.37758,8.01387,428,268455,0.00267174,0.03,1,149952,149524,428
21552341,10.6755,8.80277,430,268455,0.0325343,0.03,1,149963,149533,430
21555041,8.5351,12.1606,425,268455,0.0385069,0.04,1,149971,149546,425
21557961,8.90702,9.63211,425,268455,0.00770137,0.04,1,149980,149555,425
21560881,8.1814,8.32642,425,268455,0.00954027,0.03,1,149988,149563,425
21563781,8.03628,8.06528,425,268455,0.00990805,0.03,1,149996,149571,425
21566701,8.80726,8.01306,426,268455,0.00998161,0.03,1,150005,149579,426
21569621,7.36145,8.00261,425,268455,0.0419963,0.04,1,150012,149587,425
21571681,7.87229,8.00052,425,268455,0.0403993,0.04,1,150020,149595,425
21574601,8.77446,8.8001,425,268455,0.0400799,0.03,1,150029,149604,425
21577521,9.75489,8.16002,427,268455,0.00801597,0.03,1,150039,149612,427
21580001,7.55098,8.032,426,268455,0.0256032,0.06,1,150046,149620,426
21582921,7.1102,7.2064,426,268455,0.0211206,0.01,1,150053,149627,426
21585201,7.02204,7.84128,425,268455,0.0362241,0.03,1,150060,149635,425
21588121,10.2044,8.76826,427,268455,0.0392448,0.04,1,150071,149644,427
21589781,7.64088,8.15365,426,268455,0.023849,0.04,1,150078,149652,426
21591441,7.12818,8.83073,424,268455,0.0287698,0,1,150085,149661,424
21594361,15.8256,14.5661,426,268455,0.061754,0.01,1,150103,149677,426
21597281,9.56513,9.31323,426,268455,0.0363508,0.06,1,150111,149685,426
21600201,8.31303,8.26265,426,268455,0.0152702,0.06,1,150119,149693,426
21601841,7.2626,8.05253,425,268455,0.035054,0.06,1,150126,149701,425
21604761,8.65252,8.01051,426,268455,0.00701081,0.05,1,150135,149709,426
21607681,8.1305,8.0021,426,268455,0.00940216,0.07,1,150143,149717,426
21610601,8.0261,8.00042,426,268455,0.0258804,0.07,1,150151,149725,426
21613521,8.00522,8.00008,426,268455,0.0291761,0.07,1,150159,149733,426
21616441,8.00104,8.00002,426,268455,0.0298352,0.07,1,150167,149741,426
21618481,8.00021,8,426,268455,0.029967,0.06,1,150175,149749,426
21621401,8.00004,6.4,428,268455,0.0299934,0.04,1,150183,149755,428
21623061,6.40001,7.68,426,268455,0.0379987,0.04,1,150189,149763,426
21625981,7.68,7.936,426,268455,0.0475997,0.05,1,150197,149771,426
21628901,7.136,7.9872,425,268455,0.0575199,0.06,1,150204,149779,425
21631821,9.4272,7.99744,427,268455,0.067504,0,1,150214,149787,427
21634741,7.48544,7.99949,426,268455,0.0615008,0.03,1,150221,149795,426
21637661,7.89709,7.9999,426,268455,0.0443002,0.03,1,150229,149803,426
21640581,7.97942,7.99998,426,268455,0.04886,0.04,1,150237,149811,426
21642821,7.99588,8,426,268455,0.00977201,0.02,1,150245,149819,426
21644901,14.3992,8.8,433,268455,0.0259544,0.05,1,150261,149828,433
21647601,8.47984,13.76,425,268455,0.0211909,0.02,1,150268,149843,425
21650521,15.296,16.352,425,268455,0.00423818,0.01,1,150285,149860,425
21653441,9.45919,9.6704,425,268455,0.00884764,0.03,1,150293,149868,425
21655921,8.29184,8.33408,425,268455,0.00976953,0.01,1,150301,149876,425
21658841,9.65837,8.86682,426,268455,0.0499539,0.04,1,150311,149885,426
21661121,7.53167,8.17336,425,268455,0.0179908,0.03,1,150318,149893,425
21664041,8.70633,8.03467,426,268455,0.0115982,0.03,1,150327,149901,426
21665701,8.94127,8.00693,427,268455,0.00231963,0.02,1,150336,149909,427
21667781,11.3883,9.60139,429,268455,0.00846393,0.02,1,150348,149919,429
21670701,7.87765,10.7203,425,268455,0.00969279,0.04,1,150355,149930,425
21672561,7.17553,8.54406,424,268455,0.00993856,0.01,1,150362,149938,424
21675481,8.63511,5.70881,428,268455,0.00998771,0.01,1,150371,149943,428
21678401,6.52702,7.54176,426,268455,0.0259975,0.05,1,150377,149951,426
21680881,7.7054,7.90835,426,268455,0.0211995,0.05,1,150385,149959,426
21682961,10.3411,10.3817,426,268455,0.0122399,0.04,1,150396,149970,426
21685881,13.2682,14.0763,425,268455,0.00244798,0.01,1,150410,149985,425
21688801,9.85364,9.21527,426,268455,0.0164896,0.03,1,150419,149993,426
21691721,9.17073,8.24305,427,268455,0.00329792,0.04,1,150428,150001,427
21694641,7.43415,8.04861,426,268455,0.0166596,0.06,1,150435,150009,426
21697521,7.08683,8.00972,425,268455,0.0113319,0.04,1,150442,150017,425
21700441,9.41737,8.00194,427,268455,0.0102664,0.04,1,150452,150025,427
21703361,8.28347,8.00039,427,268455,0.0260533,0.04,1,150460,150033,427
21706261,9.65669,8.00008,429,268455,0.0132107,0.03,1,150470,150041,429
21709181,9.13134,10.4,427,268455,0.0106421,0.04,1,150479,150052,427
21712101,8.22627,8.48,427,268455,0.00212843,0.04,1,150487,150060,427
21715021,7.24525,8.096,426,268455,0.0404257,0.02,1,150494,150068,426
21717941,7.84905,8.0192,426,268455,0.0480851,0.05,1,150502,150076,426
21720401,7.96981,8.00384,426,268455,0.041617,0.03,1,150510,150084,426
21722481,8.79396,7.20077,428,268455,0.0163234,0.06,1,150519,150091,428
21724561,12.9588,15.0402,425,268455,0.0192647,0.03,1,150533,150108,425
21727481,8.99176,7.80803,427,268455,0.0198529,0.01,1,150541,150114,427
21729141,10.5984,7.96161,430,268455,0.0119706,0.01,1,150552,150122,430
21732061,8.51967,11.9923,425,268455,0.0103941,0.03,1,150560,150135,425
21734961,8.10393,8.79846,425,268455,0.0100788,0.04,1,150568,150143,425
21737881,14.4208,13.7597,426,268455,0.0340158,0.03,1,150584,150158,426
21740801,9.28416,9.15194,426,268455,0.0308032,0.05,1,150592,150166,426
21743721,8.25683,8.23039,426,268455,0.00616063,0.05,1,150600,150174,426
21746641,8.85137,8.04608,427,268455,0.0252321,0.06,1,150609,150182,427
21749561,8.97027,8.00922,428,268455,0.0690464,0.06,1,150618,150190,428
21752481,8.19405,8.00184,428,268455,0.0218093,0.07,1,150626,150198,428
21755401,7.23881,8.00037,427,268455,0.0123619,0.07,1,150633,150206,427
21758321,7.04776,8.00007,426,268455,0.00247237,0.05,1,150640,150214,426
21761241,8.60955,8.00001,427,268455,0.0244945,0.06,1,150649,150222,427
21763461,9.72191,8,429,268455,0.0288989,0.04,1,150659,150230,429
21766381,9.14438,9.6,428,268455,0.0137798,0.05,1,150668,150240,428
21769301,7.42888,8.32,427,268455,0.018756,0.05,1,150675,150248,427
21772221,7.08578,8.064,426,268455,0.0197512,0.03,1,150682,150256,426
21775141,7.81716,8.0128,426,268455,0.0279502,0.04,1,150690,150264,426
21776981,8.76343,8.00256,427,268455,0.01359,0,1,150699,150272,427
21778641,6.55269,8.80051,424,268455,0.026718,0.05,1,150705,150281,424
21780721,10.9105,9.7601,426,268455,0.0213436,0,1,150717,150291,426
21783641,8.58211,8.35202,426,268455,0.0122687,0.03,1,150725,150299,426
21785301,7.31642,8.0704,425,268455,0.00245374,0.05,1,150732,150307,425
21786961,7.06328,8.01408,424,268455,0.000490749,0,1,150739,150315,424
21789881,6.21266,5.60282,425,268455,0.0480982,0.01,1,150745,150320,425
21792161,8.44253,7.52056,426,268455,0.0416196,0.04,1,150754,150328,426
21795081,9.68851,9.50411,426,268455,0.00832393,0.02,1,150764,150338,426
21797781,15.5377,8.30082,435,268455,0.00966479,0.01,1,150781,150346,435
21800701,10.3075,16.0602,426,268455,0.00993296,0.03,1,150790,150364,426
21803621,9.26151,9.61203,427,268455,0.00198659,0.05,1,150799,150372,427
21806541,7.4523,8.32241,426,268455,0.0163973,0.06,1,150806,150380,426
21809461,7.09046,8.06448,425,268455,0.00327946,0.02,1,150813,150388,425
21812381,8.61809,8.0129,426,268455,0.00865589,0.04,1,150822,150396,426
21814001,7.32362,8.00258,425,268455,0.00173118,0.01,1,150829,150404,425
21816081,11.0647,10.4005,426,268455,0.00834624,0,1,150841,150415,426
21819001,11.8129,12.4801,425,268455,0.00966925,0.01,1,150853,150428,425
21821921,8.76259,8.89602,425,268455,0.00193385,0.01,1,150861,150436,425
21824841,8.95252,8.1792,426,268455,0.00838677,0.03,1,150870,150444,426
21827761,8.1905,8.03584,426,268455,0.0176774,0.05,1,150878,150452,426
21830681,7.2381,8.00717,425,268455,0.0275355,0.04,1,150885,150460,425
21833601,7.84762,8.00143,425,268455,0.0295071,0.02,1,150893,150468,425
21835221,7.96952,8.00029,425,268455,0.0139014,0.03,1,150901,150476,425
21836881,7.1939,6.40006,426,268455,0.0107803,0.08,1,150908,150482,426
21839801,7.83878,6.88001,427,268455,0.0261561,0.05,1,150916,150489,427
21842721,7.96776,7.776,427,268455,0.0292312,0.06,1,150924,150497,427
21845641,7.99355,7.9552,427,268455,0.0218462,0.04,1,150932,150505,427
21848561,7.19871,7.99104,426,268455,0.0363692,0.04,1,150939,150513,426
21851481,7.83974,7.99821,426,268455,0.0392739,0.02,1,150947,150521,426
21854401,7.96795,7.99964,426,268455,0.0318548,0.04,1,150955,150529,426
21857061,12.7936,7.99993,432,268455,0.014371,0.01,1,150969,150537,432
21859141,8.95872,12.8,426,268455,0.0348742,0.04,1,150977,150551,426
21861221,12.1917,8.96,431,268455,0.0149748,0.07,1,150990,150559,431
21864141,8.83835,12.192,426,268255,0.026995,0.01,1,150998,150572,426
21866001,6.56767,8.8384,424,268255,0.045399,0.03,1,151004,150580,424
21868081,6.11353,5.76768,425,268255,0.0170798,0.04,1,151010,150585,425
21871001,9.22271,8.35354,426,268455,0.027416,0.03,1,151020,150594,426
21872661,6.64454,8.07071,424,268455,0.0214832,0.03,1,151026,150602,424
21874321,6.92891,5.61414,426,268455,0.0202966,0.03,1,151033,150607,426
21877241,4.58578,5.12283,425,268455,0.0360593,0.06,1,151037,150612,425
21878901,7.31716,7.42457,425,268455,0.0152119,0.03,1,151045,150620,425
21880561,7.86343,7.08491,426,268455,0.0110424,0.03,1,151053,150627,426
21883481,10.3727,10.217,426,268455,0.0102085,0.05,1,151064,150638,426
21886401,8.47454,8.4434,426,268455,0.0100417,0.06,1,151072,150646,426
21889321,7.29491,8.08868,425,268455,0.0100083,0.04,1,151079,150654,425
21892241,8.65898,8.01774,426,268455,0.0180017,0.03,1,151088,150662,426
21894081,6.5318,8.00355,424,268455,0.0196003,0.03,1,151094,150670,424
21897001,8.50636,7.20071,426,268455,0.0279201,0.03,1,151103,150677,426
21899921,8.10127,7.84014,426,268455,0.013584,0.05,1,151111,150685,426
21902401,7.22025,7.96803,425,268455,0.0027168,0.05,1,151118,150693,425
21905321,7.84405,7.19361,426,268455,0.00854336,0.02,1,151126,150700,426
21908241,7.96881,7.83872,426,268455,0.0257087,0.05,1,151134,150708,426
21911141,10.3938,7.96774,429,268455,0.0211417,0.01,1,151145,150716,429
21913221,7.67875,11.1935,424,268455,0.0122283,0.01,1,151152,150728,424
21915301,9.53575,7.03871,428,268455,0.0104457,0.05,1,151162,150734,428
21917381,6.70715,8.60774,425,268455,0.00208913,0.07,1,151168,150743,425
21920081,6.14143,6.52155,425,268455,0.00841783,0.03,1,151174,150749,425
21923001,11.6283,11.7043,425,268455,0.00968357,0.04,1,151187,150762,425
21925281,8.72566,8.74086,425,268455,0.0259367,0.01,1,151195,150770,425
21928201,19.3451,18.5482,426,268455,0.0131873,0,1,151217,150791,426
21931121,9.46903,10.1096,425,268455,0.00263747,0.05,1,151224,150799,425
21934041,8.29381,8.42193,425,268455,0.000527494,0.02,1,151232,150807,425
21936101,6.45876,8.08439,423,268455,0.000105499,0.02,1,151238,150815,423
21939021,7.69175,6.41688,425,268455,0.0080211,0.01,1,151246,150821,425
21941941,7.93835,7.68338,425,268455,0.0576042,0.01,1,151254,150829,425
21944861,7.98767,7.93668,425,268455,0.0595208,0.04,1,151262,150837,425
21947121,7.99753,7.98734,425,268455,0.0519042,0.01,1,151270,150845,425
21950041,17.5995,16.7975,426,268455,0.0183808,0.01,1,151290,150864,426
21952961,9.1199,9.75949,425,268455,0.00367617,0.07,1,151297,150872,425
21955441,8.22398,8.3519,425,268455,0.000735233,0.02,1,151305,150880,425
21958361,7.2448,7.27038,425,268455,0.000147047,0.02,1,151312,150887,425
21960021,5.44896,7.85408,422,268455,0.00802941,0.03,1,151317,150895,422
21962941,8.28979,5.57082,426,267847,0.0176059,0.05,1,151326,150900,426
21965841,8.05796,7.51416,426,267847,0.0275212,0.06,1,151334,150908,426
21967921,7.21159,7.90283,425,267847,0.0215042,0.06,1,151341,150916,425
21970001,7.04232,6.38057,426,267847,0.0123008,0.03,1,151348,150922,426
21972921,7.00846,6.07611,427,267847,0.0504602,0.04,1,151355,150928,427
21975841,6.20169,7.61522,425,267847,0.042092,0.04,1,151361,150936,425
21978761,8.44034,7.92304,426,267847,0.0484184,0.01,1,151370,150944,426
21981681,8.08807,7.98461,426,267847,0.0336837,0.06,1,151378,150952,426
21984561,8.01761,7.99692,426,267847,0.0307367,0.05,1,151386,150960,426
21987481,16.0035,15.9994,426,267847,0.0381473,0.03,1,151404,150978,426
21989761,9.6007,9.59988,426,267847,0.0396295,0.07,1,151412,150986,426
21992681,14.7201,15.52,425,267847,0.0319259,0.03,1,151428,151003,425
21994961,9.34403,9.504,425,267847,0.00638518,0.03,1,151436,151011,425
21997881,7.46881,6.7008,426,267847,0.00927704,0.04,1,151443,151017,426
22000801,7.09376,7.74016,425,267847,0.00985541,0.04,1,151450,151025,425
22003281,7.81875,7.94803,425,267847,0.00197108,0.03,1,151458,151033,425
22006201,7.96375,7.18961,426,267847,0.0243942,0.02,1,151466,151040,426
22008901,7.99275,7.83792,426,267847,0.0288788,0.03,1,151474,151048,426
22010981,7.19855,7.16758,426,267847,0.0457758,0.02,1,151481,151055,426
22013061,10.2397,7.83352,429,267847,0.0491552,0.04,1,151492,151063,429
22015141,12.4479,11.1667,430,267847,0.033831,0.06,1,151505,151075,430
22018061,9.68959,12.6333,426,267847,0.00676621,0.04,1,151514,151088,426
22020981,7.53792,8.92667,425,267847,0.0253532,0.03,1,151521,151096,425
22023901,7.90758,8.18533,425,267847,0.0210706,0.03,1,151529,151104,425
22026821,8.78152,8.03707,426,267847,0.0362141,0,1,151538,151112,426
22028661,7.3563,8.00741,425,267847,0.0392428,0.03,1,151545,151120,425
22031581,7.87126,7.20148,426,267847,0.0558486,0.06,1,151553,151127,426
22034501,7.97425,7.8403,426,267847,0.0351697,0.06,1,151561,151135,426
22036981,7.19485,7.96806,425,267847,0.0150339,0.03,1,151568,151143,425
22039901,7.03897,7.19361,425,267847,0.00300679,0.04,1,151575,151150,425
22042821,7.80779,7.83872,425,267847,0.0246014,0.03,1,151583,151158,425
22045301,7.96156,7.96774,425,267847,0.0129203,0.03,1,151591,151166,425
22048221,7.19231,7.19355,425,267847,0.0345841,0.03,1,151598,151173,425
22051121,8.63846,7.83871,426,267847,0.0229168,0,1,151607,151181,426
22053201,8.12769,7.96774,426,267847,0.0525834,0.04,1,151615,151189,426
22056121,12.0255,12.7935,425,267847,0.0105167,0.03,1,151628,151203,425
22057781,17.6051,8.95871,436,267847,0.00210333,0.01,1,151647,151211,436
22060701,9.92102,16.9917,425,267847,0.0164207,0.02,1,151655,151230,425
22063621,8.3842,9.79835,425,267847,0.0112841,0.02,1,151663,151238,425
22066101,8.87684,8.35967,426,267847,0.00225683,0.09,1,151672,151246,426
22069021,8.17537,7.27193,427,267847,0.00845136,0.09,1,151680,151253,427
22071941,6.43507,7.85439,425,267847,0.00969027,0.06,1,151686,151261,425
22074861,7.68701,7.97088,425,267847,0.0179381,0.04,1,151694,151269,425
22076501,7.9374,7.99418,425,267847,0.00358761,0.01,1,151702,151277,425
22078161,7.18748,7.19883,425,267847,0.0407175,0,1,151709,151284,425
22080241,11.8375,11.0398,426,267847,0.0081435,0,1,151722,151296,426
22083161,8.7675,8.60795,426,267847,0.0016287,0.04,1,151730,151304,426
22084821,8.1535,8.12159,426,267847,0.0243257,0.01,1,151738,151312,426
22087741,8.0307,8.02432,426,267847,0.0128651,0.03,1,151746,151320,426
22090661,8.80614,8.00486,427,267847,0.00257303,0.02,1,151755,151328,427
22093581,7.36123,8.00097,426,267847,0.00851461,0.02,1,151762,151336,426
22096501,8.67225,8.00019,427,267847,0.0177029,0.01,1,151771,151344,427
22098961,7.33445,8.00004,426,267847,0.0435406,0.07,1,151778,151352,426
22101881,7.86689,7.20001,427,267847,0.0167081,0.04,1,151786,151359,427
22104801,7.17338,7.84,426,267847,0.00334162,0.05,1,151793,151367,426
22107701,11.8347,7.968,431,267847,0.00866832,0.01,1,151806,151375,431
22110621,7.16694,11.1936,425,267847,0.0337337,0.02,1,151812,151387,425
22113541,7.83339,8.63872,425,267847,0.0387467,0.05,1,151820,151395,425
22116461,7.96668,8.12774,425,267847,0.0317493,0.05,1,151828,151403,425
22119141,7.99334,8.02555,425,267847,0.0143499,0.04,1,151836,151411,425
22120801,7.19867,7.20511,425,267847,0.01087,0.03,1,151843,151418,425
22122881,14.2397,14.241,425,267847,0.026174,0.03,1,151859,151434,425
22125801,12.4479,11.6482,426,267847,0.0212348,0.01,1,151871,151445,426
22128721,9.68959,8.72964,427,267847,0.00424696,0.02,1,151880,151453,427
22131641,8.33792,8.14593,427,267847,0.0168494,0.04,1,151888,151461,427
22134561,8.06758,8.02919,427,267847,0.00336988,0.04,1,151896,151469,427
22137481,8.01352,8.00584,427,267847,0.00867398,0.06,1,151904,151477,427
22140401,7.2027,8.00117,426,267847,0.0337348,0.06,1,151911,151485,426
22143061,8.64054,8.00023,427,267847,0.014747,0.04,1,151920,151493,427
22145141,14.5281,9.60005,433,267847,0.0509494,0.02,1,151936,151503,433
22147221,7.70562,13.92,424,267847,0.0661899,0.04,1,151942,151518,424
22150141,7.94112,7.584,426,267847,0.061238,0.05,1,151950,151524,426
22152001,7.18822,7.9168,425,267847,0.0122476,0.06,1,151957,151532,425
22154921,11.0376,9.58336,427,267847,0.00244952,0,1,151969,151542,427
22157841,7.80753,8.31667,426,267847,0.0404899,0.03,1,151976,151550,426
22160761,7.96151,8.06333,426,267847,0.032098,0.04,1,151984,151558,426
22163681,8.7923,8.01267,427,267847,0.0304196,0.03,1,151993,151566,427
22165521,5.75846,8.00253,424,267847,0.0300839,0.03,1,151998,151574,424
22168441,7.55169,5.60051,427,267847,0.0460168,0.01,1,152006,151579,427
22171361,6.31034,7.5201,425,267847,0.0492034,0.07,1,152012,151587,425
22174281,8.46207,7.90402,426,267847,0.00984067,0.01,1,152021,151595,426
22177201,8.09241,7.9808,426,267847,0.00196813,0.05,1,152029,151603,426
22180121,7.21848,7.99616,425,267847,0.0163936,0.07,1,152036,151611,425
22183041,8.6437,7.99923,426,267847,0.0112787,0.01,1,152045,151619,426
22185701,8.12874,7.99985,426,267847,0.00225574,0.01,1,152053,151627,426
22187781,16.0257,8.79997,435,267847,0.0164511,0.05,1,152071,151636,435
22189861,12.8051,15.36,430,267847,0.0112902,0.03,1,152083,151653,430
22191521,8.16103,13.472,424,267847,0.034258,0.02,1,152090,151666,424
22194441,9.63221,9.0944,426,267847,0.0148516,0.01,1,152100,151674,426
22197361,8.32644,8.21888,426,267847,0.0269703,0.02,1,152108,151682,426
22200281,8.86529,8.04378,427,267847,0.0373941,0.03,1,152117,151690,427
22203201,7.37306,8.00876,426,267847,0.0154788,0.08,1,152124,151698,426
22206121,7.07461,8.00175,425,267847,0.0110958,0.04,1,152131,151706,425
22208581,12.6149,8.00035,431,267847,0.0182192,0,1,152145,151714,431
22211281,7.32298,11.2001,425,267847,0.0116438,0.03,1,152151,151726,425
22214201,11.0646,11.84,425,267847,0.0103288,0.01,1,152163,151738,425
22216901,7.81292,8.768,424,267847,0.0340658,0.04,1,152170,151746,424
22219821,8.76258,7.3536,426,267847,0.0308132,0.03,1,152179,151753,426
22221681,7.35252,7.87072,425,267847,0.00616263,0.04,1,152186,151761,425
22223761,8.6705,8.77414,425,267847,0.0412325,0,1,152195,151770,425
22226681,13.7341,12.9548,426,267847,0.0162465,0.01,1,152210,151784,426
22229601,9.14682,8.99097,426,267847,0.0032493,0.04,1,152218,151792,426
22232521,8.22936,8.19819,426,267847,0.00064986,0.04,1,152226,151800,426
22235441,7.24587,8.03964,425,267847,0.03213,0.04,1,152233,151808,425
22238361,7.84917,8.00793,425,267847,0.014426,0.01,1,152241,151816,425
22241281,7.96983,8.00159,425,267847,0.0108852,0.01,1,152249,151824,425
22244201,7.99397,8.00032,425,267847,0.010177,0.03,1,152257,151832,425
22247121,8.79879,8.00006,426,267847,0.0100354,0.03,1,152266,151840,426
22249761,8.15976,8.00001,426,267847,0.0340071,0.02,1,152274,151848,426
22251841,8.03195,7.2,427,267847,0.0308014,0.05,1,152282,151855,427
22253921,4.80639,6.24,425,267847,0.0301603,0.06,1,152286,151861,425
22256001,11.3613,10.848,426,267847,0.0380321,0.04,1,152299,151873,426
22258921,17.4723,16.5696,427,267847,0.0316064,0.03,1,152318,151891,427
22261841,9.89445,9.71392,427,267847,0.0383213,0.08,1,152326,151899,427
22264761,8.37889,8.34278,427,267847,0.0556643,0.05,1,152334,151907,427
22267681,8.07578,8.06856,427,267847,0.0351329,0.06,1,152342,151915,427
22270601,8.81516,8.01371,428,267847,0.0390266,0.06,1,152351,151923,428
22273521,8.16303,8.00274,428,267847,0.0238053,0.05,1,152359,151931,428
22275141,7.23261,8.00055,427,267847,0.0127611,0.06,1,152366,151939,427
22277841,7.84652,8.80011,426,267847,0.0265522,0,1,152374,151948,426
22280761,7.9693,8.96002,425,267847,0.0293104,0.05,1,152382,151957,425
22283041,8.79386,8.192,426,267847,0.00586209,0.06,1,152391,151965,426
22285961,12.1588,12.0384,426,267847,0.0171724,0.01,1,152404,151978,426
22288241,8.83175,8.80768,426,267847,0.0274345,0.05,1,152412,151986,426
22291161,9.76635,8.96154,427,267847,0.0214869,0.04,1,152422,151995,427
22294081,8.35327,8.19231,427,267847,0.0362974,0.06,1,152430,152003,427
22297001,7.27065,8.03846,426,267847,0.0552595,0.04,1,152437,152011,426
22299921,7.85413,8.00769,426,267847,0.0590519,0.04,1,152445,152019,426
22302841,8.77083,8.00154,427,267847,0.0518104,0.05,1,152454,152027,427
22305761,7.35417,8.00031,426,267847,0.0263621,0.06,1,152461,152035,426
22308681,7.87083,8.00006,426,267847,0.0132724,0.02,1,152469,152043,426
22311601,7.97417,8.00001,426,267847,0.0266545,0.05,1,152477,152051,426
22314521,7.19483,8,425,267847,0.0133309,0.05,1,152484,152059,425
22316321,7.83897,8,425,267847,0.0186662,0.05,1,152492,152067,425
22318401,15.1678,13.6,427,267847,0.0197332,0.01,1,152509,152082,427
22321321,10.2336,9.92,427,267847,0.0119466,0.04,1,152518,152091,427
22324021,10.8467,8.384,430,267847,0.00238933,0.03,1,152529,152099,430
22326101,13.3693,12.0768,431,267847,0.00847787,0,1,152543,152112,431
22329021,9.87387,12.8154,427,267847,0.0496956,0.01,1,152552,152125,427
22331941,7.57477,8.96307,426,267847,0.0179391,0.03,1,152559,152133,426
22334861,7.11495,8.19261,425,267847,0.0115878,0.02,1,152566,152141,425
22337781,8.62299,8.03852,426,267847,0.0103176,0.01,1,152575,152149,426
22340701,8.9246,8.0077,427,267847,0.0100635,0.06,1,152584,152157,427
22343621,8.18492,8.00154,427,267847,0.0260127,0.06,1,152592,152165,427
22345861,6.43698,8.00031,425,267847,0.0212025,0.04,1,152598,152173,425
22348781,8.4874,8.00006,426,267847,0.0202405,0.01,1,152607,152181,426
22350641,6.49748,8.00001,424,267847,0.0200481,0.11,1,152613,152189,424
22353561,8.4995,7.2,426,267847,0.0120096,0,1,152622,152196,426
22356261,15.2999,7.84,435,267847,0.0344019,0.01,1,152639,152204,435
22358341,15.06,15.168,433,267847,0.0228804,0.03,1,152654,152221,433
22361261,9.412,15.0336,426,267847,0.0525761,0.03,1,152662,152236,426
22364181,7.4824,9.40672,425,267847,0.0185152,0.03,1,152669,152244,425
22367101,7.89648,8.28134,425,267847,0.035703,0.01,1,152677,152252,425
22370021,9.5793,8.05627,427,267847,0.0311406,0.01,1,152687,152260,427
22372941,8.31586,8.01125,427,267847,0.00622812,0.07,1,152695,152268,427
22375861,8.06317,8.00225,427,267847,0.00924562,0.07,1,152703,152276,427
22378781,7.21263,8.00045,426,267847,0.00984913,0.07,1,152710,152284,426
22381701,7.84253,8.00009,426,267847,0.00196982,0.06,1,152718,152292,426
22384621,7.96851,8.00002,426,267847,0.024394,0.07,1,152726,152300,426
22387041,7.1937,8,425,267847,0.0288788,0,1,152733,152308,425
22389121,15.0387,13.6,427,267847,0.0377758,0.06,1,152750,152323,427
22392041,11.8077,11.52,427,267847,0.0315552,0.03,1,152761,152334,427
22394961,7.96155,8.704,426,267847,0.014311,0.05,1,152768,152342,426
22396821,6.39231,8.1408,424,267847,0.0268622,0.05,1,152774,152350,424
22399741,8.47846,7.22816,426,267847,0.0133724,0.03,1,152783,152357,426
22402661,8.09569,7.84563,426,267847,0.0106745,0.06,1,152791,152365,426
22405581,8.01914,7.96913,426,267847,0.0101349,0.06,1,152799,152373,426
22408501,8.80383,7.99383,427,267847,0.042027,0.04,1,152808,152381,427
22410961,7.36077,7.99877,426,267847,0.0644054,0.06,1,152815,152389,426
22413881,9.47215,9.59975,426,267847,0.0448811,0.03,1,152825,152399,426
22415541,9.09443,8.31995,427,267847,0.0489762,0.05,1,152834,152407,427
22417621,10.6189,8.86399,429,267847,0.0337952,0.05,1,152845,152416,429
22419281,6.92378,9.7728,425,267847,0.046759,0.06,1,152851,152426,425
22422201,11.7848,10.7546,427,267847,0.0173518,0.06,1,152864,152437,427
22425121,7.95695,8.55091,426,267847,0.0194704,0.06,1,152871,152445,426
22428041,7.19139,8.11018,425,267847,0.0118941,0.04,1,152878,152453,425
22430961,7.83828,8.02204,425,267847,0.0103788,0.03,1,152886,152461,425
22433881,7.96766,8.00441,425,267847,0.00207576,0.05,1,152894,152469,425
22436801,8.79353,8.00088,426,267847,0.0244152,0.03,1,152903,152477,426
22439721,8.15871,8.00018,426,267847,0.028883,0.03,1,152911,152485,426
22442641,8.03174,8.00004,426,267847,0.0137766,0.05,1,152919,152493,426
22445561,8.00635,8.00001,426,267847,0.00275532,0.04,1,152927,152501,426
22447361,7.20127,8,425,267847,0.00855106,0.01,1,152934,152509,425
22450281,15.8403,14.4,427,267847,0.00971021,0.04,1,152952,152525,427
22452981,11.1681,9.28,429,267847,0.00194204,0.05,1,152962,152533,429
22454641,6.23361,9.856,424,267847,0.00838841,0.06,1,152967,152543,424
22457561,10.0467,9.1712,426,267847,0.00967768,0.01,1,152978,152552,426
22460481,7.60934,8.23424,425,267847,0.00993554,0.03,1,152985,152560,425
22463401,8.72187,8.04685,426,267847,0.00198711,0,1,152994,152568,426
22466321,8.14437,8.00937,426,267847,0.00839742,0.03,1,153002,152576,426
22468161,6.42887,8.00187,424,267847,0.00167948,0.04,1,153008,152584,424
22471081,12.4858,10.4004,427,267847,0.0243359,0,1,153022,152595,427
22474001,7.29715,8.48007,425,267847,0.0128672,0.03,1,153028,152603,425
22476921,7.85943,8.09601,425,267847,0.0265734,0,1,153036,152611,425
22479841,9.57189,8.0192,427,267847,0.00531469,0,1,153046,152619,427
22481681,7.51438,8.00384,426,267847,0.00906294,0.07,1,153053,152627,426
22483761,7.10288,7.20077,426,267847,0.00181259,0.04,1,153060,152634,426
22486681,11.0206,11.0402,426,267847,0.0483625,0.02,1,153072,152646,426
22488341,7.00412,8.60803,424,267847,0.0176725,0.07,1,153078,152654,424
22490421,7.80082,7.32161,425,267847,0.0035345,0.04,1,153086,152661,425
22492081,6.36016,6.26432,425,267847,0.0247069,0.05,1,153092,152667,425
22495001,6.07203,5.25286,426,267847,0.0129414,0.06,1,153098,152672,426
22496661,6.01441,7.45057,424,268012,0.0185883,0.07,1,153104,152680,424
22499581,8.40288,7.09011,426,268012,0.0197177,0.03,1,153113,152687,426
22501861,6.48058,7.81802,424,268012,0.0119435,0.06,1,153119,152695,424
22503521,7.69612,6.3636,426,268012,0.0103887,0.06,1,153127,152701,426
22506441,11.1392,10.8727,426,268012,0.0100777,0.03,1,153139,152713,426
22509361,9.42784,8.57454,427,268012,0.0100155,0.05,1,153148,152721,427
22512281,8.28557,8.11491,427,268012,0.00200311,0.06,1,153156,152729,427
22515201,8.05711,8.02298,427,268012,0.0164006,0.06,1,153164,152737,427
22518081,7.21142,8.0046,426,268012,0.0112801,0.03,1,153171,152745,426
22520161,11.8423,12.0009,426,268012,0.00225602,0.05,1,153184,152758,426
22523081,10.3685,11.2002,425,268012,0.0404512,0.03,1,153194,152769,425
22526001,8.47369,8.64004,425,268012,0.0320902,0.03,1,153202,152777,425
22528901,8.09474,8.12801,425,268012,0.038418,0.03,1,153210,152785,425
22530561,8.81895,8.0256,426,268012,0.0396836,0.03,1,153219,152793,426
22533481,8.96379,7.20512,428,268012,0.0399367,0.07,1,153228,152800,428
22535761,8.19276,7.84102,428,268012,0.0239873,0.07,1,153236,152808,428
22538681,8.03855,8.7682,427,268012,0.0127975,0.06,1,153244,152817,427
22541601,8.00771,8.15364,427,268012,0.0185595,0.07,1,153252,152825,427
22544081,8.00154,8.03073,427,268012,0.0197119,0.07,1,153260,152833,427
22546161,9.60031,9.60615,427,268012,0.00394238,0.07,1,153270,152843,427
22549081,9.92006,10.7212,426,268012,0.0327885,0.05,1,153280,152854,426
22551781,10.784,8.54425,429,268012,0.0465577,0.04,1,153291,152862,429
22553861,11.7568,11.3088,429,268012,0.0333115,0.02,1,153303,152874,429
22556781,8.75136,11.0618,426,268012,0.0306623,0.01,1,153311,152885,426
22559701,8.95027,8.61235,427,268012,0.0141325,0.01,1,153320,152893,427
22561761,7.39005,8.12247,426,268012,0.0348265,0.07,1,153327,152901,426
22564681,5.47801,6.42449,425,268012,0.0069653,0.03,1,153332,152907,425
22567601,7.4956,7.6849,425,268012,0.00139306,0.03,1,153340,152915,425
22570521,7.89912,7.93698,425,268012,0.00827861,0.01,1,153348,152923,425
22573201,7.97982,7.9874,425,268012,0.00965572,0.05,1,153356,152931,425
22576121,7.19596,7.19748,425,268012,0.00193114,0.02,1,153363,152938,425
22578401,8.63919,7.8395,426,268012,0.0163862,0.03,1,153372,152946,426
22580481,11.3278,11.1679,426,269043,0.0112772,0.04,1,153384,152958,426
22583401,11.0656,11.0336,426,269043,0.0102554,0.02,1,153395,152969,426
22586321,7.81311,8.60672,425,269043,0.0100511,0.04,1,153402,152977,425
22589221,8.76262,8.12134,426,269043,0.0260102,0.01,1,153411,152985,426
22590881,6.55252,8.02427,424,269043,0.029202,0.01,1,153417,152993,424
22593801,6.9105,5.60485,426,269043,0.0298404,0.01,1,153424,152998,426
22596721,7.7821,7.52097,426,269043,0.0299681,0.04,1,153432,153006,426
22598581,6.35642,7.90419,424,269043,0.0139936,0.06,1,153438,153014,424
22600661,10.0713,7.18084,428,269043,0.0267987,0.03,1,153449,153021,428
22603581,8.41426,10.2362,425,269043,0.0293597,0.02,1,153457,153032,425
22606501,8.08285,8.44723,425,269043,0.0138719,0.01,1,153465,153040,425
22608981,7.21657,8.08945,424,269043,0.0107744,0.01,1,153472,153048,424
22610641,7.84331,7.21789,425,269043,0.0261549,0.01,1,153480,153055,425
22613561,6.36866,5.44358,426,269043,0.013231,0.04,1,153486,153060,426
22616261,15.6737,7.48872,436,269043,0.0106462,0,1,153504,153068,436
22619181,9.53475,15.8977,426,269043,0.0101292,0.03,1,153512,153086,426
22621041,7.50695,9.57955,425,269043,0.0180258,0.04,1,153519,153094,425
22623961,7.90139,7.51591,426,269043,0.00360517,0.03,1,153527,153101,426
22626881,7.18028,7.90318,425,269043,0.024721,0.03,1,153534,153109,425
22629801,8.63606,7.98064,426,269043,0.0289442,0.01,1,153543,153117,426
22632481,7.32721,7.99613,425,269043,0.0137888,0.05,1,153550,153125,425
22634561,11.0654,11.1992,425,269043,0.0267578,0.01,1,153562,153137,425
22637481,11.8131,11.0398,426,269043,0.0213516,0,1,153574,153148,426
22639761,7.96262,8.60797,425,269043,0.0122703,0.02,1,153581,153156,425
22642681,8.79252,8.12159,426,269043,0.0424541,0.02,1,153590,153164,426
22644341,7.3585,8.02432,425,269043,0.0404908,0.03,1,153597,153172,425
22647261,8.6717,7.20486,427,269043,0.0240982,0.04,1,153606,153179,427
22649121,6.53434,7.84097,425,269043,0.0128196,0.07,1,153612,153187,425
22652041,10.1069,9.56819,426,269043,0.0265639,0.03,1,153623,153197,426
22654961,8.42137,8.31364,426,269043,0.0293128,0.07,1,153631,153205,426
22657861,9.68427,8.06273,428,269043,0.0298626,0.06,1,153641,153213,428
22660781,8.33685,9.61255,426,269043,0.0139725,0.05,1,153649,153223,426
22663061,12.0674,8.32251,431,269043,0.0107945,0.01,1,153662,153231,431
22665981,8.81347,12.0645,426,269043,0.0101589,0.02,1,153670,153244,426
22668901,8.16269,8.8129,426,269043,0.0100318,0.04,1,153678,153252,426
22671821,8.83254,8.16258,427,269043,0.0100064,0.04,1,153687,153260,427
22674741,8.16651,8.03252,427,269043,0.0260013,0.06,1,153695,153268,427
22677661,8.0333,8.0065,427,269043,0.0452003,0.05,1,153703,153276,427
22679281,6.40666,8.0013,425,269043,0.00904005,0.06,1,153709,153284,425
22682201,13.2813,12.8003,426,269043,0.00980801,0.02,1,153724,153298,426
22683861,6.65627,8.96005,423,269043,0.0099616,0.03,1,153729,153306,423
22685941,8.53125,5.79201,427,269043,0.00199232,0.04,1,153738,153311,427
22688861,7.30625,7.5584,426,269043,0.000398464,0.04,1,153745,153319,426
22690721,7.06125,7.91168,425,269043,0.00807969,0.05,1,153752,153327,425
22693641,7.81225,7.18234,426,269043,0.00961594,0.02,1,153760,153334,426
22696341,6.36245,7.83647,424,269043,0.0339232,0.05,1,153766,153342,424
22698001,6.87249,7.16729,424,269043,0.0627846,0.01,1,153773,153349,424
22700921,8.5745,7.03346,426,269043,0.0205569,0.03,1,153782,153356,426
22702581,8.1149,7.80669,426,269043,0.0281114,0.03,1,153790,153364,426
22705501,8.82298,8.76134,426,269043,0.00562228,0.03,1,153799,153373,426
22708421,8.1646,8.15227,426,269043,0.00912446,0.03,1,153807,153381,426
22711341,8.03292,8.03045,426,269043,0.00982489,0.04,1,153815,153389,426
22712981,7.20658,8.00609,425,269043,0.00196498,0.05,1,153822,153397,425
22715061,8.64132,7.20122,427,269043,0.024393,0.03,1,153831,153404,427
22717981,7.32826,8.64024,425,269043,0.0128786,0.03,1,153838,153413,425
22720901,8.66565,8.12805,426,269043,0.0185757,0.01,1,153847,153421,426
22723381,7.33313,8.02561,425,269043,0.0277151,0.03,1,153854,153429,425
22726301,8.66663,7.20512,427,269043,0.00554303,0.03,1,153863,153436,427
22729201,8.13333,7.84102,427,269043,0.00110861,0.03,1,153871,153444,427
22731281,10.4267,11.9682,425,269043,0.00822172,0.04,1,153882,153457,425
22734201,12.4853,11.9936,426,269043,0.0256443,0,1,153895,153469,426
22737121,8.89707,8.79873,426,269043,0.0211289,0.03,1,153903,153477,426
22739601,7.37941,8.15975,425,269043,0.0202258,0.02,1,153910,153485,425
22742521,10.2759,10.4319,425,269043,0.0120452,0.01,1,153921,153496,425
22745441,9.25518,8.48639,426,269043,0.00240903,0.03,1,153930,153504,426
22748341,9.85104,8.09728,428,269043,0.0324818,0.02,1,153940,153512,428
22750001,7.57021,9.61946,425,269043,0.0304964,0.05,1,153947,153522,425
22752921,10.314,9.92389,426,269043,0.0140993,0.02,1,153958,153532,426
22755621,10.0628,8.38478,428,269043,0.0188199,0.04,1,153968,153540,428
22758541,7.61256,9.67696,425,269043,0.011764,0.03,1,153975,153550,425
22761461,7.92251,8.33539,425,269043,0.0343528,0.05,1,153983,153558,425
22764381,7.9845,8.06708,425,269043,0.00687056,0.02,1,153991,153566,425
22767061,8.7969,8.01342,426,269043,0.00137411,0.05,1,154000,153574,426
22769141,7.35938,7.20268,426,269043,0.0242748,0.06,1,154007,153581,426
22772061,6.27188,6.24054,426,269043,0.00485496,0.06,1,154013,153587,426
22774341,6.85438,7.64811,425,269043,0.00897099,0.04,1,154020,153595,425
22776421,14.1709,7.92962,433,269043,0.0017942,0.03,1,154036,153603,433
22779341,9.23417,12.7859,427,269043,0.00035884,0.03,1,154044,153617,427
22782241,7.44683,8.95718,426,269043,0.00807177,0.05,1,154051,153625,426
22785161,10.2894,10.5914,426,269043,0.0256144,0.01,1,154062,153636,426
22788081,8.45787,8.51829,426,269043,0.0291229,0.04,1,154070,153644,426
22791001,8.09157,8.10366,426,269043,0.0138246,0.04,1,154078,153652,426
22793061,12.0183,8.02073,431,269043,0.0347649,0.03,1,154091,153660,431
22795141,6.40366,12.0041,423,269043,0.00695298,0.04,1,154096,153673,423
22796801,6.88073,7.20083,424,269043,0.0253906,0.01,1,154103,153679,424
22799721,9.37615,7.84017,426,269043,0.0210781,0.03,1,154113,153687,426
22801381,7.47523,7.96803,425,269043,0.0282156,0.05,1,154120,153695,425
22804301,7.89505,7.99361,425,269043,0.00564312,0.05,1,154128,153703,425
22807221,7.97901,7.99872,425,269043,0.00912862,0.03,1,154136,153711,425
22810141,7.9958,7.99974,425,269043,0.00982573,0.03,1,154144,153719,425
22811781,11.1992,7.99995,429,269043,0.00996515,0.03,1,154156,153727,429
22814481,8.63983,11.2,425,269043,0.017993,0.03,1,154164,153739,425
22817401,8.92797,7.84,427,269043,0.0275986,0.01,1,154173,153746,427
22820321,7.38559,7.968,426,269043,0.00551972,0.04,1,154180,153754,426
22823221,11.0771,7.9936,430,269043,0.0171039,0.05,1,154192,153762,430
22826141,9.41542,11.9987,426,269043,0.0434208,0.01,1,154201,153775,426
22829041,7.48308,8.79974,425,269043,0.0406842,0.04,1,154208,153783,425
22831961,8.69662,8.15995,426,269043,0.00813683,0.01,1,154217,153791,426
22834661,8.13932,8.03199,426,269043,0.00162737,0.05,1,154225,153799,426
22837581,8.82786,8.8064,426,269043,0.00832547,0.04,1,154234,153808,426
22840501,8.16557,8.16128,426,269043,0.00966509,0.06,1,154242,153816,426
22842981,10.4331,8.03226,429,269043,0.041933,0.04,1,154253,153824,429
22845061,9.28662,9.60645,428,269043,0.0163866,0.08,1,154262,153834,428
22847981,7.45732,9.92129,425,269043,0.0272773,0.06,1,154269,153844,425
22850261,10.2915,8.38426,428,269043,0.0454555,0.02,1,154280,153852,428
22853181,8.45829,10.4769,425,269043,0.0410911,0.02,1,154288,153863,425
22856101,8.89166,8.49537,426,269043,0.0562182,0.01,1,154297,153871,426
22859021,8.17833,8.09907,426,269043,0.0272436,0.07,1,154305,153879,426
22861701,8.03567,8.01981,426,269043,0.0454487,0.06,1,154313,153887,426
22863781,8.00713,7.20396,427,269043,0.00908975,0.05,1,154321,153894,427
22865861,6.40143,9.44079,423,269043,0.049818,0.04,1,154327,153904,423
22868781,8.48029,6.68816,426,269043,0.0339636,0.01,1,154336,153910,426
22870641,6.49606,7.73763,424,269043,0.0307927,0.05,1,154342,153918,424
22872721,9.29921,7.94753,426,269043,0.0221585,0.05,1,154352,153926,426
22875641,11.4598,11.9895,425,269043,0.00443171,0.04,1,154364,153939,425
22878561,8.69197,8.7979,425,269043,0.0168863,0.03,1,154372,153947,425
22881041,8.13839,8.15958,425,269043,0.0433773,0.02,1,154380,153955,425
22883121,12.0277,12.0319,425,269043,0.0566755,0.05,1,154393,153968,425
22886041,12.0055,11.2064,426,269043,0.0273351,0.02,1,154405,153979,426
22888961,9.60111,8.64128,427,269043,0.021467,0.02,1,154414,153987,427
22891881,7.52022,8.12826,426,269043,0.0122934,0.03,1,154421,153995,426
22894801,7.90404,8.02565,426,269043,0.0104587,0.04,1,154429,154003,426
22897721,7.18081,8.00513,425,269043,0.00209174,0.04,1,154436,154011,425
22900641,8.63616,8.00103,426,269043,0.00841835,0,1,154445,154019,426
22903561,8.12723,8.00021,426,269043,0.00968367,0.02,1,154453,154027,426
22906421,12.0254,8.00004,431,269043,0.00993673,0.01,1,154466,154035,431
22908501,5.60509,11.2,423,269043,0.00998735,0.07,1,154470,154047,423
22911421,7.52102,7.04,425,269043,0.00999747,0.05,1,154478,154053,425
22914341,7.9042,7.808,425,269043,0.0339995,0.05,1,154486,154061,425
22916821,11.1808,7.9616,429,269043,0.0307999,0.02,1,154498,154069,429
22918481,7.83617,10.3923,425,269043,0.02216,0.05,1,154505,154080,425
22921401,10.3672,10.0785,426,269043,0.004432,0.03,1,154516,154090,426
22923681,8.47345,8.41569,426,269043,0.0328864,0.06,1,154524,154098,426
22926601,10.4947,9.68314,427,269043,0.0385773,0.03,1,154535,154108,427
22929301,6.09894,8.33663,424,269043,0.00771546,0.04,1,154540,154116,424
22931381,6.01979,7.26733,423,269043,0.0415431,0.03,1,154546,154123,423
22934301,7.60396,6.25347,425,269043,0.0643086,0.05,1,154554,154129,425
22936581,14.3208,7.65069,433,269043,0.0128617,0.01,1,154570,154137,433
22939501,9.26416,12.7301,427,269043,0.0105723,0.06,1,154578,154151,427
22941781,8.25283,8.94603,427,269043,0.0101145,0.05,1,154586,154159,427
22944701,6.45057,8.18921,425,269043,0.0180229,0.04,1,154592,154167,425
22946981,7.69011,8.03784,425,269043,0.0276046,0.03,1,154600,154175,425
22949061,10.338,8.00757,428,269043,0.0215209,0.04,1,154611,154183,428
22951981,8.4676,8.80151,427,269043,0.0123042,0.06,1,154619,154192,427
22954901,7.29352,8.1603,426,269043,0.0104608,0.04,1,154626,154200,426
22956961,7.8587,8.03206,426,269043,0.0340922,0,1,154634,154208,426
22959881,9.57174,8.80641,427,269043,0.0148184,0,1,154644,154217,427
22962161,7.51435,8.16128,426,269043,0.00296369,0.05,1,154651,154225,426
22965081,13.5029,13.6323,426,269043,0.00859274,0.04,1,154666,154240,426
22968001,9.90057,9.12645,427,269043,0.00971855,0.04,1,154675,154248,427
22970921,8.38011,8.22529,427,269043,0.00994371,0.06,1,154683,154256,427
22973841,8.07602,8.04506,427,269043,0.0259887,0.05,1,154691,154264,427
22976761,8.0152,8.00901,427,269043,0.0531978,0.05,1,154699,154272,427
22978801,8.00304,8.0018,427,269043,0.0586395,0.07,1,154707,154280,427
22981721,6.40061,6.40036,427,269043,0.0197279,0.05,1,154713,154286,427
22984641,6.08012,7.68007,425,269043,0.0359456,0.03,1,154719,154294,425
22987121,8.41602,7.93601,426,269043,0.0311891,0.03,1,154728,154302,426
22990041,12.0832,11.9872,426,269043,0.0382378,0.03,1,154741,154315,426
22992961,8.81664,8.79744,426,269043,0.0156476,0.06,1,154749,154323,426
22995881,8.16333,8.15949,426,269043,0.00312951,0.07,1,154757,154331,426
22998801,8.03267,8.0319,426,269043,0.0246259,0.05,1,154765,154339,426
23001681,7.20653,8.00638,425,269043,0.0369252,0.02,1,154772,154347,425
23003761,7.84131,8.00128,425,269043,0.023385,0.04,1,154780,154355,425
23005841,13.5683,12.8003,426,269043,0.00467701,0.04,1,154795,154369,426
23008761,10.7137,9.76005,427,269043,0.000935401,0.05,1,154805,154378,427
23011681,8.54273,8.35201,427,269043,0.00818708,0.06,1,154813,154386,427
23013541,5.70855,8.0704,424,269043,0.0256374,0.07,1,154818,154394,424
23015621,13.9417,7.21408,433,269043,0.0211275,0.03,1,154834,154401,433
23017701,15.5883,14.2428,433,269043,0.0442255,0,1,154850,154417,433
23020621,9.51767,14.8486,426,269043,0.0168451,0.03,1,154858,154432,426
23023541,8.30353,9.36971,426,269043,0.011369,0.03,1,154866,154440,426
23026461,7.26071,8.27394,425,269043,0.0022738,0.03,1,154873,154448,425
23029381,7.85214,8.05479,425,269043,0.00845476,0.01,1,154881,154456,425
23032301,8.77043,8.01096,426,269043,0.00169095,0.01,1,154890,154464,426
23035221,8.95409,8.00219,427,269043,0.00833819,0.04,1,154899,154472,427
23038141,8.19082,8.00044,427,269043,0.0416676,0.04,1,154907,154480,427
23041061,8.03816,8.00009,427,269043,0.0163335,0.05,1,154915,154488,427
23043981,8.00763,8.00002,427,269043,0.0352667,0.03,1,154923,154496,427
23046821,11.2015,8,431,269043,0.0470533,0.03,1,154935,154504,431
23049521,7.84031,10.4,427,269043,0.0334107,0.04,1,154942,154515,427
23051601,7.96806,9.28,426,269043,0.0306821,0.05,1,154950,154524,426
23054521,12.7936,12.256,427,269043,0.0301364,0.05,1,154964,154537,427
23057441,8.95872,8.8512,427,269043,0.00602729,0.12,1,154972,154545,427
23060361,7.39174,8.17024,426,269043,0.00120546,0.1,1,154979,154553,426
23063281,7.07835,8.03405,425,269043,0.00824109,0.03,1,154986,154561,425
23065121,7.01567,8.00681,424,269043,0.0256482,0.03,1,154993,154569,424
23068041,11.8031,10.4014,426,269043,0.0291296,0.01,1,155006,154580,426
23070961,8.76063,8.48027,426,269043,0.0378259,0.06,1,155014,154588,426
23073861,8.15213,8.09605,426,269043,0.0315652,0.05,1,155022,154596,426
23076781,7.23042,8.01921,425,269043,0.046313,0.05,1,155029,154604,425
23079061,10.2461,8.00384,428,269043,0.0172626,0.04,1,155040,154612,428
23081141,13.2492,8.80077,433,269043,0.0274525,0.04,1,155054,154621,433
23084061,9.84984,14.5602,426,269043,0.0054905,0.01,1,155063,154637,426
23086981,8.36997,9.31203,426,269043,0.0090981,0.06,1,155071,154645,426
23089901,8.87399,8.26241,427,269043,0.0258196,0.03,1,155080,154653,427
23092821,8.1748,8.05248,427,269043,0.00516392,0.06,1,155088,154661,427
23094661,9.63496,8.0105,429,269043,0.0330328,0.04,1,155098,154669,429
23097581,7.52699,10.4021,425,269043,0.0146066,0.04,1,155105,154680,425
23100501,9.5054,8.48042,427,269043,0.0109213,0,1,155115,154688,427
23103421,8.30108,8.09608,427,269043,0.0421843,0.05,1,155123,154696,427
23106341,8.06022,8.01922,427,269043,0.0644369,0.04,1,155131,154704,427
23109261,8.01204,8.00384,427,269043,0.0368874,0.07,1,155139,154712,427
23111921,7.20241,8.00077,426,269043,0.0233775,0.06,1,155146,154720,426
23114841,7.84048,7.20015,427,269043,0.0446755,0.05,1,155154,154727,427
23117761,6.3681,7.84003,425,269043,0.0409351,0.06,1,155160,154735,425
23119621,9.27362,7.96801,427,269043,0.040187,0,1,155170,154743,427
23121701,8.25472,8.7936,426,269043,0.0320374,0.03,1,155178,154752,426
23124621,8.85094,8.95872,426,269043,0.00640748,0.07,1,155187,154761,426
23127541,8.17019,8.19174,426,269043,0.0092815,0.05,1,155195,154769,426
23130461,8.03404,8.03835,426,269043,0.0018563,0.04,1,155203,154777,426
23133381,7.20681,8.00767,425,269043,0.0403713,0.02,1,155210,154785,425
23136261,10.2414,8.00153,428,269043,0.00807425,0.02,1,155221,154793,428
23138341,8.44827,9.60031,426,269043,0.00161485,0.06,1,155229,154803,426
23140421,7.28965,8.32006,425,269043,0.00032297,0.06,1,155236,154811,425
23142081,7.85793,8.06401,425,269043,0.0240646,0.03,1,155244,154819,425
23144161,10.3716,9.6128,426,269043,0.0528129,0.01,1,155255,154829,426
23146241,7.67432,6.72256,427,269043,0.0345626,0.01,1,155262,154835,427
23149161,24.7349,25.3445,426,269043,0.0229125,0.01,1,155291,154865,426
23152081,10.547,11.4689,425,269043,0.0125825,0.03,1,155298,154873,425
23155001,9.30939,8.69378,426,269043,0.0105165,0.01,1,155307,154881,426
23157921,8.26188,8.13876,426,269043,0.0341033,0.01,1,155315,154889,426
23160841,8.05238,8.02775,426,269043,0.0148207,0.01,1,155323,154897,426
23163761,8.01048,8.00555,426,269043,0.0109641,0.01,1,155331,154905,426
23166681,8.8021,8.00111,427,269043,0.0261928,0.03,1,155340,154913,427
23169601,8.16042,8.00022,427,269043,0.0212386,0.07,1,155348,154921,427
23172521,7.23208,8.00004,426,269043,0.00424771,0.05,1,155355,154929,426
23174321,7.04642,8.00001,425,269043,0.0248495,0.05,1,155362,154937,425
23177241,7.00928,5.6,427,269043,0.0129699,0.05,1,155369,154942,427
23180161,7.00186,7.52,426,269043,0.010594,0.05,1,155376,154950,426
23182021,4.60037,7.904,422,269043,0.0101188,0.05,1,155380,154958,422
23184101,12.1201,5.5808,431,269043,0.0260238,0.03,1,155394,154963,431
23186181,7.22401,11.5162,424,269043,0.00520475,0.05,1,155400,154976,424
23187841,7.0448,7.10323,425,269043,0.033041,0.05,1,155407,154982,425
23190761,7.00896,7.02065,425,269043,0.0546082,0.04,1,155414,154989,425
23193681,7.80179,7.80413,425,269043,0.0269216,0.05,1,155422,154997,425
23196161,7.96036,7.96083,425,269043,0.0293843,0.04,1,155430,155005,425
23199081,12.7921,11.9922,426,269043,0.00587687,0.04,1,155444,155018,426
23202001,8.95841,8.79843,426,269043,0.0331754,0.04,1,155452,155026,426
23204921,8.99168,8.15969,427,269043,0.0386351,0.04,1,155461,155034,427
23207841,7.39834,8.03194,426,269043,0.015727,0.04,1,155468,155042,426
23209681,7.07967,8.00639,425,269043,0.0271454,0.02,1,155475,155050,425
23211761,11.8159,11.2013,426,269043,0.0214291,0.03,1,155488,155062,426
23214681,8.76319,8.64026,426,269043,0.0202858,0.05,1,155496,155070,426
23217601,8.95264,8.12805,427,269043,0.0440572,0.04,1,155505,155078,427
23219461,4.99053,8.02561,423,269043,0.0488114,0.05,1,155509,155086,423
23221541,7.39811,5.60512,426,269043,0.0337623,0.03,1,155517,155091,426
23224461,7.87962,8.32102,425,269043,0.0147525,0.03,1,155525,155100,425
23227381,9.57592,8.0642,427,269043,0.0349505,0.03,1,155535,155108,427
23229861,7.51518,8.01284,426,269043,0.0389901,0.06,1,155542,155116,426
23231521,7.10304,7.20257,426,269043,0.063798,0.07,1,155549,155123,426
23233601,7.02061,7.84051,425,269043,0.0447596,0.05,1,155556,155131,425
23236521,7.80412,6.3681,427,269043,0.0169519,0.02,1,155564,155137,427
23239441,7.96082,7.67362,427,269043,0.00339038,0.06,1,155572,155145,427
23241301,4.79216,7.93472,423,269043,0.000678077,0.05,1,155576,155153,423
23242961,6.55843,5.58694,425,269043,0.0321356,0.05,1,155583,155158,425
23245881,6.91169,6.71739,425,269043,0.0464271,0.04,1,155590,155165,425
23248801,7.78234,7.74348,425,269043,0.0492854,0.03,1,155598,155173,425
23251721,8.75647,7.9487,426,269043,0.0338571,0.03,1,155607,155181,426
23254641,8.15129,7.98974,426,269043,0.0147714,0.03,1,155615,155189,426
23256901,7.23026,7.99795,425,269043,0.0429543,0.03,1,155622,155197,425
23258561,6.24605,6.39959,425,269043,0.00859086,0.04,1,155628,155203,425
23260641,6.04921,5.27992,426,269043,0.0257182,0.02,1,155634,155208,426
23263561,13.2098,13.056,426,269043,0.0131436,0.03,1,155649,155223,426
23266481,9.84197,9.0112,427,269043,0.0266287,0.04,1,155658,155231,427
23269401,8.36839,8.20224,427,269043,0.0373257,0.06,1,155666,155239,427
23271041,6.47368,8.04045,425,269043,0.0394651,0.06,1,155672,155247,425
23273961,11.6947,11.2081,426,269043,0.00789303,0.01,1,155685,155259,426
23276881,8.73895,8.64162,426,269043,0.0415786,0.06,1,155693,155267,426
23278741,23.3478,8.12832,445,269043,0.0163157,0.01,1,155720,155275,445
23281661,11.0696,23.2257,426,269043,0.00326314,0.06,1,155728,155302,426
23284581,7.81391,11.0451,425,269043,0.00865263,0.04,1,155735,155310,425
23287501,7.96278,8.60903,425,269043,0.0257305,0.01,1,155743,155318,425
23290181,7.99256,8.12181,425,269043,0.00514611,0.02,1,155751,155326,425
23293101,7.19851,7.22436,425,269043,0.00902922,0.03,1,155758,155333,425
23295381,13.4397,7.84487,432,269043,0.0498058,0,1,155773,155341,432
23298301,9.08794,12.769,426,269043,0.0419612,0.02,1,155781,155355,426
23301221,7.41759,8.95379,425,269043,0.0243922,0.04,1,155788,155363,425
23304141,8.68352,8.19076,426,269043,0.0128784,0.03,1,155797,155371,426
23307061,8.1367,8.03815,426,269043,0.0185757,0.04,1,155805,155379,426
23309981,8.02734,8.00763,426,269043,0.0197151,0.04,1,155813,155387,426
23312641,7.20547,8.00153,425,269043,0.011943,0.03,1,155820,155395,425
23315561,7.84109,7.20031,426,269043,0.00238861,0.04,1,155828,155402,426
23318261,8.76822,7.84006,427,269043,0.0244777,0.04,1,155837,155410,427
23320961,8.95364,9.56801,426,269043,0.0208955,0.03,1,155846,155420,426
23323881,11.3907,9.9136,428,269043,0.0281791,0.02,1,155858,155430,428
23326801,8.67815,8.38272,428,269043,0.0296358,0.06,1,155866,155438,428
23329281,6.53563,8.07654,426,269043,0.0299272,0.07,1,155872,155446,426
23332201,12.5071,12.8153,426,269043,0.00598543,0.03,1,155886,155460,426
23335121,8.90143,8.96306,426,269043,0.0171971,0.06,1,155894,155468,426
23336981,8.98029,8.19261,427,269043,0.0274394,0.03,1,155903,155476,427
23339901,9.79606,9.63852,427,269043,0.0134879,0.03,1,155913,155486,427
23342801,7.55921,8.3277,426,269043,0.0186976,0.05,1,155920,155494,426
23345721,11.1118,12.0655,425,269043,0.0357395,0.01,1,155932,155507,425
23348641,9.42237,8.81311,426,269043,0.0471479,0.03,1,155941,155515,426
23351541,10.6845,8.16262,429,269043,0.00942958,0.03,1,155952,155523,429
23354461,8.53689,9.63252,427,269043,0.00988592,0.05,1,155960,155533,427
23357381,7.30738,8.3265,426,269043,0.0259772,0.07,1,155967,155541,426
23360301,7.06148,8.0653,425,269043,0.0291954,0.04,1,155974,155549,425
23362561,7.8123,8.01306,425,269043,0.0298391,0.03,1,155982,155557,425
23365481,11.1625,9.60261,427,269043,0.0299678,0.02,1,155994,155567,427
23368401,8.63249,8.32052,427,269043,0.0299936,0.06,1,156002,155575,427
23371321,8.1265,8.0641,427,269043,0.0299987,0.06,1,156010,155583,427
23374001,7.2253,8.01282,426,269043,0.0299997,0.04,1,156017,155591,426
23376921,14.2451,13.6026,427,269043,0.0299999,0.04,1,156033,155606,427
23379841,9.24901,9.12051,427,269043,0.046,0.05,1,156041,155614,427
23382761,8.2498,8.2241,427,269043,0.0172,0.07,1,156049,155622,427
23385681,7.24996,8.04482,426,269043,0.01944,0.05,1,156056,155630,426
23388601,7.04999,8.00896,425,269043,0.011888,0.03,1,156063,155638,425
23391521,7.81,8.00179,425,269043,0.0183776,0.01,1,156071,155646,425
23393761,8.762,8.00036,426,269043,0.0276755,0.01,1,156080,155654,426
23396681,6.5524,6.40007,426,269043,0.0295351,0.03,1,156086,155660,426
23399601,7.71048,7.68001,426,269043,0.029907,0.05,1,156094,155668,426
23402081,7.9421,7.936,426,269043,0.0139814,0.07,1,156102,155676,426
23405001,15.9884,16.7872,425,269645,0.0107963,0.02,1,156120,155695,425
23407281,9.59768,9.75744,425,269645,0.0101593,0.01,1,156128,155703,425
23409361,21.9195,21.1515,426,269645,0.0100319,0.04,1,156153,155727,426
23412281,15.5839,15.4303,426,269645,0.0100064,0.02,1,156167,155741,426
23415201,9.51678,9.48606,426,269645,0.0180013,0.04,1,156175,155749,426
23418121,8.30336,8.29721,426,269645,0.00360025,0.04,1,156183,155757,426
23421041,8.06067,8.05944,426,269645,0.000720051,0.06,1,156191,155765,426
23423921,7.21213,8.01189,425,269645,0.00814401,0.04,1,156198,155773,425
23426841,11.8424,11.2024,426,269645,0.0176288,0.03,1,156211,155785,426
23429761,7.96849,8.64048,425,269645,0.0115258,0.05,1,156218,155793,425
23432681,8.7937,8.1281,426,269645,0.0103052,0.01,1,156227,155801,426
23434321,6.55874,8.02562,424,269645,0.00206103,0.05,1,156233,155809,424
23437241,7.71175,7.20512,425,269645,0.0244122,0.03,1,156241,155816,425
23440161,8.74235,7.84102,426,269645,0.0208824,0.03,1,156250,155824,426
23443081,8.14847,7.9682,426,269645,0.0121765,0.05,1,156258,155832,426
23446001,8.02969,7.99364,426,269645,0.0024353,0.08,1,156266,155840,426
23448881,8.00594,7.99873,426,269645,0.00848706,0.07,1,156274,155848,426
23451801,8.00119,7.99975,426,269645,0.0176974,0.06,1,156282,155856,426
23454081,8.00024,7.99995,426,269645,0.00353948,0.02,1,156290,155864,426
23457001,12,11.2,427,269645,0.0167079,0.04,1,156303,155876,427
23459921,8.80001,8.64,427,269645,0.0113416,0.04,1,156311,155884,427
23462401,7.36,8.128,426,269645,0.0182683,0.05,1,156318,155892,426
23465321,7.072,7.2256,426,269645,0.0196537,0.04,1,156325,155899,426
23467601,7.8144,7.84512,426,269645,0.0359307,0.05,1,156333,155907,426
23470521,7.16288,6.36902,427,269645,0.0471861,0.04,1,156340,155913,427
23472181,8.63258,7.6738,428,269645,0.0174372,0.02,1,156349,155921,428
23473841,6.52652,8.73476,425,269645,0.0274874,0.03,1,156355,155930,425
23475921,8.5053,8.14695,426,269645,0.00549749,0.01,1,156364,155938,426
23478841,8.90106,8.82939,426,269645,0.0250995,0.03,1,156373,155947,426
23480501,5.78021,8.16588,423,269645,0.0290199,0.03,1,156378,155955,423
23483421,8.35604,5.63318,427,269645,0.037804,0.04,1,156387,155960,427
23485281,6.47121,7.52664,425,269645,0.0315608,0.03,1,156393,155968,425
23488201,12.4942,12.7053,425,269645,0.0303122,0.03,1,156407,155982,425
23491121,9.69885,8.94107,426,269645,0.0300624,0.03,1,156416,155990,426
23494041,8.33977,8.18821,426,269645,0.0300125,0.07,1,156424,155998,426
23496961,8.06795,8.03764,426,269645,0.0460025,0.07,1,156432,156006,426
23498801,7.21359,8.00753,425,269645,0.0332005,0.06,1,156439,156014,425
23501721,7.04272,7.20151,425,269645,0.0146401,0.05,1,156446,156021,425
23504641,8.60854,7.8403,426,269645,0.050928,0.03,1,156455,156029,426
23506501,8.12171,7.96806,426,269645,0.0501856,0.04,1,156463,156037,426
23508581,12.0243,7.99361,431,269645,0.0340371,0.03,1,156476,156045,431
23511501,10.4049,12.7987,427,269645,0.0308074,0.04,1,156486,156059,427
23514421,7.68097,8.95974,426,269645,0.0301615,0.05,1,156493,156067,426
23517341,7.93619,8.19195,426,269645,0.0380323,0.05,1,156501,156075,426
23520261,7.98724,8.03839,426,269645,0.0156065,0.02,1,156509,156083,426
23523181,7.19745,8.00768,425,269645,0.0111213,0.03,1,156516,156091,425
23526101,7.83949,8.00154,425,269645,0.0102243,0.01,1,156524,156099,425
23529021,7.9679,8.00031,425,269645,0.00204485,0.01,1,156532,156107,425
23531941,7.99358,8.00006,425,269645,0.00040897,0.01,1,156540,156115,425
23534581,9.59872,8.00001,427,269645,0.0240818,0.02,1,156550,156123,427
23537501,8.31974,9.6,425,269645,0.0288164,0.05,1,156558,156133,425
23539781,23.2639,8.32,444,269645,0.0137633,0.01,1,156585,156141,444
23541861,13.4528,22.464,429,269645,0.0267527,0.02,1,156596,156167,429
23543941,15.4906,14.0928,433,269645,0.00535053,0.01,1,156612,156179,433
23546861,9.49811,14.0186,427,269645,0.00107011,0.05,1,156620,156193,427
23549781,8.29962,9.20371,427,269645,0.000214021,0.04,1,156628,156201,427
23552701,7.25992,8.24074,426,269645,0.0480428,0.02,1,156635,156209,426
23554961,7.05198,8.04815,425,269645,0.0496086,0.05,1,156642,156217,425
23557881,7.0104,6.40963,426,269645,0.0419217,0.02,1,156649,156223,426
23560801,7.80208,7.68193,426,269645,0.0323843,0.04,1,156657,156231,426
23563721,7.16042,7.93639,425,269645,0.0464769,0.04,1,156664,156239,425
23566641,7.83208,7.98728,425,269645,0.0332954,0.03,1,156672,156247,425
23568901,7.16642,7.99746,424,269645,0.0466591,0.01,1,156679,156255,424
23570561,7.03328,6.39949,425,269645,0.0173318,0.05,1,156686,156261,425
23573481,11.0067,10.0799,426,269645,0.0114664,0.05,1,156698,156272,426
23576401,8.60133,8.41598,426,269645,0.0102933,0.05,1,156706,156280,426
23579321,8.12027,8.0832,426,269645,0.00205865,0.04,1,156714,156288,426
23582241,7.22405,8.01664,425,269645,0.0324117,0.03,1,156721,156296,425
23585121,7.84481,8.00333,425,269645,0.0224823,0.03,1,156729,156304,425
23588041,9.56896,8.00067,427,269645,0.0284965,0.05,1,156739,156312,427
23590961,8.31379,8.00013,427,269645,0.0216993,0.06,1,156747,156320,427
23593441,6.46276,8.00003,425,269645,0.00433986,0.06,1,156753,156328,425
23596361,9.29255,9.60001,425,269645,0.00886797,0.03,1,156763,156338,425
23599281,8.25851,8.32,425,269645,0.0177736,0.05,1,156771,156346,425
23602181,8.0517,8.064,425,269645,0.0115547,0.01,1,156779,156354,425
23604881,8.01034,8.0128,425,269645,0.0103109,0.03,1,156787,156362,425
23606961,8.00207,7.20256,426,269645,0.0100622,0.04,1,156795,156369,426
23609041,8.80041,7.84051,427,269645,0.0260124,0.04,1,156804,156377,427
23611121,8.16008,9.5681,425,269645,0.0292025,0.05,1,156812,156387,425
23614041,7.23202,6.71362,426,269645,0.0298405,0.02,1,156819,156393,426
23616321,7.8464,7.74272,426,269645,0.0299681,0.04,1,156827,156401,426
23618401,11.9693,12.7485,425,269645,0.0219936,0.03,1,156840,156415,425
23621321,8.79386,7.34971,427,269645,0.00439872,0.02,1,156848,156421,427
23622981,5.75877,7.86994,424,269645,0.00887975,0.05,1,156853,156429,424
23625901,8.35175,7.17399,426,269645,0.025776,0.01,1,156862,156436,426
23628821,8.87035,7.8348,427,269645,0.0291552,0.02,1,156871,156444,427
23631741,6.57407,7.96696,425,269645,0.013831,0.03,1,156877,156452,425
23633381,6.91481,7.99339,424,269645,0.0107662,0.03,1,156884,156460,424
23635041,7.78296,6.39868,426,269645,0.00215324,0.07,1,156892,156466,426
23637121,7.15659,6.87974,426,269645,0.0164306,0.06,1,156899,156473,426
23639201,11.0313,10.9759,426,269645,0.0112861,0.01,1,156911,156485,426
23642121,12.6063,13.3952,425,269645,0.0102572,0.03,1,156924,156499,425
23645041,8.92125,9.07904,425,269645,0.0260514,0.04,1,156932,156507,425
23647961,8.18425,8.21581,425,269645,0.0132103,0.03,1,156940,156515,425
23650881,8.03685,8.04316,425,269645,0.00264206,0.01,1,156948,156523,425
23653801,8.80737,8.00863,426,269645,0.0165284,0.01,1,156957,156531,426
23656721,8.16147,8.00173,426,269645,0.0113057,0.04,1,156965,156539,426
23659641,8.83229,8.00035,427,269645,0.0102611,0.03,1,156974,156547,427
23662561,7.36646,8.00007,426,269645,0.00205223,0.03,1,156981,156555,426
23665481,7.87329,8.00001,426,269645,0.000410445,0.03,1,156989,156563,426
23668321,7.17466,8,425,269645,0.0320821,0.03,1,156996,156571,425
23670401,15.0349,14.4,426,269645,0.0144164,0.05,1,157013,156587,426
23672481,16.607,16.48,426,269645,0.0108833,0.04,1,157030,156604,426
23674561,13.7214,14.496,425,269645,0.0261767,0.01,1,157043,156618,425
23677481,9.14428,7.6992,427,269645,0.00523533,0.04,1,157051,156624,427
23679141,8.22886,7.93984,427,269645,0.00904707,0.06,1,157059,156632,427
23682061,7.24577,7.18797,427,269645,0.00180941,0.06,1,157066,156639,427
23684341,8.64915,7.83759,428,269645,0.0163619,0.05,1,157075,156647,428
23687261,6.52983,7.96752,426,269645,0.0592724,0.07,1,157081,156655,426
23689541,6.90597,7.9935,425,269645,0.0758545,0.05,1,157088,156663,425
23692461,6.98119,6.3987,426,269645,0.0631709,0.06,1,157095,156669,426
23695381,8.59624,7.67974,427,269645,0.0366342,0.04,1,157104,156677,427
23698301,6.51925,7.93595,425,269645,0.0233268,0.06,1,157110,156685,425
23700981,7.70385,7.98719,425,269645,0.0286654,0.03,1,157118,156693,425
23703061,10.3408,7.19744,429,269645,0.00573307,0.03,1,157129,156700,429
23705141,6.06815,9.43949,424,269645,0.00914661,0.07,1,157134,156710,424
23708061,7.61363,6.6879,426,269645,0.00182932,0.06,1,157142,156716,426
23709921,7.12273,7.73758,425,269645,0.0323659,0.06,1,157149,156724,425
23712841,7.82455,7.14752,426,269645,0.0304732,0.05,1,157157,156731,426
23715761,7.96491,7.8295,426,269645,0.0300946,0.02,1,157165,156739,426
23718681,7.19298,7.9659,425,269645,0.0380189,0.03,1,157172,156747,425
23721601,7.8386,7.99318,425,269645,0.0396038,0.03,1,157180,156755,425
23724521,7.96772,7.99864,425,269645,0.0239208,0.05,1,157188,156763,425
23726561,7.99354,7.99973,425,269645,0.0367841,0.01,1,157196,156771,425
23729481,7.99871,7.99995,425,269645,0.0153568,0.05,1,157204,156779,425
23731141,10.3997,7.99999,428,269645,0.0270714,0.02,1,157215,156787,428
23734061,7.67995,8.8,426,269645,0.0134143,0.03,1,157222,156796,426
23736981,7.93599,8.16,426,269645,0.0346829,0.03,1,157230,156804,426
23739901,7.9872,8.032,426,269645,0.0469366,0.04,1,157238,156812,426
23742821,8.79744,8.0064,427,269645,0.0333873,0.02,1,157247,156820,427
23745701,12.1595,8.00128,432,269645,0.00667746,0.05,1,157260,156828,432
23747361,7.2319,12.8003,424,269645,0.0333355,0.01,1,157266,156842,424
23750281,11.8464,11.3601,426,269645,0.0306671,0.03,1,157279,156853,426
23753201,8.76928,8.67201,426,269645,0.0221334,0.03,1,157287,156861,426
23755061,10.5539,8.1344,429,269645,0.0124267,0,1,157298,156869,429
23757981,8.51077,10.4269,426,269645,0.0104853,0.03,1,157306,156880,426
23760901,7.30215,8.48538,425,269645,0.0100971,0.04,1,157313,156888,425
23763821,7.86043,8.09708,425,269645,0.0260194,0.03,1,157321,156896,425
23766741,7.97209,8.01942,425,269645,0.0132039,0.03,1,157329,156904,425
23769621,11.1944,8.00388,429,269645,0.0426408,0.02,1,157341,156912,429
23771701,12.6389,10.4008,431,269645,0.0405282,0.04,1,157354,156923,431
23773781,9.72778,11.6802,428,269645,0.0161056,0.05,1,157363,156935,428
23776701,8.34556,10.336,426,269645,0.0112211,0.04,1,157371,156945,426
23779621,8.06911,8.46721,426,269645,0.0102442,0.04,1,157379,156953,426
23782541,7.21382,8.09344,425,269645,0.0100488,0.04,1,157386,156961,425
23785461,7.84276,8.01869,425,269645,0.0100098,0.01,1,157394,156969,425
23788381,8.76855,8.00374,426,269645,0.026002,0.02,1,157403,156977,426
23790001,7.35371,8.00075,425,269645,0.0292004,0.05,1,157410,156985,425
23792921,7.07074,6.40015,426,269645,0.00584008,0.03,1,157417,156991,426
23795841,7.81415,7.68003,426,269645,0.025168,0.05,1,157425,156999,426
23798761,7.16283,7.93601,425,269645,0.0050336,0.04,1,157432,157007,425
23801441,7.83257,7.9872,425,269645,0.00100672,0.05,1,157440,157015,425
23803521,15.1665,15.1974,425,269645,0.0242013,0,1,157457,157032,425
23805601,18.2333,18.2395,425,269645,0.0208403,0.02,1,157476,157051,425
23808521,12.4467,11.6479,426,269645,0.0121681,0.01,1,157487,157061,426
23811221,8.88933,8.72958,426,269645,0.0184336,0.06,1,157495,157069,426
23814141,8.97787,7.34592,428,269645,0.00368672,0.09,1,157504,157076,428
23816421,6.59557,7.86918,426,269645,0.0247373,0.1,1,157510,157084,426
23819341,6.11911,6.37384,426,269645,0.0129475,0.07,1,157516,157090,426
23821621,8.42382,7.67477,427,269645,0.0105895,0.05,1,157525,157098,427
23823281,7.28476,8.73495,425,269645,0.0021179,0.03,1,157532,157107,425
23826201,6.25695,5.74699,426,269645,0.0324236,0.01,1,157538,157112,426
23829121,6.85139,7.5494,425,269645,0.0464847,0.03,1,157545,157120,425
23831601,7.77028,7.90988,425,269645,0.0332969,0,1,157553,157128,425
23834521,9.55406,8.78198,426,269645,0.00665939,0.03,1,157563,157137,426
23837221,11.5108,8.1564,430,269645,0.00133188,0.03,1,157575,157145,430
23840141,9.50216,11.2313,427,269645,0.0322664,0.03,1,157584,157157,427
23843061,7.50043,8.64626,426,269645,0.00645328,0.03,1,157591,157165,426
23845981,7.90009,8.12925,426,269645,0.00929066,0.03,1,157599,157173,426
23848901,7.98002,8.02585,426,269645,0.0418581,0.03,1,157607,157181,426
23851821,7.196,8.00517,425,269645,0.0483716,0.03,1,157614,157189,425
23854741,8.6392,8.00103,426,269645,0.0496743,0.01,1,157623,157197,426
23857661,7.32784,8.00021,425,269645,0.0259349,0.04,1,157630,157205,425
23859681,7.06557,8.00004,424,269645,0.013187,0.03,1,157637,157213,424
23861761,9.41311,7.20001,427,269645,0.0106374,0.06,1,157647,157220,427
23864681,11.4826,12.64,425,269645,0.0421275,0.03,1,157659,157234,425
23867601,8.69652,8.928,425,269645,0.0484255,0.02,1,157667,157242,425
23870521,8.93931,8.1856,426,269645,0.0256851,0.03,1,157676,157250,426
23873201,7.38786,8.03712,425,269645,0.029137,0.05,1,157683,157258,425
23876121,7.87757,7.20742,426,269645,0.0298274,0.03,1,157691,157265,426
23878401,7.17551,7.84148,425,269645,0.0459655,0.04,1,157698,157273,425
23880481,11.0351,10.3683,426,269645,0.0411931,0.03,1,157710,157284,426
23883401,11.807,12.4737,425,269645,0.0482386,0.02,1,157722,157297,425
23885061,7.9614,8.89473,424,269645,0.0256477,0.03,1,157729,157305,424
23887981,7.99228,7.37895,425,269645,0.0371295,0.05,1,157737,157312,425
23890261,7.99846,7.87579,425,269645,0.0154259,0.03,1,157745,157320,425
23893181,7.99969,6.37516,427,269645,0.0430852,0.04,1,157753,157326,427
23896101,7.99994,7.67503,427,269645,0.048617,0.02,1,157761,157334,427
23898581,7.19999,7.93501,426,269645,0.0337234,0.06,1,157768,157342,426
23900241,7.04,7.187,426,269645,0.0147447,0.01,1,157775,157349,426
23902321,11.808,12.6374,425,269645,0.0109489,0.02,1,157788,157363,425
23904401,7.9616,7.32748,426,269645,0.0261898,0.02,1,157795,157369,426
23907321,12.7923,12.6655,426,269645,0.029238,0.03,1,157809,157383,426
23910241,8.15846,8.9331,425,269645,0.0538476,0.05,1,157816,157391,425
23913161,8.83169,8.18662,426,269645,0.0187695,0,1,157825,157399,426
23916081,8.16634,8.03732,426,269645,0.0197539,0.03,1,157833,157407,426
23919001,7.23327,8.00746,425,269645,0.00395078,0.05,1,157840,157415,425
23921921,7.84665,8.00149,425,269645,0.00879016,0.01,1,157848,157423,425
23924581,7.96933,8.0003,425,269645,0.00975803,0.03,1,157856,157431,425
23927501,7.99387,7.20006,426,269645,0.00995161,0.04,1,157864,157438,426
23930421,7.99877,7.84001,426,269645,0.0259903,0.04,1,157872,157446,426
23932481,7.99975,7.968,426,269645,0.0371981,0.03,1,157880,157454,426
23934561,7.19995,6.3936,427,269645,0.0234396,0.03,1,157887,157460,427
23936641,16.64,16.4787,427,269645,0.0126879,0.03,1,157906,157479,427
23938721,9.728,11.2957,425,269645,0.0265376,0.04,1,157914,157489,425
23941641,7.5456,7.05915,426,269645,0.00530752,0.02,1,157921,157495,426
23943301,7.10912,7.81183,425,269645,0.0090615,0.05,1,157928,157503,425
23944961,7.02182,7.96237,424,269645,0.0018123,0.02,1,157935,157511,424
23947881,9.40436,7.19247,427,269645,0.00036246,0.01,1,157945,157518,427
23950801,8.28087,7.83849,427,269645,0.0160725,0.04,1,157953,157526,427
23953701,9.65617,7.9677,429,269645,0.0512145,0.07,1,157963,157534,429
23956621,7.53123,10.3935,425,269645,0.0182429,0.03,1,157970,157545,425
23959541,9.50625,8.47871,427,269645,0.0436486,0.01,1,157980,157553,427
23962461,7.50125,8.09574,426,269645,0.0167297,0.04,1,157987,157561,426
23964721,7.10025,8.01915,425,269645,0.0193459,0.05,1,157994,157569,425
23967641,12.62,12.0038,426,269645,0.0358692,0,1,158008,157582,426
23970561,9.72401,8.80077,427,269645,0.0311738,0.04,1,158017,157590,427
23972421,9.1448,8.16015,428,269645,0.0142348,0.05,1,158026,157598,428
23975341,8.22896,8.83203,427,269645,0.018847,0.06,1,158034,157607,427
23978261,7.24579,8.16641,426,269645,0.0117694,0.05,1,158041,157615,426
23981181,7.84916,8.03328,426,269645,0.0103539,0.04,1,158049,157623,426
23984101,7.16983,8.00666,425,269645,0.0100708,0.04,1,158056,157631,425
23986981,7.83397,8.00133,425,269645,0.0100142,0.04,1,158064,157639,425
23989901,7.96679,8.00027,425,269645,0.0340028,0.03,1,158072,157647,425
23992801,7.99336,8.00005,425,269645,0.0308006,0.05,1,158080,157655,425
23994881,7.99867,8.00001,425,269645,0.0461601,0.05,1,158088,157663,425
23997801,10.3997,10.4,425,269645,0.033232,0.05,1,158099,157674,425
24000721,10.0799,8.48,427,269645,0.0306464,0.03,1,158109,157682,427
24002581,7.61599,8.096,426,269645,0.0141293,0.08,1,158116,157690,426
24005501,7.9232,7.2192,427,269645,0.0268259,0.03,1,158124,157697,427
24008421,7.98464,7.84384,427,269645,0.0373652,0.05,1,158132,157705,427
24011341,7.19693,7.96877,426,269645,0.039473,0.06,1,158139,157713,426
24012981,8.63939,7.99375,427,269645,0.0158946,0.01,1,158148,157721,427
24015061,5.72788,8.79875,423,269645,0.0111789,0.05,1,158153,157730,423
24017141,9.14558,6.55975,427,269645,0.0422358,0.01,1,158163,157736,427
24018801,8.22912,8.51195,426,269645,0.0324472,0.05,1,158171,157745,426
24020881,6.44582,7.30239,425,269645,0.0144894,0.03,1,158177,157752,425
24023801,10.0892,9.46048,426,269645,0.0108979,0.03,1,158188,157762,426
24026721,8.41783,8.2921,426,269645,0.0101796,0.04,1,158196,157770,426
24029641,8.08357,8.05842,426,269645,0.00203592,0.03,1,158204,157778,426
24031281,7.21671,8.01168,425,269645,0.00840718,0.06,1,158211,157786,425
24033361,8.64334,8.00234,426,269645,0.0176814,0.05,1,158220,157794,426
24035441,11.3287,9.60047,428,269645,0.0275363,0.07,1,158232,157804,428
24037521,7.86573,9.92009,425,269645,0.00550726,0.08,1,158239,157814,425
24040441,7.97315,8.38402,425,269645,0.00110145,0.05,1,158247,157822,425
24042101,10.3946,8.0768,428,269645,0.0162203,0.01,1,158258,157830,428
24045021,8.47893,10.4154,425,269645,0.0112441,0.03,1,158266,157841,425
24047941,8.09579,8.48307,425,269645,0.0102488,0.05,1,158274,157849,425
24050861,8.81916,8.09661,426,269645,0.00204976,0.03,1,158283,157857,426
24053781,8.96383,8.01932,427,269645,0.00840995,0.04,1,158292,157865,427
24056701,7.39277,8.00386,426,269645,0.033682,0.05,1,158299,157873,426
24059621,7.87855,8.00077,426,269645,0.0227364,0.05,1,158307,157881,426
24062541,7.97571,8.00015,426,269645,0.0845473,0.06,1,158315,157889,426
24065461,7.99514,8.00003,426,269645,0.0729095,0.04,1,158323,157897,426
24067061,13.599,8.00001,433,269645,0.0225819,0.01,1,158338,157905,433
24069981,9.11981,14.4,425,269645,0.0285164,0.02,1,158346,157921,425
24072901,8.22396,9.28,425,269645,0.0297033,0.03,1,158354,157929,425
24075381,8.84479,8.256,426,269645,0.0139407,0.02,1,158363,157937,426
24077461,10.569,7.2512,430,269645,0.0187881,0.05,1,158374,157944,430
24079541,10.9138,10.2502,430,269645,0.0437576,0.03,1,158385,157955,430
24081201,6.98276,11.65,424,269645,0.00875152,0.01,1,158391,157967,424
24084121,10.1966,9.53001,426,269645,0.0177503,0.01,1,158402,157976,426
24087041,9.23931,8.306,427,269645,0.0115501,0.01,1,158411,157984,427
24089961,7.44786,8.0612,426,269645,0.03431,0.03,1,158418,157992,426
24092881,7.88957,8.01224,426,269645,0.006862,0.06,1,158426,158000,426
24095801,7.97791,8.00245,426,269645,0.0013724,0.05,1,158434,158008,426
24098721,7.99558,8.00049,426,269645,0.00827448,0.01,1,158442,158016,426
24100961,7.99912,8.0001,426,269645,0.0016549,0.01,1,158450,158024,426
24103041,7.19982,8.00002,425,269645,0.024331,0.05,1,158457,158032,425
24105961,10.24,9.6,426,269645,0.0048662,0.03,1,158468,158042,426
24108881,7.64799,8.32,425,269645,0.0249732,0.06,1,158475,158050,425
24111801,8.7296,8.064,426,269645,0.0369946,0.01,1,158484,158058,426
24114481,8.14592,8.0128,426,269645,0.0473989,0.03,1,158492,158066,426
24117401,8.02918,7.20256,427,269645,0.0414798,0.03,1,158500,158073,427
24120321,8.00584,7.84051,427,269645,0.016296,0.04,1,158508,158081,427
24123241,7.20117,7.9681,426,269645,0.0352592,0.05,1,158515,158089,426
24125921,7.84023,7.99362,426,269645,0.0310518,0.06,1,158523,158097,426
24128001,10.368,10.3987,426,269645,0.0222104,0,1,158534,158108,426
24130921,9.27361,9.27975,426,269645,0.00444207,0.02,1,158543,158117,426
24133201,8.25472,8.25595,426,269645,0.000888415,0.04,1,158551,158125,426
24136121,9.65094,9.65119,426,269645,0.00817768,0.04,1,158561,158135,426
24139041,9.13019,8.33024,427,269645,0.0256355,0.03,1,158570,158143,427
24141521,7.42604,8.06605,426,269645,0.0451271,0.05,1,158577,158151,426
24144441,11.0852,11.2132,426,269645,0.0410254,0.03,1,158589,158163,426
24147361,8.61704,8.64264,426,269645,0.0322051,0.04,1,158597,158171,426
24150281,8.12341,8.12853,426,269645,0.046441,0.04,1,158605,158179,426
24153201,8.02468,8.02571,426,269645,0.0172882,0.04,1,158613,158187,426
24155461,12.0049,8.00514,431,269645,0.0354576,0.03,1,158626,158195,431
24157121,7.20099,12.001,424,269645,0.0470915,0.02,1,158632,158208,424
24160041,7.0402,6.40021,426,269645,0.00941831,0.02,1,158639,158213,426
24162961,7.80804,7.68004,426,269645,0.00988366,0.04,1,158647,158221,426
24165861,7.96161,7.93601,426,269645,0.00997673,0.04,1,158655,158229,426
24167941,11.9923,7.9872,431,269645,0.0259953,0.03,1,158668,158237,431
24170021,13.5985,11.9974,432,269645,0.0211991,0.01,1,158682,158250,432
24172941,9.11969,14.3995,425,269645,0.0122398,0.03,1,158690,158265,425
24175841,8.22394,9.2799,425,269645,0.010448,0.01,1,158698,158273,425
24178761,8.84479,8.25598,426,269645,0.00208959,0.01,1,158707,158281,426
24180421,4.96896,8.0512,422,269645,0.000417918,0.05,1,158711,158289,422
24182501,10.5938,5.61024,429,269645,8.35837e-05,0,1,158723,158294,429
24185421,10.1188,9.12205,429,269645,0.00801672,0.09,1,158733,158304,429
24188341,6.82375,8.22441,427,269645,0.00160334,0.09,1,158739,158312,427
24191261,7.76475,8.04488,427,269645,0.000320669,0.08,1,158747,158320,427
24194181,7.95295,8.00898,427,269645,0.0400641,0.06,1,158755,158328,427
24197061,9.59059,8.0018,429,269645,0.0320128,0.05,1,158765,158336,429
24199141,9.91812,10.4004,428,269645,0.0304026,0.03,1,158775,158347,428
24202061,9.18362,10.8801,426,269645,0.0460805,0.01,1,158784,158358,426
24204981,8.23672,8.57601,426,269645,0.0412161,0.04,1,158792,158366,426
24207461,8.04734,8.1152,426,269645,0.0162432,0.03,1,158800,158374,426
24209541,15.2095,7.22304,436,269645,0.0272486,0.01,1,158817,158381,436
24212241,9.44189,15.8446,426,269645,0.0294497,0.04,1,158825,158399,426
24214321,8.28838,8.76892,427,269645,0.00588995,0.02,1,158833,158406,427
24217241,13.6577,14.5538,426,269645,0.041178,0.01,1,158848,158422,426
24220161,8.33153,9.31076,425,269645,0.0162356,0.04,1,158855,158430,425
24223081,8.06631,8.26215,425,269645,0.0112471,0.04,1,158863,158438,425
24226001,8.81326,8.05243,426,269645,0.0102494,0.03,1,158872,158446,426
24228921,8.16265,8.01049,426,269645,0.0180499,0.04,1,158880,158454,426
24231841,8.03253,8.0021,426,269645,0.01961,0.06,1,158888,158462,426
24234081,8.00651,8.00042,426,269645,0.011922,0.02,1,158896,158470,426
24237001,10.4013,10.4001,426,269645,0.0343844,0.03,1,158907,158481,426
24239281,8.48026,8.48002,426,269645,0.0308769,0.05,1,158915,158489,426
24242201,5.69605,6.496,425,269645,0.0301754,0.04,1,158920,158495,425
24245121,8.33921,7.6992,426,269645,0.0140351,0.03,1,158929,158503,426
24247601,8.06784,7.93984,426,269645,0.026807,0.04,1,158937,158511,426
24250521,7.21357,7.18797,426,269645,0.0133614,0.04,1,158944,158518,426
24253441,7.84271,7.83759,426,269645,0.0346723,0.04,1,158952,158526,426
24256361,7.16854,7.96752,425,269645,0.0229345,0.03,1,158959,158534,425
24259041,7.83371,7.9935,425,269645,0.0445869,0.04,1,158967,158542,425
24261961,14.3667,13.5987,426,269645,0.0329174,0.02,1,158983,158557,426
24264881,10.0733,9.11974,427,269645,0.0145835,0.06,1,158992,158565,427
24267801,8.41467,8.22395,427,269645,0.0109167,0.06,1,159000,158573,427
24270721,7.28293,8.04479,426,269645,0.0101833,0.04,1,159007,158581,426
24273641,8.65659,8.00896,427,269645,0.0100367,0.03,1,159016,158589,427
24276101,6.53132,8.00179,425,269645,0.0340073,0.06,1,159022,158597,425
24279021,6.90626,7.20036,425,269645,0.0148015,0.04,1,159029,158604,425
24280881,7.78125,7.84007,425,269645,0.00296029,0.02,1,159037,158612,425
24283801,7.15625,5.56801,427,269645,0.0325921,0.05,1,159044,158617,427
24285461,7.83125,7.5136,427,269645,0.00651841,0.05,1,159052,158625,427
24287541,8.76625,8.70272,427,269645,0.0173037,0.03,1,159061,158634,427
24289621,10.5533,8.94054,429,269645,0.0274607,0.02,1,159072,158643,429
24292541,9.31065,10.5881,427,269645,0.0214921,0.03,1,159081,158654,427
24295461,8.26213,8.51762,427,269645,0.0282984,0.03,1,159089,158662,427
24297941,8.05243,8.10352,427,269645,0.0136597,0.06,1,159097,158670,427
24300021,8.81049,9.6207,426,269645,0.0107319,0.03,1,159106,158680,426
24302101,12.9621,8.32414,432,269645,0.0341464,0.02,1,159120,158688,432
24305021,8.99242,12.8648,426,269645,0.0308293,0.02,1,159128,158702,426
24306881,6.59848,8.97297,424,269645,0.0141659,0.04,1,159134,158710,424
24309801,8.5197,8.19459,425,269645,0.0428332,0.02,1,159143,158718,425
24312501,8.90394,8.03892,426,269645,0.0165666,0.04,1,159152,158726,426
24314581,8.18079,8.80778,425,269645,0.0353133,0.04,1,159160,158735,425
24316241,8.03616,6.56156,427,269645,0.0150627,0.02,1,159168,158741,427
24319161,5.60723,5.31231,427,269645,0.0270125,0.06,1,159173,158746,427
24320821,9.12145,7.46246,429,269645,0.00540251,0.03,1,159183,158754,429
24323741,9.02429,10.2925,427,269645,0.0250805,0.08,1,159192,158765,427
24326661,8.20486,8.4585,427,269645,0.0130161,0.07,1,159200,158773,427
24329141,8.04097,8.0917,427,269645,0.0106032,0.06,1,159208,158781,427
24332061,8.00819,9.61834,425,269645,0.0181206,0.03,1,159216,158791,425
24334981,9.60164,8.32367,427,269645,0.0196241,0.01,1,159226,158799,427
24337901,9.12033,8.06473,428,269645,0.00392483,0.07,1,159235,158807,428
24339541,6.62407,8.01295,426,269645,0.032785,0.06,1,159241,158815,426
24341621,12.5248,8.00259,432,269645,0.014557,0.04,1,159255,158823,432
24344541,9.70496,12.8005,427,269645,0.0109114,0.05,1,159264,158837,427
24346821,15.541,8.9601,436,269645,0.0261823,0.03,1,159281,158845,436
24349741,10.3082,16.992,426,269645,0.0292365,0.01,1,159290,158864,426
24352021,6.06164,9.7984,423,269645,0.00584729,0.05,1,159295,158872,423
24354941,7.61233,6.75968,425,269645,0.00116946,0.05,1,159303,158878,425
24357861,7.92247,7.75194,425,269645,0.000233892,0.04,1,159311,158886,425
24360781,7.98449,7.95039,425,269645,0.0320468,0.01,1,159319,158894,425
24363461,7.9969,7.99008,425,269645,0.00640936,0.05,1,159327,158902,425
24365121,7.19938,7.19802,425,269645,0.00128187,0.05,1,159334,158909,425
24368041,9.43988,9.4396,425,269645,0.00825637,0.01,1,159344,158919,425
24370321,9.08798,8.28792,426,269645,0.0656513,0.03,1,159353,158927,426
24373241,9.0176,8.85758,426,269645,0.0531303,0.03,1,159362,158936,426
24375521,8.20352,8.17152,426,269645,0.0426261,0.05,1,159370,158944,426
24378441,6.4407,6.4343,426,269645,0.0325252,0.02,1,159376,158950,426
24380721,7.68814,7.68686,426,269645,0.014505,0.05,1,159384,158958,426
24383641,7.13763,6.33737,427,269645,0.00290101,0.06,1,159391,158964,427
24386561,6.22753,7.66747,425,269645,0.0165802,0.04,1,159397,158972,425
24389481,7.64551,7.93349,425,269645,0.00331604,0.03,1,159405,158980,425
24392161,7.9291,7.9867,425,269645,0.00866321,0.01,1,159413,158988,425
24395081,9.58582,9.59734,425,269645,0.0177326,0.03,1,159423,158998,425
24398001,9.11716,8.31947,426,269645,0.0275465,0.02,1,159432,159006,426
24399861,9.02343,8.06389,427,269645,0.0135093,0.02,1,159441,159014,427
24402781,9.00469,8.81278,427,269645,0.00270186,0.03,1,159450,159023,427
24405701,6.60094,8.16256,425,269645,0.0325404,0.04,1,159456,159031,425
24408621,8.52019,8.03251,426,269645,0.0225081,0,1,159465,159039,426
24411541,8.10404,8.0065,426,269645,0.0285016,0.02,1,159473,159047,426
24414461,8.02081,8.0013,426,269645,0.0137003,0.06,1,159481,159055,426
24416081,6.40416,8.00026,424,269645,0.00274006,0.06,1,159487,159063,424
24418161,9.28083,8.00005,426,269645,0.00854801,0.05,1,159497,159071,426
24420241,7.45617,6.40001,427,269645,0.0177096,0.04,1,159504,159077,427
24423161,9.49123,10.08,426,269645,0.0115419,0.02,1,159514,159088,426
24426081,8.29825,8.416,426,269645,0.0183084,0.04,1,159522,159096,426
24429001,8.05965,8.0832,426,269645,0.0196617,0.04,1,159530,159104,426
24430641,7.21193,8.01664,425,269645,0.0359323,0.05,1,159537,159112,425
24432721,9.44239,9.60333,425,269645,0.0311865,0.03,1,159547,159122,425
24435641,9.88848,9.12067,426,269645,0.0462373,0.02,1,159557,159131,426
24437301,6.7777,8.22413,424,269645,0.0332475,0.04,1,159563,159139,424
24439381,6.95554,7.24483,424,269645,0.0306495,0.03,1,159570,159146,424
24441461,8.59111,6.24897,427,269645,0.0301299,0.04,1,159579,159152,427
24444381,8.11822,9.24979,425,269645,0.022026,0.03,1,159587,159162,425
24447281,8.82364,8.24996,426,269645,0.0204052,0.03,1,159596,159170,426
24449361,10.5647,10.45,426,269645,0.020081,0.02,1,159607,159181,426
24452281,13.3129,13.29,426,269645,0.0280162,0.03,1,159621,159195,426
24455201,9.06259,9.058,426,269645,0.0296032,0.06,1,159629,159203,426
24458121,8.21252,8.2116,426,269645,0.0139206,0.04,1,159637,159211,426
24461041,7.2425,8.04232,425,269645,0.0187841,0.03,1,159644,159219,425
24462881,7.8485,8.00846,425,269645,0.0117568,0.01,1,159652,159227,425
24465801,10.3697,10.4017,425,269645,0.0343514,0.01,1,159663,159238,425
24468721,8.47394,8.48034,425,269645,0.0228703,0.03,1,159671,159246,425
24471621,11.2948,8.09607,429,269645,0.0365741,0.02,1,159683,159254,429
24473701,9.45896,11.2192,426,269645,0.0313148,0.02,1,159692,159266,426
24475361,8.29179,8.64384,426,269645,0.030263,0.02,1,159700,159274,426
24478281,17.6584,17.7288,426,269645,0.0140526,0.01,1,159720,159294,426
24481201,11.5317,9.94575,428,269645,0.0188105,0.02,1,159730,159302,428
24484121,7.10633,8.38915,426,269645,0.0117621,0.05,1,159736,159310,426
24487041,7.02127,8.07783,425,269645,0.0103524,0.02,1,159743,159318,425
24489961,8.60425,8.01557,426,269645,0.00207048,0,1,159752,159326,426
24492881,8.92085,8.00311,427,269645,0.0084141,0.03,1,159761,159334,427
24495801,8.98417,8.00062,428,269645,0.0176828,0.03,1,159770,159342,428
24497621,9.79683,8.00012,430,269645,0.00353656,0.06,1,159780,159350,430
24500541,7.55937,10.4,426,269645,0.0487073,0.05,1,159787,159361,426
24502821,8.71187,8.48,427,269645,0.0337415,0.05,1,159796,159369,427
24505741,8.14237,9.696,425,269645,0.0387483,0.01,1,159804,159379,425
24508661,8.82848,8.3392,426,269645,0.0317497,0.03,1,159813,159387,426
24511581,8.1657,8.06784,426,269645,0.0223499,0.04,1,159821,159395,426
24514501,8.03314,8.01357,426,269645,0.01247,0.05,1,159829,159403,426
24517421,8.00663,8.00271,426,269645,0.002494,0.04,1,159837,159411,426
24520341,8.00133,8.00054,426,269645,0.0084988,0.06,1,159845,159419,426
24523261,8.00027,8.00011,426,269645,0.0176998,0.06,1,159853,159427,426
24525281,6.40005,8.00002,424,269645,0.04354,0.05,1,159859,159435,424
24528201,10.88,9.6,426,269645,0.024708,0.01,1,159871,159445,426
24531121,9.376,8.32,427,269645,0.0289416,0.03,1,159880,159453,427
24534041,6.6752,8.064,425,269645,0.0137883,0.05,1,159886,159461,425
24536961,7.73504,8.0128,425,269645,0.0267577,0.01,1,159894,159469,425
24538801,7.94701,8.00256,425,269645,0.0453515,0,1,159902,159477,425
24541721,5.5894,5.60051,425,269645,0.0730703,0.05,1,159907,159482,425
24544641,8.31788,7.5201,426,269645,0.0306141,0.03,1,159916,159490,426
24547121,7.26358,7.90402,425,269645,0.0141228,0.05,1,159923,159498,425
24550041,11.8527,11.1808,426,269645,0.0508246,0.01,1,159936,159510,426
24552741,11.1705,8.63616,429,269645,0.0661649,0.02,1,159947,159518,429
24555661,8.63411,10.5272,426,269645,0.037233,0.04,1,159955,159529,426
24558581,8.92682,8.50545,427,269645,0.0074466,0.08,1,159964,159537,427
24561501,8.18536,8.10109,427,269645,0.0254893,0.07,1,159972,159545,427
24563761,8.03707,8.02022,427,269645,0.0370979,0.06,1,159980,159553,427
24565841,8.00741,8.80404,426,269645,0.0314196,0.05,1,159988,159562,426
24567921,6.40148,6.56081,426,269645,0.0462839,0.04,1,159994,159568,426
24570001,6.0803,6.11216,426,269645,0.0492568,0.03,1,160000,159574,426
24572081,7.61606,8.42243,425,269645,0.00985136,0.02,1,160008,159583,425
24575001,10.3232,9.68449,426,269645,0.0259703,0.01,1,160019,159593,426
24576661,7.66464,8.3369,425,269645,0.0531941,0.03,1,160026,159601,425
24578321,7.13293,8.06738,424,269645,0.0346388,0.03,1,160033,159609,424
24580401,8.62659,8.01348,425,269645,0.0469278,0.03,1,160042,159617,425
24582481,9.72532,9.6027,425,269645,0.0413856,0.01,1,160052,159627,425
24585401,12.3451,11.5205,426,269645,0.0162771,0.02,1,160065,159639,426
24588321,8.86901,8.70411,426,269645,0.00325542,0.02,1,160073,159647,426
24591241,8.1738,8.14082,426,269645,0.00865108,0.04,1,160081,159655,426
24594161,8.83476,8.02816,427,269645,0.00173022,0.04,1,160090,159663,427
24596001,5.76695,8.00563,424,269645,0.00834604,0.05,1,160095,159671,424
24598921,5.95339,5.60113,425,269645,0.00966921,0.02,1,160101,159676,425
24601841,8.39068,7.52023,426,269645,0.00193384,0.03,1,160110,159684,426
24603701,6.47814,7.90405,424,269645,0.0243868,0.04,1,160116,159692,424
24605781,10.0956,7.18081,428,269645,0.0448774,0.03,1,160127,159699,428
24607861,22.0191,9.43616,443,269645,0.00897547,0.04,1,160152,159709,443
24609941,14.8038,21.8872,431,269645,0.0417951,0.03,1,160165,159734,431
24612861,8.56076,14.7774,425,269645,0.016359,0.02,1,160172,159747,425
24615781,8.91215,9.35549,426,269645,0.0352718,0,1,160181,159755,426
24618701,7.38243,8.2711,425,269645,0.0230544,0.05,1,160188,159763,425
24621621,9.47649,8.05422,427,269645,0.0206109,0,1,160198,159771,427
24624541,8.2953,8.01084,427,269645,0.0201222,0.06,1,160206,159779,427
24627461,8.05906,8.00217,427,269645,0.0360244,0.04,1,160214,159787,427
24630381,8.01181,8.00043,427,269645,0.0472049,0.05,1,160222,159795,427
24633301,8.00236,8.00009,427,269645,0.049441,0.05,1,160230,159803,427
24636221,7.20047,8.00002,426,269645,0.0258882,0.04,1,160237,159811,426
24638021,7.84009,8,426,269645,0.0451776,0.02,1,160245,159819,426
24640941,8.76802,8,427,269645,0.0330355,0.03,1,160254,159827,427
24643861,7.3536,8,426,269645,0.00660711,0.05,1,160261,159835,426
24646341,7.87072,8,426,269645,0.00932142,0.04,1,160269,159843,426
24648001,7.17414,7.2,426,269645,0.0258643,0.07,1,160276,159850,426
24650921,6.23483,7.04,425,269645,0.0131729,0.06,1,160282,159857,425
24653841,8.44697,7.808,426,269645,0.0106346,0.02,1,160291,159865,426
24656761,8.08939,7.9616,426,269645,0.0101269,0.04,1,160299,159873,426
24658401,7.21788,7.99232,425,269645,0.00202538,0.04,1,160306,159881,425
24661321,7.84358,6.39846,427,269645,0.000405077,0.05,1,160314,159887,427
24664241,7.96872,7.67969,427,269645,0.00808102,0.06,1,160322,159895,427
24667161,7.19374,7.93594,426,269645,0.0256162,0.03,1,160329,159903,426
24670081,7.03875,7.98719,425,269645,0.0211232,0.03,1,160336,159911,425
24673001,9.40775,7.99744,427,269645,0.0202246,0.03,1,160346,159919,427
24675041,8.28155,7.99949,427,269645,0.0440449,0.06,1,160354,159927,427
24677961,7.25631,6.3999,428,269645,0.016809,0.08,1,160361,159933,428
24679621,8.65126,7.67998,429,269645,0.0113618,0.06,1,160370,159941,429
24682541,7.33025,9.536,426,269645,0.0102724,0.02,1,160377,159951,426
24684821,8.66605,8.3072,427,269645,0.0100545,0.03,1,160386,159959,427
24687741,8.13321,8.86144,426,269645,0.00201089,0.04,1,160394,159968,426
24690661,8.02664,8.17229,426,269645,0.0164022,0.04,1,160402,159976,426
24693581,8.80533,8.03446,427,269645,0.0352804,0.02,1,160411,159984,427
24696261,10.5611,8.00689,430,269645,0.0230561,0.04,1,160422,159992,430
24698961,8.51221,11.2014,426,269645,0.0286112,0.04,1,160430,160004,426
24701881,8.10244,7.84028,427,269645,0.0297222,0.03,1,160438,160011,427
24704581,6.42049,7.96806,425,269645,0.0139444,0.06,1,160444,160019,425
24706661,9.2841,7.19361,428,269645,0.0187889,0.03,1,160454,160026,428
24708741,9.85682,8.63872,429,269645,0.0117578,0.06,1,160464,160035,429
24710821,7.57136,10.5277,425,269645,0.0183516,0.06,1,160471,160046,425
24712901,7.91427,6.90555,427,269645,0.0196703,0.03,1,160479,160052,427
24714981,10.3829,9.38111,428,269645,0.0119341,0.03,1,160490,160062,428
24717061,6.87657,9.07622,425,269645,0.0183868,0.05,1,160496,160071,425
24718721,5.37531,6.61524,424,269645,0.00367736,0.04,1,160501,160077,424
24721641,10.6751,9.32305,426,269645,0.0327355,0.03,1,160513,160087,426
24723301,6.13501,8.26461,423,269645,0.0385471,0.03,1,160518,160095,423
24726221,7.627,5.65292,426,269645,0.0157094,0.04,1,160526,160100,426
24729121,7.9254,7.53058,426,269645,0.00314188,0.03,1,160534,160108,426
24732041,8.78508,7.90612,427,269645,0.0326284,0.05,1,160543,160116,427
24734321,7.35702,7.98122,426,269645,0.0465257,0.05,1,160550,160124,426
24736401,8.6714,7.99624,427,269645,0.0413051,0.01,1,160559,160132,427
24738481,18.5343,19.1992,426,269645,0.032261,0.01,1,160580,160154,426
24741401,20.5069,19.8398,427,269645,0.0304522,0.03,1,160601,160174,427
24744321,9.70137,10.368,426,269645,0.00609044,0.03,1,160608,160182,426
24747241,8.34027,8.47359,426,269645,0.00121809,0.04,1,160616,160190,426
24750161,8.06805,8.09472,426,269645,0.000243618,0.04,1,160624,160198,426
24753081,8.01361,8.01894,426,269645,0.00804872,0.04,1,160632,160206,426
24756001,8.00272,8.00379,426,269645,0.0416097,0.06,1,160640,160214,426
24758241,7.20054,8.00076,425,269645,0.0163219,0.05,1,160647,160222,425
24761161,9.44011,8.00015,427,269645,0.0272644,0.05,1,160657,160230,427
24763441,7.48802,8.00003,426,269645,0.0294529,0.07,1,160664,160238,426
24766361,10.2976,10.4,426,269645,0.0218906,0.01,1,160675,160249,426
24769281,8.45952,8.48,426,269645,0.0363781,0.04,1,160683,160257,426
24772201,8.0919,8.096,426,269645,0.00727562,0.06,1,160691,160265,426
24775121,8.01838,8.0192,426,269645,0.0174551,0.04,1,160699,160273,426
24778041,8.00368,8.00384,426,269645,0.027491,0.04,1,160707,160281,426
24780501,7.20074,8.00077,425,269645,0.0134982,0.05,1,160714,160289,425
24783421,8.64015,7.20015,427,269645,0.0106996,0.04,1,160723,160296,427
24786341,8.12803,7.84003,427,269645,0.00213993,0.05,1,160731,160304,427
24788821,8.82561,7.96801,428,269645,0.000427986,0.06,1,160740,160312,428
24791741,8.16512,9.5936,426,269645,0.0240856,0.06,1,160748,160322,426
24794641,8.83302,8.31872,427,269645,0.0448171,0.06,1,160757,160330,427
24797561,8.1666,8.06374,427,269645,0.0409634,0.06,1,160765,160338,427
24800481,6.43332,8.01275,425,269645,0.0161927,0.05,1,160771,160346,425
24803401,7.68666,8.00255,425,269645,0.0112385,0.01,1,160779,160354,425
24806321,7.93733,8.00051,425,269645,0.0182477,0.03,1,160787,160362,425
24808161,7.18747,8.0001,424,269645,0.0276495,0,1,160794,160370,424
24811081,11.8375,11.2,425,269645,0.0295299,0,1,160807,160382,425
24814001,10.3675,8.64,427,269645,0.013906,0,1,160817,160390,427
24816901,8.4735,8.128,427,269645,0.0107812,0.06,1,160825,160398,427
24818561,6.4947,8.0256,425,269645,0.00215624,0.07,1,160831,160406,425
24821481,9.29894,8.80512,426,269645,0.0244312,0.01,1,160841,160415,426
24824401,8.25979,8.16102,426,269645,0.0448863,0.04,1,160849,160423,426
24826881,8.05196,8.0322,426,269645,0.0249773,0.03,1,160857,160431,426
24829801,7.21039,7.20644,426,269645,0.00499545,0.01,1,160864,160438,426
24832081,8.64208,7.84129,427,269645,0.00899909,0.03,1,160873,160446,427
24835001,9.72842,10.3683,426,269645,0.00979982,0.03,1,160883,160457,426
24837921,9.14568,8.47365,427,269645,0.02596,0.05,1,160892,160465,427
24840841,7.42914,8.09473,426,269645,0.053192,0.03,1,160899,160473,426
24843521,7.88583,8.01895,426,269645,0.0346384,0.05,1,160907,160481,426
24845601,9.57717,9.60379,426,269645,0.00692768,0.02,1,160917,160491,426
24847681,9.11543,8.32076,427,269645,0.00938554,0.05,1,160926,160499,427
24849761,6.62309,6.46415,427,269645,0.0338771,0.04,1,160932,160505,427
24851841,10.1246,11.6928,425,269645,0.0307754,0.02,1,160943,160518,425
24854761,10.0249,9.53857,426,269645,0.0301551,0.01,1,160953,160527,426
24857681,9.20498,8.30771,427,269645,0.00603102,0.06,1,160962,160535,427
24860161,8.241,8.06154,427,269645,0.0332062,0.07,1,160970,160543,427
24863081,7.2482,7.21231,427,269645,0.00664124,0.06,1,160977,160550,427
24866001,7.84964,7.84246,427,269645,0.00132825,0.07,1,160985,160558,427
24868901,23.1699,7.96849,446,269645,0.0242657,0.03,1,161012,160566,446
24870981,24.634,23.9937,443,269645,0.0288531,0.01,1,161037,160594,443
24873901,11.3268,24.7987,426,269645,0.0297706,0.04,1,161045,160619,426
24876821,9.46536,11.3597,427,269645,0.0219541,0.04,1,161054,160627,427
24879741,6.69307,8.67195,425,269645,0.00439082,0.04,1,161060,160635,425
24882661,8.53861,8.13439,426,269645,0.0248782,0.05,1,161069,160643,426
24885581,7.30772,8.02688,425,269645,0.0129756,0.04,1,161076,160651,425
24888501,8.66154,8.00538,426,269645,0.0105951,0.04,1,161085,160659,426
24891421,8.13231,8.00108,426,269645,0.010119,0.04,1,161093,160667,426
24894341,7.22646,8.00022,425,269645,0.0260238,0.06,1,161100,160675,425
24897261,7.84529,8.00004,425,269645,0.0132048,0.02,1,161108,160683,425
24899681,7.96906,8.00001,425,269645,0.026641,0.04,1,161116,160691,425
24902601,7.99381,7.2,426,269645,0.0133282,0.04,1,161124,160698,426
24904261,7.99876,7.84,426,269645,0.0106656,0.03,1,161132,160706,426
24907181,7.19975,7.168,426,269645,0.0181331,0.03,1,161139,160713,426
24910101,7.03995,7.8336,425,269645,0.0196266,0.04,1,161146,160721,425
24912581,7.80799,7.96672,425,269645,0.0359253,0.03,1,161154,160729,425
24915501,8.7616,7.19334,427,269645,0.0471851,0.05,1,161163,160736,427
24918421,7.35232,7.83867,426,269645,0.033437,0.06,1,161170,160744,426
24920901,7.07046,7.96773,425,269645,0.0306874,0.05,1,161177,160752,425
24923821,7.81409,7.19355,426,269645,0.0141375,0.03,1,161185,160759,426
24925681,7.16282,7.83871,425,269645,0.0108275,0.03,1,161192,160767,425
24928601,8.63256,7.16774,427,269645,0.0101655,0.02,1,161201,160774,427
24931521,8.12651,7.83355,427,269645,0.0180331,0.03,1,161209,160782,427
24934441,7.2253,7.96671,426,269645,0.0276066,0.02,1,161216,160790,426
24937121,7.04506,7.99334,425,269645,0.0135213,0.03,1,161223,160798,425
24939201,8.60901,8.79867,425,269645,0.0267043,0.05,1,161232,160807,425
24942121,10.5218,10.5597,425,269645,0.00534085,0,1,161243,160818,425
24945041,10.1044,8.51195,427,269645,0.00906817,0,1,161253,160826,427
24947961,8.42087,8.10239,427,269645,0.00981363,0.06,1,161261,160834,427
24950881,7.28417,8.02048,426,269645,0.00996273,0.06,1,161268,160842,426
24953801,7.85683,8.0041,426,269645,0.0259925,0.05,1,161276,160850,426
24956261,8.77137,8.00082,427,269645,0.0291985,0.03,1,161285,160858,427
24957921,6.55427,8.80016,424,269645,0.0138397,0.03,1,161291,160867,424
24960841,7.71085,5.76003,427,269645,0.0107679,0.02,1,161299,160872,427
24963121,6.34217,7.55201,425,269645,0.00215359,0.03,1,161305,160880,425
24965201,8.46843,7.9104,426,269645,0.0164307,0.06,1,161314,160888,426
24968121,9.69369,10.3821,425,269645,0.0192861,0.05,1,161324,160899,425
24971041,9.13874,8.47642,426,269645,0.0198572,0.03,1,161333,160907,426
24972901,5.82775,8.09528,423,269645,0.0119714,0.01,1,161338,160915,423
24974561,6.76555,5.61906,425,269645,0.00239429,0.04,1,161345,160920,425
24977481,11.7531,10.7238,426,269645,0.0244789,0,1,161358,160932,426
24980181,7.95062,8.54476,425,269645,0.0288958,0.05,1,161365,160940,425
24982261,6.39012,7.30895,424,269645,0.0457792,0.06,1,161371,160947,424
24984341,6.07803,6.26179,424,269645,0.0251558,0.05,1,161377,160953,424
24986421,11.6156,6.05236,431,269645,0.0130312,0.02,1,161390,160959,431
24989341,8.72312,11.6105,426,269645,0.0106062,0.01,1,161398,160972,426
24991201,6.54462,8.72209,424,269645,0.0181212,0.03,1,161404,160980,424
24994121,7.70892,5.74442,427,269645,0.0116242,0,1,161412,160985,427
24996401,7.94178,7.54888,427,269645,0.0263249,0.02,1,161420,160993,427
24999321,25.5884,25.5098,427,269645,0.013265,0.01,1,161450,161023,427
25000981,20.3177,11.502,438,269645,0.00265299,0,1,161469,161031,438
25003901,10.4635,18.3004,426,269645,0.0165306,0.02,1,161477,161051,426
25006821,9.29271,10.0601,427,269645,0.0113061,0.01,1,161486,161059,427
25009741,6.65854,8.41202,425,269645,0.0262612,0.04,1,161492,161067,425
25012661,9.33171,8.0824,427,269645,0.0292522,0.03,1,161502,161075,427
25015581,7.46634,8.01648,426,5840,0.0298504,0.06,1,161509,161083,426
25018501,7.09327,8.0033,425,5840,0.00597009,0.06,1,161516,161091,425
25021421,7.81865,8.00066,425,5840,0.00119402,0.03,1,161524,161099,425
25023861,9.56373,8.00013,427,5840,0.0322388,0.03,1,161534,161107,427
25026781,8.31275,9.60003,425,5840,0.0144478,0.02,1,161542,161117,425
25029701,8.06255,8.32001,425,5840,0.0108896,0.05,1,161550,161125,425
25032181,8.01251,8.064,425,5840,0.0101779,0.02,1,161558,161133,425
25034881,8.8025,7.2128,427,5840,0.00203558,0.03,1,161567,161140,427
25037801,7.3605,7.04256,427,5840,0.000407116,0.05,1,161574,161147,427
25039461,7.8721,7.80851,427,5840,8.14233e-05,0.04,1,161582,161155,427
25042381,7.97442,8.7617,426,5840,1.62847e-05,0.03,1,161590,161164,426
25045301,7.19488,8.15234,425,5840,3.25693e-06,0.04,1,161597,161172,425
25048221,8.63898,8.03047,426,5840,6.51386e-07,0.03,1,161606,161180,426
25051141,7.3278,8.00609,425,5840,0.0240001,0.04,1,161613,161188,425
25054061,7.86556,8.00122,425,5840,0.0288,0.05,1,161621,161196,425
25056981,7.97311,8.00024,425,5840,0.00576001,0.03,1,161629,161204,425
25058801,7.19462,8.00005,424,5840,0.001152,0.05,1,161636,161212,424
25061721,8.63892,7.20001,426,5840,0.0002304,0.03,1,161645,161219,426
25064641,7.32778,7.84,425,5840,0.00804608,0.04,1,161652,161227,425
25067561,7.86556,7.968,425,5840,0.00960922,0.01,1,161660,161235,425
25070481,7.97311,7.9936,425,5840,0.0339218,0.02,1,161668,161243,425
25073401,7.99462,7.99872,425,5840,0.0147844,0,1,161676,161251,425
25075441,8.79892,7.99974,426,5840,0.0109569,0.03,1,161685,161259,426
25078361,6.55979,6.39995,426,5840,0.00219137,0.04,1,161691,161265,426
25080021,9.31196,7.67999,428,5840,0.00843828,0.06,1,161701,161273,428
25082941,8.26239,9.536,426,5840,0.00168765,0.03,1,161709,161283,426
25085861,8.05248,8.3072,426,5840,0.0163375,0.03,1,161717,161291,426
25088781,8.0105,8.06144,426,5840,0.0192675,0.04,1,161725,161299,426
25090421,8.0021,8.01229,426,5840,0.0198535,0.02,1,161733,161307,426
25093341,8.80042,8.80246,426,5840,0.0039707,0.04,1,161742,161316,426
25096241,7.36008,8.16049,425,5840,0.00879414,0.04,1,161749,161324,425
25098321,7.87202,8.0321,425,5840,0.00175883,0,1,161757,161332,425
25101241,13.5744,12.0064,427,5840,0.0243518,0.03,1,161772,161345,427
25103521,8.31488,8.80128,426,5840,0.00487035,0.08,1,161779,161353,426
25105601,7.26298,6.56026,427,5840,0.000974071,0.04,1,161786,161359,427
25108521,7.8526,8.51205,426,5840,0.00819481,0.04,1,161794,161368,426
25111441,7.97052,8.10241,426,5840,0.00163896,0.04,1,161802,161376,426
25114361,7.9941,8.02048,426,5840,0.000327793,0.04,1,161810,161384,426
25116421,10.3988,8.0041,429,5840,6.55585e-05,0.03,1,161821,161392,429
25119341,7.67976,10.4008,425,5840,0.0160131,0.04,1,161828,161403,425
25122241,7.93595,8.48016,425,5840,0.0112026,0.04,1,161836,161411,425
25124321,7.98719,8.09603,425,5840,0.0182405,0.02,1,161844,161419,425
25127241,13.5974,13.6192,425,5840,0.0116481,0.03,1,161859,161434,425
25128901,21.9195,9.12384,441,5840,0.00232962,0.03,1,161883,161442,441
25130981,16.3839,20.2248,433,5840,0.00846592,0.03,1,161898,161465,433
25133061,12.8768,16.045,430,5840,0.00969318,0.03,1,161910,161480,430
25135981,8.97536,12.809,426,5840,0.00993864,0.01,1,161918,161492,426
25137441,164.995,8.9618,622,5840,0.00198773,0.01,1,162122,161500,622
25140361,206.599,329.792,429,5840,0.000397545,0.03,1,162339,161910,429
25143281,204.52,76.3585,620,267950,0.0240795,0,1,162543,161923,620
25146201,218.504,348.072,426,267950,0.0448159,0.05,1,162765,162339,426
25149121,53.3008,77.6143,428,267950,0.0169632,0.01,1,162777,162349,428
25152041,17.8602,23.5229,427,267950,0.0273926,0.05,1,162786,162359,427
25154961,11.572,12.7046,427,267950,0.0214785,0.01,1,162796,162369,427
25157881,9.51441,10.5409,426,267950,0.0442957,0.03,1,162805,162379,426
25160801,9.90288,10.1082,426,267950,0.0488591,0.05,1,162815,162389,426
25163721,10.7806,10.0216,427,267950,0.0497718,0.01,1,162826,162399,427
25166641,9.35612,10.0043,426,267950,0.0179544,0.03,1,162835,162409,426
25169561,10.6712,10.0009,427,267950,0.0355909,0.05,1,162846,162419,427
25172481,9.33424,10.0002,426,267950,0.0151182,0.01,1,162855,162429,426
25175401,10.6668,10,427,267950,0.0110236,0.03,1,162866,162439,427
25178321,9.33337,10,426,267950,0.0102047,0.03,1,162875,162449,426
25181241,10.6667,10,427,267950,0.0340409,0.01,1,162886,162459,427
25184161,9.33333,10,426,267950,0.0148082,0.03,1,162895,162469,426
25187081,10.6667,10,427,267950,0.00296164,0.01,1,162906,162479,427
25190001,9.33333,10,426,267950,0.0245923,0.05,1,162915,162489,426
25192921,10.6667,10,427,267950,0.0129185,0.03,1,162926,162499,427
25195841,9.33333,10,426,267950,0.0265837,0.03,1,162935,162509,426
25198761,10.6667,10,427,267950,0.0133167,0.03,1,162946,162519,427
25201681,10.1333,10,427,267950,0.0106633,0.03,1,162956,162529,427
25204601,10.0267,10,427,267950,0.0101327,0.03,1,162966,162539,427
25207521,9.20533,10,426,267950,0.0420265,0.01,1,162975,162549,426
25210441,9.84107,10,426,267950,0.0164053,0.03,1,162985,162559,426
25213361,9.96821,10,426,267950,0.0272811,0.01,1,162995,162569,426
25216281,10.7936,10,427,267950,0.0134562,0.01,1,163006,162579,427
25219201,10.1587,10,427,267950,0.00269124,0.02,1,163016,162589,427
25222121,10.0317,10,427,267950,0.00853825,0.05,1,163026,162599,427
25225041,10.0063,10,427,267950,0.00970765,0.04,1,163036,162609,427
25227961,10.0013,10,427,267950,0.0259415,0.03,1,163046,162619,427
25230881,10.0003,10,427,267950,0.0131883,0.04,1,163056,162629,427
25233801,10.0001,10,427,267950,0.00263766,0.05,1,163066,162639,427
25236721,10,10,427,267950,0.0165275,0.04,1,163076,162649,427
25239641,10,10,427,267950,0.0273055,0.03,1,163086,162659,427
25242561,10,10,427,267950,0.0214611,0.05,1,163096,162669,427
25245481,10,10,427,267950,0.0122922,0.03,1,163106,162679,427
25248401,10,10,427,267950,0.0264584,0.03,1,163116,162689,427
25251321,10,10,427,267950,0.0212917,0.03,1,163126,162699,427
25254241,9.2,10,426,267950,0.0282583,0.03,1,163135,162709,426
25257161,10.64,10,427,267950,0.0296517,0.01,1,163146,162719,427
25260081,10.928,10,428,267950,0.0139303,0.02,1,163157,162729,428
25263001,9.3856,10,427,267950,0.00278607,0.05,1,163166,162739,427
25265921,10.6771,10,428,267950,0.00855721,0.03,1,163177,162749,428
25268841,9.33542,10,427,267950,0.0417114,0.04,1,163186,162759,427
25271761,9.86708,10,427,267950,0.0483423,0.05,1,163196,162769,427
25274681,9.97342,10,427,267950,0.0176685,0.05,1,163206,162779,427
25277601,9.99468,10,427,267950,0.0355337,0.05,1,163216,162789,427
25280521,10.7989,10,428,267950,0.0151067,0.03,1,163227,162799,428
25283441,10.1598,10,428,267950,0.00302135,0.05,1,163237,162809,428
25286361,8.43196,10,426,267950,0.00860427,0.05,1,163245,162819,426
25289281,10.4864,10,427,267950,0.0177209,0.04,1,163256,162829,427
25292201,9.29728,10,426,267950,0.0115442,0.04,1,163265,162839,426
25295121,9.85946,10,426,267950,0.0103088,0.04,1,163275,162849,426
25298041,9.97189,10,426,267950,0.0100618,0.05,1,163285,162859,426
25300961,10.7944,10,427,267950,0.00201235,0.01,1,163296,162869,427
25303881,9.35888,10,426,267950,0.0244025,0.04,1,163305,162879,426
25306801,9.87178,10,426,267950,0.0448805,0.04,1,163315,162889,426
25309721,10.7744,10,427,267950,0.0249761,0.03,1,163326,162899,427
25312641,9.35487,10,426,267950,0.0129952,0.04,1,163335,162909,426
25315561,10.671,10,427,267950,0.010599,0.05,1,163346,162919,427
25318481,9.3342,10,426,267950,0.0101198,0.06,1,163355,162929,426
25321401,9.86684,10,426,267950,0.018024,0.06,1,163365,162939,426
25324321,9.97337,10,426,267950,0.0116048,0.05,1,163375,162949,426
25327241,11.5947,10,428,267950,0.00232096,0.03,1,163387,162959,428
25330161,8.71893,10,426,267950,0.00846419,0.05,1,163395,162969,426
25333081,10.5438,10,427,267950,0.00969284,0.03,1,163406,162979,427
25336001,9.30876,10,426,267950,0.00993857,0.05,1,163415,162989,426
25338921,9.86175,10,426,267950,0.0419877,0.03,1,163425,162999,426
25341841,10.7724,10,427,267950,0.0163975,0.01,1,163436,163009,427
25344761,9.35447,10,426,267950,0.0112795,0.06,1,163445,163019,426
25347681,10.6709,10,427,267950,0.0102559,0.05,1,163456,163029,427
25350601,9.33418,10,426,267950,0.0100512,0.06,1,163465,163039,426
25353521,9.86684,10,426,267950,0.0100102,0.06,1,163475,163049,426
25356441,10.7734,10,427,267950,0.010002,0.03,1,163486,163059,427
25359361,10.1547,10,427,267950,0.0100004,0.03,1,163496,163069,427
25362281,10.0309,10,427,267950,0.0100001,0.05,1,163506,163079,427
25365201,10.0062,10,427,267950,0.00200002,0.05,1,163516,163089,427
25368121,10.8012,10,428,267950,0.0164,0.03,1,163527,163099,428
25371041,9.36025,10,427,267950,0.03528,0.05,1,163536,163109,427
25373961,9.87205,10,427,267950,0.023056,0.05,1,163546,163119,427
25376881,9.97441,10,427,267950,0.0126112,0.04,1,163556,163129,427
25379801,9.19488,10,426,267950,0.0265222,0.02,1,163565,163139,426
25382721,9.83898,10,426,267950,0.0133044,0.03,1,163575,163149,426
25385641,10.7678,10,427,267950,0.00266089,0.01,1,163586,163159,427
25388561,10.9536,10,428,267950,0.000532178,0.05,1,163597,163169,428
25391481,10.1907,10,428,267950,0.00810644,0.07,1,163607,163179,428
25394401,9.23814,10,427,267950,0.0336213,0.07,1,163616,163189,427
25397321,9.84763,10,427,267950,0.0147243,0.04,1,163626,163199,427
25400241,9.96953,10,427,267950,0.0269449,0.05,1,163636,163209,427
25403161,9.9939,10,427,267950,0.013389,0.04,1,163646,163219,427
25406081,9.19878,10,426,267950,0.0266778,0.03,1,163655,163229,426
25409001,10.6398,10,427,267950,0.0133356,0.03,1,163666,163239,427
25411921,9.32795,10,426,267950,0.0266671,0.06,1,163675,163249,426
25414841,9.86559,10,426,267950,0.0293334,0.06,1,163685,163259,426
25417761,9.97312,10,426,267950,0.0298667,0.06,1,163695,163269,426
25420681,9.99462,10,426,267950,0.0299733,0.03,1,163705,163279,426
25423601,10.7989,10,427,267950,0.0299947,0.01,1,163716,163289,427
25426521,10.9598,10,428,267950,0.00599893,0.03,1,163727,163299,428
25429441,9.39196,10,427,267950,0.00919979,0.05,1,163736,163309,427
25432361,9.07839,10,426,267950,0.00983996,0.03,1,163745,163319,426
25435281,10.6157,10,427,267950,0.00996799,0.01,1,163756,163329,427
25438201,9.32314,10,426,267950,0.0259936,0.01,1,163765,163339,426
25441121,10.6646,10,427,267950,0.00519872,0.03,1,163776,163349,427
25444041,9.33293,10,426,267950,0.0250397,0.06,1,163785,163359,426
25446961,9.86659,10,426,267950,0.0210079,0.06,1,163795,163369,426
25449881,9.97332,10,426,267950,0.0122016,0.06,1,163805,163379,426
25452801,9.99466,10,426,267950,0.0264403,0.06,1,163815,163389,426
25455721,9.99893,10,426,267950,0.0292881,0.04,1,163825,163399,426
25458641,11.5998,10,428,267950,0.0138576,0.01,1,163837,163409,428
25461561,8.71996,10,426,267950,0.0187715,0.05,1,163845,163419,426
25464481,9.74399,10,426,267950,0.0117543,0.06,1,163855,163429,426
25467401,9.9488,10,426,267950,0.0183509,0.06,1,163865,163439,426
25470321,9.98976,10,426,267950,0.0276702,0.06,1,163875,163449,426
25473241,9.99795,10,426,267950,0.045534,0.04,1,163885,163459,426
25476161,9.99959,10,426,267950,0.0411068,0.03,1,163895,163469,426
25479081,9.99992,10,426,267950,0.0322214,0.06,1,163905,163479,426
25482001,9.99998,10,426,267950,0.0304443,0.06,1,163915,163489,426
25484921,10,10,426,267950,0.0300889,0.06,1,163925,163499,426
25487841,10.8,10,427,267950,0.0140178,0.05,1,163936,163509,427
25490761,10.16,10,427,267950,0.0268036,0.04,1,163946,163519,427
25493681,10.032,10,427,267950,0.0213607,0.04,1,163956,163529,427
25496601,9.2064,10,426,267950,0.0282721,0.03,1,163965,163539,426
25499521,10.6413,10,427,267950,0.0136544,0.03,1,163976,163549,427
25502441,9.32826,10,426,267950,0.0107309,0.06,1,163985,163559,426
25505361,9.86565,10,426,267950,0.0341462,0.03,1,163995,163569,426
25508281,10.7731,10,427,267950,0.0308292,0.01,1,164006,163579,427
25511201,10.1546,10,427,267950,0.0141658,0.03,1,164016,163589,427
25514121,10.0309,10,427,267950,0.00283317,0.04,1,164026,163599,427
25517041,10.0062,10,427,267950,0.000566634,0.05,1,164036,163609,427
25519961,10.0012,10,427,267950,0.0161133,0.06,1,164046,163619,427
25522881,10.0002,10,427,267950,0.0192227,0.05,1,164056,163629,427
25525801,10,10,427,267750,0.0198445,0.04,1,164066,163639,427
25528721,10,10,427,267750,0.0199689,0.06,1,164076,163649,427
25531641,10,10,427,267750,0.0199938,0.04,1,164086,163659,427
25534561,10,10,427,267750,0.0199988,0.05,1,164096,163669,427
25537481,10,10,427,267750,0.0119998,0.04,1,164106,163679,427
25540401,10,10,427,267750,0.0184,0.05,1,164116,163689,427
25543321,9.2,10,426,267750,0.01168,0.04,1,164125,163699,426
25546241,10.64,10,427,267750,0.018336,0.05,1,164136,163709,427
25549161,9.328,10,426,267750,0.0116672,0.05,1,164145,163719,426
25552081,9.8656,10,426,267750,0.0103334,0.05,1,164155,163729,426
25555001,10.7731,10,427,267750,0.0420667,0.05,1,164166,163739,427
25557921,10.1546,10,427,267750,0.00841334,0.03,1,164176,163749,427
25560841,9.23092,10,426,267750,0.0256827,0.03,1,164185,163759,426
25563761,10.6462,10,427,267750,0.00513653,0.01,1,164196,163769,427
25566681,10.1292,10,427,267750,0.00102731,0.02,1,164206,163779,427
25569601,9.22585,10,426,267750,0.00820546,0.04,1,164215,163789,426
25572521,10.6452,10,427,267750,0.00964109,0.05,1,164226,163799,427
25575441,10.129,10,427,267750,0.00192822,0.05,1,164236,163809,427
25578361,9.22581,10,426,267750,0.0243856,0.06,1,164245,163819,426
25581281,9.84516,10,426,267750,0.0288771,0.03,1,164255,163829,426
25584201,9.96903,10,426,267750,0.0297754,0.03,1,164265,163839,426
25587121,10.7938,10,427,267750,0.0379551,0.01,1,164276,163849,427
25590041,10.1588,10,427,267750,0.015591,0.04,1,164286,163859,427
25592961,10.8318,10,428,267750,0.0031182,0.02,1,164297,163869,428
25595881,9.36635,10,427,267750,0.00862364,0.05,1,164306,163879,427
25598801,9.87327,10,427,267750,0.00172473,0.05,1,164316,163889,427
25601721,9.97465,10,427,267750,0.0163449,0.05,1,164326,163899,427
25604641,9.99493,10,427,267750,0.00326899,0.04,1,164336,163909,427
25607561,9.99899,10,427,267750,0.0086538,0.05,1,164346,163919,427
25610481,10.7998,10,428,267750,0.00973076,0.03,1,164357,163929,428
25613401,9.35996,10,427,267750,0.0179462,0.04,1,164366,163939,427
25616321,9.87199,10,427,267750,0.0195892,0.01,1,164376,163949,427
25619241,9.9744,10,427,267750,0.0359178,0.05,1,164386,163959,427
25622161,9.19488,10,426,267750,0.0471836,0.04,1,164395,163969,426
25625081,10.639,10,427,267750,0.0414367,0.04,1,164406,163979,427
25628001,9.3278,10,426,267750,0.0322873,0.06,1,164415,163989,426
25630921,10.6656,10,427,267750,0.0224575,0.05,1,164426,163999,427
25633841,9.33311,10,426,267750,0.0284915,0.05,1,164435,164009,426
25636761,9.86662,10,426,267750,0.0216983,0.03,1,164445,164019,426
25639681,10.7733,10,427,267750,0.0443397,0.03,1,164456,164029,427
25642601,10.1547,10,427,267750,0.0168679,0.03,1,164466,164039,427
25645521,10.0309,10,427,267750,0.0113736,0.03,1,164476,164049,427
25648441,10.0062,10,427,267750,0.0262747,0.03,1,164486,164059,427
25651361,10.0012,10,427,270670,0.0212549,0.03,1,164496,164069,427
25654281,10.0002,10,427,270670,0.012251,0.03,1,164506,164079,427
25657201,9.20005,10,426,270670,0.0104502,0.03,1,164515,164089,426
25660121,10.64,10,427,270670,0.01009,0.02,1,164526,164099,427
25663041,9.328,10,426,270670,0.010018,0.06,1,164535,164109,426
25665961,10.6656,10,427,270670,0.0020036,0.03,1,164546,164119,427
25668881,9.33312,10,426,270670,0.0164007,0.06,1,164555,164129,426
25671801,9.86662,10,426,270670,0.0352801,0.04,1,164565,164139,426
25674721,10.7733,10,427,270670,0.015056,0.03,1,164576,164149,427
25677641,9.35467,10,426,270670,0.0270112,0.04,1,164585,164159,426
25680561,10.6709,10,427,270670,0.0134022,0.03,1,164596,164169,427
25683481,9.33419,10,426,270670,0.0346804,0.05,1,164605,164179,426
25686401,9.86684,10,426,270670,0.0309361,0.03,1,164615,164189,426
25689321,9.97337,10,426,270670,0.00618722,0.04,1,164625,164199,426
25692241,10.7947,10,427,270670,0.0252374,0.03,1,164636,164209,427
25695161,9.35893,10,426,270670,0.0130475,0.06,1,164645,164219,426
25698081,10.6718,10,427,270670,0.0106095,0.05,1,164656,164229,427
25701001,10.1344,10,427,270670,0.0021219,0.01,1,164666,164239,427
25703921,10.0269,10,427,270670,0.0244244,0.03,1,164676,164249,427
25706841,10.0054,10,427,270670,0.0288849,0.05,1,164686,164259,427
25709761,10.0011,10,427,270670,0.00577698,0.04,1,164696,164269,427
25712681,9.20022,10,426,270670,0.0411554,0.04,1,164705,164279,426
25715601,9.84004,10,426,270670,0.0322311,0.05,1,164715,164289,426
25718521,9.96801,10,426,270670,0.0304462,0.03,1,164725,164299,426
25721441,10.7936,10,427,270670,0.0220892,0.05,1,164736,164309,427
25724361,9.35872,10,426,270670,0.0284178,0.06,1,164745,164319,426
25727281,10.6717,10,427,270670,0.0216836,0.03,1,164756,164329,427
25730201,10.1343,10,427,270670,0.0363367,0.04,1,164766,164339,427
25733121,10.0269,10,427,270670,0.0232673,0.02,1,164776,164349,427
25736041,10.0054,10,427,270670,0.0126535,0.03,1,164786,164359,427
25738961,10.8011,10,428,270670,0.0105307,0.01,1,164797,164369,428
25741881,9.36022,10,427,270670,0.0101061,0.05,1,164806,164379,427
25744801,9.87204,10,427,270670,0.0260212,0.03,1,164816,164389,427
25747721,9.97441,10,427,270670,0.0372042,0.04,1,164826,164399,427
25750641,9.99488,10,427,270670,0.0154408,0.04,1,164836,164409,427
25753561,9.99898,10,427,270670,0.0350882,0.02,1,164846,164419,427
25756481,9.9998,10,427,270670,0.0150176,0.04,1,164856,164429,427
25759401,11.6,10,429,270670,0.0110035,0.07,1,164868,164439,429
25762321,7.91999,10,426,270670,0.00220071,0.06,1,164875,164449,426
25765241,10.384,10,427,270670,0.0244401,0.03,1,164886,164459,427
25768161,10.0768,10,427,270670,0.012888,0.04,1,164896,164469,427
25771081,10.0154,10,427,270670,0.0265776,0.03,1,164906,164479,427
25774001,9.20307,10,426,270670,0.0293155,0.03,1,164915,164489,426
25776921,7.44061,8.4,425,270670,0.0138631,0.03,1,164922,164497,425
25778481,7.08812,8.08,424,270670,0.0267726,0.03,1,164929,164505,424
25781401,7.01762,6.416,425,270670,0.0133545,0.02,1,164936,164511,425
25784321,7.80352,7.6832,425,270670,0.0266709,0.05,1,164944,164519,425
25787241,7.9607,7.93664,425,270670,0.0133342,0.03,1,164952,164527,425
25789301,8.79214,7.98733,426,270670,0.0426668,0.02,1,164961,164535,426
25792221,8.95843,7.99747,427,270670,0.0165334,0.02,1,164970,164543,427
25795141,7.39169,7.99949,426,270670,0.0433067,0.06,1,164977,164551,426
25798061,7.87834,7.9999,426,270670,0.0326613,0.07,1,164985,164559,426
25800741,7.17567,7.99998,425,270670,0.0225323,0.06,1,164992,164567,425
25803661,7.83513,7.2,426,270670,0.0285065,0.06,1,165000,164574,426
25806581,7.96703,7.84,426,270670,0.0537013,0.02,1,165008,164582,426
25808641,7.99341,7.968,426,270670,0.0347403,0.05,1,165016,164590,426
25810721,11.1987,11.1936,426,270670,0.0149481,0.03,1,165028,164602,426
25813641,13.4397,12.6387,427,270670,0.0589896,0.04,1,165042,164615,427
25816561,9.08795,8.92774,427,270670,0.0197979,0.04,1,165050,164623,427
25818421,5.01759,8.18555,423,270670,0.00395958,0.04,1,165054,164631,423
25820081,5.80352,5.63711,424,270058,0.000791917,0.04,1,165060,164636,424
25823001,9.1607,7.52742,426,270058,0.0161584,0.03,1,165070,164644,426
25825281,7.43214,7.90548,425,270058,0.0112317,0.04,1,165077,164652,425
25828201,11.8864,10.3811,427,270058,0.0262463,0,1,165090,164663,427
25831121,7.97729,8.47622,426,270058,0.0292493,0.04,1,165097,164671,426
25832981,7.19546,8.09524,425,270058,0.00584985,0.03,1,165104,164679,425
25834641,7.03909,7.21905,425,270058,0.00916997,0.04,1,165111,164686,425
25837561,9.40782,7.84381,427,270058,0.033834,0.06,1,165121,164694,427
25839221,11.4816,7.96876,431,270058,0.0147668,0.06,1,165133,164702,431
25842141,7.09631,11.1938,425,270058,0.0109534,0.05,1,165139,164714,425
25845061,8.61926,8.63875,426,270058,0.00219067,0.01,1,165148,164722,426
25847981,8.12385,8.12775,426,270058,0.000438134,0.03,1,165156,164730,426
25850661,7.22477,8.02555,425,270058,0.0240876,0.03,1,165163,164738,425
25853581,7.84495,7.20511,426,270058,0.00481752,0.05,1,165171,164745,426
25855861,18.369,7.84102,439,270058,0.0169635,0.03,1,165192,164753,439
25858781,9.2738,18.3682,425,270058,0.0433927,0.07,1,165199,164774,425
25861701,8.25476,10.0736,425,270058,0.0326785,0.04,1,165207,164782,425
25864621,8.05095,8.41473,425,270058,0.0225357,0.05,1,165215,164790,425
25867541,9.61019,8.08295,427,270058,0.0445071,0.05,1,165225,164798,427
25870461,7.52204,8.01659,426,270058,0.00890143,0.07,1,165232,164806,426
25872081,6.30441,8.00332,424,270058,0.0177803,0.05,1,165238,164814,424
25875001,7.66088,6.40066,426,270058,0.0355561,0.04,1,165246,164820,426
25877921,7.93218,7.68013,426,270058,0.0311112,0.05,1,165254,164828,426
25879781,11.1864,7.93603,430,270058,0.0142222,0.03,1,165266,164836,430
25882701,7.83729,11.1872,425,270058,0.0188444,0.04,1,165273,164848,425
25885621,7.96746,8.63744,425,270058,0.0517689,0.01,1,165281,164856,425
25888101,11.1935,8.12749,429,270058,0.0183538,0.04,1,165293,164864,429
25889761,7.0387,10.4255,424,270058,0.0116708,0.03,1,165299,164875,424
25892681,11.8077,10.8851,426,270058,0.0503342,0,1,165312,164886,426
25895601,8.76155,8.57702,426,270058,0.0500668,0.02,1,165320,164894,426
25898521,8.95231,8.1154,427,270058,0.0100134,0.02,1,165329,164902,427
25900581,4.99046,8.02308,423,270058,0.00200267,0.07,1,165333,164910,423
25903501,7.39809,6.40462,425,270058,0.00840053,0.01,1,165341,164916,425
25905781,9.47962,7.68092,427,270058,0.0176801,0.03,1,165351,164924,427
25907441,6.69592,8.73618,424,270058,0.027536,0.07,1,165357,164933,424
25910361,8.53918,7.34724,426,270258,0.0295072,0.04,1,165366,164940,426
25913281,8.90784,7.86945,427,270258,0.00590144,0.08,1,165375,164948,427
25916181,8.18157,7.97389,427,270258,0.0171803,0.05,1,165383,164956,427
25919101,8.03631,7.99478,427,270258,0.0274361,0.06,1,165391,164964,427
25922021,7.20726,7.99896,426,270258,0.0214872,0.06,1,165398,164972,426
25924501,11.8415,7.99979,431,270258,0.0122974,0.02,1,165411,164980,431
25927421,8.76829,11.2,427,270258,0.0104595,0.03,1,165419,164992,427
25930341,7.35366,8.63999,426,270258,0.0180919,0.06,1,165426,165000,426
25932821,6.27073,8.128,424,270258,0.0116184,0.04,1,165432,165008,424
25935741,9.25415,7.2256,427,270258,0.0183237,0.01,1,165442,165015,427
25938661,9.05083,7.84512,428,270258,0.00366474,0.05,1,165451,165023,428
25941581,8.21017,7.96902,428,270258,0.000732947,0.05,1,165459,165031,428
25943221,9.64203,7.9938,430,270258,0.0161466,0.02,1,165469,165039,430
25946141,8.32841,11.1988,426,270258,0.0192293,0.02,1,165477,165051,426
25948421,8.86568,8.63975,427,270258,0.0278459,0.04,1,165486,165059,427
25951121,8.17314,8.12795,427,270258,0.0295692,0.05,1,165494,165067,427
25953201,6.43463,7.22559,426,270258,0.0139138,0.04,1,165500,165074,426
25956121,9.28693,10.2451,425,270258,0.0267828,0.05,1,165510,165085,425
25957781,12.2574,8.44902,430,270258,0.00535655,0.03,1,165523,165093,430
25960701,8.85148,11.2898,426,270258,0.00907131,0.04,1,165531,165105,426
25962981,6.5703,8.65796,424,270258,0.00181426,0.03,1,165537,165113,424
25965681,6.91406,6.53159,425,270258,0.0163629,0.03,1,165544,165119,425
25967761,7.78281,6.90632,426,270258,0.0112726,0.03,1,165552,165126,426
25969841,7.95656,8.58126,425,270258,0.0102545,0,1,165560,165135,425
25972761,12.7913,12.1163,426,270258,0.0500509,0.03,1,165574,165148,426
25974421,5.75826,8.82325,422,270258,0.0580102,0.03,1,165578,165156,422
25977341,8.35165,5.76465,426,270258,0.027602,0.01,1,165587,165161,426
25980261,7.27033,7.55293,425,270258,0.0295204,0.06,1,165594,165169,425
25982741,10.2541,7.91059,428,270258,0.0219041,0.01,1,165605,165177,428
25984401,7.65081,8.78212,426,270258,0.0123808,0.07,1,165612,165186,426
25986481,9.53016,9.75642,426,270258,0.0104762,0.04,1,165622,165196,426
25989401,7.50603,6.75128,427,270258,0.0260952,0.04,1,165629,165202,427
25991061,6.30121,7.75026,425,270258,0.021219,0.05,1,165635,165210,425
25992721,6.06024,7.15005,424,270258,0.00424381,0.05,1,165641,165217,424
25994801,7.61205,7.03001,425,270258,0.00884876,0.03,1,165649,165224,425
25997721,11.1224,10.206,426,270258,0.0177698,0.01,1,165661,165235,426
26000641,8.62448,8.4412,426,270258,0.027554,0.03,1,165669,165243,426
26003561,7.3249,8.08824,425,270258,0.00551079,0.03,1,165676,165251,425
26005201,7.06498,8.01765,424,270258,0.0171022,0.01,1,165683,165259,424
26008121,9.413,7.20353,427,270258,0.0114204,0.01,1,165693,165266,427
26011041,8.2826,7.84071,427,270258,0.0102841,0.05,1,165701,165274,427
26013521,6.45652,7.96814,425,270258,0.0340568,0.04,1,165707,165282,425
26016441,10.0913,8.79363,427,270258,0.0308114,0.01,1,165718,165291,427
26018721,7.61826,8.15873,426,270258,0.00616227,0.07,1,165725,165299,426
26020801,7.92365,8.03175,426,270258,0.00123245,0.07,1,165733,165307,426
26023721,10.3847,11.2063,425,270258,0.0242465,0.03,1,165744,165319,425
26026641,8.47695,8.64127,425,270258,0.0528493,0.03,1,165752,165327,425
26029121,8.89539,8.12825,426,270258,0.0265699,0.02,1,165761,165335,426
26032041,8.17908,8.82565,425,270258,0.013314,0.04,1,165769,165344,425
26034961,8.83582,8.16513,426,270258,0.00266279,0.02,1,165778,165352,426
26037861,10.5672,8.03303,429,270258,0.0245326,0.03,1,165789,165360,429
26039941,7.71343,9.60661,426,270258,0.0289065,0.06,1,165796,165370,426
26042021,11.1427,8.32132,430,270258,0.0217813,0.04,1,165808,165378,430
26044941,8.62854,11.2643,426,270258,0.0203563,0.03,1,165816,165390,426
26047861,8.12571,8.65285,426,270258,0.0120713,0.04,1,165824,165398,426
26050781,7.22514,8.13057,425,270258,0.0184143,0.03,1,165831,165406,425
26053701,8.64503,8.02611,426,270258,0.0436829,0.01,1,165840,165414,426
26056621,8.12901,8.00522,426,270258,0.0407366,0.04,1,165848,165422,426
26059541,8.0258,8.00104,426,270258,0.0321473,0.04,1,165856,165430,426
26061361,6.40516,8.00021,424,270258,0.0144295,0.03,1,165862,165438,424
26064281,6.08103,5.60004,425,270258,0.0428859,0.02,1,165868,165443,425
26067201,7.61621,7.52001,425,270258,0.0485772,0.01,1,165876,165451,425
26069681,7.92324,7.904,425,270258,0.0497154,0.02,1,165884,165459,425
26071761,8.78465,8.7808,425,270258,0.0179431,0,1,165893,165468,425
26073841,7.35693,6.55616,426,270258,0.00358862,0.03,1,165900,165474,426
26076761,6.27139,6.11123,426,270258,0.0487177,0.04,1,165906,165480,426
26078421,10.0543,7.62225,429,270258,0.0177435,0.05,1,165917,165488,429
26081341,8.41086,10.3244,426,270258,0.0275487,0.04,1,165925,165499,426
26083621,6.48217,8.46489,424,270258,0.0295097,0.04,1,165931,165507,424
26086321,7.69643,7.29298,425,270258,0.0219019,0.03,1,165939,165514,425
26089241,19.1393,17.4586,427,270258,0.0123804,0.05,1,165961,165534,427
26092161,9.42786,9.89172,426,270258,0.0104761,0.03,1,165968,165542,426
26095061,7.48557,8.37834,425,270258,0.0100952,0.02,1,165975,165550,425
26097981,9.49711,8.07567,427,270258,0.00201904,0,1,165985,165558,427
26100881,8.29942,8.01513,427,270258,0.000403809,0.07,1,165993,165566,427
26103801,11.2599,12.003,426,270258,0.00808076,0.02,1,166005,165579,426
26106501,11.852,8.80061,430,270258,0.00161615,0.06,1,166017,165587,430
26109421,8.7704,11.3601,426,270258,0.00832323,0.04,1,166025,165599,426
26112341,7.35408,8.67202,425,270258,0.00966465,0.04,1,166032,165607,425
26114821,7.87082,8.1344,425,270258,0.0259329,0.03,1,166040,165615,425
26116901,12.7742,7.22688,432,270258,0.00518659,0,1,166054,165622,432
26119601,8.15483,12.6454,425,270258,0.0330373,0.05,1,166061,165636,425
26122521,7.23097,8.12907,425,270258,0.00660746,0.04,1,166068,165643,425
26125441,9.44619,8.02581,427,270258,0.00932149,0.03,1,166078,165651,427
26127301,9.08924,8.00516,428,270258,0.0178643,0.05,1,166087,165659,428
26129381,8.21785,10.401,425,270258,0.00357286,0.03,1,166095,165670,425
26132301,8.04357,8.48021,425,270258,0.0487146,0.03,1,166103,165678,425
26134161,7.20871,8.09604,424,270258,0.0337429,0.04,1,166110,165686,424
26137081,10.2417,8.81921,426,270258,0.0547486,0.01,1,166121,165695,426
26139781,6.84835,8.16384,424,270258,0.0509497,0.05,1,166127,165703,424
26141441,6.96967,7.23277,424,270258,0.0581899,0.05,1,166134,165710,424
26144361,7.79393,7.04655,425,270258,0.067638,0.01,1,166142,165717,425
26146021,10.3588,7.80931,428,270258,0.0455276,0.02,1,166153,165725,428
26148941,9.27176,9.56186,427,270258,0.0171055,0.06,1,166162,165735,427
26151841,7.45435,8.31237,426,270258,0.0114211,0.06,1,166169,165743,426
26154761,12.6909,12.0625,427,270258,0.0262842,0,1,166183,165756,427
26157681,8.13817,8.81249,426,270258,0.0292568,0.06,1,166190,165764,426
26160601,8.02763,8.1625,426,270258,0.0298514,0.06,1,166198,165772,426
26163521,8.00553,8.0325,426,270258,0.0219703,0.06,1,166206,165780,426
26165361,7.20111,8.0065,425,270258,0.0363941,0.03,1,166213,165788,425
26168281,6.24022,5.6013,426,270258,0.00727881,0.03,1,166219,165793,426
26170561,7.64804,7.52026,426,270258,0.00945576,0.03,1,166227,165801,426
26172641,7.92961,8.70405,425,270258,0.0178912,0.04,1,166235,165810,425
26175561,10.3859,9.74081,426,270258,0.0355782,0.01,1,166246,165820,426
26178481,7.67718,8.34816,425,270258,0.0311156,0.06,1,166253,165828,425
26180341,7.93544,8.06963,425,270258,0.0142231,0.07,1,166261,165836,425
26182421,6.38709,7.21393,424,270258,0.0108446,0.05,1,166267,165843,424
26184081,6.87742,6.24279,425,270258,0.0261689,0.04,1,166274,165849,425
26187001,10.9755,9.24856,427,270258,0.0452338,0.05,1,166286,165859,427
26189921,8.5951,8.24971,427,270258,0.0250468,0.07,1,166294,165867,427
26192841,7.31902,8.04994,426,270258,0.0450094,0.07,1,166301,165875,426
26195761,7.0638,8.00999,425,270258,0.0490019,0.04,1,166308,165883,425
26198681,9.41276,8.002,427,270258,0.0498004,0,1,166318,165891,427
26201601,7.48255,8.0004,426,270258,0.00996007,0.03,1,166325,165899,426
26204261,8.69651,8.00008,427,270258,0.00999201,0.01,1,166334,165907,427
26206961,8.1393,8.80002,426,270258,0.0179984,0.03,1,166342,165916,426
26209041,8.02786,7.36,427,270258,0.00359968,0.06,1,166350,165923,427
26211961,11.2056,11.872,426,270258,0.0487199,0.01,1,166362,165936,426
26214881,8.64111,8.7744,426,270258,0.057744,0.03,1,166370,165944,426
26217361,7.32822,8.15488,425,270258,0.0275488,0.01,1,166377,165952,425
26219441,14.2656,14.431,425,270258,0.0135098,0.01,1,166393,165968,425
26222361,12.4531,12.4862,425,270258,0.034702,0.01,1,166405,165980,425
26225281,9.69063,8.89724,426,270258,0.0309404,0.01,1,166414,165988,426
26228201,7.53812,8.17945,425,270258,0.0141881,0.04,1,166421,165996,425
26231121,8.70763,8.03589,426,270258,0.0348376,0.01,1,166430,166004,426
26234001,7.34152,8.00718,425,270258,0.0149675,0.01,1,166437,166012,425
26236921,12.6683,12.0014,426,270258,0.0269935,0.03,1,166451,166025,426
26238581,8.13366,8.80029,425,270258,0.0453987,0.06,1,166458,166033,425
26241501,8.82673,8.16006,426,270258,0.0410797,0.01,1,166467,166041,426
26244421,8.16535,8.03201,426,270258,0.040216,0.01,1,166475,166049,426
26246901,12.0331,8.0064,431,270258,0.0400432,0.05,1,166488,166057,431
26249821,9.60661,12.8013,426,270258,0.0320086,0.03,1,166497,166071,426
26252741,7.52132,8.96026,425,270258,0.0384017,0.02,1,166504,166079,425
26255661,9.50426,8.19205,427,270258,0.0236803,0,1,166514,166087,427
26257301,5.90085,8.03841,424,270258,0.00473607,0.05,1,166519,166095,424
26260221,7.58017,6.40768,426,270258,0.0169472,0.05,1,166527,166101,426
26263141,8.71603,7.68154,427,270258,0.00338944,0.09,1,166536,166109,427
26265201,8.14321,7.93631,427,270258,0.0326779,0.06,1,166544,166117,427
26267281,7.22864,6.38726,428,270258,0.0305356,0.07,1,166551,166123,428
26270201,6.24573,6.07745,428,270258,0.0141071,0.09,1,166557,166129,428
26272481,7.64915,7.61549,428,270258,0.00282142,0.07,1,166565,166137,428
26274561,10.3298,12.7231,425,270258,0.000564285,0.01,1,166576,166151,425
26276641,6.86597,7.34462,425,270258,0.00811286,0.01,1,166582,166157,425
26279561,11.7732,11.0689,426,270258,0.00162257,0,1,166595,166169,426
26282481,8.75464,8.61378,426,270258,0.0163245,0.01,1,166603,166177,426
26284961,8.15093,8.12276,426,270258,0.0112649,0.07,1,166611,166185,426
26287881,8.03019,7.22455,427,270258,0.018253,0.06,1,166619,166192,427
26290801,7.20604,7.84491,426,270258,0.0196506,0.07,1,166626,166200,426
26292661,13.4412,7.96898,433,270258,0.0199301,0.01,1,166641,166208,433
26295581,9.08824,13.5938,426,270258,0.027986,0.03,1,166649,166223,426
26298501,8.21765,9.11876,426,270258,0.0295972,0.03,1,166657,166231,426
26301421,8.84353,8.22375,427,270258,0.0139194,0.02,1,166666,166239,427
26303681,6.56871,8.04475,425,270258,0.0107839,0.03,1,166672,166247,425
26306601,7.71374,8.00895,425,270258,0.0341568,0.03,1,166680,166255,425
26309521,8.74275,8.00179,426,270258,0.0308314,0.05,1,166689,166263,426
26312421,8.94855,8.00036,427,270258,0.0541663,0.06,1,166698,166271,427
26315121,7.38971,8.00007,426,270258,0.0588333,0.02,1,166705,166279,426
26318041,14.2779,14.4,426,270258,0.0197667,0.04,1,166721,166295,426
26320961,9.25559,9.28,426,270258,0.0119533,0.07,1,166729,166303,426
26323881,7.45112,8.256,425,270258,0.0103907,0.07,1,166736,166311,425
26326801,7.89022,8.0512,425,270258,0.00207813,0.02,1,166744,166319,425
26329681,7.97804,8.01024,425,270258,0.0244156,0.03,1,166752,166327,425
26332601,11.9956,10.402,427,270258,0.0128831,0.03,1,166765,166338,427
26335521,7.99912,8.48041,426,270258,0.0105766,0.05,1,166772,166346,426
26338441,7.99982,8.09608,426,270258,0.0261153,0.06,1,166780,166354,426
26340081,7.19996,8.01922,425,270258,0.0132231,0.02,1,166787,166362,425
26343001,13.44,13.6038,425,270258,0.0106446,0.03,1,166802,166377,425
26345921,9.088,9.12077,425,270258,0.0421289,0.02,1,166810,166385,425
26348401,8.2176,8.22415,425,270258,0.0164258,0.05,1,166818,166393,425
26350481,10.4435,9.64483,426,270258,0.0192852,0.03,1,166829,166403,426
26352561,10.0887,10.729,425,270258,0.00385703,0.01,1,166839,166414,425
26355481,13.2177,12.5458,426,270258,0.0247714,0.01,1,166853,166427,426
26358401,9.84355,8.90916,427,270258,0.00495428,0.03,1,166862,166435,427
26361321,8.36871,8.18183,427,270258,0.00899086,0.03,1,166870,166443,427
26364241,8.07374,8.03637,427,270258,0.00979817,0.04,1,166878,166451,427
26367161,8.01475,8.00727,427,270258,0.0259596,0.06,1,166886,166459,427
26370081,8.80295,8.00145,428,270258,0.00519193,0.06,1,166895,166467,428
26373001,8.16059,8.00029,428,270258,0.0410384,0.05,1,166903,166475,428
26375441,6.43212,8.00006,426,270258,0.0562077,0.06,1,166909,166483,426
26377521,6.88642,7.20001,426,270258,0.0512415,0.07,1,166916,166490,426
26380441,10.1773,11.04,425,270258,0.0582483,0.04,1,166927,166502,425
26383361,10.0355,8.608,427,270258,0.0436497,0,1,166937,166510,427
26385221,4.40709,8.1216,422,270258,0.0327299,0.02,1,166940,166518,422
26387921,7.28142,5.62432,425,270258,0.022546,0.01,1,166948,166523,425
26390841,9.45628,8.32486,426,270258,0.0205092,0.03,1,166958,166532,426
26393761,8.29126,8.06497,426,270258,0.0121018,0.03,1,166966,166540,426
26395621,11.2583,8.01299,430,270258,0.0184204,0.01,1,166978,166548,430
26398541,7.85165,11.2026,425,270258,0.00368407,0.04,1,166985,166560,425
26401461,8.77033,8.64052,426,270258,0.000736815,0.01,1,166994,166568,426
26403521,7.35407,8.1281,425,270258,0.0241474,0.04,1,167001,166576,425
26406441,10.2708,9.62562,426,270258,0.0208295,0.01,1,167012,166586,426
26409141,9.25416,8.32512,427,270258,0.00416589,0.02,1,167021,166594,427
26411221,10.6508,8.86503,429,270258,0.0328332,0.06,1,167032,166603,429
26414141,9.33017,10.573,427,270258,0.0385666,0.03,1,167041,166614,427
26417061,7.46603,8.5146,426,270258,0.0157133,0.03,1,167048,166622,426
26419541,7.09321,8.10292,425,270258,0.00314267,0.03,1,167055,166630,425
26421201,7.01864,7.22058,425,270258,0.0166285,0.03,1,167062,166637,425
26423281,6.20373,5.44412,426,270258,0.0273257,0.01,1,167068,166642,426
26426201,11.6407,11.4888,426,270258,0.0374651,0.01,1,167081,166655,426
26427861,11.1281,8.69776,429,270258,0.023493,0.05,1,167092,166663,429
26430781,8.62563,10.5396,426,270258,0.0286986,0.06,1,167100,166674,426
26433701,8.92513,8.50791,427,270258,0.00573972,0.06,1,167109,166682,427
26436621,8.18503,8.10158,427,270258,0.0251479,0.08,1,167117,166690,427
26439541,7.237,8.02032,426,270258,0.0130296,0.08,1,167124,166698,426
26441381,7.0474,8.00406,425,270258,0.0266059,0.05,1,167131,166706,425
26444301,7.80948,8.00081,425,270258,0.0293212,0.05,1,167139,166714,425
26447221,7.9619,8.00016,425,270258,0.0298642,0.02,1,167147,166722,425
26449701,11.1924,8.00003,429,270258,0.0219728,0.01,1,167159,166730,429
26451361,7.03848,9.60001,425,270258,0.0283946,0.05,1,167165,166740,425
26454281,9.4077,9.12,426,270258,0.00567891,0.03,1,167175,166749,426
26457201,7.48154,8.224,425,270258,0.00913578,0.02,1,167182,166757,425
26460121,8.69631,8.0448,426,270258,0.0258272,0.03,1,167191,166765,426
26463041,8.13926,8.00896,426,270258,0.0131654,0.02,1,167199,166773,426
26465961,8.02785,8.00179,426,270258,0.0106331,0.03,1,167207,166781,426
26468881,8.80557,8.00036,427,270258,0.0421266,0.04,1,167216,166789,427
26471121,6.56111,8.00007,425,270258,0.0324253,0.07,1,167222,166797,425
26473201,10.1122,9.60001,426,270258,0.00648506,0.04,1,167233,166807,426
26476121,9.22244,8.32,427,270258,0.00929701,0.03,1,167242,166815,427
26479041,6.64449,8.064,425,270258,0.0498594,0.06,1,167248,166823,425
26481521,7.7289,8.0128,425,270258,0.0499719,0.02,1,167256,166831,425
26483601,12.7458,12.8026,425,270258,0.0179944,0.01,1,167270,166845,425
26486521,19.3492,18.5605,426,270258,0.00359887,0,1,167291,166865,426
26489441,10.2698,10.1121,426,270258,0.000719775,0.04,1,167299,166873,426
26491921,8.45397,8.42242,426,270258,0.00814395,0.05,1,167307,166881,426
26494841,8.09079,7.28448,427,270258,0.0256288,0.04,1,167315,166888,427
26497761,8.01816,7.8569,427,270258,0.0291258,0.07,1,167323,166896,427
26500681,8.00363,7.97138,427,270258,0.0138252,0.08,1,167331,166904,427
26503601,8.00073,7.99428,427,270258,0.010765,0.08,1,167339,166912,427
26506521,8.00015,7.99886,427,270258,0.010153,0.06,1,167347,166920,427
26509441,8.00003,7.99977,427,270258,0.0100306,0.05,1,167355,166928,427
26512101,6.40001,7.99995,425,270258,0.0260061,0.05,1,167361,166936,425
26513761,6.88,7.19999,425,270258,0.00520122,0.01,1,167368,166943,425
26516681,9.376,8.64,426,270258,0.00104024,0,1,167378,166952,426
26519601,9.0752,8.128,427,270258,0.016208,0.04,1,167387,166960,427
26522501,7.41504,8.0256,426,270258,0.00324161,0.03,1,167394,166968,426
26525421,7.08301,8.00512,425,270258,0.0326483,0.02,1,167401,166976,425
26527701,12.6166,8.00102,431,270258,0.0305297,0.04,1,167415,166984,431
26529361,8.12332,12.0002,425,270258,0.0381059,0.06,1,167422,166997,425
26532281,10.4247,11.2,425,270258,0.0556212,0.02,1,167433,167008,425
26535201,9.28493,8.64001,426,270258,0.0351242,0.01,1,167442,167016,426
26538101,10.657,8.128,429,270258,0.0150248,0.02,1,167453,167024,429
26541021,7.7314,9.6256,426,270258,0.00300497,0.03,1,167460,167034,426
26543301,10.3463,8.32512,429,270258,0.00860099,0,1,167471,167042,429
26546221,8.46926,10.465,426,270258,0.0097202,0.05,1,167479,167053,426
26549141,8.09385,8.493,426,270258,0.00994404,0.05,1,167487,167061,426
26552061,8.81877,8.0986,427,270258,0.0179888,0.05,1,167496,167069,427
26554321,7.36375,8.01972,426,270258,0.00359776,0.04,1,167503,167077,426
26556401,11.0728,11.2039,426,270258,0.000719552,0.02,1,167515,167089,426
26559321,12.6146,12.6408,426,270258,0.00814391,0.01,1,167528,167102,426
26561601,8.12291,8.92816,425,270258,0.0176288,0.03,1,167535,167110,425
26564521,8.02458,7.38563,426,270258,0.00352576,0.06,1,167543,167117,426
26566181,5.60492,7.87713,423,270258,0.0167052,0.04,1,167548,167125,423
26569101,7.52098,5.57543,426,270258,0.027341,0.06,1,167556,167130,426
26572021,7.9042,7.51509,426,270258,0.00546821,0.06,1,167564,167138,426
26574941,7.98084,7.90302,426,270258,0.00909364,0.06,1,167572,167146,426
26577861,7.99617,7.9806,426,270258,0.00181873,0.04,1,167580,167154,426
26579701,9.59923,7.99612,428,270258,0.0323637,0.04,1,167590,167162,428
26582401,7.51985,9.59922,425,270258,0.0304727,0.04,1,167597,167172,425
26584481,7.90397,7.51984,426,270258,0.0300945,0.06,1,167605,167179,426
26587401,9.58079,10.304,425,270258,0.0140189,0.01,1,167615,167190,425
26589061,10.7162,8.46079,428,270258,0.0268038,0.04,1,167626,167198,428
26591981,9.34323,9.69216,427,270258,0.0533608,0.05,1,167635,167208,427
26594901,7.46865,8.33843,426,270258,0.0346722,0.04,1,167642,167216,426
26597821,7.09373,8.06769,425,270258,0.0149344,0.01,1,167649,167224,425
26600741,8.61875,8.01354,426,270258,0.0109869,0.01,1,167658,167232,426
26603621,8.12375,8.00271,426,270258,0.0101974,0.06,1,167666,167240,426
26605701,10.4247,8.00054,429,270258,0.0180395,0.07,1,167677,167248,429
26608621,7.68495,10.4001,425,270258,0.0116079,0.05,1,167684,167259,425
26611541,7.93699,8.48002,425,270258,0.0343216,0.01,1,167692,167267,425
26614461,7.9874,8.096,425,270258,0.0308643,0.01,1,167700,167275,425
26616101,17.5975,8.0192,437,270258,0.0301729,0,1,167720,167283,437
26618181,11.5195,16.8038,428,270258,0.0140346,0.03,1,167730,167302,428
26621101,7.9039,11.3608,425,270258,0.00280691,0.04,1,167737,167312,425
26624021,7.98078,8.67215,425,270258,0.0245614,0.03,1,167745,167320,425
26626941,7.99616,8.13443,425,270258,0.0289123,0.01,1,167753,167328,425
26629861,7.99923,8.02689,425,270258,0.0297825,0.05,1,167761,167336,425
26632781,7.99985,8.00538,425,270258,0.0379565,0.05,1,167769,167344,425
26635701,7.99997,8.00108,425,270258,0.0235913,0.05,1,167777,167352,425
26638621,8.79999,8.00022,426,270258,0.00471826,0.04,1,167786,167360,426
26641541,8.16,8.00004,426,270258,0.00894365,0.05,1,167794,167368,426
26644461,7.232,8.00001,425,270258,0.0417887,0.06,1,167801,167376,425
26646261,10.2464,8,428,270258,0.0323577,0,1,167812,167384,428
26649181,8.44928,9.6,426,270258,0.0144715,0.01,1,167820,167394,426
26652101,8.88986,8.32,427,270258,0.00289431,0.04,1,167829,167402,427
26655021,6.57797,8.064,425,270258,0.00857886,0.05,1,167835,167410,425
26657941,9.31559,8.0128,427,270258,0.00971577,0.02,1,167845,167418,427
26660401,6.66312,8.00256,425,270258,0.0179432,0.05,1,167851,167426,425
26662481,8.53262,8.80051,425,270258,0.00358863,0.02,1,167860,167435,425
26665401,12.1065,12.1601,425,270258,0.00871773,0.01,1,167873,167448,425
26668321,8.82131,8.83202,425,270258,0.00974355,0.03,1,167881,167456,425
26670181,8.16426,8.1664,425,270258,0.00194871,0.03,1,167889,167464,425
26671841,7.23285,8.03328,424,270258,0.0163897,0.01,1,167896,167472,424
26673921,7.84657,7.20666,425,270258,0.0192779,0,1,167904,167479,425
26676841,14.3693,13.4413,426,270258,0.0118556,0.03,1,167920,167494,426
26679761,8.47386,9.08827,425,270258,0.0423711,0.03,1,167927,167502,425
26682681,8.89477,8.21765,426,270258,0.0164742,0.01,1,167936,167510,426
26685601,8.97895,8.04353,427,270258,0.00329484,0.02,1,167945,167518,427
26687441,6.59579,8.00871,425,270258,0.024659,0.06,1,167951,167526,425
26689521,7.71916,7.20174,426,270258,0.0369318,0.04,1,167959,167533,426
26692441,12.7438,11.8403,427,270258,0.00738636,0.01,1,167973,167546,427
26695361,8.94877,8.76807,427,270258,0.00147727,0.04,1,167981,167554,427
26698281,8.18975,8.15361,427,270258,0.0322955,0.06,1,167989,167562,427
26701201,8.03795,8.03072,427,270258,0.0304591,0.04,1,167997,167570,427
26704121,7.20759,8.00614,426,270258,0.0140918,0.04,1,168004,167578,426
26707041,7.84152,8.00123,426,270258,0.0108184,0.04,1,168012,167586,426
26709961,7.9683,8.00025,426,270258,0.0261637,0.04,1,168020,167594,426
26711781,7.19366,8.00005,425,270258,0.0132327,0.05,1,168027,167602,425
26714701,7.83873,7.20001,426,270258,0.0106465,0.05,1,168035,167609,426
26717601,7.16775,7.84,425,270258,0.0101293,0.06,1,168042,167617,425
26720521,17.4335,15.968,427,270258,0.0180259,0.03,1,168062,167635,427
26723441,8.28671,9.5936,425,270258,0.0356052,0.05,1,168068,167643,425
26726361,8.05734,8.31872,425,270258,0.047121,0,1,168076,167651,425
26728001,7.21147,8.06374,424,270258,0.0654242,0.01,1,168083,167659,424
26730921,7.84229,6.41275,426,270258,0.0450848,0,1,168091,167665,426
26732581,8.76846,7.68255,427,270258,0.00901697,0.04,1,168100,167673,427
26735501,8.15369,9.53651,425,270258,0.00180339,0.05,1,168108,167683,425
26738421,8.03074,8.3073,425,270258,0.0483607,0.04,1,168116,167691,425
26741341,8.00615,8.06146,425,270258,0.0336721,0.05,1,168124,167699,425
26744261,8.00123,8.01229,425,270258,0.0147344,0.03,1,168132,167707,425
26746101,11.2002,8.00246,429,270258,0.00294689,0.02,1,168144,167715,429
26748181,9.44005,10.4005,427,270258,0.000589377,0.02,1,168153,167726,427
26750261,9.88801,10.0801,427,270258,0.0241179,0.05,1,168163,167736,427
26751921,6.7776,9.21602,424,270258,0.0128236,0.05,1,168169,167745,424
26754841,6.95552,5.8432,426,270258,0.00256471,0.04,1,168176,167750,426
26757121,8.5911,7.56864,427,270258,0.00851294,0.06,1,168185,167758,427
26760041,8.91822,9.51373,426,270258,0.00970259,0.03,1,168194,167768,426
26762961,8.98364,8.30275,427,270258,0.0419405,0.05,1,168203,167776,427
26765881,8.19673,8.06055,427,270258,0.0323881,0.06,1,168211,167784,427
26768801,8.03935,8.01211,427,270258,0.0544776,0.06,1,168219,167792,427
26771061,5.60787,8.00242,424,270258,0.0428955,0.07,1,168224,167800,424
26773981,7.52157,6.40048,426,270258,0.0405791,0.04,1,168232,167806,426
26776261,5.50431,7.6801,423,270258,0.0161158,0.05,1,168237,167814,423
26778341,13.1009,6.33602,432,270258,0.0112232,0.01,1,168252,167820,432
26780001,8.22017,11.6672,426,270258,0.0102446,0.01,1,168259,167833,426
26782921,5.64403,6.33344,426,270258,0.0100489,0.03,1,168264,167838,426
26785201,6.72881,7.66669,425,270258,0.0100098,0.04,1,168271,167846,425
26788121,9.34576,8.73334,426,270258,0.010002,0.01,1,168281,167855,426
26791041,7.46915,8.14667,425,270258,0.0100004,0.04,1,168288,167863,425
26793521,7.89383,8.02933,425,270258,0.0340001,0.01,1,168296,167871,425
26795601,9.57877,9.60587,425,270258,0.0228,0.05,1,168306,167881,425
26798521,10.7158,9.92117,426,270258,0.01256,0.03,1,168317,167891,426
26801441,9.34315,8.38423,427,270258,0.010512,0.03,1,168326,167899,427
26804341,11.4686,8.07685,431,270258,0.0261024,0.02,1,168338,167907,431
26806421,9.49373,11.2154,428,270258,0.0292205,0.07,1,168347,167919,428
26808501,13.8987,11.0431,432,270258,0.0218441,0,1,168362,167930,432
26811421,9.17975,13.4086,426,270258,0.00436882,0.05,1,168370,167944,426
26814341,9.03595,9.08172,427,270258,0.0328738,0.02,1,168379,167952,427
26817261,6.60719,8.21634,425,270258,0.0305748,0.03,1,168385,167960,425
26820181,7.72144,8.04327,425,270258,0.022115,0.01,1,168393,167968,425
26822021,6.34429,8.00865,423,270258,0.012423,0.01,1,168399,167976,423
26824101,6.86886,5.60173,425,270258,0.0024846,0.03,1,168406,167981,425
26825761,6.97377,5.92035,426,270258,0.000496919,0.05,1,168413,167987,426
26828681,6.99475,6.78407,426,270258,0.0160994,0.04,1,168420,167994,426
26830341,9.39895,7.75681,428,270258,0.00321988,0.01,1,168430,168002,428
26833261,6.67979,8.75136,425,270258,0.016644,0.04,1,168436,168011,425
26836181,7.73596,8.15027,425,270258,0.0193288,0.03,1,168444,168019,425
26839101,7.94719,8.03005,425,270258,0.0198658,0.03,1,168452,168027,425
26842021,7.98944,8.00601,425,270258,0.0119732,0.03,1,168460,168035,425
26843861,11.1979,8.0012,429,270258,0.0103946,0.03,1,168472,168043,429
26846781,7.83958,9.60024,426,270258,0.0180789,0.03,1,168479,168053,426
26849701,8.76792,8.32005,427,270258,0.0116158,0.01,1,168488,168061,427
26852181,8.15358,8.06401,427,270258,0.00232316,0.05,1,168496,168069,427
26853841,7.23072,7.2128,427,270258,0.0244646,0.07,1,168503,168076,427
26856761,6.24614,7.04256,426,270258,0.0288929,0.04,1,168509,168083,426
26859041,7.64923,7.80851,426,270258,0.0617786,0.02,1,168517,168091,426
26861961,11.9298,11.9617,426,270258,0.100356,0.02,1,168530,168104,426
26864881,7.98597,8.79234,425,270258,0.0520711,0.05,1,168537,168112,425
26867801,7.99719,8.15847,425,270258,0.0344142,0.03,1,168545,168120,425
26869441,7.99944,8.03169,425,270258,0.0468828,0.01,1,168553,168128,425
26872361,8.79989,7.20634,427,270258,0.00937657,0.02,1,168562,168135,427
26875281,8.15998,7.84127,427,270258,0.0338753,0.04,1,168570,168143,427
26878181,7.232,7.96825,426,270258,0.0387751,0.03,1,168577,168151,426
26880261,9.4464,7.99365,428,270258,0.015755,0.02,1,168587,168159,428
26882341,7.48928,10.3987,424,270258,0.011151,0.02,1,168594,168170,424
26884421,8.69786,6.87975,427,270258,0.0102302,0.04,1,168603,168176,427
26886501,8.13957,9.37595,425,270258,0.026046,0.01,1,168611,168186,425
26889421,8.02791,6.67519,427,270258,0.0212092,0.04,1,168619,168192,427
26891701,10.4056,7.73504,430,270258,0.00424184,0.03,1,168630,168200,430
26894621,7.68112,10.347,426,270258,0.0248484,0.06,1,168637,168211,426
26896481,7.93622,8.4694,426,270258,0.0289697,0.09,1,168645,168219,426
26899401,8.78724,9.69388,425,270258,0.00579393,0.05,1,168654,168229,425
26902321,8.15745,8.33878,425,270258,0.00915879,0.05,1,168662,168237,425
26905241,8.03149,8.06776,425,270258,0.00983176,0.04,1,168670,168245,425
26908161,8.8063,8.01355,426,270258,0.0499664,0.02,1,168679,168253,426
26910421,7.36126,8.00271,425,270258,0.0179933,0.03,1,168686,168261,425
26912501,7.87225,6.40054,427,270258,0.0115987,0.03,1,168694,168267,427
26915421,7.97445,8.48011,426,270258,0.00231973,0.06,1,168702,168276,426
26918321,7.19489,8.09602,425,270258,0.00846395,0.05,1,168709,168284,425
26921241,10.239,10.4192,425,270258,0.00169279,0.05,1,168720,168295,425
26922901,6.8478,8.48384,423,270258,0.000338558,0.03,1,168726,168303,423
26925821,8.56956,5.69677,427,270258,0.0240677,0.04,1,168735,168308,427
26928101,8.91391,7.53935,428,270258,0.0608135,0.05,1,168744,168316,428
26930181,10.5828,9.50787,429,270258,0.0281627,0.04,1,168755,168326,429
26933101,7.71656,10.7016,425,270258,0.00563254,0.03,1,168762,168337,425
26934961,7.14331,8.54031,424,270258,0.0171265,0.02,1,168769,168345,424
26937041,7.02866,5.70806,426,270258,0.0274253,0.02,1,168776,168350,426
26939121,13.4057,12.3416,427,270258,0.0134851,0.03,1,168791,168364,427
26942041,10.6811,10.4683,427,270258,0.00269701,0.05,1,168801,168374,427
26943701,5.33623,8.49366,423,270258,0.0085394,0.02,1,168805,168382,423
26946621,7.46725,5.69873,426,270258,0.00170788,0.03,1,168813,168387,426
26948901,5.49345,7.53975,423,270258,0.00834158,0.04,1,168818,168395,423
26950561,7.49869,6.30795,425,270258,0.00966831,0.03,1,168826,168401,425
26953481,9.49974,9.26159,425,270258,0.0259337,0.03,1,168836,168411,425
26956181,11.4999,8.25232,429,270258,0.0291867,0.03,1,168848,168419,429
26958881,8.69999,11.2505,425,270258,0.0218373,0.03,1,168856,168431,425
26961801,11.34,11.8501,425,270258,0.00436747,0.03,1,168868,168443,425
26964721,9.468,8.77002,426,270258,0.0408735,0.02,1,168877,168451,426
26967641,8.2936,8.154,426,270258,0.0481747,0.04,1,168885,168459,426
26969281,6.45872,8.0308,424,270258,0.0496349,0.04,1,168891,168467,424
26972201,9.29174,8.00616,426,270258,0.049927,0.01,1,168901,168475,426
26975121,8.25835,8.00123,426,270258,0.0499854,0.03,1,168909,168483,426
26977601,8.05167,8.00025,426,270258,0.0499971,0.05,1,168917,168491,426
26980521,8.01033,7.20005,427,270258,0.0499994,0.02,1,168925,168498,427
26983441,8.80207,7.84001,428,270258,0.0339999,0.05,1,168934,168506,428
26986341,9.76041,7.968,430,270258,0.0148,0.07,1,168944,168514,430
26988421,8.35208,7.9936,430,270258,0.04296,0.1,1,168952,168522,430
26991341,8.87042,11.1987,427,270258,0.008592,0.02,1,168961,168534,427
26993621,8.17408,8.63974,427,270258,0.0177184,0.03,1,168969,168542,427
26996541,8.03482,8.12795,427,270258,0.0195437,0.02,1,168977,168550,427
26999461,8.00696,8.02559,427,270258,0.0279087,0.05,1,168985,168558,427
27001941,10.4014,8.00512,430,270258,0.0375817,0.03,1,168996,168566,430
27004861,7.68028,11.201,425,270258,0.0155163,0.03,1,169003,168578,425
27007781,8.73606,8.6402,426,270258,0.0191033,0.03,1,169012,168586,426
27010261,9.74721,8.12804,428,270258,0.0278207,0.01,1,169022,168594,428
27013181,8.34944,9.62561,426,270258,0.0135641,0.04,1,169030,168604,426
27016101,8.86989,8.32512,427,270258,0.0267128,0.02,1,169039,168612,427
27018581,6.57398,8.06502,425,270258,0.0293426,0.05,1,169045,168620,425
27020241,6.1148,7.213,424,270258,0.00586851,0.07,1,169051,168627,424
27022321,8.42296,7.0426,426,270258,0.0091737,0.06,1,169060,168634,426
27025241,10.4846,9.40852,427,270258,0.00183474,0.04,1,169071,168644,427
27026901,8.49692,8.2817,427,270258,0.00836695,0.06,1,169079,168652,427
27029821,8.09938,8.05634,427,270258,0.0256734,0.06,1,169087,168660,427
27032741,8.01988,8.01127,427,270258,0.0131347,0.06,1,169095,168668,427
27035661,8.00398,8.00225,427,270258,0.0106269,0.05,1,169103,168676,427
27038581,8.0008,8.00045,427,270258,0.0421254,0.06,1,169111,168684,427
27040421,4.80016,8.00009,423,270258,0.0484251,0.05,1,169115,168692,423
27042501,4.96003,5.60002,423,270258,0.041685,0.05,1,169120,168697,423
27044581,12.192,5.92,431,270258,0.024337,0.04,1,169134,168703,431
27047501,8.8384,11.584,426,270258,0.0048674,0.05,1,169142,168716,426
27050421,8.96768,8.7168,427,270258,0.00897348,0.04,1,169151,168724,427
27053341,8.19354,8.14336,427,270258,0.0097947,0.06,1,169159,168732,427
27054981,7.23871,8.02867,426,270258,0.00995894,0.05,1,169166,168740,426
27057901,7.04774,8.00573,425,270258,0.0259918,0.05,1,169173,168748,425
27060181,10.2095,8.00115,428,270258,0.0211984,0,1,169184,168756,428
27062261,12.4419,9.60023,431,270258,0.0202397,0.04,1,169197,168766,431
27065181,8.08838,12.32,425,270258,0.0120479,0.05,1,169204,168779,425
27068081,8.01768,8.86401,425,270258,0.0104096,0.01,1,169212,168787,425
27070161,8.00354,8.1728,425,270258,0.00208192,0.03,1,169220,168795,425
27073081,8.80071,8.83456,425,270258,0.000416383,0.02,1,169229,168804,425
27075781,12.9601,8.16691,431,270258,0.0320833,0.03,1,169243,168812,431
27078701,8.99203,12.0334,426,270258,0.0224167,0.05,1,169251,168825,426
27081621,8.19841,8.80668,426,270258,0.00448333,0.01,1,169259,168833,426
27083681,7.23968,8.16134,425,270258,0.0408967,0.02,1,169266,168841,425
27086601,13.4479,13.6323,425,270258,0.0161793,0.05,1,169281,168856,425
27088261,13.0896,9.12645,430,270258,0.0192359,0.04,1,169294,168864,430
27091181,9.01792,10.6253,427,270258,0.0438472,0.05,1,169302,168875,427
27094101,8.20358,8.52506,427,270258,0.0327694,0.05,1,169310,168883,427
27097021,8.04072,8.10501,427,270258,0.0145539,0.04,1,169318,168891,427
27099701,8.00814,8.021,427,270258,0.0429108,0.06,1,169326,168899,427
27101781,8.00163,7.2042,428,270258,0.0485822,0.05,1,169334,168906,428
27104701,7.20033,8.64084,426,270258,0.0257164,0.06,1,169341,168915,426
27107621,7.84007,8.12817,426,270258,0.0371433,0.01,1,169349,168923,426
27110541,7.96801,8.02563,426,270258,0.0234287,0.03,1,169357,168931,426
27113461,8.7936,8.00513,427,270258,0.00468573,0.04,1,169366,168939,427
27115301,12.1587,8.00103,432,270258,0.0409371,0,1,169379,168947,432
27118221,8.83174,12.8002,426,270258,0.0561874,0.04,1,169387,168961,426
27120501,8.96635,8.96004,427,270258,0.0352375,0.04,1,169396,168969,427
27123421,8.19327,8.19201,427,270258,0.0070475,0.05,1,169404,168977,427
27125701,8.83865,8.0384,428,270258,0.0414095,0.05,1,169413,168985,428
27128621,8.96773,10.4077,426,270258,0.0562819,0.01,1,169422,168996,426
27131541,8.19355,8.48154,426,270258,0.0512564,0.02,1,169430,169004,426
27134461,7.23871,8.09631,425,270258,0.0342513,0.04,1,169437,169012,425
27137141,7.84774,8.01926,425,270258,0.0148503,0.03,1,169445,169020,425
27140061,8.76955,7.20385,427,270258,0.0429701,0.06,1,169454,169027,427
27142341,9.75391,7.84077,429,270258,0.024594,0.06,1,169464,169035,429
27145261,6.75078,9.56815,425,270258,0.0129188,0.04,1,169470,169045,425
27148181,8.55016,8.31363,426,270258,0.0265838,0.02,1,169479,169053,426
27151101,8.91003,8.06273,427,270258,0.0453168,0.03,1,169488,169061,427
27152741,8.98201,8.01255,428,270258,0.0170633,0.05,1,169497,169069,428
27155441,8.1964,8.80251,427,270258,0.0274127,0.05,1,169505,169078,427
27158361,7.23928,7.3605,427,270258,0.0134825,0.03,1,169512,169085,427
27160641,6.24786,7.8721,425,270258,0.0426965,0.06,1,169518,169093,425
27163561,7.64957,6.37442,427,270258,0.0325393,0.06,1,169526,169099,427
27165221,9.52991,7.67488,429,270258,0.0305079,0.05,1,169536,169107,429
27168141,8.30598,10.335,426,270258,0.0301016,0.03,1,169544,169118,426
27171061,7.2612,8.467,425,270258,0.0300203,0.04,1,169551,169126,425
27173981,8.65224,8.0934,426,270258,0.00600406,0,1,169560,169134,426
27176661,11.3304,8.01868,430,270258,0.00920081,0.02,1,169572,169142,430
27179581,7.86609,11.2037,425,270258,0.0658402,0.02,1,169579,169154,425
27181441,7.17322,8.64075,424,270258,0.077168,0.03,1,169586,169162,424
27184361,9.43464,8.12815,426,270258,0.0314336,0.03,1,169596,169170,426
27187281,8.28693,8.02563,426,270258,0.00628672,0.05,1,169604,169178,426
27190201,8.05739,8.00513,426,270258,0.0172573,0.05,1,169612,169186,426
27192261,7.21148,8.00103,425,270258,0.0274515,0.02,1,169619,169194,425
27194341,9.4423,8.00021,427,270258,0.0294903,0.04,1,169629,169202,427
27196001,8.28846,8.80004,426,270258,0.0378981,0.03,1,169637,169211,426
27198921,8.85769,8.16001,427,270258,0.0395796,0.05,1,169646,169219,427
27201841,8.17154,8.032,427,270258,0.0239159,0.04,1,169654,169227,427
27204741,20.8343,8.0064,443,270258,0.0287832,0,1,169678,169235,443
27207661,10.5669,20.8013,427,270258,0.00575664,0.04,1,169686,169259,427
27210581,8.51337,10.5603,427,270258,0.0171513,0.04,1,169694,169267,427
27213501,6.50267,8.51205,425,270258,0.0114303,0.03,1,169700,169275,425
27216181,8.50054,8.10241,426,270258,0.0102861,0.01,1,169709,169283,426
27218261,8.90011,7.22048,428,270258,0.00205721,0.06,1,169718,169290,428
27220341,13.78,10.2441,432,270258,0.0164114,0.01,1,169733,169301,432
27223261,9.156,13.2488,426,270258,0.0352823,0.07,1,169741,169315,426
27226181,7.4312,9.04976,425,270258,0.0150565,0.07,1,169748,169323,425
27228661,7.88624,8.20995,425,270258,0.0110113,0.01,1,169756,169331,425
27231581,7.97725,7.24199,426,270258,0.0102023,0.03,1,169764,169338,426
27233861,7.19545,7.8484,425,270258,0.0260405,0.04,1,169771,169346,425
27236781,8.63909,6.36968,428,270258,0.0132081,0.06,1,169780,169352,428
27239701,7.32782,7.67394,427,270258,0.0266416,0.06,1,169787,169360,427
27242621,7.86556,7.93479,427,270258,0.0293283,0.04,1,169795,169368,427
27245301,6.37311,7.98696,425,270258,0.0298657,0.05,1,169801,169376,425
27247381,15.6746,7.19739,436,270258,0.0299731,0.02,1,169819,169383,436
27250301,9.53492,15.8395,426,270258,0.00599463,0.04,1,169827,169401,426
27252581,7.50698,9.5679,425,270258,0.00919893,0.05,1,169834,169409,425
27254241,7.1014,6.71358,426,270258,0.0258398,0.05,1,169841,169415,426
27256321,4.62028,5.34272,425,270258,0.029168,0.02,1,169845,169420,425
27259241,6.52406,5.86854,426,270258,0.00583359,0.02,1,169852,169426,426
27260901,5.30481,7.57371,423,270258,0.0251667,0.03,1,169857,169434,423
27263821,8.26096,5.51474,427,270258,0.00503334,0.02,1,169866,169439,427
27266101,12.0522,7.50295,432,270258,0.0250067,0.03,1,169879,169447,432
27269021,7.21044,11.9006,425,270258,0.0210013,0.06,1,169885,169460,425
27271941,9.44209,8.78012,427,270258,0.0362003,0.03,1,169895,169468,427
27274861,8.28842,8.15602,427,270258,0.0392401,0.04,1,169903,169476,427
27277541,5.65768,8.0312,424,270258,0.063848,0.04,1,169908,169484,424
27280461,8.33154,7.20624,426,270258,0.0607696,0.03,1,169917,169491,426
27282741,12.0663,7.84125,431,270258,0.0201539,0.02,1,169930,169499,431
27285661,8.01326,11.1682,426,270258,0.0120308,0.05,1,169937,169511,426
27287941,6.40265,8.63365,424,270258,0.0104062,0.06,1,169943,169519,424
27290861,7.68053,6.52673,426,270258,0.0260812,0.05,1,169951,169525,426
27293761,7.93611,7.70535,426,270258,0.0292162,0.05,1,169959,169533,426
27295841,7.98722,7.94107,426,270258,0.0138432,0.03,1,169967,169541,426
27298761,11.1974,10.3882,427,270258,0.0107686,0,1,169979,169552,427
27301681,9.43949,8.47764,428,270258,0.0101537,0.04,1,169988,169560,428
27304161,8.2879,8.09553,428,270258,0.0260307,0.08,1,169996,169568,428
27307081,8.05758,7.21911,429,270258,0.0132061,0.06,1,170004,169575,429
27310001,5.61152,7.84382,426,270258,0.00264123,0.05,1,170009,169583,426
27311861,6.7223,7.96876,425,270258,0.0405282,0.04,1,170016,169591,425
27313941,14.1445,7.19375,434,270258,0.0721057,0.03,1,170032,169598,434
27316861,9.22889,14.2388,426,270258,0.0224211,0.04,1,170040,169614,426
27319781,9.04578,9.24775,427,270258,0.0204842,0.05,1,170049,169622,427
27322701,9.00916,8.24955,428,270258,0.0120968,0.05,1,170058,169630,428
27325621,6.60183,8.04991,426,270258,0.00241937,0.04,1,170064,169638,426
27328501,8.52037,8.00998,427,270258,0.00848387,0.02,1,170073,169646,427
27330581,9.70407,8.002,429,270258,0.0256968,0,1,170083,169654,429
27332241,7.54081,10.4004,425,270258,0.00513936,0,1,170090,169665,425
27335161,19.1082,18.8801,426,270258,0.00902787,0.04,1,170112,169686,426
27336821,8.62163,10.176,424,270258,0.00180557,0.03,1,170118,169694,424
27339741,8.92433,7.6352,426,270258,0.00836112,0.01,1,170127,169701,426
27342661,8.18487,7.92704,426,270258,0.00167222,0.02,1,170135,169709,426
27345581,8.03697,7.98541,426,270258,0.000334445,0.02,1,170143,169717,426
27348501,8.00739,7.99708,426,270258,0.0160669,0.04,1,170151,169725,426
27350961,7.20148,7.99942,425,270258,0.00321338,0.05,1,170158,169733,425
27353881,11.0403,10.3999,426,270258,0.00864268,0.02,1,170170,169744,426
27356801,9.40806,8.47998,427,270258,0.0257285,0.02,1,170179,169752,427
27358661,9.88161,8.096,429,270258,0.0291457,0.04,1,170189,169760,429
27361581,7.57632,9.6192,426,270258,0.0138291,0.06,1,170196,169770,426
27364501,7.91526,8.32384,426,270258,0.0267658,0.06,1,170204,169778,426
27367421,7.98305,8.06477,426,270258,0.0133532,0.06,1,170212,169786,426
27370341,7.99661,8.01295,426,270258,0.00267063,0.05,1,170220,169794,426
27372801,7.99932,8.00259,426,270258,0.00853413,0.03,1,170228,169802,426
27375721,7.19986,7.20052,426,270258,0.00970683,0.04,1,170235,169809,426
27377381,7.83997,7.8401,426,270258,0.00994137,0.04,1,170243,169817,426
27379461,6.36799,7.96802,424,270258,0.0259883,0.05,1,170249,169825,424
27381121,6.8736,6.3936,425,270258,0.0131977,0.04,1,170256,169831,425
27383201,5.37472,5.27872,425,270258,0.0266395,0,1,170261,169836,425
27386121,13.8749,13.8557,425,270258,0.0453279,0.03,1,170277,169852,425
27389041,9.17499,9.17115,425,270258,0.0250656,0.03,1,170285,169860,425
27391961,9.035,8.23423,426,270258,0.0130131,0.03,1,170294,169868,426
27394641,9.007,8.04685,427,270258,0.0266026,0.02,1,170303,169876,427
27396721,9.0014,8.80937,427,270258,0.0293205,0.03,1,170312,169885,427
27399641,7.40028,6.56187,428,270258,0.0298641,0.07,1,170319,169891,428
27401301,7.08006,7.71237,427,270258,0.00597282,0.07,1,170326,169899,427
27404221,7.01601,7.14247,427,270258,0.00919456,0.06,1,170333,169906,427
27407141,6.2032,7.82849,425,270258,0.0418389,0.03,1,170339,169914,425
27409621,7.64064,7.9657,425,270258,0.0323678,0.03,1,170347,169922,425
27412541,7.12813,7.19314,425,270258,0.0224736,0.03,1,170354,169929,425
27414821,7.82563,7.83863,425,270258,0.0204947,0.03,1,170362,169937,425
27416481,5.56513,6.36773,424,270258,0.0120989,0.03,1,170367,169943,424
27418561,8.31303,7.67355,425,270258,0.0104198,0.02,1,170376,169951,425
27421481,11.2626,11.1347,425,270258,0.018084,0.01,1,170388,169963,425
27424401,8.65252,8.62694,425,270258,0.0276168,0.03,1,170396,169971,425
27427321,9.7305,8.12539,427,270258,0.0215234,0.03,1,170406,169979,427
27430241,7.5461,8.02508,426,270258,0.0123047,0.04,1,170413,169987,426
27433161,8.70922,8.00502,427,270258,0.00246093,0.04,1,170422,169995,427
27435201,6.54184,8.001,425,270258,0.0164922,0.05,1,170428,170003,425
27438121,7.70837,6.4002,427,270258,0.0112984,0.06,1,170436,170009,427
27440401,9.54167,7.68004,429,270258,0.0102597,0.09,1,170446,170017,429
27442481,10.7083,12.736,426,270258,0.0100519,0.04,1,170457,170031,426
27445401,10.1417,11.3472,425,270258,0.0420104,0.04,1,170467,170042,425
27448321,8.42833,8.66944,425,270258,0.0324021,0.03,1,170475,170050,425
27451241,8.08567,8.13389,425,270258,0.0144804,0.04,1,170483,170058,425
27452881,7.21713,8.02678,424,270258,0.0348961,0.06,1,170490,170066,424
27455801,11.0434,10.4054,425,270258,0.0309792,0.01,1,170502,170077,425
27458721,8.60869,8.48107,425,270258,0.0301958,0.01,1,170510,170085,425
27461641,8.12174,8.09621,425,270258,0.0220392,0.03,1,170518,170093,425
27463281,7.22435,8.01924,424,270258,0.0204078,0.02,1,170525,170101,424
27465361,14.2449,13.6038,425,270258,0.0120816,0.01,1,170541,170116,425
27467441,11.649,10.7208,426,270258,0.00241631,0.02,1,170552,170126,426
27470361,12.7298,11.7442,427,270258,0.00848326,0.01,1,170565,170138,427
27473281,8.14596,8.74883,426,270258,0.00169665,0.03,1,170572,170146,426
27475761,7.22919,8.14977,425,270258,0.00033933,0.04,1,170579,170154,425
27478681,7.84584,7.22995,426,270258,6.78661e-05,0.02,1,170587,170161,426
27481601,7.96917,7.84599,426,270258,0.0320136,0.04,1,170595,170169,426
27484081,7.99383,7.9692,426,270258,0.0224027,0.03,1,170603,170177,426
27487001,12.7988,13.5938,425,270258,0.0124805,0.03,1,170617,170192,425
27489281,8.95975,9.11877,425,270258,0.0344961,0.03,1,170625,170200,425
27492201,7.39195,6.62375,426,270258,0.0628992,0.03,1,170632,170206,426
27495121,7.87839,7.72475,426,270258,0.0205798,0.04,1,170640,170214,426
27498041,7.97568,7.94495,426,270258,0.00411597,0.04,1,170648,170222,426
27500961,7.19514,7.98899,425,270258,0.0408232,0.03,1,170655,170230,425
27503841,8.63903,7.9978,426,270258,0.0401646,0.03,1,170664,170238,426
27506761,8.12781,7.99956,426,270258,0.0400329,0.03,1,170672,170246,426
27509461,9.62556,7.99991,428,270258,0.0240066,0.04,1,170682,170254,428
27512161,8.32511,9.59998,426,270258,0.0128013,0.02,1,170690,170264,426
27514241,8.86502,9.12,426,270258,0.0105603,0.02,1,170699,170273,426
27517161,13.773,13.824,426,270258,0.0421121,0.01,1,170714,170288,426
27519441,9.9546,9.1648,427,270258,0.0244224,0.05,1,170723,170296,427
27522361,5.99092,6.63296,426,270258,0.00488448,0.04,1,170728,170302,426
27524021,9.99818,7.72659,429,270258,0.0249769,0.02,1,170739,170310,429
27526941,9.19964,10.3453,427,270258,0.0129954,0.03,1,170748,170321,427
27529861,8.23993,8.46906,427,270258,0.0105991,0.04,1,170756,170329,427
27532781,6.44799,8.09381,425,270258,0.0421198,0.05,1,170762,170337,425
27535701,7.6896,8.01876,425,270258,0.032424,0.03,1,170770,170345,425
27538621,7.93792,8.00375,425,270258,0.0464848,0.03,1,170778,170353,425
27541541,7.98758,8.00075,425,270258,0.049297,0.04,1,170786,170361,425
27544461,8.79752,8.00015,426,270258,0.0738594,0.03,1,170795,170369,426
27546901,7.3595,8.00003,425,270258,0.0227719,0.05,1,170802,170377,425
27549601,7.8719,7.20001,426,270258,0.0285544,0.05,1,170810,170384,426
27551681,6.37438,7.04,425,270258,0.00571087,0.04,1,170816,170391,425
27554601,10.0749,10.208,425,270258,0.00914218,0.03,1,170827,170402,425
27556261,8.41498,8.4416,425,270258,0.00982844,0.03,1,170835,170410,425
27559181,7.28299,7.28832,425,270258,0.00996569,0.02,1,170842,170417,425
27561041,7.0566,7.85766,424,270258,0.0179931,0.01,1,170849,170425,424
27563961,11.8113,10.3715,426,270258,0.0275986,0.01,1,170862,170436,426
27566881,8.76226,8.47431,426,270258,0.0135197,0.03,1,170870,170444,426
27569801,8.95245,8.09486,427,270258,0.00270395,0.04,1,170879,170452,427
27572721,7.39049,8.01897,426,270258,0.0245408,0.06,1,170886,170460,426
27574981,9.4781,8.00379,428,270258,0.0129082,0.05,1,170896,170468,428
27577061,12.2956,9.60076,431,270258,0.0265816,0.04,1,170909,170478,431
27579981,8.85912,11.5202,427,270258,0.0373163,0.06,1,170917,170490,427
27582901,8.17182,8.70403,427,270258,0.0154633,0.07,1,170925,170498,427
27585381,8.03436,8.14081,427,270258,0.0510927,0.05,1,170933,170506,427
27587461,6.40687,8.02816,425,270258,0.0262185,0.06,1,170939,170514,425
27590381,6.08137,6.40563,425,270258,0.0372437,0.05,1,170945,170520,425
27593301,8.41628,7.68113,426,270258,0.0474487,0,1,170954,170528,426
27595781,12.8833,7.93623,432,270258,0.0254897,0.03,1,170968,170536,432
27597861,16.1767,12.7872,435,270258,0.0210979,0.01,1,170985,170550,435
27599941,12.0353,16.9574,428,270258,0.00421959,0.02,1,170996,170568,428
27602861,9.60707,12.1915,426,270258,0.0248439,0.01,1,171005,170579,426
27605141,7.52141,8.8383,425,270258,0.0369688,0.04,1,171012,170587,425
27608061,7.90428,6.56766,427,270258,0.0553938,0.05,1,171020,170593,427
27610341,4.78086,7.71353,423,270258,0.0590787,0.05,1,171024,170601,423
27612001,7.35617,6.34271,425,270258,0.0358158,0.01,1,171032,170607,425
27614921,9.47123,6.86854,428,270258,0.0151631,0.05,1,171042,170614,428
27616581,9.89425,7.77371,430,270258,0.0110326,0.06,1,171052,170622,430
27619501,7.57885,11.1547,425,270258,0.0102065,0.04,1,171059,170634,425
27621781,7.91577,8.63095,425,270258,0.0020413,0.01,1,171067,170642,425
27624701,7.98315,6.52619,427,270258,0.000408261,0.03,1,171075,170648,427
27627621,7.99663,7.70524,427,270258,8.16522e-05,0.04,1,171083,170656,427
27630541,7.19933,7.94105,426,270258,0.0480163,0.04,1,171090,170664,426
27633221,8.63987,7.98821,427,270258,0.0176033,0.04,1,171099,170672,427
27636141,7.32797,8.79764,425,270258,0.0195207,0.03,1,171106,170681,425
27638421,7.06559,8.15953,424,270258,0.0119041,0.04,1,171113,170689,424
27641341,8.61312,6.43191,427,270258,0.0103808,0.01,1,171122,170695,427
27644261,8.12262,7.68638,427,270258,0.00207617,0.04,1,171130,170703,427
27646741,14.4245,7.93728,435,270258,0.0244152,0.04,1,171146,170711,435
27649661,10.0849,15.9875,426,270258,0.044883,0.06,1,171155,170729,426
27652561,7.61698,9.59749,425,270258,0.0169766,0.05,1,171162,170737,425
27654641,7.9234,8.3195,425,270258,0.0113953,0.03,1,171170,170745,425
27657561,7.98468,6.4639,427,270258,0.0342791,0,1,171178,170751,427
27659221,5.59694,7.69278,424,270258,0.00685581,0.05,1,171183,170759,424
27662141,9.11939,7.13856,427,270258,0.0253712,0.03,1,171193,170766,427
27664421,8.22388,7.82771,427,270258,0.0290742,0.06,1,171201,170774,427
27666081,7.24478,6.36554,428,270258,0.0298148,0.1,1,171208,170780,428
27669001,7.84896,9.27311,426,270258,0.021963,0.07,1,171216,170790,426
27671921,7.16979,8.25462,425,270258,0.0443926,0.06,1,171223,170798,425
27674841,7.83396,8.05092,425,270258,0.0488785,0,1,171231,170806,425
27677521,7.96679,8.01018,425,270258,0.0497757,0.03,1,171239,170814,425
27680441,7.19336,7.20204,425,270258,0.00995514,0.02,1,171246,170821,425
27683361,8.63867,7.84041,426,270258,0.00999103,0.01,1,171255,170829,426
27686281,8.12773,7.96808,426,270258,0.00999821,0.04,1,171263,170837,426
27688341,6.42555,7.99362,424,270258,0.0259996,0.05,1,171269,170845,424
27690001,7.68511,6.39872,426,270258,0.0451999,0.03,1,171277,170851,426
27692081,8.73702,8.47974,426,270258,0.02504,0.03,1,171286,170860,426
27695001,8.9474,8.89595,426,270258,0.053008,0.03,1,171295,170869,426
27697921,7.38948,8.17919,425,270258,0.0586016,0.06,1,171302,170877,425
27700401,7.8779,8.03584,425,270258,0.0597203,0.03,1,171310,170885,425
27703321,7.97558,7.20717,426,270258,0.0759441,0.03,1,171318,170892,426
27704981,8.79512,7.84143,427,270258,0.0471888,0.03,1,171327,170900,427
27707061,5.75902,8.76829,423,270258,0.0174378,0.04,1,171332,170909,423
27709141,6.7518,6.55366,424,270258,0.0354876,0.03,1,171339,170915,424
27710801,6.15036,6.11073,424,270258,0.0150975,0,1,171345,170921,424
27713721,7.63007,5.22215,427,270258,0.0190195,0.05,1,171353,170926,427
27715381,11.126,7.44443,431,270258,0.0118039,0.04,1,171365,170934,431
27718081,7.0252,10.2889,426,270258,0.0343608,0.07,1,171371,170945,426
27721001,7.00504,7.65778,426,270258,0.0308722,0.05,1,171378,170952,426
27722661,8.60101,7.93156,427,270258,0.0381744,0.02,1,171387,170960,427
27724321,7.3202,7.98631,426,270258,0.0156349,0.05,1,171394,170968,426
27726401,9.46404,10.3973,425,270258,0.011127,0,1,171404,170979,425
27728481,13.0928,12.4795,426,270258,0.0022254,0.04,1,171418,170992,426
27730561,13.8186,12.0959,428,270258,0.0244451,0.01,1,171432,171004,428
27733481,9.16371,9.61918,427,270258,0.012889,0.05,1,171440,171013,427
27736401,7.43274,8.32384,426,270258,0.0105778,0.02,1,171447,171021,426
27738881,7.08655,8.06477,425,270258,0.0261156,0.04,1,171454,171029,425
27741801,9.41731,9.61295,425,270258,0.0132231,0.02,1,171464,171039,425
27744721,9.08346,8.32259,426,270258,0.0106446,0.03,1,171473,171047,426
27746581,8.21669,8.06452,426,270258,0.0101289,0.06,1,171481,171055,426
27748661,10.4433,8.0129,429,270258,0.0260258,0.05,1,171492,171063,429
27751581,8.48867,9.60258,427,270258,0.0292052,0.03,1,171500,171073,427
27754501,8.09773,8.32052,427,270258,0.013841,0.07,1,171508,171081,427
27757421,7.21955,8.0641,426,270258,0.0187682,0.06,1,171515,171089,426
27760101,7.04391,8.01282,425,270258,0.0117536,0.03,1,171522,171097,425
27763021,7.00878,7.20256,425,270258,0.0263507,0.03,1,171529,171104,425
27765301,7.00176,7.84051,424,270258,0.00527015,0.02,1,171536,171112,424
27766961,6.20035,6.3681,424,270258,0.00905403,0.04,1,171542,171118,424
27769881,8.44007,6.87362,426,270258,0.0258108,0.01,1,171551,171125,426
27772161,8.08801,7.77472,426,270258,0.0211622,0.02,1,171559,171133,426
27775081,7.2176,6.35494,427,270258,0.0202324,0.05,1,171566,171139,427
27776741,7.84352,7.67099,427,270258,0.0120465,0.05,1,171574,171147,427
27778821,12.7687,8.7342,432,270258,0.0104093,0.01,1,171588,171156,432
27781741,8.95374,12.9468,426,270258,0.0100819,0.04,1,171596,171170,426
27784661,8.19075,8.98937,426,270258,0.0260164,0.04,1,171604,171178,426
27787141,10.4381,8.19787,429,270258,0.0292033,0.03,1,171615,171186,429
27789841,8.48763,10.4396,426,270258,0.0458407,0.03,1,171623,171197,426
27792761,11.2975,10.8879,427,270258,0.0331681,0.02,1,171635,171208,427
27795681,8.65951,8.57758,427,270258,0.0226336,0.06,1,171643,171216,427
27798601,8.1319,8.11552,427,270258,0.0205267,0.07,1,171651,171224,427
27801521,6.42638,8.0231,425,270258,0.0121053,0.04,1,171657,171232,425
27804441,7.68528,8.00462,425,270258,0.0264211,0.05,1,171665,171240,425
27807361,7.93706,8.00092,425,270258,0.0212842,0.02,1,171673,171248,425
27810281,8.78741,8.00018,426,270258,0.0362568,0.07,1,171682,171256,426
27813201,8.15748,8.00004,426,270258,0.0312514,0.06,1,171690,171264,426
27816121,7.2315,8.00001,425,270258,0.00625027,0.07,1,171697,171272,425
27818341,7.8463,8,425,270258,0.00925006,0.04,1,171705,171280,425
27821041,8.76926,6.4,428,270258,0.00985001,0.06,1,171714,171286,428
27823121,8.95385,8.48,428,270258,0.02597,0.09,1,171723,171295,428
27825201,7.39077,6.496,429,270258,0.013194,0.09,1,171730,171301,429
27828121,8.67815,10.0992,427,270258,0.0106388,0.08,1,171739,171312,427
27831041,7.33563,8.41984,426,270258,0.0261278,0.03,1,171746,171320,426
27833521,7.86713,8.08397,426,270258,0.0292256,0.04,1,171754,171328,426
27836441,11.9734,12.8168,425,270258,0.0298451,0.03,1,171767,171342,425
27839361,8.79469,8.96336,425,270258,0.053969,0.03,1,171775,171350,425
27841841,8.15894,8.19267,425,270258,0.0427938,0.05,1,171783,171358,425
27844761,12.0318,10.4385,427,270258,0.0325588,0.02,1,171796,171369,427
27847461,11.2064,8.48771,430,270258,0.0145118,0.06,1,171807,171377,430
27850381,7.84127,11.2975,425,270258,0.0109023,0.03,1,171814,171389,425
27853301,8.76825,8.65951,426,270258,0.0101805,0.02,1,171823,171397,426
27856221,8.15365,8.1319,426,270258,0.0100361,0.03,1,171831,171405,426
27858901,11.2307,8.02638,430,270258,0.0180072,0.01,1,171843,171413,430
27860981,19.8461,11.2053,440,270258,0.0196014,0.03,1,171865,171425,440
27863681,10.3692,19.8411,426,270258,0.00392029,0.05,1,171873,171447,426
27866601,10.0738,12.7682,425,270258,0.000784058,0.05,1,171883,171458,425
27869521,8.41477,8.95364,425,270258,0.0401568,0.04,1,171891,171466,425
27872441,8.08295,8.19073,425,270258,0.0240314,0.05,1,171899,171474,425
27875361,8.81659,8.03815,426,270258,0.0288063,0.03,1,171908,171482,426
27877201,7.36332,8.00763,425,270258,0.0217613,0.03,1,171915,171490,425
27879281,9.47266,9.60153,425,270258,0.0283523,0.04,1,171925,171500,425
27882201,11.4945,10.7203,426,270258,0.0456705,0.01,1,171937,171511,426
27885121,8.69891,8.54406,426,270258,0.0651341,0.04,1,171945,171519,426
27887601,7.33978,8.10881,425,270258,0.0450268,0.04,1,171952,171527,425
27890521,8.66796,7.22176,427,270258,0.0410054,0.01,1,171961,171534,427
27893441,8.13359,7.84435,427,270258,0.0322011,0.04,1,171969,171542,427
27896361,7.22672,7.96887,426,270258,0.00644021,0.03,1,171976,171550,426
27899281,7.84534,7.99377,426,270258,0.00928804,0.02,1,171984,171558,426
27902201,7.96907,7.99875,426,270258,0.00985761,0.03,1,171992,171566,426
27905121,7.19381,7.99975,425,270258,0.00197152,0.05,1,171999,171574,425
27907361,7.83876,7.99995,425,270258,0.0323943,0.03,1,172007,171582,425
27909441,11.1678,10.4,426,270258,0.0464789,0.03,1,172019,171593,426
27912361,11.0336,10.88,426,270258,0.0332958,0.01,1,172030,171604,426
27915281,9.40671,8.576,427,270258,0.0226592,0.05,1,172039,171612,427
27918201,7.48134,8.1152,426,270258,0.00453183,0.03,1,172046,171620,426
27920881,7.09627,8.02304,425,270258,0.0169064,0.03,1,172053,171628,425
27923801,11.0193,11.2046,425,270258,0.0433813,0.01,1,172065,171640,425
27926081,8.60385,8.64092,425,270258,0.0246763,0.01,1,172073,171648,425
27929001,8.92077,8.92818,425,270258,0.0129353,0.05,1,172082,171657,425
27931921,9.78415,8.18564,427,270258,0.0265871,0.04,1,172092,171665,427
27934841,6.75683,8.03713,425,270258,0.0293174,0.05,1,172098,171673,425
27937761,7.75137,8.00743,425,270258,0.0218635,0.05,1,172106,171681,425
27940641,7.95027,8.00149,425,270258,0.0043727,0.03,1,172114,171689,425
27943561,8.79005,8.0003,426,270258,0.000874539,0.03,1,172123,171697,426
27946481,8.15801,8.00006,426,270258,0.0401749,0.04,1,172131,171705,426
27948961,8.0316,8.00001,426,270258,0.040035,0.04,1,172139,171713,426
27951881,7.20632,7.2,426,270258,0.016007,0.04,1,172146,171720,426
27953541,4.64126,7.84,422,270258,0.0032014,0.04,1,172150,171728,422
27955621,8.12825,5.568,426,270258,0.00064028,0.02,1,172159,171733,426
27957701,10.4257,7.5136,429,270258,0.000128056,0.02,1,172170,171741,429
27960621,8.48513,10.3027,426,270258,0.0160256,0.03,1,172178,171752,426
27963541,8.89703,8.46054,427,270258,0.0352051,0.03,1,172187,171760,427
27966021,7.37941,8.09211,426,270258,0.039041,0.06,1,172194,171768,426
27968101,6.27588,7.21842,425,270258,0.0238082,0.05,1,172200,171775,425
27969761,6.05518,6.24368,425,270258,0.00476164,0.05,1,172206,171781,425
27972681,9.21104,7.64874,427,270258,0.0329523,0.03,1,172216,171789,427
27974341,8.24221,7.92975,427,270258,0.0145905,0.05,1,172224,171797,427
27976421,7.24844,9.58595,424,270258,0.00291809,0.03,1,172231,171807,424
27978081,7.04969,6.71719,425,270258,0.0245836,0.03,1,172238,171813,425
27981001,12.6099,11.7434,426,270258,0.0209167,0.01,1,172252,171826,426
27983921,8.92199,8.74869,426,270258,0.00418334,0.04,1,172260,171834,426
27986401,7.3844,8.14974,425,270258,0.0328367,0.07,1,172267,171842,425
27989321,7.07688,7.22995,425,270258,0.0385673,0.02,1,172274,171849,425
27990981,19.0154,7.84599,439,270258,0.00771347,0.01,1,172296,171857,439
27993901,11.8031,18.3692,428,270258,0.00954269,0.02,1,172306,171878,428
27996181,7.96061,10.0738,427,270258,0.00990854,0.06,1,172313,171886,427
27998261,7.99212,8.41477,427,270258,0.00198171,0.04,1,172321,171894,427
28001181,7.19842,8.08295,426,270258,0.00839634,0.03,1,172328,171902,426
28004101,7.83968,8.01659,426,270258,0.00967927,0.04,1,172336,171910,426
28006161,7.96794,8.00332,426,270258,0.00993585,0.03,1,172344,171918,426
28008241,7.19359,7.20066,426,270258,0.00998717,0.05,1,172351,171925,426
28011161,10.2387,8.64013,428,270258,0.0499974,0.04,1,172362,171934,428
28013861,8.44774,8.12803,428,270258,0.0499995,0.05,1,172370,171942,428
28016781,8.08955,10.4256,425,270258,0.0259999,0.04,1,172378,171953,425
28018641,7.21791,8.48512,424,270258,0.0132,0,1,172385,171961,424
28020721,7.04358,5.69702,426,270258,0.01864,0.04,1,172392,171966,426
28023641,6.20872,5.9394,426,270258,0.051728,0.04,1,172398,171972,426
28026561,6.84174,7.58788,425,270258,0.0423456,0.03,1,172405,171980,425
28028421,10.9683,7.91758,429,270258,0.0324691,0,1,172417,171988,429
28031341,8.59367,10.3835,426,270258,0.0464938,0.05,1,172425,171999,426
28033201,7.31873,8.4767,425,270258,0.0172988,0.01,1,172432,172007,425
28036121,6.26375,5.69534,426,270258,0.0114598,0.02,1,172438,172012,426
28039041,7.65275,7.53907,426,270258,0.034292,0.03,1,172446,172020,426
28041941,7.93055,7.90781,426,270258,0.00685839,0.05,1,172454,172028,426
28044021,19.1861,7.98156,440,270258,0.00937168,0.01,1,172476,172036,440
28046941,9.43722,18.3963,426,270258,0.0258743,0.05,1,172483,172057,426
28049861,8.28744,10.0793,426,270258,0.0291749,0.04,1,172491,172065,426
28052781,8.05749,8.41585,426,270258,0.029835,0.04,1,172499,172073,426
28055461,8.0115,8.08317,426,270258,0.037967,0.02,1,172507,172081,426
28058381,7.2023,7.21663,426,270258,0.0155934,0.04,1,172514,172088,426
28060661,11.0405,7.84333,430,270258,0.0351187,0.03,1,172526,172096,430
28063581,8.60809,11.9687,425,270258,0.0230237,0.03,1,172534,172109,425
28066501,9.72162,8.79373,427,270258,0.00460475,0.03,1,172544,172117,427
28069421,9.14432,8.15875,428,270258,0.0249209,0.05,1,172553,172125,428
28072341,6.62886,8.03175,426,270258,0.0129842,0.06,1,172559,172133,426
28075261,7.72577,8.00635,426,270258,0.0265968,0.01,1,172567,172141,426
28078181,7.94515,8.00127,426,270258,0.0453194,0.03,1,172575,172149,426
28081101,7.98903,8.00025,426,270258,0.0410639,0.04,1,172583,172157,426
28084021,7.99781,8.00005,426,270258,0.0242128,0.06,1,172591,172165,426
28086941,7.99956,8.00001,426,270258,0.0448426,0.06,1,172599,172173,426
28089781,10.3999,8,429,270258,0.0249685,0.06,1,172610,172181,429
28092701,7.67998,10.4,425,270258,0.0289937,0.05,1,172617,172192,425
28095621,8.736,8.48,426,270258,0.0217987,0.03,1,172626,172200,426
28098541,7.3472,8.096,425,270258,0.0363597,0.06,1,172633,172208,425
28100801,7.86944,8.0192,425,270258,0.0472719,0.03,1,172641,172216,425
28103721,9.57389,8.80384,426,270258,0.0174544,0.03,1,172651,172225,426
28106421,7.51478,8.16077,425,270258,0.0274909,0.07,1,172658,172233,425
28108501,13.503,7.23215,433,270258,0.0214982,0.03,1,172673,172240,433
28110581,12.3006,12.6464,431,270258,0.0602996,0.04,1,172685,172254,431
28113501,8.86012,12.9293,426,270258,0.0360599,0.02,1,172693,172267,426
28116421,8.17202,8.98586,426,270258,0.039212,0.02,1,172701,172275,426
28119341,7.2344,8.19717,425,270258,0.0318424,0.05,1,172708,172283,425
28120981,14.2469,8.03943,433,270258,0.0143685,0,1,172724,172291,433
28123061,11.6494,14.4079,428,270258,0.0028737,0.02,1,172735,172307,428
28125981,8.72988,11.6816,425,270258,0.000574739,0.05,1,172743,172318,425
28128901,8.94598,8.73632,426,270258,0.0241149,0.02,1,172752,172326,426
28131821,8.1892,8.14726,426,270258,0.028823,0.04,1,172760,172334,426
28134741,8.03784,8.02945,426,270258,0.0297646,0.04,1,172768,172342,426
28137201,8.00757,8.00589,426,270258,0.0299529,0.05,1,172776,172350,426
28139281,7.20151,7.20118,426,270258,0.0299906,0.06,1,172783,172357,426
28141361,7.0403,7.84024,425,270258,0.0299981,0.05,1,172790,172365,425
28144281,11.0081,9.56805,427,270258,0.0219996,0,1,172802,172375,427
28147201,8.60161,8.31361,427,270258,0.0123999,0.03,1,172810,172383,427
28149061,4.92032,8.06272,423,270258,0.01048,0.06,1,172814,172391,423
28151761,7.38406,5.61254,426,270258,0.050096,0.03,1,172822,172396,426
28153841,7.07681,6.72251,426,270258,0.0340192,0.05,1,172829,172403,426
28156761,10.2154,10.1445,426,270258,0.0148038,0.02,1,172840,172414,426
28158421,5.24307,8.4289,422,270258,0.0109608,0.04,1,172844,172422,422
28161341,8.24861,5.68578,426,270258,0.0101922,0,1,172853,172427,426
28164241,7.24972,7.53716,425,270258,0.00203843,0.02,1,172860,172435,425
28167161,12.6499,12.7074,425,270258,0.000407686,0.03,1,172874,172449,425
28169441,8.92999,8.94149,425,270258,0.0160815,0.05,1,172882,172457,425
28172361,8.986,8.1883,426,270258,0.0112163,0.05,1,172891,172465,426
28174021,10.5972,8.03766,429,270258,0.0422433,0.05,1,172902,172473,429
28176101,8.51944,10.4075,426,270258,0.0404487,0.06,1,172910,172484,426
28177761,7.30389,8.48151,425,270258,0.0160897,0.05,1,172917,172492,425
28180681,10.2608,10.4963,425,270258,0.0352179,0.03,1,172928,172503,425
28182961,8.45216,8.49926,425,270258,0.0230436,0.01,1,172936,172511,425
28185881,11.2904,10.4999,426,270258,0.0286087,0.01,1,172948,172522,426
28188801,8.65809,8.49997,426,270258,0.0297217,0.04,1,172956,172530,426
28191721,8.13162,8.09999,426,270258,0.0459443,0.06,1,172964,172538,426
28194641,8.82632,8.02,427,270258,0.0171889,0.06,1,172973,172546,427
28197561,8.96526,8.004,428,270258,0.0274378,0.04,1,172982,172554,428
28200481,7.39305,8.0008,427,270258,0.0294876,0.06,1,172989,172562,427
28203401,7.87861,8.00016,427,270258,0.00589751,0.06,1,172997,172570,427
28206321,7.97572,8.00003,427,270258,0.0011795,0.04,1,173005,172578,427
28209241,7.99514,8.00001,427,270258,0.0162359,0.06,1,173013,172586,427
28212081,7.99903,8,427,270258,0.0352472,0.07,1,173021,172594,427
28215001,7.19981,8,426,270258,0.0310494,0.05,1,173028,172602,426
28217281,7.83996,8,426,270258,0.0302099,0.05,1,173036,172610,426
28220201,7.16799,6.4,427,270258,0.022042,0.03,1,173043,172616,427
28223121,7.8336,7.68,427,270258,0.0204084,0.05,1,173051,172624,427
28226041,7.16672,7.936,426,270258,0.0360817,0.06,1,173058,172632,426
28228721,7.03334,7.9872,425,270258,0.0472163,0.05,1,173065,172640,425
28231641,7.80667,7.19744,426,270258,0.0494433,0.02,1,173073,172647,426
28233301,4.76133,7.83949,422,270258,0.0498887,0.02,1,173077,172655,422
28235381,9.75227,5.5679,428,269645,0.0179777,0.04,1,173088,172660,428
28237041,8.35045,8.31358,427,269645,0.0355955,0.05,1,173096,172669,427
28239121,8.87009,9.66272,426,269645,0.0231191,0.07,1,173105,172679,426
28241201,7.37402,6.73254,427,269645,0.0126238,0.05,1,173112,172685,427
28244121,16.6748,18.1465,425,269645,0.0185248,0.01,1,173131,172706,425
28247041,10.535,10.0293,426,269645,0.011705,0.03,1,173140,172714,426
28249521,7.70699,8.40586,425,269645,0.010341,0,1,173147,172722,425
28251601,11.9414,12.0812,425,269645,0.0420682,0,1,173160,172735,425
28254521,7.98828,7.21623,426,269645,0.00841364,0,1,173167,172741,426
28256801,7.19766,7.84325,425,269645,0.00968273,0.05,1,173174,172749,425
28259721,7.03953,6.36865,426,269645,0.00193655,0.04,1,173181,172755,426
28262001,7.80791,7.67373,426,269645,0.000387309,0.05,1,173189,172763,426
28264921,5.56158,6.33475,425,269645,0.0160775,0.04,1,173194,172769,425
28266581,5.11232,7.66695,422,269645,0.0352155,0.04,1,173199,172777,422
28269501,7.42246,5.53339,425,269645,0.0150431,0.03,1,173207,172782,425
28271781,13.4845,7.50668,432,269645,0.0190086,0.03,1,173222,172790,432
28273861,9.0969,13.5013,425,269645,0.0118017,0.03,1,173230,172805,425
28275941,11.4194,7.50027,431,269645,0.0103603,0.06,1,173242,172811,431
28278861,8.68388,12.7001,425,269645,0.0100721,0.04,1,173250,172825,425
28281781,8.13678,8.94001,425,269645,0.0100144,0,1,173258,172833,425
28284701,8.02736,8.188,425,269645,0.0260029,0.03,1,173266,172841,425
28286341,8.00547,8.0376,425,269645,0.0292006,0.02,1,173274,172849,425
28289261,8.00109,8.00752,425,269645,0.0218401,0,1,173282,172857,425
28292181,9.60022,8.0015,427,269645,0.012368,0,1,173292,172865,427
28295101,8.32004,8.0003,427,269645,0.0024736,0.03,1,173300,172873,427
28297361,6.46401,8.00006,425,269645,0.0164947,0.07,1,173306,172881,425
28300281,7.6928,6.40001,427,269645,0.0272989,0.04,1,173314,172887,427
28302561,7.13856,7.68,426,269645,0.0134598,0.05,1,173321,172895,426
28304641,13.4277,11.936,428,269645,0.042692,0.01,1,173336,172908,428
28306721,8.28554,9.5872,426,269645,0.0245384,0.08,1,173343,172917,426
28308801,5.65711,6.71744,425,269645,0.0129077,0.03,1,173348,172923,425
28311721,12.3314,10.9435,427,269645,0.0185815,0.02,1,173362,172935,427
28314001,8.86628,8.5887,427,269645,0.0357163,0.05,1,173370,172943,427
28316081,8.17326,8.91774,426,269645,0.0311433,0.06,1,173378,172952,426
28319001,8.03465,8.98355,425,269645,0.0542287,0.03,1,173386,172961,425
28321921,8.80693,8.19671,426,269645,0.0668457,0.03,1,173395,172969,426
28323781,7.36139,8.03934,425,269645,0.0213691,0.04,1,173402,172977,425
28326701,7.07228,7.20787,425,269645,0.0122738,0.04,1,173409,172984,425
28328561,7.01446,7.84157,424,269645,0.0344548,0.01,1,173416,172992,424
28331481,7.00289,5.56831,426,269645,0.022891,0.01,1,173423,172997,426
28334401,8.60058,7.51366,427,269645,0.0285782,0.04,1,173432,173005,427
28336881,7.32012,7.90273,426,269645,0.0297156,0.05,1,173439,173013,426
28339801,8.66402,9.58055,425,269645,0.0219431,0.05,1,173448,173023,425
28342721,8.9328,8.31611,426,269645,0.0123886,0.05,1,173457,173031,426
28345641,8.98656,8.06322,427,269645,0.0264777,0.03,1,173466,173039,427
28348321,6.59731,8.01264,425,269645,0.0132955,0.05,1,173472,173047,425
28351241,8.51946,7.20253,427,269645,0.0106591,0.02,1,173481,173054,427
28354161,8.10389,7.84051,427,269645,0.0101318,0.06,1,173489,173062,427
28356641,6.42078,7.9681,425,269645,0.0260264,0.06,1,173495,173070,425
28359561,7.68416,7.19362,426,269645,0.0292053,0.02,1,173503,173077,426
28362481,7.13683,7.83872,425,269645,0.0138411,0.03,1,173510,173085,425
28365401,8.62737,7.96774,426,269645,0.0427682,0.01,1,173519,173093,426
28367461,11.3255,7.99355,430,269645,0.0165536,0.02,1,173531,173101,430
28370161,7.86509,11.1987,425,269645,0.0113107,0.06,1,173538,173113,425
28372241,7.97302,7.83974,426,269645,0.00226215,0.05,1,173546,173120,426
28374321,12.7946,13.5679,425,269645,0.00845243,0.01,1,173560,173135,425
28377241,13.7589,12.3136,427,269645,0.0416905,0.02,1,173574,173147,427
28380161,8.35178,8.86272,426,269645,0.0083381,0.03,1,173581,173155,426
28382021,7.27036,8.17254,425,269645,0.0256676,0.02,1,173588,173163,425
28384941,7.85407,8.03451,425,269645,0.00513352,0.03,1,173596,173171,425
28387841,7.97081,8.0069,425,269645,0.0010267,0,1,173604,173179,425
28389921,7.99416,8.00138,425,269645,0.000205341,0.05,1,173612,173187,425
28392841,11.1988,10.4003,426,269645,4.10682e-05,0.02,1,173624,173198,426
28395761,8.63977,8.48006,426,269645,0.0240082,0.04,1,173632,173206,426
28398681,8.12795,8.09601,426,269645,0.0448016,0.04,1,173640,173214,426
28400321,7.22559,8.0192,425,269645,0.0409603,0.05,1,173647,173222,425
28403241,10.2451,10.4038,425,269645,0.00819207,0.04,1,173658,173233,425
28405941,12.449,8.48077,430,269645,0.0256384,0,1,173671,173241,430
28408021,8.8898,10.4962,427,269645,0.0291277,0.04,1,173679,173252,427
28410941,8.17796,8.49923,427,269645,0.00582554,0.03,1,173687,173260,427
28412801,6.43559,8.09985,425,269645,0.0331651,0.06,1,173693,173268,425
28415721,10.0871,10.42,425,269645,0.030633,0.01,1,173704,173279,425
28418641,9.21742,8.48399,426,269645,0.0381266,0,1,173713,173287,426
28421541,8.24348,8.0968,426,269645,0.0156253,0.04,1,173721,173295,426
28423201,6.4487,8.01936,424,269645,0.0271251,0.03,1,173727,173303,424
28426121,10.0897,9.60387,425,269645,0.013425,0.02,1,173738,173313,425
28429041,10.0179,8.32077,427,269645,0.002685,0.05,1,173748,173321,427
28431961,6.80359,8.06415,425,269645,0.008537,0.06,1,173754,173329,425
28433601,6.96072,8.01283,424,269645,0.0017074,0.01,1,173761,173337,424
28436521,11.7921,10.4026,426,269645,0.00834148,0.03,1,173774,173348,426
28439221,7.95843,8.48051,425,269645,0.0176683,0.02,1,173781,173356,425
28441301,6.39169,7.2961,424,269645,0.00353366,0.05,1,173787,173363,424
28443381,9.27834,6.25922,428,269645,0.0327067,0.05,1,173797,173369,428
28446301,8.25567,8.45184,427,269645,0.0305413,0.06,1,173805,173378,427
28448581,10.4511,8.09037,430,269645,0.0141083,0.04,1,173816,173386,430
28450661,10.0902,12.0181,427,269645,0.0268217,0.01,1,173826,173399,427
28453581,8.41805,9.60361,426,269645,0.0293643,0.04,1,173834,173408,426
28456501,8.08361,8.32072,426,269645,0.0298729,0.04,1,173842,173416,426
28459421,8.01672,8.06414,426,269645,0.0219746,0.03,1,173850,173424,426
28461061,8.00334,8.01283,426,269645,0.00439491,0.04,1,173858,173432,426
28463981,8.00067,8.00257,426,269645,0.000878983,0.04,1,173866,173440,426
28466901,7.20013,8.00051,425,269645,0.0081758,0.03,1,173873,173448,425
28469821,8.64003,8.0001,426,269645,0.00963516,0.01,1,173882,173456,426
28471461,8.92801,8.00002,427,269645,0.025927,0.05,1,173891,173464,427
28474381,8.1856,9.6,425,269645,0.0291854,0.01,1,173899,173474,425
28477301,8.03712,8.32,425,269645,0.0378371,0.05,1,173907,173482,425
28480221,8.00742,8.064,425,269645,0.0155674,0.05,1,173915,173490,425
28483141,8.00148,8.0128,425,269645,0.00311348,0.05,1,173923,173498,425
28486061,8.8003,8.00256,426,269645,0.0086227,0.05,1,173932,173506,426
28488981,7.36006,8.00051,425,269645,0.00172454,0.05,1,173939,173514,425
28491901,7.87201,8.0001,425,269645,0.000344908,0.03,1,173947,173522,425
28494821,7.9744,8.00002,425,269645,0.032069,0.02,1,173955,173530,425
28497741,8.79488,8,426,269645,0.0544138,0,1,173964,173538,426
28500661,7.35898,8,425,269645,0.0428828,0.03,1,173971,173546,425
28503281,7.8718,8,425,269645,0.0165766,0.04,1,173979,173554,425
28505361,9.57436,8.8,426,269645,0.0193153,0.04,1,173989,173563,426
28508281,20.3149,20.16,426,269645,0.0278631,0.01,1,174012,173586,426
28511201,9.66297,10.432,425,269645,0.00557261,0.04,1,174019,173594,425
28514121,8.33259,8.4864,425,269645,0.00911452,0,1,174027,173602,425
28517041,8.06652,8.09728,425,269645,0.0098229,0,1,174035,173610,425
28519961,8.8133,8.01946,426,269645,0.00196458,0.01,1,174044,173618,426
28522421,8.16266,8.00389,426,269645,0.000392916,0.05,1,174052,173626,426
28524501,8.83253,7.20078,428,269645,0.00807858,0.05,1,174061,173633,428
28526161,5.76651,8.64016,424,269645,0.00961572,0.06,1,174066,173642,424
28529081,8.3533,8.12803,425,269645,0.0259231,0.01,1,174075,173650,425
28531361,8.87066,8.02561,426,269645,0.0611846,0.03,1,174084,173658,426
28533441,7.37413,6.40512,427,269645,0.0602369,0.02,1,174091,173664,427
28536361,8.67483,8.48102,427,269645,0.0440474,0.05,1,174100,173673,427
28538641,7.33497,8.0962,426,269645,0.0168095,0.05,1,174107,173681,426
28541561,10.267,10.4192,426,269645,0.0273619,0.03,1,174118,173692,426
28543221,6.8534,8.48385,424,269645,0.0454724,0.02,1,174124,173700,424
28545301,10.1707,5.69677,430,269645,0.0170945,0.03,1,174135,173705,430
28547381,9.23414,9.93935,428,269645,0.0114189,0.07,1,174144,173716,428
28550301,9.04683,10.7879,426,269645,0.0262838,0.03,1,174153,173727,426
28553221,8.20937,8.55757,426,269645,0.0132568,0.01,1,174161,173735,426
28556141,7.24187,8.11151,425,269645,0.0106514,0.01,1,174168,173743,425
28557781,6.24837,8.0223,423,269645,0.0181303,0.03,1,174174,173751,423
28560701,9.24967,6.40446,427,269645,0.0436261,0,1,174184,173757,427
28562561,7.44993,7.68089,426,269645,0.0167252,0.05,1,174191,173765,426
28564641,7.08999,7.93618,425,269645,0.027345,0,1,174198,173773,425
28567561,13.418,12.7872,426,269645,0.037469,0.04,1,174213,173787,426
28570481,9.0836,8.95745,426,269645,0.0314938,0.03,1,174221,173795,426
28573401,8.21672,8.19149,426,269645,0.0302988,0.03,1,174229,173803,426
28576321,8.04334,8.0383,426,269645,0.0380598,0.03,1,174237,173811,426
28578581,8.00867,8.00766,426,269645,0.055612,0.04,1,174245,173819,426
28580661,7.20173,8.00153,425,269645,0.0351224,0.05,1,174252,173827,425
28582741,10.2403,6.40031,430,269645,0.0150245,0.04,1,174263,173833,430
28584401,7.64807,10.8801,425,269645,0.0270049,0.02,1,174270,173845,425
28587321,7.92961,8.57601,425,269645,0.037401,0.01,1,174278,173853,425
28590241,8.78592,8.1152,426,269645,0.0314802,0,1,174287,173861,426
28593141,7.35718,8.02304,425,269645,0.00629604,0.03,1,174294,173869,425
28594801,7.87144,8.00461,425,269645,0.00125921,0.03,1,174302,173877,425
28597721,5.57429,5.60092,425,269645,0.0242518,0.05,1,174307,173882,425
28600001,7.51486,7.52018,425,269645,0.0128504,0.04,1,174315,173890,425
28602081,7.10297,6.30404,426,269645,0.0345701,0.03,1,174322,173896,426
28605001,11.8206,11.6608,426,269645,0.00691401,0,1,174335,173909,426
28607921,7.96412,8.73216,425,269645,0.0253828,0.03,1,174342,173917,425
28610841,8.79282,8.14643,426,269645,0.0210766,0.03,1,174351,173925,426
28613761,9.75856,8.02929,428,269645,0.0122153,0.04,1,174361,173933,428
28616641,5.95171,8.00586,425,269645,0.0104431,0.06,1,174366,173941,425
28619561,9.99034,8.00117,428,269645,0.0100886,0.05,1,174377,173949,428
28622481,8.39807,8.00023,428,269645,0.0180177,0.05,1,174385,173957,428
28624961,5.67961,8.00005,425,269645,0.0116035,0.07,1,174390,173965,425
28627881,6.73592,7.20001,425,269645,0.0103207,0.05,1,174397,173972,425
28630801,7.74718,7.84,425,269645,0.0100641,0.03,1,174405,173980,425
28633721,8.74944,7.968,426,269645,0.0180128,0.04,1,174414,173988,426
28636401,7.34989,7.9936,425,269645,0.0116026,0.01,1,174421,173996,425
28639321,21.47,21.5987,425,269645,0.0263205,0.01,1,174446,174021,425
28641601,10.694,10.7197,425,269645,0.0132641,0.01,1,174454,174029,425
28644521,13.3388,13.3439,425,269645,0.0266528,0,1,174468,174043,425
28647441,9.06776,9.06879,425,269645,0.00533056,0,1,174476,174051,425
28650361,9.81355,8.21376,427,269645,0.00106611,0.03,1,174486,174059,427
28653281,9.96271,8.04275,429,269645,0.000213223,0.06,1,174496,174067,429
28656201,8.39254,8.00855,429,269645,4.26445e-05,0.09,1,174504,174075,429
28659121,6.47851,8.00171,427,269645,0.0320085,0.08,1,174510,174083,427
28662041,6.8957,8.00034,426,269645,0.0144017,0.05,1,174517,174091,426
28664481,7.77914,8.00007,426,269645,0.0108803,0.06,1,174525,174099,426
28667401,10.3558,9.60001,427,269645,0.0341761,0.04,1,174536,174109,427
28670321,8.47117,8.32,427,269645,0.0468352,0.04,1,174544,174117,427
28673221,8.89423,8.064,428,269645,0.041367,0.04,1,174553,174125,428
28675301,14.5788,10.4128,433,269645,0.0242734,0.02,1,174569,174136,433
28678001,8.51577,14.0826,425,269645,0.0208547,0.01,1,174576,174151,425
28680921,10.5032,10.8165,426,269645,0.0121709,0.03,1,174587,174161,426
28683841,9.30063,8.5633,427,269645,0.0424342,0.04,1,174596,174169,427
28686761,7.46013,8.11266,426,269645,0.0244868,0.06,1,174603,174177,426
28688401,6.29203,8.02253,424,269645,0.00489737,0.07,1,174609,174185,424
28691321,12.4584,10.4045,427,269645,0.0249795,0.03,1,174623,174196,427
28694241,7.29168,8.4809,425,269645,0.0209959,0.05,1,174629,174204,425
28697141,8.65834,8.09618,426,269645,0.00419918,0.04,1,174638,174212,426
28699221,12.9317,8.01924,432,269645,0.00883984,0,1,174652,174220,432
28700881,6.58633,12.0038,424,269645,0.00976797,0.07,1,174657,174233,424
28703801,10.9173,10.4008,426,269645,0.00995359,0.03,1,174669,174243,426
28706721,7.78345,8.48015,425,269645,0.00999072,0.07,1,174676,174251,425
28709201,8.75669,8.09603,426,269645,0.00199814,0.01,1,174685,174259,426
28712121,7.35134,7.21921,426,269645,0.0483996,0.04,1,174692,174266,426
28715041,7.87027,7.84384,426,269645,0.0496799,0.04,1,174700,174274,426
28716901,7.97405,7.96877,426,269645,0.017936,0.03,1,174708,174282,426
28718981,14.3948,8.79375,433,269645,0.0035872,0.03,1,174724,174291,433
28721901,10.079,13.7588,427,269645,0.00871744,0.04,1,174733,174306,427
28724821,7.61579,9.15175,426,269645,0.00174349,0.06,1,174740,174314,426
28727741,7.92316,8.23035,426,269645,0.000348698,0.04,1,174748,174322,426
28730661,8.78463,8.04607,427,269645,0.0240697,0.02,1,174757,174330,427
28733581,8.15693,8.00921,427,269645,0.0208139,0.03,1,174765,174338,427
28736501,6.43139,8.00184,425,269645,0.0201628,0.03,1,174771,174346,425
28739421,8.48628,8.00037,426,269645,0.0120326,0.02,1,174780,174354,426
28742341,7.29726,8.00007,425,269645,0.0104065,0.04,1,174787,174362,425
28744561,7.85945,8.00001,425,269645,0.0100813,0.03,1,174795,174370,425
28747481,7.17189,6.4,426,269645,0.0180163,0.04,1,174802,174376,426
28749141,6.23438,7.68,424,269645,0.0196033,0.05,1,174808,174384,424
28752061,7.64688,7.136,425,269645,0.00392065,0.03,1,174816,174391,425
28754981,8.72938,7.8272,426,269645,0.0167841,0.03,1,174825,174399,426
28757901,8.14588,7.96544,426,269645,0.0113568,0.05,1,174833,174407,426
28760821,8.02918,7.99309,426,269645,0.0102714,0.05,1,174841,174415,426
28763741,8.00584,7.99862,426,269645,0.0100543,0.06,1,174849,174423,426
28766661,8.80117,7.99972,427,269645,0.0340109,0.05,1,174858,174431,427
28768901,16.1602,7.99994,437,269645,0.0308022,0.05,1,174876,174439,437
28771821,9.63205,17.6,425,269645,0.0301604,0.04,1,174884,174459,425
28774101,13.9264,9.92,432,269645,0.0140321,0.01,1,174899,174467,432
28777021,10.7853,13.984,427,269645,0.00280642,0,1,174909,174482,427
28779301,8.55706,9.1968,427,269645,0.000561283,0.03,1,174917,174490,427
28782221,8.91141,9.03936,427,269645,0.00811226,0.04,1,174926,174499,427
28785141,7.38228,8.20787,426,269645,0.0176225,0.04,1,174933,174507,426
28787201,7.07646,8.04157,425,269645,0.00352449,0.03,1,174940,174515,425
28790121,7.81529,6.40831,427,269645,0.000704898,0.03,1,174948,174521,427
28793041,7.96306,7.68166,427,269645,0.00014098,0.05,1,174956,174529,427
28795961,7.19261,7.93633,426,269645,0.0160282,0.08,1,174963,174537,426
28798881,7.83852,7.98727,426,269645,0.0272056,0.06,1,174971,174545,426
28801801,7.9677,7.99745,426,269645,0.0294411,0.07,1,174979,174553,426
28803841,7.99354,7.99949,426,269645,0.0298882,0.04,1,174987,174561,426
28805921,12.7987,12.7999,426,269645,0.0299776,0,1,175001,174575,426
28808841,8.15974,7.35998,427,269645,0.0299955,0.04,1,175008,174581,427
28811121,6.43195,7.872,425,269645,0.0299991,0.03,1,175014,174589,425
28814041,11.6864,11.9744,425,269645,0.00599982,0.03,1,175027,174602,425
28816961,8.73728,8.79488,425,269645,0.00919996,0.05,1,175035,174610,425
28819441,8.94746,8.15898,426,269645,0.02584,0.04,1,175044,174618,426
28821521,10.5895,9.6318,427,269645,0.029168,0.05,1,175055,174628,427
28824441,13.3179,14.7264,425,269645,0.0138336,0.01,1,175069,174644,425
28827361,9.86358,9.34527,426,269645,0.0107667,0.01,1,175078,174652,426
28830281,7.57272,8.26905,425,269645,0.0341533,0.03,1,175085,174660,425
28831921,7.91454,8.05381,425,269645,0.0148307,0.03,1,175093,174668,425
28834001,8.78291,7.21076,427,269645,0.0269661,0.03,1,175102,174675,427
28836921,6.55658,6.24215,427,269645,0.0213932,0.06,1,175108,174681,427
28838581,6.11132,7.64843,425,269645,0.0282786,0.06,1,175114,174689,425
28841501,6.82226,7.12969,425,269645,0.0216557,0.03,1,175121,174696,425
28843781,6.96445,7.82594,424,269645,0.0203311,0.03,1,175128,174704,424
28846701,7.79289,6.36519,426,269645,0.0120662,0.04,1,175136,174710,426
28848981,15.9586,7.67304,436,269645,0.0184132,0,1,175154,174718,436
28851061,11.9917,15.9346,429,269645,0.00368265,0,1,175165,174736,429
28853981,9.59834,11.9869,427,269645,0.00073653,0.03,1,175174,174747,427
28855841,7.51967,8.79738,426,269645,0.00814731,0.05,1,175181,174755,426
28858761,7.90393,8.95948,425,269645,0.0176295,0.03,1,175189,174764,425
28861681,7.98079,8.1919,425,269645,0.0275259,0.03,1,175197,174772,425
28864601,7.99616,8.03838,425,269645,0.0295052,0.03,1,175205,174780,425
28867521,8.79923,8.00768,426,269645,0.013901,0.01,1,175214,174788,426
28870441,7.35985,8.00154,425,269645,0.0107802,0.05,1,175221,174796,425
28873361,7.87197,8.00031,425,269645,0.00215604,0.01,1,175229,174804,425
28876281,8.77439,8.00006,426,269645,0.00843121,0.01,1,175238,174812,426
28879201,8.15488,8.00001,426,269645,0.00968624,0.03,1,175246,174820,426
28882121,8.03098,8,426,269645,0.0259372,0.03,1,175254,174828,426
28885041,8.0062,8,426,269645,0.0211875,0.04,1,175262,174836,426
28887961,8.00124,8,426,269645,0.0282375,0.05,1,175270,174844,426
28890881,8.80025,8,427,269645,0.0376475,0.05,1,175279,174852,427
28893801,8.16005,8,427,269645,0.0315295,0.07,1,175287,174860,427
28896721,8.03201,8,427,269645,0.0463059,0.07,1,175295,174868,427
28898901,12.8064,8,433,269645,0.0412612,0.03,1,175309,174876,433
28901821,8.16128,13.6,425,269645,0.0322522,0.03,1,175316,174891,425
28904101,13.6323,9.12,432,269645,0.0304504,0,1,175331,174899,432
28907021,9.92645,13.824,426,269645,0.0380901,0,1,175340,174914,426
28909921,8.38529,9.1648,426,269645,0.015618,0.03,1,175348,174922,426
28912841,8.07706,8.23296,426,269645,0.0271236,0.02,1,175356,174930,426
28915761,8.01541,8.04659,426,269645,0.0294247,0.03,1,175364,174938,426
28917621,6.40308,8.00932,424,269645,0.0138849,0.05,1,175370,174946,424
28920321,6.88062,5.60186,426,269645,0.018777,0.06,1,175377,174951,426
28923241,9.37612,9.12037,426,269645,0.0117554,0.05,1,175387,174961,426
28926161,8.27522,8.22407,426,269645,0.0103511,0.05,1,175395,174969,426
28928021,12.855,8.04481,432,269645,0.0340702,0,1,175409,174977,432
28930941,8.97101,12.809,426,269645,0.038814,0.03,1,175417,174991,426
28933861,8.1942,8.96179,426,269645,0.0237628,0.05,1,175425,174999,426
28936781,7.23884,8.19236,425,269645,0.0447526,0.04,1,175432,175007,425
28938421,7.84777,8.03847,425,269645,0.0489505,0.03,1,175440,175015,425
28941341,7.16955,7.20769,425,269645,0.0257901,0.04,1,175447,175022,425
28944241,8.63391,7.84154,426,269645,0.045158,0.04,1,175456,175030,426
28947161,11.3268,11.1683,426,269645,0.0330316,0.03,1,175468,175042,426
28948821,5.46536,8.63366,422,269645,0.0466063,0.05,1,175472,175050,422
28950481,6.69307,5.72673,424,269645,0.0333213,0.04,1,175479,175055,424
28952561,6.13861,5.14535,425,269645,0.0146643,0.03,1,175485,175060,425
28954641,10.8277,9.02907,427,269645,0.0349329,0,1,175497,175070,427
28957561,9.36554,9.00581,427,269645,0.00698657,0.04,1,175506,175079,427
28960481,7.47311,8.20116,426,269645,0.00939731,0.05,1,175513,175087,426
28962341,7.89462,8.04023,426,269645,0.0338795,0.08,1,175521,175095,426
28965041,7.97892,8.00805,426,269645,0.0227759,0.05,1,175529,175103,426
28967121,6.39578,7.20161,425,269645,0.00455518,0.03,1,175535,175110,425
28969201,6.07916,6.24032,425,269645,0.016911,0.03,1,175541,175116,425
28972121,12.4158,11.6481,426,269645,0.0193822,0.01,1,175555,175129,426
28974401,8.88317,8.72961,426,269645,0.0118764,0.04,1,175563,175137,426
28977321,5.77663,6.54592,425,269645,0.00237529,0.04,1,175568,175143,425
28978981,9.95533,7.70918,428,269645,0.0244751,0.03,1,175579,175151,428
28981061,17.9911,10.3418,437,269645,0.00489501,0.03,1,175599,175162,437
28983981,10.7982,17.2684,427,269645,0.008979,0.02,1,175608,175181,427
28986901,8.55964,9.85367,427,269645,0.0257958,0.03,1,175616,175189,427
28989821,7.31193,8.37073,426,269645,0.0131592,0.03,1,175623,175197,426
28992081,7.06239,8.07415,425,269645,0.0266318,0.03,1,175630,175205,425
28995001,7.81248,8.01483,425,269645,0.0293264,0.01,1,175638,175213,425
28997921,8.7625,8.00297,426,269645,0.0138653,0.01,1,175647,175221,426
28999781,7.3525,8.00059,425,269645,0.00277305,0.03,1,175654,175229,425
29002701,7.0705,7.20012,425,269645,0.0325546,0.02,1,175661,175236,425
29005621,8.6141,7.84002,426,269645,0.0385109,0.03,1,175670,175244,426
29008541,8.92282,7.968,427,269645,0.0317022,0.05,1,175679,175252,427
29011221,7.38456,7.9936,426,269645,0.00634044,0.05,1,175686,175260,426
29014141,6.27691,7.19872,425,269645,0.00926809,0.03,1,175692,175267,425
29017061,7.65538,7.83974,425,269645,0.00185362,0.01,1,175700,175275,425
29019981,7.93108,7.96795,425,269645,0.00837072,0.05,1,175708,175283,425
29022661,10.3862,7.99359,428,269645,0.00967414,0.02,1,175719,175291,428
29025581,8.47724,9.59872,426,269645,0.00193483,0.05,1,175727,175301,426
29027441,7.29545,8.31974,425,269645,0.016387,0.01,1,175734,175309,425
29030361,9.45909,8.86395,426,269645,0.0272774,0.01,1,175744,175318,426
29032641,9.09182,8.17279,427,269645,0.0134555,0.05,1,175753,175326,427
29035561,16.2184,16.8346,426,269645,0.0346911,0,1,175771,175345,426
29038481,10.4437,9.76691,427,269645,0.0149382,0.01,1,175780,175353,427
29041401,6.88873,8.35338,425,269645,0.00298764,0.02,1,175786,175361,425
29044321,7.77775,8.07068,425,269645,0.000597529,0.02,1,175794,175369,425
29047241,7.95555,8.01414,425,269645,0.00811951,0.01,1,175802,175377,425
29050161,9.59111,8.00283,427,269645,0.0096239,0,1,175812,175385,427
29053081,8.31822,8.00057,427,269645,0.00192478,0.04,1,175820,175393,427
29056001,8.06364,8.00011,427,269645,0.00838496,0.04,1,175828,175401,427
29058021,14.4127,8.00002,435,269645,0.00967699,0.02,1,175844,175409,435
29060941,9.28255,14.4,427,269645,0.0179354,0.06,1,175852,175425,427
29063221,6.65651,9.28,425,269645,0.0355871,0.07,1,175858,175433,425
29066141,7.7313,6.656,427,269645,0.0311174,0.06,1,175866,175439,427
29069041,7.14626,7.7312,426,269645,0.0142235,0.05,1,175873,175447,426
29071961,11.0293,11.9462,425,269645,0.0028447,0.03,1,175885,175460,425
29074881,9.40585,8.78925,426,269645,0.0165689,0.01,1,175894,175468,426
29077801,9.08117,8.15785,427,269645,0.0273138,0.04,1,175903,175476,427
29080721,7.41623,8.03157,426,269645,0.0294628,0.05,1,175910,175484,426
29083601,7.08325,8.00631,425,269645,0.0218926,0.03,1,175917,175492,425
29085681,10.2166,10.4013,425,269645,0.00437851,0.03,1,175928,175503,425
29087761,6.84333,6.88025,425,269645,0.0248757,0.02,1,175934,175509,425
29090681,8.56867,8.57605,425,269645,0.0289751,0.03,1,175943,175518,425
29092341,12.1137,8.11521,430,269645,0.013795,0.01,1,175956,175526,430
29095261,9.62275,12.023,426,269645,0.010759,0.02,1,175965,175539,426
29098181,8.32455,8.80461,426,269645,0.0021518,0.04,1,175973,175547,426
29101101,8.06491,8.16092,426,269645,0.00043036,0.03,1,175981,175555,426
29103781,13.613,8.03218,433,269645,0.0240861,0.04,1,175996,175563,433
29106701,9.1226,13.6064,426,269645,0.0528172,0.04,1,176004,175578,426
29109601,8.22452,9.12129,426,269645,0.0105634,0.02,1,176012,175586,426
29111681,17.6449,18.6243,425,269645,0.0261127,0.04,1,176032,175607,425
29114601,13.129,11.7249,427,269645,0.00522254,0,1,176044,175617,427
29117521,9.0258,8.74497,427,269645,0.0330445,0.04,1,176052,175625,427
29120441,8.20516,8.14899,427,269645,0.0146089,0.04,1,176060,175633,427
29123361,7.24103,8.0298,426,269645,0.0269218,0.04,1,176067,175641,426
29126281,7.84821,8.00596,426,269645,0.0373844,0.06,1,176075,175649,426
29129201,8.76964,8.00119,427,269645,0.0154769,0.06,1,176084,175657,427
29131861,6.55393,8.00024,425,269645,0.0270954,0.05,1,176090,175665,425
29134781,6.91079,7.20005,425,269645,0.0534191,0.06,1,176097,175672,425
29137701,7.78216,7.84001,425,269645,0.0346838,0.03,1,176105,175680,425
29140621,7.95643,7.968,425,269645,0.0469368,0.05,1,176113,175688,425
29143301,7.19129,7.9936,424,269645,0.0173874,0.01,1,176120,175696,424
29144961,7.03826,7.19872,424,269645,0.0354775,0.05,1,176127,175703,424
29147881,7.80765,7.03974,425,269645,0.0150955,0.01,1,176135,175710,425
29150161,8.76153,7.80795,426,269645,0.0270191,0.03,1,176144,175718,426
29153081,12.1523,11.9616,426,269645,0.0294038,0.03,1,176157,175731,426
29156001,8.83046,8.79232,426,269645,0.0458808,0.05,1,176165,175739,426
29158921,8.16609,8.15846,426,269645,0.0411762,0.05,1,176173,175747,426
29161841,8.03322,8.03169,426,269645,0.0162352,0.06,1,176181,175755,426
29163681,7.20664,8.00634,425,269645,0.019247,0.01,1,176188,175763,425
29166601,16.6413,15.2013,427,269645,0.0118494,0.03,1,176207,175780,427
29169521,8.12827,9.44025,425,269645,0.0263699,0.05,1,176213,175788,425
29172001,8.02565,8.28805,425,269645,0.029274,0.01,1,176221,175796,425
29174921,8.00513,7.25761,426,269645,0.0138548,0.02,1,176229,175803,426
29176581,8.80103,7.85152,427,269645,0.00277096,0.02,1,176238,175811,427
29179501,8.16021,9.5703,425,269645,0.00855419,0.04,1,176246,175821,425
29182421,8.03204,8.31406,425,269645,0.00171084,0.02,1,176254,175829,425
29184901,8.80641,8.06281,426,269645,0.00834217,0.03,1,176263,175837,426
29187821,8.16128,7.21256,427,269645,0.00166843,0.06,1,176271,175844,427
29190101,5.63226,7.84251,424,269645,0.0323337,0.06,1,176276,175852,424
29193021,6.72645,6.3685,425,269645,0.0304667,0.05,1,176283,175858,425
29195941,7.74529,7.6737,425,269645,0.0540933,0.05,1,176291,175866,425
29198421,9.54906,7.93474,427,269645,0.0268187,0.03,1,176301,175874,427
29200081,7.50981,8.78695,425,269645,0.0133637,0.01,1,176308,175883,425
29202161,7.10196,5.75739,427,269645,0.0266727,0.05,1,176315,175888,427
29205081,8.62039,8.35148,427,269645,0.0133345,0.05,1,176324,175897,427
29208001,7.32408,8.0703,426,269645,0.0266669,0.03,1,176331,175905,426
29209861,5.46482,8.01406,423,269645,0.0213334,0.02,1,176336,175913,423
29211521,6.69296,5.60281,425,269645,0.0202667,0,1,176343,175918,425
29214441,10.1386,9.12056,426,269645,0.0440533,0.01,1,176354,175928,426
29217361,8.42772,8.22411,426,269645,0.0408107,0.04,1,176362,175936,426
29220261,11.2855,8.04482,430,269645,0.0401621,0.03,1,176374,175944,430
29222341,11.8571,11.209,430,269645,0.0160324,0.03,1,176386,175956,430
29224421,7.97142,12.6418,424,269645,0.0112065,0.03,1,176393,175969,424
29226081,7.19428,7.32836,425,269645,0.0102413,0.05,1,176400,175975,425
29229001,10.2389,9.46567,426,269645,0.0100483,0.02,1,176411,175985,426
29231281,9.24777,8.29313,427,269645,0.0100097,0.01,1,176420,175993,427
29234201,14.6496,16.0586,425,269645,0.0340019,0.03,1,176436,176011,425
29237121,10.9299,9.61173,427,269645,0.0148004,0,1,176446,176019,427
29240041,6.98598,8.32235,425,269645,0.0109601,0.05,1,176452,176027,425
29242101,9.3972,8.06447,427,269645,0.00219202,0.03,1,176462,176035,427
29244181,7.47944,8.81289,425,269645,0.0084384,0.03,1,176469,176044,425
29246261,11.0959,6.56258,431,269645,0.00168768,0.05,1,176481,176050,431
29249181,7.81918,10.9125,426,269645,0.0403375,0.06,1,176488,176062,426
29252101,7.96384,8.5825,426,269645,0.0400675,0.04,1,176496,176070,426
29254161,7.99277,8.1165,426,269645,0.0160135,0.01,1,176504,176078,426
29257081,8.79855,8.0233,427,269645,0.0112027,0.06,1,176513,176086,427
29260001,8.15971,8.00466,427,269645,0.0262405,0.06,1,176521,176094,427
29262921,8.03194,8.00093,427,269645,0.0612481,0.06,1,176529,176102,427
29265841,8.00639,8.00019,427,269645,0.0362496,0.06,1,176537,176110,427
29268761,7.20128,8.00004,426,269645,0.0152499,0.05,1,176544,176118,426
29271681,8.64026,8.00001,427,269645,0.01905,0.04,1,176553,176126,427
29274601,8.12805,8,427,269645,0.01181,0.05,1,176561,176134,427
29277521,7.22561,8,426,269645,0.018362,0.04,1,176568,176142,426
29279541,8.64512,8,427,269645,0.0036724,0.02,1,176577,176150,427
29282461,8.12902,8,427,269645,0.00873448,0.08,1,176585,176158,427
29284741,9.6258,8,429,269645,0.0017469,0.04,1,176595,176166,429
29287661,8.32516,10.4,426,269645,0.0163494,0.06,1,176603,176177,426
29290581,8.06503,8.48,426,269645,0.0112699,0.07,1,176611,176185,426
29293501,7.21301,8.096,425,269645,0.034254,0.06,1,176618,176193,425
29296181,11.0426,8.0192,429,269645,0.0388508,0.04,1,176630,176201,429
29298261,10.2085,10.4038,428,269645,0.0477702,0.02,1,176640,176212,428
29299921,7.6417,10.8808,424,269645,0.033554,0.02,1,176647,176223,424
29302841,10.3283,10.1762,425,269645,0.0627108,0,1,176658,176233,425
29305121,8.46567,8.43523,425,269645,0.0365422,0.02,1,176666,176241,425
29307201,6.49313,6.48705,425,269645,0.0153084,0,1,176672,176247,425
29310121,6.89863,6.09741,426,269645,0.0190617,0.02,1,176679,176253,426
29313041,7.77973,7.61948,426,269645,0.0118123,0.04,1,176687,176261,426
29315521,7.95595,7.9239,426,269645,0.0103625,0.05,1,176695,176269,426
29318441,7.99119,7.18478,427,269645,0.0420725,0.04,1,176703,176276,427
29320101,6.39824,7.83696,425,269645,0.0084145,0.06,1,176709,176284,425
29323021,6.87965,7.16739,425,269645,0.0176829,0.06,1,176716,176291,425
29325301,10.1759,7.83348,428,269645,0.0115366,0.04,1,176727,176299,428
29328221,8.43519,10.3667,425,269645,0.0183073,0.02,1,176735,176310,425
29331141,8.88704,8.47334,426,269645,0.0356615,0.01,1,176744,176318,426
29334061,8.17741,8.09467,426,269645,0.0151323,0.06,1,176752,176326,426
29336741,8.83548,8.01893,427,269645,0.00302646,0.02,1,176761,176334,427
29339661,9.7671,8.80379,428,269645,0.0166053,0.04,1,176771,176343,428
29342561,6.75342,8.16076,426,269645,0.0113211,0.04,1,176777,176351,426
29344641,7.75068,8.03215,426,269645,0.0102642,0.04,1,176785,176359,426
29347561,13.5501,13.6064,426,269645,0.0260528,0.04,1,176800,176374,426
29350481,9.11003,9.12129,426,269645,0.0132106,0.05,1,176808,176382,426
29352961,7.42201,8.22426,425,269645,0.0106421,0.03,1,176815,176390,425
29355041,7.0844,7.24485,425,269645,0.0101284,0.03,1,176822,176397,425
29357121,9.41688,9.44897,425,269645,0.0100257,0.03,1,176832,176407,425
29359201,12.2834,11.4898,426,269645,0.0340051,0.03,1,176845,176419,426
29362121,7.25668,7.09796,426,269645,0.014801,0.04,1,176851,176425,426
29363781,10.2513,7.81959,429,269645,0.0109602,0.01,1,176862,176433,429
29365861,11.6503,11.1639,429,269645,0.00219204,0.01,1,176874,176445,429
29367521,7.13005,11.0328,424,269645,0.000438408,0.05,1,176880,176456,424
29370441,8.62601,7.80656,426,269645,0.0160877,0.01,1,176889,176463,426
29373361,8.9252,7.96131,427,269445,0.00321754,0.04,1,176898,176471,427
29376261,8.18504,7.99226,427,269445,0.00864351,0.06,1,176906,176479,427
29378341,8.83701,7.99845,428,269445,0.0097287,0.04,1,176915,176487,428
29381261,8.1674,10.3997,425,269445,0.0339457,0.03,1,176923,176498,425
29384181,8.83348,8.47994,426,269445,0.0387891,0.03,1,176932,176506,426
29387101,8.9667,8.09599,427,269445,0.0237578,0.06,1,176941,176514,427
29388741,7.39334,8.0192,426,269445,0.0207516,0.06,1,176948,176522,426
29390401,7.07867,8.00384,425,269445,0.0201503,0.03,1,176955,176530,425
29393321,7.01573,7.20077,425,269445,0.0360301,0.03,1,176962,176537,425
29394981,9.40315,7.84015,427,269445,0.015206,0.04,1,176972,176545,427
29397901,8.28063,9.56803,425,269445,0.0110412,0.03,1,176980,176555,425
29400821,9.65613,8.31361,427,269445,0.0102082,0.01,1,176990,176563,427
29403741,8.33123,8.06272,427,269445,0.0180416,0.06,1,176998,176571,427
29406661,6.46625,8.01254,425,269445,0.0116083,0.05,1,177004,176579,425
29409581,8.49325,8.00251,426,269445,0.0103217,0,1,177013,176587,426
29412501,8.09865,8.0005,426,269445,0.00206433,0.04,1,177021,176595,426
29415361,8.01973,8.0001,426,269445,0.000412867,0.05,1,177029,176603,426
29418281,8.00395,8.00002,426,269445,0.00808257,0.06,1,177037,176611,426
29419941,8.00079,8,426,269445,0.0256165,0.07,1,177045,176619,426
29422861,8.80016,8,427,269445,0.0451233,0.06,1,177054,176627,427
29425781,8.16003,8,427,269445,0.00902466,0.07,1,177062,176635,427
29428701,8.03201,8,427,269445,0.00980493,0.07,1,177070,176643,427
29430341,6.4064,8,425,269445,0.017961,0.08,1,177076,176651,425
29432421,6.88128,6.4,426,269445,0.0275922,0.03,1,177083,176657,426
29434501,9.37626,8.48,427,269445,0.0375184,0,1,177093,176666,427
29437421,8.27525,9.696,425,269445,0.0315037,0,1,177101,176676,425
29440321,9.65505,8.3392,427,269445,0.0383007,0.01,1,177111,176684,427
29443241,6.73101,8.06784,425,269445,0.0316602,0.04,1,177117,176692,425
29446161,7.7462,8.01357,425,269445,0.014332,0,1,177125,176700,425
29448641,7.94924,8.00271,425,269445,0.00286641,0.01,1,177133,176708,425
29451561,12.7898,12.0005,426,269445,0.00857328,0,1,177147,176721,426
29454481,9.75797,8.80011,427,269445,0.0337147,0.05,1,177156,176729,427
29457381,9.15159,8.16002,428,269445,0.0307429,0.04,1,177165,176737,428
29459041,9.03032,10.432,426,269445,0.0141486,0.03,1,177174,176748,426
29461961,8.20606,9.2864,425,269445,0.0108297,0.03,1,177182,176757,425
29464881,8.04121,8.25728,425,269445,0.00216594,0.04,1,177190,176765,425
29467361,8.00824,8.05146,425,269445,0.000433189,0.03,1,177198,176773,425
29470281,7.20165,7.21029,425,269445,0.0400866,0.01,1,177205,176780,425
29473201,7.84033,7.84206,425,269445,0.0480173,0.03,1,177213,176788,425
29475681,7.96807,7.96841,425,269445,0.0576035,0.02,1,177221,176796,425
29478601,15.1936,15.1937,425,269445,0.0355207,0.03,1,177238,176813,425
29481521,9.43872,9.43874,425,269445,0.0391041,0.03,1,177246,176821,425
29484441,9.08774,8.28775,426,269445,0.0318208,0.02,1,177255,176829,426
29487361,8.21755,8.05755,426,269445,0.00636417,0.04,1,177263,176837,426
29489621,8.84351,8.01151,427,269445,0.00927283,0.04,1,177272,176845,427
29492321,8.1687,9.6023,425,269445,0.00185457,0.03,1,177280,176855,425
29494401,8.03374,7.52046,426,269445,0.0243709,0.02,1,177288,176862,426
29497321,16.0067,16.7041,425,269445,0.0288742,0.04,1,177306,176881,425
29500021,8.80135,9.74082,424,269445,0.0297748,0.03,1,177313,176889,424
29502101,17.7603,7.54816,437,269445,0.021955,0.01,1,177333,176896,437
29505021,10.7521,16.7096,427,269445,0.012391,0.06,1,177342,176915,427
29507941,7.75041,9.74193,426,269445,0.0024782,0.05,1,177349,176923,426
29510421,7.15008,8.34839,425,269445,0.0164956,0.07,1,177356,176931,425
29513341,7.83002,7.26968,426,269445,0.0272991,0.06,1,177364,176938,426
29516261,7.966,7.85394,426,269445,0.0134598,0.04,1,177372,176946,426
29519181,7.9932,7.97079,426,269445,0.00269196,0.04,1,177380,176954,426
29522101,7.99864,7.99416,426,269445,0.00853839,0.04,1,177388,176962,426
29524981,10.3997,7.99883,429,269445,0.0257077,0.02,1,177399,176970,429
29527061,9.27995,10.3998,427,269445,0.0131415,0.03,1,177408,176981,427
29528721,7.45599,9.27995,425,269445,0.0266283,0.03,1,177415,176990,425
29531641,5.4912,5.85599,425,269445,0.0133257,0.03,1,177420,176995,425
29533301,8.29824,7.5712,426,269445,0.0266651,0.01,1,177429,177003,426
29536221,8.05965,7.91424,426,269445,0.029333,0.04,1,177437,177011,426
29539141,7.21193,7.98285,425,269445,0.0058666,0.04,1,177444,177019,425
29541621,7.84239,7.99657,425,269445,0.0251733,0.01,1,177452,177027,425
29544541,7.16848,7.19931,425,269445,0.0290347,0.04,1,177459,177034,425
29546401,7.0337,7.83986,424,269445,0.0298069,0.04,1,177466,177042,424
29549321,7.80674,7.16797,425,269445,0.0539614,0.02,1,177474,177049,425
29552021,8.76135,7.83359,426,269445,0.0347923,0.05,1,177483,177057,426
29553681,8.15227,8.76672,425,269445,0.0149585,0.02,1,177491,177066,425
29556601,8.03045,7.35334,426,269445,0.0269917,0.02,1,177499,177073,426
29559521,8.00609,7.87067,426,269445,0.0293983,0.03,1,177507,177081,426
29562421,11.2012,7.97413,430,269445,0.0138797,0.03,1,177519,177089,430
29565121,9.44024,11.1948,427,269445,0.0107759,0.07,1,177528,177101,427
29568041,6.68805,7.83897,426,269445,0.0181552,0.04,1,177534,177108,426
29569701,5.33761,7.96779,423,269445,0.019631,0.02,1,177539,177116,423
29572621,7.46752,5.59356,426,269445,0.0199262,0.01,1,177547,177121,426
29575541,7.0935,7.51871,425,269445,0.0119852,0.01,1,177554,177129,425
29578461,9.4187,7.90374,427,269445,0.042397,0.02,1,177564,177137,427
29581141,9.88374,7.98075,429,269445,0.0164794,0.04,1,177574,177145,429
29583221,9.97675,10.3961,428,269445,0.0192959,0.04,1,177584,177156,428
29586141,8.39535,10.8792,425,269445,0.0358592,0.01,1,177592,177167,425
29588001,7.27907,8.57585,424,269445,0.0311718,0.01,1,177599,177175,424
29590081,7.85581,7.31517,425,269445,0.00623437,0.03,1,177607,177182,425
29593001,11.1712,9.46303,427,269645,0.00924687,0.01,1,177619,177192,427
29595281,7.83423,8.29261,426,269645,0.00184937,0.07,1,177626,177200,426
29598201,7.16685,6.45852,427,269645,0.00836988,0.06,1,177633,177206,427
29601121,7.83337,7.6917,427,269645,0.025674,0.07,1,177641,177214,427
29603601,7.16667,7.93834,426,269645,0.0211348,0.06,1,177648,177222,426
29606521,8.63333,8.78767,426,269645,0.052227,0.04,1,177657,177231,426
29608181,8.92667,8.15753,427,269645,0.0424454,0.02,1,177666,177239,427
29610261,8.18533,8.03151,427,269645,0.0324891,0.06,1,177674,177247,427
29613181,8.03707,9.6063,425,269645,0.0224978,0.05,1,177682,177257,425
29615041,7.20741,8.32126,424,269645,0.00449956,0.03,1,177689,177265,424
29617961,11.0415,9.66425,426,269645,0.0248999,0.01,1,177701,177275,426
29620241,8.6083,8.33285,426,269645,0.02898,0.05,1,177709,177283,426
29623161,8.12166,6.46657,428,269645,0.013796,0.05,1,177717,177289,428
29625441,8.02433,7.69331,428,269645,0.0107592,0.07,1,177725,177297,428
29627521,9.60487,11.1387,426,269645,0.0101518,0.04,1,177735,177309,426
29630441,6.72097,7.02773,426,269645,0.00203037,0.04,1,177741,177315,426
29632101,20.5442,7.80555,442,269645,0.0244061,0,1,177765,177323,442
29635021,9.70884,20.7611,425,269645,0.00488121,0.04,1,177772,177347,425
29637941,8.34177,10.5522,425,269645,0.0169762,0.05,1,177780,177355,425
29640861,8.86835,8.51044,426,269645,0.00339525,0.01,1,177789,177363,426
29643781,8.17367,8.10209,426,269645,0.00067905,0.02,1,177797,177371,426
29645621,7.23473,8.02042,425,269645,0.00013581,0.05,1,177804,177379,425
29648541,7.84695,7.20408,426,269645,2.7162e-05,0.06,1,177812,177386,426
29651461,7.96939,7.84082,426,269645,5.4324e-06,0.06,1,177820,177394,426
29653941,11.1939,7.96816,430,269645,0.0160011,0.04,1,177832,177402,430
29656861,8.63878,11.1936,426,269645,0.0112002,0.03,1,177840,177414,426
29659781,8.12776,8.63873,426,269645,0.01024,0.04,1,177848,177422,426
29661841,8.02555,8.12775,426,269645,0.00204801,0.05,1,177856,177430,426
29664761,9.60511,9.62555,426,269645,0.0084096,0.03,1,177866,177440,426
29667041,7.52102,8.32511,425,269645,0.0336819,0.05,1,177873,177448,425
29669961,7.9042,6.46502,427,269645,0.0387364,0.04,1,177881,177454,427
29672881,7.98084,7.693,427,269645,0.0237473,0.04,1,177889,177462,427
29675801,7.99617,7.9386,427,269645,0.0367495,0.04,1,177897,177470,427
29677441,6.39923,7.98772,425,269645,0.00734989,0.03,1,177903,177478,425
29680361,10.0798,9.59754,426,269645,0.00146998,0.03,1,177914,177488,426
29683281,9.21597,8.31951,427,269645,0.000293996,0.03,1,177923,177496,427
29686181,9.84319,8.0639,429,269645,0.0160588,0.02,1,177933,177504,429
29689101,8.36864,10.4128,426,269645,0.0112118,0.04,1,177941,177515,426
29691381,6.47373,8.48256,424,269645,0.0262424,0.05,1,177947,177523,424
29694301,7.69475,6.49651,426,269645,0.0212485,0.04,1,177955,177529,426
29697221,7.93895,7.6993,426,269645,0.00424969,0.03,1,177963,177537,426
29700141,7.98779,7.93986,426,269645,0.000849939,0.04,1,177971,177545,426
29703061,8.79756,7.98797,427,269645,0.00816999,0.02,1,177980,177553,427
29704901,4.15951,7.99759,422,269645,0.009634,0.03,1,177983,177561,422
29707821,8.0319,5.59952,426,269645,0.0099268,0.01,1,177992,177566,426
29710101,9.60638,7.5199,428,269645,0.00198536,0.03,1,178002,177574,428
29713021,8.32128,9.50398,426,269645,0.0163971,0.04,1,178010,177584,426
29715301,9.66426,8.3008,428,269645,0.0192794,0.02,1,178020,177592,428
29718221,8.33285,9.66016,426,269645,0.00385588,0.01,1,178028,177602,426
29720501,12.8666,8.33203,432,269645,0.000771177,0.01,1,178042,177610,432
29723201,8.97331,13.6664,425,269645,0.00815424,0.01,1,178050,177625,425
29726121,8.19466,9.13328,425,269645,0.00163085,0.03,1,178058,177633,425
29727781,7.23893,8.22666,424,269645,0.000326169,0.02,1,178065,177641,424
29730701,7.84779,5.64533,427,269645,0.00806523,0.07,1,178073,177646,427
29733621,7.16956,7.52907,426,269645,0.00161305,0.06,1,178080,177654,426
29736541,7.83391,7.90581,426,269645,0.000322609,0.07,1,178088,177662,426
29738801,7.96678,7.98116,426,269645,0.0160645,0.02,1,178096,177670,426
29740881,10.3934,11.1962,425,269645,0.0512129,0.03,1,178107,177682,425
29743801,9.27867,8.63925,426,269645,0.0262426,0.01,1,178116,177690,426
29746081,8.25573,8.12785,426,269645,0.00524852,0.01,1,178124,177698,426
29749001,15.2511,16.0256,425,269645,0.0090497,0.01,1,178141,177716,425
29751921,9.45023,9.60511,425,269645,0.0258099,0.01,1,178149,177724,425
29754821,9.09005,8.32102,426,269645,0.00516199,0,1,178158,177732,426
29756481,7.41801,8.0642,425,269645,0.0170324,0.03,1,178165,177740,425
29759401,8.6836,8.81284,425,269645,0.0274065,0.03,1,178174,177749,425
29762101,20.9367,8.16257,441,269645,0.0054813,0.02,1,178198,177757,441
29765021,9.78734,20.0325,425,269645,0.0170963,0.02,1,178205,177780,425
29767941,8.35747,10.4065,425,269645,0.0194193,0,1,178213,177788,425
29770861,8.07149,8.4813,425,269645,0.0198839,0,1,178221,177796,425
29772501,12.0143,8.09626,430,269645,0.00397677,0.01,1,178234,177804,430
29775421,8.80286,11.2193,426,269645,0.000795354,0.04,1,178242,177816,426
29778341,7.36057,8.64385,425,269645,0.00815907,0.03,1,178249,177824,425
29781261,7.87211,8.12877,425,269645,0.0256318,0.01,1,178257,177832,425
29784181,7.97442,8.02575,425,269645,0.00512636,0.03,1,178265,177840,425
29786021,8.79488,8.00515,426,269645,0.00102527,0.01,1,178274,177848,426
29788941,8.95898,8.80103,426,269645,0.0242051,0.02,1,178283,177857,426
29791861,8.1918,8.16021,426,269645,0.028841,0.04,1,178291,177865,426
29794781,8.03836,8.03204,426,269645,0.0137682,0.04,1,178299,177873,426
29797701,8.80767,8.00641,427,269645,0.0187536,0.02,1,178308,177881,427
29800161,6.56153,8.00128,425,269645,0.00375073,0.03,1,178314,177889,425
29803081,14.9123,14.4003,426,269645,0.00875015,0.01,1,178331,177905,426
29806001,10.1825,9.28005,427,269645,0.00975003,0.02,1,178340,177913,427
29808921,7.63649,8.25601,426,269645,0.00195001,0.03,1,178347,177921,426
29811841,7.9273,8.0512,426,269645,0.000390001,0.02,1,178355,177929,426
29814761,7.98546,8.01024,426,269645,7.80002e-05,0.01,1,178363,177937,426
29817681,7.19709,8.00205,425,269645,0.0480156,0.01,1,178370,177945,425
29820601,7.83942,8.00041,425,269645,0.0256031,0.01,1,178378,177953,425
29823521,7.96788,8.00008,425,269645,0.0131206,0.01,1,178386,177961,425
29826441,7.99358,8.00002,425,269645,0.0186241,0.02,1,178394,177969,425
29829361,7.99872,8,425,269645,0.0117248,0,1,178402,177977,425
29831781,11.1997,8,429,269645,0.010345,0.02,1,178414,177985,429
29834701,8.63995,10.4,426,269645,0.026069,0.04,1,178422,177996,426
29837621,8.12799,8.48,426,269645,0.0052138,0.04,1,178430,178004,426
29840541,7.2256,8.096,425,269645,0.00904276,0.04,1,178437,178012,425
29843461,7.84512,8.0192,425,269645,0.0338086,0.03,1,178445,178020,425
29845921,7.96902,8.00384,425,269645,0.0147617,0.03,1,178453,178028,425
29848841,10.3938,10.4008,425,269645,0.0269523,0,1,178464,178039,425
29850501,6.87876,8.48015,423,269645,0.00539047,0,1,178470,178047,423
29853421,7.77575,5.69603,426,269645,0.0170781,0.02,1,178478,178052,426
29855701,11.9552,7.53921,431,269645,0.00341562,0.01,1,178491,178060,431
29858401,8.79103,12.7078,425,269645,0.000683124,0.02,1,178499,178074,425
29861321,10.5582,9.74157,427,269645,0.00813662,0.02,1,178510,178083,427
29864241,8.51164,8.34831,427,269645,0.00162732,0.04,1,178518,178091,427
29867161,8.10233,8.06966,427,269645,0.000325465,0.06,1,178526,178099,427
29870081,7.22047,8.01393,426,269645,0.0240651,0.03,1,178533,178107,426
29873001,7.84409,8.00279,426,269645,0.052813,0.02,1,178541,178115,426
29875461,9.56882,8.00056,428,269645,0.0185626,0.02,1,178551,178123,428
29877121,8.31376,10.4001,425,269645,0.0197125,0.03,1,178559,178134,425
29879201,13.6628,14.08,425,269645,0.0279425,0.02,1,178574,178149,425
29882121,10.7326,9.216,427,269645,0.0055885,0.02,1,178584,178157,427
29883781,6.14651,8.2432,424,269645,0.0251177,0.05,1,178589,178165,424
29886701,7.6293,7.24864,425,269645,0.0290235,0.03,1,178597,178172,425
29889601,7.92586,7.84973,425,269645,0.0458047,0.02,1,178605,178180,425
29892521,23.9852,23.9699,425,269645,0.0331609,0.03,1,178633,178208,425
29895441,11.197,11.194,425,269645,0.0146322,0.03,1,178641,178216,425
29898361,9.43941,8.6388,426,269645,0.0189264,0.02,1,178650,178224,426
29901041,7.48788,8.12776,425,269645,0.0197853,0,1,178657,178232,425
29903121,9.49758,8.82555,426,269645,0.0439571,0.04,1,178667,178241,426
29906041,13.8995,13.7651,426,269645,0.0407914,0.01,1,178682,178256,426
29908961,9.1799,9.15302,426,269645,0.0481583,0.04,1,178690,178264,426
29911881,8.23598,8.2306,426,269645,0.00963166,0.04,1,178698,178272,426
29914801,7.2472,8.04612,425,269645,0.0499263,0.03,1,178705,178280,425
29916641,7.04944,8.00922,424,269645,0.0259853,0.01,1,178712,178288,424
29919561,9.40989,8.00184,426,269645,0.0131971,0.01,1,178722,178296,426
29922481,8.28198,8.00037,426,269645,0.0346394,0.04,1,178730,178304,426
29925401,8.0564,8.00007,426,269645,0.0149279,0.04,1,178738,178312,426
29928321,7.21128,8.00001,425,269645,0.0269856,0.03,1,178745,178320,425
29931201,7.84226,8,425,269645,0.00539712,0.02,1,178753,178328,425
29934121,10.3685,10.4,425,269645,0.0250794,0.01,1,178764,178339,425
29936401,8.47369,8.48,425,269645,0.0130159,0.01,1,178772,178347,425
29939321,12.0947,11.296,426,269645,0.0266032,0,1,178785,178359,426
29942241,8.01895,8.6592,425,269645,0.0213206,0.02,1,178792,178367,425
29945161,8.80379,8.13184,426,269645,0.0122641,0,1,178801,178375,426
29947221,5.76076,8.02637,423,269645,0.0184528,0.05,1,178806,178383,423
29950141,7.55215,6.40527,425,269645,0.00369057,0.03,1,178814,178389,425
29953061,7.91043,7.68105,425,269645,0.0407381,0.02,1,178822,178397,425
29955981,7.98209,7.93621,425,269645,0.0401476,0.03,1,178830,178405,425
29958901,7.99642,7.98724,425,269645,0.0240295,0.03,1,178838,178413,425
29961821,7.99928,7.99745,425,269645,0.0288059,0,1,178846,178421,425
29964741,8.79986,7.99949,426,269645,0.0137612,0.01,1,178855,178429,426
29966981,11.36,7.9999,430,269645,0.0267522,0.03,1,178867,178437,430
29969901,8.67199,11.2,426,269645,0.0293504,0.03,1,178875,178449,426
29972821,8.1344,8.64,426,269645,0.00587009,0.03,1,178883,178457,426
29975741,8.02688,8.128,426,269645,0.017174,0.02,1,178891,178465,426
29978661,7.20538,8.0256,425,269645,0.0354348,0.01,1,178898,178473,425
29981581,7.84108,8.00512,425,269645,0.023087,0.01,1,178906,178481,425
29984501,8.76822,8.00102,426,269645,0.0126174,0.01,1,178915,178489,426
29986321,6.55364,8.0002,424,269645,0.0345235,0.04,1,178921,178497,424
29989241,8.51073,7.20004,426,269645,0.0149047,0.01,1,178930,178504,426
29991521,7.30215,7.84001,425,269645,0.0269809,0.01,1,178937,178512,425
29994441,8.66043,8.768,425,269645,0.0293962,0.01,1,178946,178521,425
29997361,8.93209,8.1536,426,269645,0.0138792,0.01,1,178955,178529,426
30000281,8.18642,8.03072,426,269645,0.00277585,0.06,1,178963,178537,426
30002341,6.43728,8.00614,424,269645,0.000555169,0.05,1,178969,178545,424
30004001,6.88746,6.40123,425,269645,0.016111,0.04,1,178976,178551,425
30006921,11.7775,10.0802,427,269645,0.0272222,0.03,1,178989,178562,427
30009621,15.1555,8.41605,435,269645,0.0214444,0.03,1,179005,178570,435
30011701,7.8311,15.2832,424,269645,0.0522889,0.05,1,179011,178587,424
30014401,7.16622,7.85664,425,269645,0.0344578,0.07,1,179018,178593,425
30017321,10.2332,10.3713,425,269645,0.0148916,0.02,1,179029,178604,425
30018981,9.24665,8.47427,426,269645,0.0269783,0.03,1,179038,178612,426
30020641,6.64933,7.29485,425,269645,0.00539566,0.04,1,179044,178619,425
30022721,19.7299,18.259,427,269645,0.00907913,0.02,1,179067,178640,427
30025641,11.946,11.6518,427,269645,0.00981583,0.03,1,179077,178650,427
30028561,7.98919,8.73036,426,269645,0.00196317,0.06,1,179084,178658,426
30031481,8.79784,8.14607,427,269645,0.0243926,0.05,1,179093,178666,427
30034161,7.35957,8.02921,426,269645,0.0288785,0.05,1,179100,178674,426
30036241,11.0719,11.2058,426,269645,0.0137757,0.03,1,179112,178686,426
30039161,7.81438,7.04117,427,269645,0.00275514,0.05,1,179119,178692,427
30040821,10.3629,7.80823,430,269645,0.032551,0.04,1,179130,178700,430
30043741,8.47258,11.1616,426,269645,0.0145102,0.06,1,179138,178712,426
30046661,8.09452,8.63233,426,269645,0.026902,0.06,1,179146,178720,426
30049141,7.2189,8.12647,425,269645,0.0293804,0.03,1,179153,178728,425
30052061,7.84378,7.22529,426,269645,0.0538761,0.02,1,179161,178735,426
30054341,7.16876,7.84506,425,269645,0.0347752,0.04,1,179168,178743,425
30057261,8.63375,7.96901,426,269645,0.030955,0.05,1,179177,178751,426
30060181,7.32675,7.9938,425,269645,0.00619101,0.05,1,179184,178759,425
30063101,8.66535,7.99876,426,269645,0.0092382,0.01,1,179193,178767,426
30065781,7.33307,7.99975,425,269645,0.0338476,0.03,1,179200,178775,425
30067441,7.06661,7.19995,425,269645,0.0147695,0.02,1,179207,178782,425
30069521,9.41332,9.43999,425,269645,0.00295391,0.03,1,179217,178792,425
30072441,13.8827,12.288,427,269645,0.0245908,0,1,179232,178805,427
30075361,7.57653,8.8576,425,269645,0.00491816,0.06,1,179238,178813,425
30078281,7.91531,8.17152,425,269645,0.000983631,0.05,1,179246,178821,425
30081201,7.98306,8.0343,425,269645,0.000196726,0.03,1,179254,178829,425
30084121,7.99661,8.00686,425,269645,0.00803935,0.04,1,179262,178837,425
30087041,8.79932,8.00137,426,269645,0.0416079,0.01,1,179271,178845,426
30089961,8.15986,8.00027,426,269645,0.0163216,0.04,1,179279,178853,426
30092881,8.03197,8.00005,426,269645,0.0112643,0.04,1,179287,178861,426
30095801,8.00639,8.00001,426,269645,0.0262529,0.03,1,179295,178869,426
30097601,6.40128,8,424,269645,0.0212506,0.04,1,179301,178877,424
30100521,9.28026,8,426,269645,0.0442501,0.01,1,179311,178885,426
30103441,8.25605,8,426,269645,0.01685,0.06,1,179319,178893,426
30105921,7.25121,8,425,269645,0.04337,0.04,1,179326,178901,425
30108841,9.45024,8.8,426,269645,0.008674,0,1,179336,178910,426
30111761,8.29005,8.16,426,269645,0.0017348,0.02,1,179344,178918,426
30114681,8.85801,8.032,427,269645,0.016347,0.03,1,179353,178926,427
30117601,6.5716,8.0064,425,269645,0.0112694,0.03,1,179359,178934,425
30120521,7.71432,8.00128,425,269645,0.00225388,0.03,1,179367,178942,425
30123441,8.74286,8.00026,426,269645,0.0404508,0.01,1,179376,178950,426
30126101,10.5486,8.00005,429,269645,0.0320902,0.05,1,179387,178958,429
30129021,10.1097,11.2,427,269645,0.014418,0.02,1,179397,178970,427
30131941,7.62194,8.64,426,269645,0.0188836,0.06,1,179404,178978,426
30134861,7.92439,8.128,426,269645,0.0357767,0.05,1,179412,178986,426
30136501,10.3849,8.0256,429,269645,0.0151553,0.02,1,179423,178994,429
30138581,7.67698,9.60512,426,269645,0.0190311,0.05,1,179430,179004,426
30141501,7.9354,8.32102,426,269645,0.00380621,0.03,1,179438,179012,426
30143781,7.98708,8.0642,426,269645,0.00876124,0.03,1,179446,179020,426
30145441,7.19742,8.01284,425,269645,0.0177522,0.04,1,179453,179028,425
30148361,8.63948,8.80257,425,269645,0.0115504,0.05,1,179462,179037,425
30151061,10.5279,8.16051,428,269645,0.00231009,0.02,1,179473,179045,428
30153141,21.3056,10.4321,441,269645,0.00846202,0.05,1,179497,179056,441
30155221,9.86112,21.2864,424,269645,0.0016924,0.04,1,179504,179080,424
30157301,10.7722,9.05728,429,269645,0.0323385,0.02,1,179515,179086,429
30160221,7.75444,10.6115,425,269645,0.0304677,0.06,1,179522,179097,425
30163141,8.75089,8.52229,426,269645,0.0140935,0.01,1,179531,179105,426
30166061,7.35018,8.10446,425,269645,0.0268187,0.06,1,179538,179113,425
30168741,12.67,8.02089,431,269645,0.0133637,0.03,1,179552,179121,431
30170821,11.334,11.2042,430,269645,0.0106727,0.05,1,179563,179133,430
30173741,9.4668,11.8408,427,269645,0.0101345,0.03,1,179572,179145,427
30176661,7.49336,8.76817,426,269645,0.00202691,0.06,1,179579,179153,426
30179141,7.09867,8.15363,425,269645,0.0484054,0.05,1,179586,179161,425
30182061,7.01973,7.23073,425,269645,0.0176811,0.06,1,179593,179168,425
30184961,7.80395,7.84615,425,269645,0.0115362,0.01,1,179601,179176,425
30187881,8.76079,7.96923,426,269645,0.0423072,0.03,1,179610,179184,426
30190801,7.35216,7.99385,425,269645,0.00846145,0.06,1,179617,179192,425
30193281,8.67043,7.99877,426,269645,0.0416923,0.04,1,179626,179200,426
30196201,8.93409,8.79975,426,269645,0.0563385,0.01,1,179635,179209,426
30199121,8.18682,8.15995,426,269645,0.0352677,0.06,1,179643,179217,426
30202021,21.6374,8.03199,443,269645,0.0150535,0.03,1,179668,179225,443
30204941,10.7275,21.6064,426,269645,0.00301071,0.05,1,179676,179250,426
30207861,8.54549,10.7213,426,269645,0.000602141,0.06,1,179684,179258,426
30210781,7.3091,8.54426,425,269645,0.0321204,0.06,1,179691,179266,425
30213701,8.66182,8.10885,426,269645,0.0384241,0.03,1,179700,179274,426
30216621,8.13236,8.02177,426,269645,0.00768482,0.05,1,179708,179282,426
30219541,8.02647,8.00435,426,269645,0.025537,0.03,1,179716,179290,426
30222461,8.00529,8.00087,426,269645,0.00510739,0.04,1,179724,179298,426
30225381,8.00106,8.00017,426,269645,0.00102148,0.07,1,179732,179306,426
30228301,8.00021,8.00003,426,269645,0.0242043,0.03,1,179740,179314,426
30231221,7.20004,8.00001,425,269645,0.00484086,0.05,1,179747,179322,425
30234141,8.64001,8,426,269645,0.000968172,0.01,1,179756,179330,426
30237061,8.128,8,426,269645,0.00819363,0.05,1,179764,179338,426
30239041,7.2256,8,425,269645,0.00963873,0.01,1,179771,179346,425
30241961,9.44512,8.8,426,269645,0.00992775,0.01,1,179781,179355,426
30244881,8.28902,8.16,426,269645,0.00998555,0.03,1,179789,179363,426
30247801,8.0578,8.032,426,269645,0.0179971,0.07,1,179797,179371,426
30250721,8.01156,8.0064,426,269645,0.0115994,0.04,1,179805,179379,426
30253641,8.00231,8.00128,426,269645,0.0103199,0.05,1,179813,179387,426
30256561,8.00046,8.00026,426,269645,0.018064,0.05,1,179821,179395,426
30259481,8.00009,8.00005,426,269645,0.0036128,0.07,1,179829,179403,426
30262401,7.20002,8.00001,425,269645,0.0327226,0.06,1,179836,179411,425
30264421,6.24,8,423,269645,0.0145445,0.03,1,179842,179419,423
30266501,13.248,5.6,433,269645,0.0349089,0.03,1,179857,179424,433
30269421,10.6496,13.92,427,269645,0.0149818,0.01,1,179867,179440,427
30272341,6.92992,9.184,425,269645,0.00299636,0.04,1,179873,179448,425
30275261,8.58598,8.2368,426,269645,0.000599271,0.03,1,179882,179456,426
30277941,8.9172,8.04736,427,269645,0.0161199,0.02,1,179891,179464,427
30280021,10.5834,8.80947,429,269645,0.027224,0.02,1,179902,179473,429
30281681,6.91669,9.76189,425,269645,0.0294448,0,1,179908,179483,425
30283761,18.1833,17.9524,426,269645,0.013889,0.04,1,179929,179503,426
30285841,13.2367,13.1905,426,269645,0.0107778,0.03,1,179941,179515,426
30288761,12.2473,12.2381,426,269645,0.0101556,0.01,1,179953,179527,426
30291681,8.84947,8.84762,426,269645,0.0100311,0.02,1,179961,179535,426
30294161,7.36989,8.16952,425,269645,0.00200622,0.06,1,179968,179543,425
30296241,7.87398,7.2339,426,269645,0.0164012,0.02,1,179976,179550,426
30299161,6.3748,6.24678,426,269645,0.0112802,0.04,1,179982,179556,426
30301441,6.87496,7.64936,425,269645,0.0262561,0.03,1,179989,179564,425
30304361,11.775,10.3299,427,269645,0.0292512,0,1,180002,179575,427
30306021,11.155,8.46597,430,269645,0.00585024,0.01,1,180013,179583,430
30308941,9.431,11.2932,427,269645,0.03317,0.02,1,180022,179595,427
30311861,7.4862,8.65864,426,269645,0.00663401,0.04,1,180029,179603,426
30314781,8.69724,8.13173,427,269645,0.0013268,0.04,1,180038,179611,427
30317461,8.93945,8.02635,428,269645,0.0242654,0.05,1,180047,179619,428
30320381,7.38789,8.80527,426,269645,0.0288531,0.03,1,180054,179628,426
30323301,7.87758,8.16105,426,269645,0.0137706,0.05,1,180062,179636,426
30326221,7.17552,8.03221,425,269645,0.0107541,0.03,1,180069,179644,425
30329141,7.8351,8.00644,425,269645,0.0101508,0.05,1,180077,179652,425
30330981,20.767,8.00129,441,269645,0.0100302,0,1,180101,179660,441
30333901,10.5534,19.2003,427,269645,0.010006,0.05,1,180109,179682,427
30336821,8.51068,10.2401,427,269645,0.00200121,0.04,1,180117,179690,427
30339741,7.30214,8.44801,426,269645,0.0404002,0.05,1,180124,179698,426
30342661,8.66043,8.0896,427,269645,0.0320801,0.05,1,180133,179706,427
30345541,6.53209,8.01792,425,269645,0.00641601,0.03,1,180139,179714,425
30348461,7.70642,8.00358,425,269645,0.0252832,0.03,1,180147,179722,425
30351381,8.74128,8.00072,426,269645,0.0210566,0.01,1,180156,179730,426
30354301,7.34826,8.00014,425,269645,0.0122113,0.03,1,180163,179738,425
30357221,8.66965,8.00003,426,269645,0.0104423,0.03,1,180172,179746,426
30360101,8.13393,8.00001,426,269645,0.0420885,0.03,1,180180,179754,426
30363021,7.22679,8,425,269645,0.0164177,0.03,1,180187,179762,425
30365941,8.64536,8,426,269645,0.0432835,0.03,1,180196,179770,426
30368861,7.32907,8,425,269645,0.0326567,0.04,1,180203,179778,425
30371541,9.46581,8,427,269645,0.00653134,0.03,1,180213,179786,427
30374461,8.29316,8.8,426,269645,0.0173063,0.02,1,180221,179795,426
30377381,7.25863,8.16,425,269645,0.0274613,0.06,1,180228,179803,425
30380301,7.85173,8.032,425,269645,0.0294923,0.05,1,180236,179811,425
30383221,7.97035,8.0064,425,269645,0.0218985,0.02,1,180244,179819,425
30386141,7.99407,8.00128,425,269645,0.0283797,0.05,1,180252,179827,425
30389061,8.79881,8.00026,426,269645,0.0296759,0.01,1,180261,179835,426
30391301,7.35976,8.00005,425,269645,0.0379352,0.06,1,180268,179843,425
30394221,6.27195,6.40001,425,269645,0.00758704,0.04,1,180274,179849,425
30396501,7.65439,7.68,425,269645,0.00951741,0.01,1,180282,179857,425
30398581,12.7309,7.936,431,269645,0.0339035,0.03,1,180296,179865,431
30401501,8.94618,12.7872,425,269645,0.0147807,0.01,1,180304,179879,425
30404421,8.98924,8.95744,426,269645,0.0109561,0.03,1,180313,179887,426
30406901,9.79785,8.19149,428,269645,0.0101912,0.04,1,180323,179895,428
30408561,7.55957,9.6383,425,269645,0.0420382,0.03,1,180330,179905,425
30411481,7.91191,8.32766,425,269645,0.0324076,0.03,1,180338,179913,425
30414181,20.7824,8.06553,441,269645,0.0304815,0.03,1,180362,179921,441
30416261,13.7565,20.0131,430,269645,0.0140963,0.03,1,180374,179944,430
30418341,8.3513,14.4026,424,269645,0.00281926,0.01,1,180381,179957,424
30420421,10.4703,7.68052,429,269645,0.0245639,0.03,1,180392,179963,429
30423341,10.0941,11.1361,427,269645,0.00491277,0.01,1,180402,179975,427
30426261,7.61881,8.62722,426,269645,0.000982554,0.04,1,180409,179983,426
30429181,7.92376,8.12544,426,269645,0.0321965,0.05,1,180417,179991,426
30432101,7.18475,8.02509,425,269645,0.0064393,0.03,1,180424,179999,425
30434561,8.63695,8.00502,426,269645,0.00928786,0.04,1,180433,180007,426
30436641,6.52739,7.201,425,269645,0.0258576,0.01,1,180439,180014,425
30439561,15.7055,15.0402,426,269645,0.0451715,0.05,1,180457,180031,426
30442481,9.5411,9.40804,426,269645,0.0330343,0.05,1,180465,180039,426
30445401,7.50822,8.28161,425,269645,0.00660686,0.05,1,180472,180047,425
30448321,8.70164,8.05632,426,269645,0.00132137,0.01,1,180481,180055,426
30451201,7.34033,8.01126,425,269645,0.000264274,0.04,1,180488,180063,425
30454121,9.46807,8.00225,427,269645,0.0320529,0.04,1,180498,180071,427
30457041,7.49361,8.00045,426,269645,0.0624106,0.04,1,180505,180079,426
30459521,7.09872,8.00009,425,269645,0.0204821,0,1,180512,180087,425
30461601,17.4197,17.6,425,269645,0.0280964,0.02,1,180532,180107,425
30464521,9.88395,8.32,427,269645,0.0376193,0.03,1,180540,180113,427
30467441,8.37679,8.064,427,269645,0.0155239,0.06,1,180548,180121,427
30469921,7.27536,8.0128,426,269645,0.0111048,0.06,1,180555,180129,426
30472841,14.2551,14.4026,426,269645,0.010221,0.01,1,180571,180145,426
30475761,8.45101,9.28051,425,269645,0.0180442,0.06,1,180578,180153,425
30478681,9.6902,8.2561,427,269645,0.0196088,0.03,1,180588,180161,427
30481601,7.53804,8.05122,426,269645,0.0279218,0.03,1,180595,180169,426
30484521,7.90761,8.01024,426,269645,0.0215844,0.04,1,180603,180177,426
30487441,7.98152,8.00205,426,269645,0.00431687,0.02,1,180611,180185,426
30490361,7.9963,8.00041,426,269645,0.000863374,0.02,1,180619,180193,426
30493281,7.99926,8.00008,426,269645,0.000172675,0.03,1,180627,180201,426
30496201,7.19985,8.00002,425,269645,0.0240345,0.03,1,180634,180209,425
30499121,8.63997,8,426,269645,0.00480691,0.02,1,180643,180217,426
30502041,8.92799,8,427,269645,0.0329614,0.02,1,180652,180225,427
30504961,7.3856,8,426,269645,0.0305923,0.04,1,180659,180233,426
30507881,7.87712,8,426,269645,0.0301185,0.04,1,180667,180241,426
30510481,7.17542,8,425,269645,0.00602369,0.07,1,180674,180249,425
30513401,7.83508,7.2,426,269645,0.00120474,0.02,1,180682,180256,426
30516321,7.96702,7.84,426,269645,0.00824095,0.03,1,180690,180264,426
30519241,7.9934,7.968,426,269645,0.00964819,0.06,1,180698,180272,426
30522161,8.79868,7.9936,427,269645,0.00192964,0.03,1,180707,180280,427
30525081,7.35974,7.99872,426,269645,0.0403859,0.04,1,180714,180288,426
30527121,7.07195,7.99974,425,269645,0.0400772,0.02,1,180721,180296,425
30530041,13.4144,13.5999,425,269645,0.0160154,0.02,1,180736,180311,425
30532321,9.88288,9.11999,426,269645,0.0112031,0.03,1,180745,180319,426
30535241,6.77658,6.624,426,269645,0.0102406,0.04,1,180751,180325,426
30538161,6.95531,7.7248,425,269645,0.0100481,0.05,1,180758,180333,425
30541061,10.1911,7.94496,428,269645,0.0180096,0.04,1,180769,180341,428
30543141,25.2382,9.58899,447,269645,0.00360192,0.02,1,180798,180351,447
30546061,12.2476,25.9178,426,269645,0.0247204,0.03,1,180807,180381,426
30548961,8.04953,11.5836,425,269645,0.00494408,0.03,1,180814,180389,425
30551041,12.8099,11.9167,427,269645,0.000988815,0.07,1,180828,180401,427
30553961,11.362,12.7833,425,269645,0.00819776,0.02,1,180839,180414,425
30556881,9.4724,8.95667,426,269645,0.0416396,0.03,1,180848,180422,426
30559801,8.29448,8.19133,426,269645,0.0163279,0.05,1,180856,180430,426
30562721,7.2589,8.03827,425,269645,0.0192656,0.06,1,180863,180438,425
30565641,8.65178,8.00765,426,269645,0.0118531,0.05,1,180872,180446,426
30567681,7.33036,8.00153,425,269645,0.0343706,0.04,1,180879,180454,425
30569761,7.86607,8.00031,425,269645,0.0548741,0.04,1,180887,180462,425
30572681,11.1732,11.2001,425,269645,0.0429748,0.03,1,180899,180474,425
30575601,10.2346,8.64001,427,269645,0.048595,0.02,1,180909,180482,427
30577461,9.24693,8.128,428,269645,0.041719,0.04,1,180918,180490,428
30580381,7.44939,8.0256,427,269645,0.0163438,0.06,1,180925,180498,427
30583301,7.88988,8.00512,427,269645,0.0112688,0.06,1,180933,180506,427
30586221,7.17798,8.00102,426,269645,0.0262538,0.05,1,180940,180514,426
30588901,9.43559,8.0002,428,269645,0.0372507,0.04,1,180950,180522,428
30591821,8.28712,9.60004,426,269645,0.0474502,0.04,1,180958,180532,426
30594101,10.4574,8.32001,429,269645,0.02549,0.02,1,180969,180540,429
30596181,11.6915,11.264,429,269645,0.00509801,0.05,1,180981,180552,429
30599101,8.7383,11.8528,425,269645,0.0090196,0.03,1,180989,180564,425
30602021,8.14766,8.77056,425,269645,0.00180392,0.05,1,180997,180572,425
30604501,7.22953,8.15411,424,269645,0.00836078,0.04,1,181004,180580,424
30606161,7.04591,7.23082,424,269645,0.0336722,0.01,1,181011,180587,424
30609081,11.0092,9.44616,426,269645,0.0387344,0.01,1,181023,180597,426
30612001,10.2018,8.28923,428,269645,0.0157469,0.02,1,181033,180605,428
30614921,6.84037,8.05785,426,269645,0.0271494,0.05,1,181039,180613,426
30617841,8.56807,8.01157,427,269645,0.00542988,0.04,1,181048,180621,427
30620721,6.51361,8.00231,425,269645,0.017086,0.03,1,181054,180629,425
30623641,8.50272,8.00046,426,269645,0.0114172,0.02,1,181063,180637,426
30626561,8.90054,8.00009,427,269645,0.0102834,0.01,1,181072,180645,427
30629481,7.38011,8.00002,426,269645,0.0100567,0.03,1,181079,180653,426
30632401,7.07602,8,425,269645,0.0100113,0.03,1,181086,180661,425
30635321,8.6152,8,426,269645,0.0420023,0,1,181095,180669,426
30638241,8.12304,8,426,269645,0.0484005,0.02,1,181103,180677,426
30641161,8.02461,8,426,269645,0.0416801,0.04,1,181111,180685,426
30644081,8.00492,8,426,269645,0.024336,0.04,1,181119,180693,426
30647001,8.80098,8,427,269645,0.0288672,0.08,1,181128,180701,427
30649841,7.3602,8,426,269645,0.0377734,0.04,1,181135,180709,426
30652761,7.87204,8,426,269645,0.0235547,0.04,1,181143,180717,426
30655681,7.17441,8,425,269645,0.0127109,0.03,1,181150,180725,425
30658601,7.83488,8,425,269645,0.00254219,0.03,1,181158,180733,425
30661521,8.76698,8,426,269645,0.0245084,0.02,1,181167,180741,426
30663361,6.5534,8,424,269645,0.0289017,0.03,1,181173,180749,424
30665441,6.91068,5.6,426,269645,0.0297803,0.04,1,181180,180754,426
30668361,11.7821,12.32,425,269645,0.0299561,0.05,1,181193,180768,425
30671281,8.75643,8.864,425,269645,0.0299912,0.03,1,181201,180776,425
30673141,18.5513,8.1728,438,269645,0.0299982,0.01,1,181222,180784,438
30675221,11.7103,18.4346,427,269645,0.00599965,0.02,1,181232,180805,427
30676881,7.94205,11.6869,424,269645,0.00919993,0.03,1,181239,180815,424
30679801,10.3884,10.3374,425,269645,0.02584,0.02,1,181250,180825,425
30682081,9.27768,8.46748,426,269645,0.037168,0.03,1,181259,180833,426
30685001,18.6555,19.2935,425,269645,0.0314336,0.04,1,181280,180855,425
30687921,10.9311,10.2587,426,269645,0.0142867,0.03,1,181289,180863,426
30690841,9.38622,8.45174,427,269645,0.0108573,0.05,1,181298,180871,427
30693761,8.27724,8.09035,427,269645,0.00217147,0.06,1,181306,180879,427
30696681,8.85545,8.01807,428,269645,0.0244343,0.05,1,181315,180887,428
30699601,8.17109,8.00361,428,269645,0.0288869,0.05,1,181323,180895,428
30702261,12.8342,8.00072,434,269645,0.0137774,0.04,1,181337,180903,434
30705181,8.16684,14.4001,425,269645,0.0107555,0.01,1,181344,180919,425
30708101,9.63337,9.28003,427,269645,0.0101511,0,1,181354,180927,427
30711021,8.32667,8.25601,427,269645,0.00203022,0.04,1,181362,180935,427
30713941,8.06533,8.0512,427,269645,0.032406,0.05,1,181370,180943,427
30716861,8.01307,8.01024,427,269645,0.0384812,0.04,1,181378,180951,427
30719781,7.20261,8.00205,426,269645,0.0236962,0.03,1,181385,180959,426
30722641,7.04052,8.00041,425,269645,0.0207392,0.04,1,181392,180967,425
30724721,7.8081,8.00008,425,269645,0.0201479,0.03,1,181400,180975,425
30726801,8.76162,8.00002,426,269645,0.0280296,0.03,1,181409,180983,426
30729721,11.3523,11.2,426,269645,0.00560591,0.03,1,181421,180995,426
30731381,8.67046,8.64,426,269645,0.0411212,0.03,1,181429,181003,426
30734301,8.93409,8.928,426,269645,0.0322242,0.01,1,181438,181012,426
30737201,7.38682,8.1856,425,269645,0.0464448,0.02,1,181445,181020,425
30739281,7.87736,8.03712,425,269645,0.033289,0.03,1,181453,181028,425
30742201,11.1755,10.4074,426,269645,0.0306578,0.01,1,181465,181039,426
30745121,8.63509,8.48148,426,269645,0.0381316,0.03,1,181473,181047,426
30746981,8.12702,8.0963,426,269645,0.0316263,0.04,1,181481,181055,426
30749901,8.0254,8.81926,425,269645,0.0463253,0.02,1,181489,181064,425
30752821,8.80508,8.16385,426,269645,0.0412651,0.02,1,181498,181072,426
30755741,8.96102,8.03277,427,269645,0.024253,0.03,1,181507,181080,427
30758661,8.1922,8.00655,427,269645,0.0448506,0.04,1,181515,181088,427
30761581,7.23844,8.00131,426,269645,0.00897012,0.04,1,181522,181096,426
30764501,7.04769,8.00026,425,269645,0.00979402,0.05,1,181529,181104,425
30767421,8.60954,8.00005,426,269645,0.0259588,0,1,181538,181112,426
30770341,8.12191,8.00001,426,269645,0.0291918,0.03,1,181546,181120,426
30773261,8.02438,8,426,269645,0.0298384,0.03,1,181554,181128,426
30776101,7.20488,8,425,269645,0.0139677,0.03,1,181561,181136,425
30779021,8.64098,8,426,269645,0.0267935,0.01,1,181570,181144,426
30781941,8.1282,8,426,269645,0.0133587,0.05,1,181578,181152,426
30784861,8.82564,8,427,269645,0.0506717,0.04,1,181587,181160,427
30787781,8.16513,8,427,269645,0.0421343,0.04,1,181595,181168,427
30790701,7.23303,8,426,269645,0.0164269,0.03,1,181602,181176,426
30793621,7.84661,8,426,269645,0.0112854,0.05,1,181610,181184,426
30796481,7.16932,8,425,269645,0.0262571,0.05,1,181617,181192,425
30798561,7.83386,8,425,269645,0.0212514,0.06,1,181625,181200,425
30801481,11.1668,9.6,427,269645,0.0442503,0.01,1,181637,181210,427
30803141,9.43335,8.32,428,269645,0.0328501,0.03,1,181646,181218,428
30805221,9.88667,10.464,427,269645,0.05457,0.02,1,181656,181229,427
30807301,9.17733,10.0928,426,269645,0.010914,0.03,1,181665,181239,426
30809381,9.83547,8.41856,428,269645,0.0101828,0.05,1,181675,181247,428
30811461,8.36709,8.88371,427,269645,0.0420366,0.05,1,181683,181256,427
30813121,7.27342,8.97674,425,269645,0.0164073,0.03,1,181690,181265,425
30816041,24.6547,24.9953,425,269645,0.00328146,0.01,1,181719,181294,425
30818961,11.3309,11.3991,425,269645,0.000656292,0.05,1,181727,181302,425
30821881,9.46619,8.67981,426,269645,0.00813126,0.01,1,181736,181310,426
30824801,7.49324,8.13596,425,269645,0.00962625,0.05,1,181743,181318,425
30827721,7.89865,8.02719,425,269645,0.00992525,0.04,1,181751,181326,425
30829761,8.77973,8.00544,426,269645,0.0259851,0.02,1,181760,181334,426
30832681,10.5559,11.2011,425,269645,0.037197,0.03,1,181771,181346,425
30835601,9.31119,8.64022,426,269645,0.0154394,0.01,1,181780,181354,426
30838521,8.26224,8.12804,426,269645,0.0190879,0.04,1,181788,181362,426
30841201,7.25245,8.02561,425,269645,0.0118176,0.05,1,181795,181370,425
30844121,10.2505,9.60512,426,269645,0.00236352,0.01,1,181806,181380,426
30847041,8.4501,8.32102,426,269645,0.0084727,0.06,1,181814,181388,426
30849961,8.09002,8.0642,426,269645,0.00969454,0.06,1,181822,181396,426
30852881,7.218,8.01284,425,269645,0.0259389,0.03,1,181829,181404,425
30855761,8.6436,8.00257,426,269645,0.0291878,0,1,181838,181412,426
30857841,8.92872,8.80051,426,269645,0.0298376,0.07,1,181847,181421,426
30860761,10.5857,11.3601,425,269645,0.0139675,0.03,1,181858,181433,425
30863681,8.51715,8.67202,425,269645,0.0107935,0.04,1,181866,181441,425
30866581,8.10343,8.1344,425,269645,0.0101587,0.03,1,181874,181449,425
30868241,7.22069,8.02688,424,269645,0.0180317,0.03,1,181881,181457,424
30870321,7.04414,5.60538,426,269645,0.00360635,0.05,1,181888,181462,426
30872401,5.40883,5.92108,425,269645,0.0247213,0.03,1,181893,181468,425
30875321,7.48177,5.98422,427,269645,0.0289443,0.03,1,181901,181474,427
30876981,8.69635,7.59684,428,269645,0.0137889,0.06,1,181910,181482,428
30879061,6.53927,9.51937,424,269645,0.0187578,0.06,1,181916,181492,424
30881981,6.90785,6.70387,425,269645,0.0277516,0.05,1,181923,181498,425
30883841,7.78157,7.74077,425,269645,0.0295503,0.01,1,181931,181506,425
30886761,7.95631,7.14815,426,269645,0.0299101,0.03,1,181939,181513,426
30889041,7.19126,7.82963,425,269645,0.00598201,0.02,1,181946,181521,425
30891961,10.2383,9.56593,426,269645,0.0331964,0.02,1,181957,181531,426
30894881,8.44765,8.31319,426,269645,0.0386393,0.04,1,181965,181539,426
30897801,8.08953,8.06264,426,269645,0.0397279,0.02,1,181973,181547,426
30900721,8.01791,8.01253,426,269645,0.0399456,0.04,1,181981,181555,426
30903641,7.20358,8.00251,425,269645,0.0399891,0.06,1,181988,181563,425
30906561,8.64072,8.0005,426,269645,0.00799782,0.03,1,181997,181571,426
30909481,8.12814,8.0001,426,269645,0.0255996,0.06,1,182005,181579,426
30911301,8.82563,8.00002,427,269645,0.0211199,0.01,1,182014,181587,427
30914221,8.16513,8.8,426,269645,0.012224,0.04,1,182022,181596,426
30917141,8.83303,8.16,427,269645,0.0264448,0.02,1,182031,181604,427
30920061,8.96661,8.032,428,269645,0.037289,0.04,1,182040,181612,428
30922981,8.19332,8.0064,428,269645,0.0474578,0.05,1,182048,181620,428
30925901,8.03866,8.00128,428,269645,0.00949156,0.06,1,182056,181628,428
30928821,7.20773,8.00026,427,269645,0.00189831,0.05,1,182063,181636,427
30931681,6.24155,8.00005,425,269645,0.000379662,0.07,1,182069,181644,425
30934601,10.8483,10.4,426,269645,7.59324e-05,0.04,1,182081,181655,426
30937301,13.3697,8.48,432,269645,0.00801519,0,1,182095,181663,432
30940001,8.27393,12.096,426,269645,0.025603,0.04,1,182102,181676,426
30942921,8.85479,10.4192,425,269645,0.0291206,0.05,1,182111,181686,425
30945621,35.371,8.48384,459,269645,0.0138241,0.05,1,182153,181694,459
30948541,13.4742,35.2968,425,269645,0.00276482,0.02,1,182161,181736,425
30951461,9.09484,13.4594,425,269645,0.00855296,0.05,1,182169,181744,425
30953941,8.21897,9.09187,425,269645,0.00971059,0.05,1,182177,181752,425
30956861,8.04379,7.41837,426,269645,0.0259421,0.07,1,182185,181759,426
30959781,7.20876,7.88367,425,269645,0.00518842,0.05,1,182192,181767,425
30962701,8.64175,7.97673,426,269645,0.0250377,0.03,1,182201,181775,426
30964341,10.5284,7.99535,429,269645,0.0290075,0.04,1,182212,181783,429
30967261,8.50567,10.3991,426,269645,0.0298015,0.03,1,182220,181794,426
30970181,7.30113,8.47981,425,269645,0.0219603,0.04,1,182227,181802,425
30973101,8.66023,8.09596,426,269645,0.0283921,0,1,182236,181810,426
30975781,11.332,8.01919,430,269645,0.0136784,0.03,1,182248,181818,430
30978701,8.66641,10.4038,427,269645,0.0107357,0.04,1,182256,181829,427
30981621,7.33328,8.48077,426,269645,0.0181471,0.02,1,182263,181837,426
30983681,7.06666,8.09615,425,269645,0.0276294,0.03,1,182270,181845,425
30986601,8.61333,8.01923,426,269645,0.0455259,0.01,1,182279,181853,426
30989521,8.12267,8.00385,426,269645,0.0411052,0.03,1,182287,181861,426
30992421,12.0245,8.00077,431,269645,0.040221,0.04,1,182300,181869,431
30995341,8.80491,12.0002,426,269645,0.0240442,0.06,1,182308,181882,426
30998261,8.16098,8.80003,426,269645,0.0288088,0.06,1,182316,181890,426
31001181,8.0322,8.16001,426,269645,0.0297618,0.04,1,182324,181898,426
31004101,8.00644,8.032,426,269645,0.0299524,0.07,1,182332,181906,426
31006981,7.20129,8.0064,425,269645,0.0539905,0.06,1,182339,181914,425
31009681,8.64026,8.00128,426,269645,0.0347981,0.01,1,182348,181922,426
31012601,7.32805,7.20026,426,269645,0.0549596,0.04,1,182355,181929,426
31014261,7.86561,7.84005,426,269645,0.0349919,0.01,1,182363,181937,426
31016961,7.97312,7.96801,426,269645,0.0389984,0,1,182371,181945,426
31019881,9.59462,8.7936,427,269645,0.0157997,0.02,1,182381,181954,427
31022161,7.51892,8.15872,426,269645,0.0191599,0.07,1,182388,181962,426
31025081,5.50378,6.43174,425,269645,0.011832,0.04,1,182393,181968,425
31028001,8.30076,7.68635,426,269645,0.0103664,0.02,1,182402,181976,426
31029861,7.26015,7.93727,425,269645,0.0100733,0.05,1,182409,181984,425
31032781,7.85203,7.18745,426,269645,0.0180147,0.07,1,182417,181991,426
31034641,7.17041,7.83749,425,269645,0.00360293,0.03,1,182424,181999,425
31036721,6.23408,6.3675,425,269645,0.0167206,0.02,1,182430,182005,425
31039641,9.24682,8.4735,426,269645,0.0433441,0.03,1,182440,182014,426
31041301,6.64936,8.0947,424,269645,0.0326688,0.01,1,182446,182022,424
31044221,6.92987,5.61894,426,269645,0.0145338,0.06,1,182453,182027,426
31047141,8.58597,7.52379,427,269645,0.00290675,0.05,1,182462,182035,427
31050061,7.31719,7.90476,426,269645,0.0245814,0.04,1,182469,182043,426
31051701,8.66344,7.98095,427,269645,0.00491627,0.03,1,182478,182051,427
31053361,7.33269,8.79619,425,269645,0.00898325,0.05,1,182485,182060,425
31056281,5.46654,5.75924,425,269645,0.00979665,0.04,1,182490,182065,425
31059201,7.49331,7.55185,425,269645,0.0259593,0.02,1,182498,182073,425
31062121,7.89866,7.91037,425,269645,0.0291919,0.03,1,182506,182081,425
31064801,7.97973,7.98207,425,269645,0.0218384,0.03,1,182514,182089,425
31067721,11.1959,9.59641,427,269645,0.00436767,0,1,182526,182099,427
31069381,7.83919,8.31928,426,269645,0.0248735,0.02,1,182533,182107,426
31072301,7.96784,8.06386,426,269645,0.0289747,0.04,1,182541,182115,426
31074581,34.3936,8.01277,459,269645,0.0377949,0.01,1,182582,182123,459
31077501,13.2787,34.4026,426,269645,0.031559,0.04,1,182590,182164,426
31080421,9.05574,13.2805,426,269645,0.0223118,0.04,1,182598,182172,426
31082481,7.41115,9.0561,425,269645,0.0284624,0.02,1,182605,182180,425
31085401,11.0822,10.6112,426,269645,0.0136925,0.01,1,182617,182191,426
31088321,8.61645,8.52224,426,269645,0.0427385,0.03,1,182625,182199,426
31091241,8.12329,8.10445,426,269645,0.0405477,0.04,1,182633,182207,426
31094161,7.22466,8.02089,425,269645,0.0241095,0.05,1,182640,182215,425
31096421,7.84493,8.00418,425,269645,0.0128219,0.05,1,182648,182223,425
31099341,8.76899,8.00084,426,269645,0.0265644,0.02,1,182657,182231,426
31102261,8.1538,8.00017,426,269645,0.0133129,0.04,1,182665,182239,426
31104741,12.0308,8.00003,431,269645,0.00266257,0.04,1,182678,182247,431
31107661,8.80615,12,426,269645,0.0245325,0.03,1,182686,182260,426
31110581,8.96123,8.8,427,269645,0.0129065,0.04,1,182695,182268,427
31113501,7.39225,8.16,426,269645,0.0025813,0.06,1,182702,182276,426
31116421,8.67845,8.032,427,269645,0.0245163,0.04,1,182711,182284,427
31118261,9.73569,8.0064,429,269645,0.0369033,0.03,1,182721,182292,429
31121181,8.34714,10.4013,426,269645,0.0153806,0.06,1,182729,182303,426
31123041,7.26943,8.48026,425,269645,0.0190761,0.03,1,182736,182311,425
31125961,10.2539,8.89605,427,269645,0.0118152,0.01,1,182747,182320,427
31128881,8.45078,8.17921,427,269645,0.026363,0.03,1,182755,182328,427
31131361,8.09016,8.03584,427,269645,0.0292726,0.05,1,182763,182336,427
31134281,6.41803,7.20717,426,269645,0.0138545,0.04,1,182769,182343,426
31137201,8.48361,7.84143,427,269645,0.0107709,0.06,1,182778,182351,427
31140121,6.49672,7.96829,425,269645,0.0101542,0.07,1,182784,182359,425
31142801,7.69934,7.99366,425,269645,0.0260308,0.02,1,182792,182367,425
31145721,7.13987,7.19873,425,269645,0.0452062,0.03,1,182799,182374,425
31148001,7.82797,7.83975,425,269645,0.0330412,0.02,1,182807,182382,425
31150921,7.96559,7.96795,425,269645,0.00660825,0.03,1,182815,182390,425
31153841,7.99312,7.99359,425,269645,0.00932165,0.02,1,182823,182398,425
31156741,8.79862,7.99872,426,269645,0.00986433,0.03,1,182832,182406,426
31159661,8.15972,7.99974,426,269645,0.0259729,0.04,1,182840,182414,426
31161941,10.4319,7.99995,429,269645,0.0291946,0.04,1,182851,182422,429
31164861,8.48639,9.59999,427,269645,0.00583891,0.05,1,182859,182432,427
31167761,6.49728,8.32,425,269645,0.0171678,0.02,1,182865,182440,425
31170681,11.6995,11.264,426,269645,0.0114336,0.04,1,182878,182452,426
31173601,8.73989,8.6528,426,269645,0.0422867,0.06,1,182886,182460,426
31176501,8.14798,8.13056,426,269645,0.00845734,0.04,1,182894,182468,426
31179421,7.2296,8.02611,425,269645,0.0256915,0.04,1,182901,182476,425
31182341,8.64592,8.00522,426,269645,0.0211383,0.01,1,182910,182484,426
31184401,8.12918,8.00104,426,269645,0.0282277,0.01,1,182918,182492,426
31187321,8.82584,8.00021,427,269645,0.0216455,0.02,1,182927,182500,427
31190241,7.36517,8.00004,426,269645,0.0123291,0.03,1,182934,182508,426
31193161,7.87303,8.00001,426,269645,0.00246582,0.02,1,182942,182516,426
31195841,7.97461,8,426,269645,0.000493164,0.05,1,182950,182524,426
31198761,10.3949,10.4,426,269645,0.0320986,0.01,1,182961,182535,426
31201461,9.27898,8.48,427,269645,0.0304197,0.02,1,182970,182543,427
31203121,5.8558,7.296,425,269645,0.0380839,0.01,1,182975,182550,425
31205201,29.1712,28.6592,426,269645,0.0156168,0.04,1,183010,182584,426
31208121,19.4342,20.1318,425,269645,0.0111234,0.01,1,183027,182602,425
31211041,11.8868,10.4264,427,269645,0.0182247,0.02,1,183037,182610,427
31213961,8.77737,8.48527,427,269645,0.00364493,0.07,1,183045,182618,427
31216881,6.55547,8.09705,425,269645,0.040729,0.05,1,183051,182626,425
31218721,6.91109,8.01941,424,269645,0.0401458,0.03,1,183058,182634,424
31221641,9.38222,8.00388,426,269645,0.0160292,0.06,1,183068,182642,426
31224561,7.47644,8.00078,425,269645,0.0192058,0.03,1,183075,182650,425
31227481,7.89529,8.00016,425,269645,0.00384117,0.04,1,183083,182658,425
31230161,7.97906,8.00003,425,269645,0.00876823,0.01,1,183091,182666,425
31233081,8.79581,8.80001,425,269645,0.0337536,0,1,183100,182675,425
31235361,8.15916,8.16,425,269645,0.0467507,0.02,1,183108,182683,425
31238281,13.6318,12.832,426,269645,0.0333501,0.01,1,183123,182697,426
31241201,9.12637,8.9664,426,269645,0.03867,0.04,1,183131,182705,426
31244121,7.42527,8.19328,425,269645,0.039734,0.04,1,183138,182713,425
31246801,7.88505,8.03866,425,269645,0.0319468,0.03,1,183146,182721,425
31248881,7.17701,7.20773,425,269645,0.0383894,0.05,1,183153,182728,425
31251801,11.8354,11.0415,426,269645,0.0156779,0.03,1,183166,182740,426
31254721,8.76708,8.60831,426,269645,0.0271356,0.05,1,183174,182748,426
31257641,8.15342,8.12166,426,269645,0.00542712,0.04,1,183182,182756,426
31259281,7.23068,8.02433,425,269645,0.00908542,0.01,1,183189,182764,425
31262201,5.44614,5.60487,425,269645,0.00981708,0.03,1,183194,182769,425
31264481,8.28923,7.52097,426,269645,0.0259634,0.03,1,183203,182777,426
31267401,7.25785,6.30419,427,269645,0.0131927,0.04,1,183210,182783,427
31269061,6.25157,7.66084,425,5840,0.0346385,0.07,1,183216,182791,425
31271981,6.85031,7.13217,425,5840,0.0309277,0.06,1,183223,182798,425
31274901,7.77006,7.82643,425,5840,0.0301855,0.02,1,183231,182806,425
31277821,7.95401,7.96529,425,5840,0.0140371,0.03,1,183239,182814,425
31280501,7.9908,7.99306,425,5840,0.0108074,0.03,1,183247,182822,425
31283421,7.99816,7.19861,426,5840,0.0101615,0.02,1,183255,182829,426
31285701,5.59963,7.83972,423,5840,0.0100323,0.05,1,183260,182837,423
31288621,7.51993,6.36794,425,5840,0.0100065,0.03,1,183268,182843,425
31291541,8.70399,7.67359,426,5840,0.0100013,0.04,1,183277,182851,426
31294021,9.7408,7.93472,428,5840,0.00200026,0.04,1,183287,182859,428
31296941,9.14816,9.58694,427,5840,0.000400052,0.04,1,183296,182869,427
31298801,5.82963,8.31739,424,5840,0.02408,0.07,1,183301,182877,424
31301721,8.36593,7.26348,426,5840,0.020816,0.01,1,183310,182884,426
31304641,8.07319,7.8527,426,5840,0.0041632,0.06,1,183318,182892,426
31307121,7.21464,7.97054,425,5840,0.00083264,0.07,1,183325,182900,425
31310041,7.84293,7.19411,426,5840,0.000166528,0.06,1,183333,182907,426
31312961,7.96859,7.83882,426,5840,0.0160333,0.03,1,183341,182915,426
31315441,7.19372,7.96776,425,5840,0.0112067,0.03,1,183348,182923,425
31317521,9.43874,8.79355,426,5840,0.0182413,0.04,1,183358,182932,426
31320441,12.2877,12.1587,426,5840,0.00364827,0.01,1,183371,182945,426
31323361,8.85755,8.83174,426,5840,0.000729653,0.04,1,183379,182953,426
31326281,8.17151,8.16635,426,5840,0.00814593,0.05,1,183387,182961,426
31328961,7.2343,8.03327,425,5840,0.00962919,0.03,1,183394,182969,425
31331881,8.64686,7.20665,427,5840,0.00992584,0.02,1,183403,182976,427
31334161,6.52937,7.84133,425,5840,0.00198517,0.03,1,183409,182984,425
31336241,27.7059,27.9683,425,5840,0.00839703,0.03,1,183442,183017,425
31338321,22.3412,20.7937,427,5840,0.00967941,0.03,1,183463,183036,427
31341241,13.2682,14.5587,425,5840,0.00193588,0.04,1,183474,183049,425
31344161,9.05365,9.31175,425,5840,0.000387176,0.03,1,183482,183057,425
31347081,8.21073,8.26235,425,5840,0.00807744,0.05,1,183490,183065,425
31350001,8.84215,8.05247,426,5840,0.00961549,0.04,1,183499,183073,426
31351841,6.56843,8.01049,424,5840,0.0019231,0.05,1,183505,183081,424
31354761,8.51369,7.2021,426,5840,0.00838462,0.02,1,183514,183088,426
31357681,8.90274,7.84042,427,5840,0.00967692,0.04,1,183523,183096,427
31360601,8.18055,7.96808,427,5840,0.0339354,0.03,1,183531,183104,427
31363281,8.03611,7.99362,427,5840,0.0467871,0.05,1,183539,183112,427
31366201,9.60722,9.59872,427,5840,0.00935742,0.05,1,183549,183122,427
31367861,9.92144,8.31974,429,5840,0.0178715,0.04,1,183559,183130,429
31370781,9.98429,10.4639,428,5840,0.0035743,0.05,1,183569,183141,428
31373701,6.79686,8.49279,426,5840,0.0167149,0.06,1,183575,183149,426
31376621,8.55937,8.09856,427,5840,0.011343,0.04,1,183584,183157,427
31379541,6.51187,8.01971,425,5840,0.00226859,0.04,1,183590,183165,425
31382461,8.50238,8.00394,426,5840,0.000453719,0,1,183599,183173,426
31385121,8.90048,8.00079,427,5840,9.07438e-05,0.05,1,183608,183181,427
31388041,10.5801,11.2002,426,5840,1.81488e-05,0.02,1,183619,183193,426
31390961,8.51602,8.64003,426,5840,3.62975e-06,0.03,1,183627,183201,426
31392421,164.903,8.12801,622,5840,7.2595e-07,0,1,183831,183209,622
31395341,207.381,329.626,430,5840,1.4519e-07,0.03,1,184049,183619,430
31396801,204.676,76.3251,621,14015,0.024,0,1,184253,183632,621
31398261,200.935,174.465,622,15475,0.0208,0,1,184453,183831,622
31401181,168.187,209.293,564,16935,0.00416,0,1,184613,184049,564
31404101,234.437,270.659,529,17227,0.008832,0.02,1,184864,184335,529
31407021,220.487,226.932,530,17227,0.0097664,0.01,1,185081,184551,530
31409941,216.097,218.186,529,20147,0.00995328,0,1,185296,184767,529
31412861,217.62,216.437,531,20147,0.00999066,0.01,1,185514,184983,531
31415781,181.124,198.487,509,20147,0.00199813,0,1,185686,185177,509
31418701,173.025,177.297,508,20147,0.0163996,0.01,1,185857,185349,508
31421621,171.405,173.06,507,20147,0.0112799,0.01,1,186028,185521,507
31424541,172.681,172.212,508,20147,0.00225598,0,1,186201,185693,508
31427461,171.336,172.042,507,20147,0.000451197,0.01,1,186372,185865,507
31430381,171.867,172.008,507,20147,9.02394e-05,0,1,186544,186037,507
31433301,171.973,172.002,507,20147,1.80479e-05,0.03,1,186716,186209,507
31436221,172.795,172,508,20147,3.60957e-06,0,1,186889,186381,508
31439141,172.159,172,508,20147,0.0160007,0,1,187061,186553,508
31442061,171.232,172,507,20147,0.00320014,0.02,1,187232,186725,507
31444981,172.646,172,508,20147,0.000640029,0.02,1,187405,186897,508
31447901,172.129,172,508,20147,0.000128006,0,1,187577,187069,508
31450821,172.026,172,508,20147,2.56011e-05,0.01,1,187749,187241,508
31453741,171.205,172,507,20147,5.12023e-06,0,1,187920,187413,507
31456661,171.841,172,507,20147,1.02405e-06,0,1,188092,187585,507
31459581,172.768,172,508,20147,0.0240002,0.03,1,188265,187757,508
31462501,172.154,172,508,20147,0.00480004,0,1,188437,187929,508
31465421,171.231,172,507,20147,0.000960008,0.02,1,188608,188101,507
31468341,172.646,172,508,20147,0.008192,0.01,1,188781,188273,508
31471261,171.329,172,507,20147,0.0016384,0,1,188952,188445,507
31474181,172.666,172,508,20147,0.00832768,0.01,1,189125,188617,508
31477101,171.333,172,507,20147,0.00166554,0.01,1,189296,188789,507
31480021,171.867,172,507,20147,0.00833311,0,1,189468,188961,507
31482941,171.973,172,507,20147,0.00166662,0.01,1,189640,189133,507
31485861,171.995,172,507,20048,0.000333324,0,1,189812,189305,507
31488781,171.999,172,507,20048,0.00806667,0.02,1,189984,189477,507
31491701,175.2,172,511,20048,0.00961333,0.01,1,190160,189649,511
31494621,173.44,173.6,510,20048,0.0259227,0.01,1,190333,189823,510
31497541,173.088,173.92,509,20048,0.0291845,0,1,190506,189997,509
31500461,173.818,173.984,509,20048,0.0298369,0.01,1,190680,190171,509
31503381,174.764,173.997,510,20048,0.00596738,0,1,190855,190345,510
31506301,174.153,173.999,510,20048,0.00119348,0,1,191029,190519,510
31509221,172.431,174,508,20048,0.000238695,0,1,191201,190693,508
31512141,174.486,174,509,19362,4.7739e-05,0,1,191376,190867,509
31515061,173.297,174,508,19362,0.0400095,0.02,1,191549,191041,508
31517981,177.859,174,513,19362,0.00800191,0,1,191728,191215,513
31520901,182.772,182,513,19362,0.00160038,0.01,1,191912,191399,513
31523821,183.754,183.6,513,19362,0.000320076,0.03,1,192096,191583,513
31526741,183.951,183.92,513,19362,0.00806402,0,1,192280,191767,513
31529661,184.79,183.984,514,19362,0.0096128,0.01,1,192465,191951,514
31532581,183.358,183.997,513,19362,0.00192256,0.01,1,192648,192135,513
31535501,183.872,183.999,513,19362,0.00838451,0.01,1,192832,192319,513
31538421,183.974,184,513,19362,0.0096769,0,1,193016,192503,513
31541341,184.795,184,514,19362,0.0259354,0.01,1,193201,192687,514
31544261,184.159,184,514,19362,0.00518708,0,1,193385,192871,514
31547181,183.232,184,513,19362,0.0250374,0.01,1,193568,193055,513
31550101,184.646,184,514,19362,0.00500748,0.02,1,193753,193239,514
31553021,184.129,184,514,19362,0.0090015,0,1,193937,193423,514
31555941,184.026,184,514,19362,0.0018003,0.03,1,194121,193607,514
31558861,183.205,184,513,5840,0.00036006,0.02,1,194304,193791,513
31561781,184.641,184,514,5840,0.00807201,0,1,194489,193975,514
31564701,317.728,300,536,5840,0.0016144,0,1,194840,194304,536
31567621,248.346,244,537,18584,0.00032288,0,1,195071,194534,537
31570541,294.469,293.6,537,18584,0.0240646,0.01,1,195377,194840,537
31573461,242.894,242.72,537,18584,0.0288129,0,1,195607,195070,537
31576381,231.779,232.544,536,18584,0.00576258,0.01,1,195836,195300,536
31579301,230.356,230.509,536,18441,0.0251525,0,1,196066,195530,536
31582221,231.671,230.102,538,21361,0.0050305,0.01,1,196298,195760,538
31585141,230.334,230.82,537,21361,0.0010061,0,1,196528,195991,537
31588061,195.667,213.364,515,21361,0.00020122,0.01,1,196715,196200,515
31590981,187.933,191.473,515,21401,4.0244e-05,0,1,196901,196386,515
31593901,186.387,187.095,515,21401,0.016008,0,1,197087,196572,515
31596821,184.477,186.219,513,21401,0.0112016,0.01,1,197271,196758,513
31599741,184.095,184.444,513,21401,0.0262403,0.01,1,197455,196942,513
31602661,184.019,184.089,513,21401,0.0212481,0,1,197639,197126,513
31605581,185.604,184.018,515,21401,0.0362496,0,1,197825,197310,515
31608501,183.521,184.004,514,21401,0.0152499,0.01,1,198008,197494,514
31611421,183.904,184.001,514,21401,0.01105,0.01,1,198192,197678,514
31614341,183.981,184,514,21401,0.01021,0.01,1,198376,197862,514
31617261,183.996,184,514,21401,0.010042,0.03,1,198560,198046,514
31620181,183.999,184,514,21401,0.0100084,0,1,198744,198230,514
31623101,184,184,514,21401,0.0180017,0,1,198928,198414,514
31626021,184,184,514,21401,0.00360034,0,1,199112,198598,514
31628941,184,184,514,21401,0.0167201,0.03,1,199296,198782,514
31631861,184,184,514,21401,0.027344,0.01,1,199480,198966,514
31634781,184,184,514,21401,0.0054688,0,1,199664,199150,514
31637701,183.2,184,513,21401,0.0250938,0,1,199847,199334,513
31640621,184.64,184,514,21401,0.00501875,0,1,200032,199518,514
31643541,183.328,184,513,21401,0.0250037,0,1,200215,199702,513
31646461,184.666,184,514,21401,0.0210008,0.01,1,200400,199886,514
31649381,183.333,184,513,21401,0.00420015,0.01,1,200583,200070,513
31652301,183.867,184,513,21401,0.00884003,0,1,200767,200254,513
31655221,184.773,184,514,21401,0.00976801,0.02,1,200952,200438,514
31658141,184.155,184,514,21401,0.0419536,0.02,1,201136,200622,514
31661061,185.631,184,516,21401,0.0163907,0.03,1,201322,200806,516
31663981,183.526,184,515,21401,0.0112781,0,1,201505,200990,515
31666901,183.905,184,515,21401,0.0182556,0.01,1,201689,201174,515
31669821,182.381,184,513,21401,0.0196511,0,1,201871,201358,513
31672741,184.476,184,514,21401,0.0119302,0,1,202056,201542,514
31675661,184.095,184,514,21401,0.010386,0.01,1,202240,201726,514
31678581,183.219,184,513,21401,0.0420772,0.01,1,202423,201910,513
31681501,185.444,184,515,20594,0.0164154,0,1,202609,202094,515
31684421,183.489,184,514,20594,0.0272831,0.03,1,202792,202278,514
31687341,188.698,184,520,20594,0.00545662,0,1,202982,202462,520
31690261,195.34,193.6,521,20594,0.00109132,0,1,203179,202658,521
31693181,194.268,195.52,519,20594,0.00821826,0,1,203373,202854,519
31696101,196.454,195.904,520,20594,0.00964365,0.01,1,203570,203050,520
31699021,196.091,195.981,520,20594,0.0339287,0.01,1,203766,203246,520
31701941,196.018,195.996,520,20594,0.00678575,0.01,1,203962,203442,520
31704861,196.004,195.999,520,20594,0.00935715,0,1,204158,203638,520
31707781,196.001,196,520,20594,0.0258714,0,1,204354,203834,520
31710701,196.8,196,521,20594,0.0131743,0,1,204551,204030,521
31713621,195.36,196,520,20594,0.00263486,0,1,204746,204226,520
31716541,195.072,196,519,20594,0.000526971,0.01,1,204941,204422,519
31719461,195.814,196,519,5840,0.00810539,0.01,1,205137,204618,519
31722381,196.763,196,520,5840,0.00962108,0.01,1,205334,204814,520
31725301,316.153,297.6,543,5840,0.0419242,0.02,1,205680,205137,543
31728221,259.231,254.72,544,17841,0.0163848,0.05,1,205925,205381,544
31731141,291.046,290.144,544,17841,0.011277,0,1,206224,205680,544
31734061,254.209,253.229,545,17841,0.0102554,0,1,206469,205924,545
31736981,245.242,245.846,544,17841,0.0180511,0.01,1,206712,206168,544
31739901,243.448,244.369,543,17841,0.00361022,0.01,1,206955,206412,543
31742821,244.69,244.074,544,17841,0.024722,0,1,207200,206656,544
31745741,244.138,244.015,544,17841,0.0129444,0,1,207444,206900,544
31748661,244.028,244.003,544,17841,0.00258888,0.01,1,207688,207144,544
31751581,244.006,244.001,544,17841,0.000517776,0.02,1,207932,207388,544
31754501,244.001,244,544,17841,0.0241036,0.01,1,208176,207632,544
31757421,243.2,244,543,17841,0.0288207,0.03,1,208419,207876,543
31760341,243.84,244,543,20761,0.00576414,0,1,208663,208120,543
31763261,244.768,244,544,19918,0.00115283,0,1,208908,208364,544
31766181,206.554,224.8,521,19918,0.000230566,0.01,1,209105,208584,521
31769101,207.711,206.56,527,19918,0.00804611,0.01,1,209313,208786,527
31772021,206.342,207.712,525,21703,0.00160922,0,1,209519,208994,525
31774941,207.668,207.942,525,21703,0.00832184,0.03,1,209727,209202,525
31777861,198.334,207.988,513,21703,0.0176644,0.01,1,209923,209410,513
31780781,185.267,187.198,513,21703,0.00353287,0.01,1,210105,209592,513
31783701,182.653,183.04,513,21703,0.000706575,0,1,210287,209774,513
31786621,182.131,182.208,513,21703,0.00814131,0,1,210469,209956,513
31789541,181.226,182.042,512,21703,0.00162826,0.01,1,210650,210138,512
31792461,181.845,182.008,512,21703,0.00832565,0.01,1,210832,210320,512
31795381,181.969,182.002,512,21703,0.00166513,0,1,211014,210502,512
31798301,181.994,182,512,21703,0.00833303,0,1,211196,210684,512
31801221,181.999,182,512,21703,0.00166661,0,1,211378,210866,512
31804141,182.8,182,513,21703,0.000333321,0,1,211561,211048,513
31807061,182.16,182,513,21703,0.0160667,0.02,1,211743,211230,513
31809981,181.232,182,512,21703,0.00321333,0,1,211924,211412,512
31812901,182.646,182,513,21677,0.000642667,0.01,1,212107,211594,513
31815821,182.129,182,513,21677,0.000128533,0.01,1,212289,211776,513
31818741,181.226,182,512,21677,2.57067e-05,0,1,212470,211958,512
31821661,182.645,182,513,21652,5.14133e-06,0,1,212653,212140,513
31824581,181.329,182,512,21652,1.02827e-06,0,1,212834,212322,512
31827501,182.666,182,513,21652,0.00800021,0,1,213017,212504,513
31830421,181.333,182,512,21652,0.00160004,0,1,213198,212686,512
31833341,181.867,182,512,21652,0.000320008,0.01,1,213380,212868,512
31836261,182.773,182,513,21652,0.024064,0,1,213563,213050,513
31839181,182.155,182,513,21652,0.0048128,0,1,213745,213232,513
31842101,182.031,182,513,21652,0.00096256,0.01,1,213927,213414,513
31845021,181.206,182,512,21652,0.000192512,0.01,1,214108,213596,512
31847941,181.841,182,512,21652,0.0080385,0,1,214290,213778,512
31850861,181.968,182,512,21652,0.0016077,0.01,1,214472,213960,512
31853781,181.994,182,512,21652,0.00032154,0,1,214654,214142,512
31856701,182.799,182,513,21652,6.4308e-05,0.01,1,214837,214324,513
31859621,182.16,182,513,21652,1.28616e-05,0,1,215019,214506,513
31862541,181.232,182,512,21652,0.00800257,0,1,215200,214688,512
31865461,182.646,182,513,20842,0.00160051,0.01,1,215383,214870,513
31868381,181.329,182,512,20842,0.0083201,0,1,215564,215052,512
31871301,187.466,182,519,20842,0.00166402,0.01,1,215753,215234,519
31874221,191.893,191.6,518,20842,0.000332804,0,1,215946,215428,518
31877141,194.379,193.52,519,20842,6.65608e-05,0,1,216141,215622,519
31880061,193.276,193.904,518,20842,1.33122e-05,0.01,1,216334,215816,518
31882981,194.655,193.981,519,20842,0.00800266,0.01,1,216529,216010,519
31885901,194.131,193.996,519,20842,0.00160053,0,1,216723,216204,519
31888821,193.226,193.999,518,20842,0.000320106,0.01,1,216916,216398,518
31891741,193.845,194,518,20842,6.40213e-05,0,1,217110,216592,518
31894661,193.969,194,518,20842,0.0160128,0.02,1,217304,216786,518
31897581,193.994,194,518,20842,0.00320256,0,1,217498,216980,518
31900501,193.999,194,518,20842,0.00864051,0,1,217692,217174,518
31903421,194.8,194,519,20842,0.0017281,0.01,1,217887,217368,519
31906341,194.16,194,519,20842,0.00034562,0.01,1,218081,217562,519
31909261,193.232,194,518,20842,0.00806912,0,1,218274,217756,518
31912181,193.846,194,518,20842,0.00961383,0,1,218468,217950,518
31915101,194.769,194,519,20842,0.00992277,0.01,1,218663,218144,519
31918021,194.154,194,519,20842,0.0179846,0.02,1,218857,218338,519
31920941,194.031,194,519,20842,0.00359691,0.03,1,219051,218532,519
31923861,193.206,194,518,20842,0.000719382,0,1,219244,218726,518
31926781,193.841,194,518,20842,0.000143876,0,1,219438,218920,518
31929701,193.968,194,518,20842,0.00802878,0,1,219632,219114,518
31932621,193.994,194,518,20842,0.00160575,0,1,219826,219308,518
31935541,195.599,194,520,20842,0.000321151,0.02,1,220022,219502,520
31938461,193.52,194,519,20842,0.0160642,0,1,220215,219696,519
31941381,193.104,194,518,20842,0.0272128,0,1,220408,219890,518
31944301,193.821,194,518,20842,0.0134426,0.02,1,220602,220084,518
31947221,193.964,194,518,20842,0.0106885,0.01,1,220796,220278,518
31950141,194.793,194,519,20842,0.0021377,0.01,1,220991,220472,519
31953061,193.359,194,518,20842,0.000427541,0,1,221184,220666,518
31955981,194.672,194,519,20842,8.55081e-05,0.02,1,221379,220860,519
31958901,194.934,194,520,20842,0.0080171,0.03,1,221574,221054,520
31961821,193.387,194,519,20020,0.00160342,0.01,1,221767,221248,519
31964741,193.077,194,518,20020,0.000320684,0,1,221960,221442,518
31967661,198.615,194,524,20020,6.41368e-05,0,1,222160,221636,524
31970581,204.523,203.6,524,20020,1.28274e-05,0,1,222366,221842,524
31973501,205.705,205.52,524,20020,2.56547e-06,0,1,222572,222048,524
31976421,205.941,205.904,524,20020,5.13094e-07,0.01,1,222778,222254,524
31979341,207.588,205.981,526,20020,0.0080001,0,1,222986,222460,526
31982261,204.718,205.996,524,20020,0.00160002,0,1,223190,222666,524
31985181,205.744,205.999,524,20020,0.00832,0,1,223396,222872,524
31988101,206.749,206,525,20020,0.001664,0,1,223603,223078,525
31991021,206.95,206,526,20020,0.0243328,0,1,223810,223284,526
31993941,205.39,206,525,20020,0.00486656,0,1,224015,223490,525
31996861,205.878,206,525,20020,0.000973312,0.03,1,224221,223696,525
31999781,205.176,206,524,20020,0.0161947,0.02,1,224426,223902,524
32002701,205.835,206,524,20020,0.00323893,0,1,224632,224108,524
32005621,206.767,206,525,20020,0.0166478,0,1,224839,224314,525
32008541,206.153,206,525,20020,0.00332956,0,1,225045,224520,525
32011461,205.231,206,524,20020,0.000665911,0,1,225250,224726,524
32014381,206.646,206,525,20020,0.0161332,0,1,225457,224932,525
32017301,206.129,206,525,20020,0.00322664,0.01,1,225663,225138,525
32020221,205.226,206,524,20020,0.000645327,0,1,225868,225344,524
32023141,205.845,206,524,20020,0.00812907,0,1,226074,225550,524
32026061,206.769,206,525,20020,0.00162581,0,1,226281,225756,525
32028981,206.154,206,525,20020,0.000325163,0.01,1,226487,225962,525
32031901,205.231,206,524,20020,0.00806503,0,1,226692,226168,524
32034821,205.846,206,524,20020,0.00161301,0,1,226898,226374,524
32037741,205.969,206,524,20020,0.000322601,0,1,227104,226580,524
32040661,206.794,206,525,19906,6.45203e-05,0.01,1,227311,226786,525
32043581,205.359,206,524,19906,1.2904e-05,0.01,1,227516,226992,524
32046501,207.472,206,526,19906,2.58081e-06,0,1,227724,227198,526
32049421,207.894,207.6,526,19906,5.16162e-07,0,1,227932,227406,526
32052341,207.979,207.92,526,19906,1.03232e-07,0.01,1,228140,227614,526
32055261,208.796,207.984,527,19906,2.06465e-08,0.01,1,228349,227822,527
32058181,206.559,207.997,525,19906,0.008,0.01,1,228555,228030,525
32061101,208.512,207.999,526,19906,0.0256,0,1,228764,228238,526
32064021,207.302,208,525,19906,0.00512,0.03,1,228971,228446,525
32066941,208.66,208,526,19263,0.001024,0.01,1,229180,228654,526
32069861,208.132,208,526,19263,0.0162048,0,1,229388,228862,526
32072781,213.626,208,533,19263,0.019241,0,1,229603,229070,533
32075701,217.125,217.6,531,19263,0.00384819,0,1,229821,229290,531
32078621,219.425,219.52,531,19263,0.0167696,0,1,230041,229510,531
32081541,219.885,219.904,531,5840,0.00335393,0,1,230261,229730,531
32084461,219.977,219.981,531,5840,0.00867079,0,1,230481,229950,531
32087381,314.395,292.796,558,16577,0.0337342,0,1,230819,230261,558
32090301,282.079,277.759,558,16577,0.00674683,0,1,231093,230535,558
32093221,276.416,274.752,559,16577,0.00934937,0.01,1,231368,230809,559
32096141,274.483,274.15,559,16577,0.00986987,0,1,231642,231083,559
32099061,273.297,274.03,558,16577,0.017974,0,1,231915,231357,558
32101981,274.659,274.006,559,16577,0.0115948,0.01,1,232190,231631,559
32104901,274.932,274.001,560,16577,0.010319,0.01,1,232465,231905,560
32107821,273.386,274,559,16577,0.0100638,0.01,1,232738,232179,559
32110741,273.077,274,558,19497,0.0100128,0.01,1,233011,232453,558
32113661,274.615,274,559,19497,0.0100026,0,1,233286,232727,559
32116581,230.923,252.4,532,19380,0.00200051,0.03,1,233506,232974,532
32119501,221.385,226.48,531,19380,0.000400102,0.01,1,233725,233194,531
32122421,221.877,222.096,532,19380,8.00204e-05,0,1,233947,233415,532
32125341,221.975,222.019,532,19380,0.008016,0,1,234169,233637,532
32128261,222.795,222.004,533,19380,0.0016032,0,1,234392,233859,533
32131181,222.959,222.001,534,19380,0.00032064,0.01,1,234615,234081,534
32134101,221.392,222,533,17424,0.00806413,0,1,234836,234303,533
32137021,221.078,222,532,17424,0.0256128,0.01,1,235057,234525,532
32139941,255.416,238.8,553,17424,0.00512257,0,1,235321,234768,553
32142861,263.083,258.96,554,17424,0.00102451,0,1,235586,235032,554
32145781,263.817,262.992,554,17424,0.000204903,0.03,1,235850,235296,554
32148701,263.163,263.798,553,17424,0.016041,0,1,236113,235560,553
32151621,263.833,263.96,553,17424,0.0112082,0.03,1,236377,235824,553
32154541,263.967,263.992,553,17424,0.00224164,0.01,1,236641,236088,553
32157461,263.993,263.998,553,17424,0.00844833,0,1,236905,236352,553
32160381,263.999,264,553,17424,0.00168967,0.01,1,237169,236616,553
32163301,264,264,553,17424,0.000337933,0,1,237433,236880,553
32166221,264.8,264,554,17424,0.00806759,0,1,237698,237144,554
32169141,263.36,264,553,17424,0.00161352,0,1,237961,237408,553
32172061,263.872,264,553,17424,0.0243227,0,1,238225,237672,553
32174981,263.974,264,553,17424,0.00486454,0.01,1,238489,237936,553
32177901,264.795,264,554,17424,0.000972908,0,1,238754,238200,554
32180821,263.359,264,553,17424,0.00819458,0.01,1,239017,238464,553
32183741,264.672,264,554,17424,0.00163892,0,1,239282,238728,554
32186661,263.334,264,553,17363,0.000327783,0,1,239545,238992,553
32189581,264.667,264,554,17363,0.00806556,0,1,239810,239256,554
32192501,265.733,264.8,555,17363,0.00161311,0,1,240076,239521,555
32195421,265.147,265.76,554,17363,0.000322622,0.03,1,240341,239787,554
32198341,265.829,265.952,554,17363,6.45244e-05,0.03,1,240607,240053,554
32201261,266.766,265.99,555,5840,0.0080129,0,1,240874,240319,555
32204181,266.153,265.998,555,5840,0.00160258,0.01,1,241140,240585,555
32207101,318.031,292.4,587,13209,0.000320516,0,1,241471,240884,587
32210021,354.806,324.08,619,13209,0.0080641,0,1,241835,241216,619
32212941,387.761,381.616,619,13209,0.00161282,0,1,242231,241612,619
32215861,394.352,393.123,619,13209,0.00832256,0,1,242627,242008,619
32218781,395.67,395.425,619,13209,0.00966451,0,1,243023,242404,619
32221701,395.934,395.885,619,13209,0.0019329,0,1,243419,242800,619
32224621,396.787,395.977,620,13209,0.00838658,0.01,1,243816,243196,620
32227541,396.157,395.995,620,13209,0.00967732,0,1,244212,243592,620
32230461,396.031,395.999,620,16129,0.00193546,0,1,244608,243988,620
32233381,364.006,396,580,16129,0.000387093,0,1,244964,244384,580
32236301,325.601,332,580,16129,0.0160774,0,1,245280,244700,580
32239221,317.12,319.2,579,16129,0.00321548,0,1,245595,245016,579
32242141,317.024,316.64,580,16129,0.000643097,0.01,1,245912,245332,580
32245061,315.405,316.128,579,16129,0.000128619,0,1,246227,245648,579
32247981,315.881,316.026,579,16129,0.00802572,0,1,246543,245964,579
32250901,315.976,316.005,579,16129,0.0256051,0.02,1,246859,246280,579
32253821,316.795,316.001,580,15383,0.00512103,0,1,247176,246596,580
32256741,328.959,316,596,15383,0.00902421,0.01,1,247508,246912,596
32259661,340.992,340,594,15383,0.00180484,0,1,247852,247258,594
32262581,346.598,344.8,596,15383,0.000360968,0,1,248200,247604,596
32265501,345.32,345.76,595,15383,7.21936e-05,0.01,1,248545,247950,595
32268421,345.064,345.952,594,15383,1.44387e-05,0,1,248890,248296,594
32271341,345.813,345.99,594,14674,0.0240029,0,1,249236,248642,594
32274261,358.763,345.998,610,14674,0.0128006,0,1,249598,248988,610
32277181,374.153,371.6,610,14674,0.00256012,0,1,249976,249366,610
32280101,378.83,376.72,612,14674,0.000512023,0.01,1,250356,249744,612
32283021,377.366,377.744,611,14674,0.0081024,0,1,250733,250122,611
32285941,377.073,377.949,610,14674,0.00962048,0.01,1,251110,250500,610
32288861,377.815,377.99,610,14674,0.0019241,0,1,251488,250878,610
32291781,378.763,377.998,611,5840,0.000384819,0.01,1,251867,251256,611
32293241,386.953,378,622,5840,0.00807696,0,1,252256,251634,622
32294701,266.191,265.2,621,12359,0.00161539,0.01,1,252492,251871,621
32296161,243.638,242.64,622,12359,0.000323079,0.01,1,252730,252108,622
32297621,238.328,238.128,622,12359,6.46157e-05,0,1,252967,252345,622
32299081,238.066,237.226,623,12359,0.00801292,0,1,253205,252582,623
32300541,236.413,237.045,622,12359,0.00160258,0,1,253441,252819,622
32302001,236.883,237.009,622,12359,0.00832052,0,1,253678,253056,622
32303461,236.977,237.002,622,12359,0.0016641,0,1,253915,253293,622
32304921,236.195,237,621,12359,0.000332821,0,1,254151,253530,621
32306381,237.639,237,622,12359,6.65641e-05,0,1,254389,253767,622
32307841,236.328,237,621,13819,1.33128e-05,0,1,254625,254004,621
32309301,237.666,237,622,15279,2.66256e-06,0.01,1,254863,254241,622
32312221,228.333,237,611,15279,0.00800053,0.01,1,255089,254478,611
32315141,347.267,349.8,610,15396,0.00160011,0,1,255466,254856,610
32318061,371.053,372.36,609,16285,0.000320021,0.02,1,255843,255234,609
32320981,357.411,373.672,589,16285,6.40042e-05,0.01,1,256197,255608,589
32323901,341.082,343.534,590,16285,0.0160128,0,1,256534,255944,590
32326821,337.016,337.507,590,16285,0.0272026,0,1,256870,256280,590
32329741,336.203,336.301,590,16285,0.0134405,0.02,1,257206,256616,590
32332661,336.041,336.06,590,16285,0.0106881,0,1,257542,256952,590
32335581,335.208,336.012,589,16285,0.00213762,0,1,257877,257288,589
32338501,336.642,336.002,590,16285,0.00842752,0,1,258214,257624,590
32341421,335.328,336.001,589,16285,0.0016855,0.03,1,258549,257960,589
32344341,335.866,336,589,16271,0.0083371,0,1,258885,258296,589
32347261,336.773,336,590,16257,0.00166742,0.01,1,259222,258632,590
32350181,335.355,336,589,16243,0.00833348,0,1,259557,258968,589
32353101,337.471,336,591,16229,0.0016667,0.03,1,259895,259304,591
32356021,335.494,336,590,16215,0.000333339,0,1,260230,259640,590
32358941,335.099,336,589,16201,0.00806667,0.01,1,260565,259976,589
32361861,336.62,336,590,16187,0.00161333,0,1,260902,260312,590
32364781,336.124,336,590,16187,0.00832267,0.02,1,261238,260648,590
32367701,335.225,336,589,16187,0.00966453,0.01,1,261573,260984,589
32370621,335.845,336,589,16174,0.00193291,0,1,261909,261320,589
32373541,335.969,336,589,16174,0.00838658,0,1,262245,261656,589
32376461,336.794,336,590,16174,0.00967732,0,1,262582,261992,590
32379381,336.159,336,590,14710,0.00193546,0,1,262918,262328,590
32380841,360.832,336,621,14710,0.000387093,0,1,263285,262664,621
32382301,233.766,228,622,14710,0.00807742,0,1,263487,262865,622
32383761,207.553,206.4,622,14710,0.00961548,0,1,263688,263066,622
32385221,202.311,202.08,622,14710,0.0019231,0,1,263889,263267,622
32386681,201.262,201.216,622,14710,0.000384619,0.01,1,264090,263468,622
32388141,200.252,201.043,621,14710,0.00807692,0,1,264290,263669,621
32389601,201.65,201.009,622,14726,0.00161538,0,1,264492,263870,622
32391061,201.13,201.002,622,14726,0.00832308,0,1,264693,264071,622
32392521,200.226,201,621,14726,0.00966462,0.01,1,264893,264272,621
32393981,201.645,201,622,14732,0.00993292,0,1,265095,264473,622
32395441,200.329,201,621,14732,0.00198658,0.01,1,265295,264674,621
32396901,200.866,201,621,14732,0.000397317,0.01,1,265496,264875,621
32398361,201.773,201,622,14732,0.00807946,0,1,265698,265076,622
32399821,201.155,201,622,14732,0.00161589,0,1,265899,265277,622
32401281,201.031,201,622,14732,0.000323179,0.01,1,266100,265478,622
32402741,201.006,201,622,14732,0.00806464,0,1,266301,265679,622
32404201,201.001,201,622,14732,0.00961293,0,1,266502,265880,622
32405661,200.2,201,621,14732,0.00192259,0,1,266702,266081,621
32407121,201.64,201,622,14732,0.000384517,0,1,266904,266282,622
32408581,200.328,201,621,14732,7.69034e-05,0.01,1,267104,266483,621
32410041,200.866,201,621,14732,1.53807e-05,0,1,267305,266684,621
32411501,201.773,201,622,14732,3.07614e-06,0.01,1,267507,266885,622
32412961,200.355,201,621,14732,6.15227e-07,0,1,267707,267086,621
32414421,201.671,201,622,14732,0.00800012,0,1,267909,267287,622
32415881,201.134,201,622,14732,0.00960002,0.01,1,268110,267488,622
32417341,200.227,201,621,14732,0.00992,0,1,268310,267689,621
32418801,201.645,201,622,14732,0.001984,0,1,268512,267890,622
32420261,201.129,201,622,14732,0.0163968,0.01,1,268713,268091,622
32423181,201.026,201,622,14732,0.0192794,0,1,268914,268292,622
32424641,361.005,361.8,621,16582,0.00385587,0,1,269315,268694,621
32426101,233.001,233.16,621,16582,0.000771174,0.01,1,269516,268895,621
32429021,177.8,207.432,584,16582,0.0161542,0,1,269680,269096,584
32431941,291.56,299.086,582,16582,0.00323085,0.01,1,270000,269418,582
32434861,316.712,317.417,583,18195,0.000646169,0.01,1,270323,269740,583
32437781,301.742,321.083,559,18195,0.0321292,0,1,270621,270062,559
32440701,278.748,283.417,558,18195,0.00642585,0.01,1,270894,270336,558
32443621,274.95,275.883,558,18195,0.00128517,0,1,271168,270610,558
32446541,274.19,274.377,558,18177,0.000257034,0.02,1,271442,270884,558
32449461,274.038,274.075,558,18109,0.0160514,0,1,271716,271158,558
32452381,274.008,274.015,558,18041,0.00321028,0,1,271990,271432,558
32455301,274.002,274.003,558,17990,0.000642056,0,1,272264,271706,558
32458221,274,274.001,558,17939,0.000128411,0,1,272538,271980,558
32461141,274.8,274,559,17905,0.00802568,0.01,1,272813,272254,559
32464061,273.36,274,558,17871,0.00160514,0,1,273086,272528,558
32466981,273.872,274,558,17836,0.000321027,0,1,273360,272802,558
32469901,273.974,274,558,17802,0.0160642,0,1,273634,273076,558
32472821,275.595,274,560,17785,0.00321284,0.01,1,273910,273350,560
32475741,273.519,274,559,17768,0.00864257,0.01,1,274183,273624,559
32478661,273.104,274,558,17751,0.00172851,0.01,1,274456,273898,558
32481581,274.621,274,559,17734,0.0243457,0.01,1,274731,274172,559
32484501,273.324,274,558,17717,0.00486914,0.01,1,275004,274446,558
32487421,273.865,274,558,17700,0.0329738,0.01,1,275278,274720,558
32490341,273.973,274,558,17683,0.0385948,0.01,1,275552,274994,558
32493261,273.995,274,558,17666,0.00771895,0.01,1,275826,275268,558
32496181,274.799,274,559,15949,0.00954379,0.01,1,276101,275542,559
32499101,274.16,274,559,15949,0.00990876,0.01,1,276375,275816,559
32502021,317.232,295.6,586,15949,0.00198175,0,1,276703,276117,586
32504941,325.846,321.52,586,15949,0.00039635,0,1,277031,276445,586
32507861,328.369,326.704,587,15949,0.00807927,0.01,1,277360,276773,587
32510781,326.474,327.741,585,15949,0.00161585,0,1,277686,277101,585
32513701,327.695,327.948,585,15949,0.000323171,0.01,1,278014,277429,585
32516621,327.939,327.99,585,15949,0.00806463,0,1,278342,277757,585
32519541,327.988,327.998,585,15949,0.00161293,0,1,278670,278085,585
32522461,328.798,328,586,15949,0.0243226,0,1,278999,278413,586
32525381,327.36,328,585,15949,0.00486452,0,1,279326,278741,585
32528301,327.872,328,585,15949,0.0169729,0,1,279654,279069,585
32531221,327.974,328,585,15949,0.00339458,0,1,279982,279397,585
32534141,328.795,328,586,15949,0.000678916,0,1,280311,279725,586
32537061,328.159,328,586,15949,0.000135783,0,1,280639,280053,586
32539981,327.232,328,585,15949,2.71566e-05,0,1,280966,280381,585
32542901,327.846,328,585,15949,0.00800543,0,1,281294,280709,585
32545821,328.769,328,586,15949,0.00160109,0.01,1,281623,281037,586
32548741,327.354,328,585,15949,0.000320217,0,1,281950,281365,585
32551661,327.871,328,585,15949,6.40434e-05,0,1,282278,281693,585
32554581,328.774,328,586,14934,1.28087e-05,0.01,1,282607,282021,586
32557501,345.755,328,608,14934,2.56174e-06,0.01,1,282957,282349,608
32560421,366.751,363.2,608,14934,5.12347e-07,0.03,1,283329,282721,608
32563341,370.95,370.24,608,14934,0.0080001,0,1,283701,283093,608
32566261,370.99,371.648,607,14934,0.00160002,0,1,284072,283465,607
32569181,371.798,371.93,607,14934,0.000320004,0,1,284444,283837,607
32572101,371.96,371.986,607,14524,6.40008e-05,0,1,284816,284209,607
32575021,380.792,371.997,618,14524,1.28002e-05,0.01,1,285199,284581,618
32577941,391.358,389.599,618,14524,0.00800256,0,1,285593,284975,618
32580861,395.072,393.12,620,14524,0.00960051,0.01,1,285989,285369,620
32583781,392.614,393.824,618,14524,0.0179201,0.01,1,286381,285763,618
32586701,394.523,393.965,619,5840,0.011584,0.01,1,286776,286157,619
32588161,395.705,393.993,621,5840,0.0103168,0.02,1,287172,286551,621
32589621,277.541,275.599,623,12126,0.00206336,0,1,287420,286797,623
32591081,250.708,251.92,621,12126,0.000412672,0,1,287664,287043,621
32592541,246.942,247.184,621,12126,0.00808254,0,1,287910,287289,621
32594001,246.188,246.237,621,12126,0.00161651,0.01,1,288156,287535,621
32595461,246.038,246.047,621,12126,0.000323301,0,1,288402,287781,621
32596921,246.008,246.009,621,12126,6.46603e-05,0.01,1,288648,288027,621
32598381,246.002,246.002,621,12126,1.29321e-05,0,1,288894,288273,621
32599841,246.8,246,622,12126,2.58641e-06,0.01,1,289141,288519,622
32601301,245.36,246,621,12126,5.17282e-07,0,1,289386,288765,621
32602761,246.672,246,622,12118,1.03456e-07,0.01,1,289633,289011,622
32604221,246.134,246,622,12118,0.00800002,0.03,1,289879,289257,622
32605681,246.027,246,622,12118,0.0016,0,1,290125,289503,622
32607141,246.005,246,622,13578,0.00832,0.02,1,290371,289749,622
32608601,246.801,246,623,15038,0.009664,0,1,290618,289995,623
32611521,243.76,246,620,15038,0.0019328,0,1,290861,290241,620
32614441,363.152,364.4,619,15060,0.00038656,0.01,1,291254,290635,619
32617361,387.03,388.08,618,15923,7.7312e-05,0.01,1,291647,291029,618
32620281,375.006,391.216,598,15923,1.54624e-05,0,1,292019,291421,598
32623201,358.201,361.443,598,15923,3.09248e-06,0,1,292373,291775,598
32626121,354.84,355.489,598,15923,6.18496e-07,0.01,1,292727,292129,598
32629041,354.968,354.298,599,15923,1.23699e-07,0,1,293082,292483,599
32631961,354.194,354.06,599,15923,2.47398e-08,0.01,1,293436,292837,599
32634881,353.239,354.012,598,15923,4.94797e-09,0,1,293789,293191,598
32637801,354.648,354.002,599,15923,9.89593e-10,0,1,294144,293545,599
32640721,353.33,354,598,15923,0.024,0.01,1,294497,293899,598
32643641,354.666,354,599,15923,0.0128,0.01,1,294852,294253,599
32646561,353.333,354,598,15923,0.00256,0.01,1,295205,294607,598
32649481,355.467,354,600,15910,0.000512,0,1,295561,294961,600
32652401,353.493,354,599,15897,0.0001024,0.01,1,295914,295315,599
32655321,353.899,354,599,15884,2.048e-05,0.02,1,296268,295669,599
32658241,353.18,354,598,15884,0.0080041,0,1,296621,296023,598
32661161,353.836,354,598,15871,0.00160082,0,1,296975,296377,598
32664081,354.767,354,599,15871,0.000320164,0.02,1,297330,296731,599
32667001,353.353,354,598,15871,6.40328e-05,0,1,297683,297085,598
32669921,353.871,354,598,15871,1.28066e-05,0,1,298037,297439,598
32672841,353.974,354,598,15871,0.00800256,0,1,298391,297793,598
32675761,353.995,354,598,15871,0.00160051,0.01,1,298745,298147,598
32678681,353.999,354,598,14439,0.0163201,0.01,1,299099,298501,598
32680141,372.4,354,621,14439,0.00326402,0.01,1,299476,298855,621
32681601,244.08,240.4,621,14439,0.0086528,0,1,299688,299067,621
32683061,218.416,217.68,621,14439,0.0257306,0,1,299900,299279,621
32684521,213.283,213.136,621,14439,0.00514611,0.01,1,300112,299491,621
32685981,212.257,212.227,621,14439,0.00102922,0,1,300324,299703,621
32687441,212.051,212.045,621,14439,0.000205844,0.01,1,300536,299915,621
32688901,212.01,212.009,621,14439,0.0240412,0,1,300748,300127,621
32690361,212.802,212.002,622,14439,0.00480823,0.01,1,300961,300339,622
32691821,212.16,212,622,14439,0.0169616,0,1,301173,300551,622
32693281,211.232,212,621,14439,0.00339233,0.01,1,301384,300763,621
32694741,213.446,212,623,14439,0.000678466,0,1,301598,300975,623
32696201,210.689,212,621,14439,0.00813569,0,1,301808,301187,621
32697661,211.738,212,621,14439,0.00962714,0,1,302020,301399,621
32699121,211.948,212,621,14439,0.00192543,0,1,302232,301611,621
32700581,212.79,212,622,14439,0.00838509,0,1,302445,301823,622
32702041,211.358,212,621,14439,0.00967702,0,1,302656,302035,621
32703501,211.872,212,621,14439,0.0099354,0,1,302868,302247,621
32704961,211.974,212,621,14439,0.0179871,0,1,303080,302459,621
32706421,211.995,212,621,14439,0.00359742,0,1,303292,302671,621
32707881,212.799,212,622,14439,0.00871948,0.03,1,303505,302883,622
32709341,211.36,212,621,14439,0.0017439,0.02,1,303716,303095,621
32710801,213.472,212,623,14439,0.0163488,0,1,303930,303307,623
32712261,211.494,212,622,14425,0.0112698,0,1,304141,303519,622
32713721,211.099,212,621,14425,0.010254,0,1,304352,303731,621
32715181,211.82,212,621,14425,0.0100508,0,1,304564,303943,621
32716641,212.764,212,622,14425,0.0180102,0,1,304777,304155,622
32718101,211.353,212,621,14425,0.011602,0.01,1,304988,304367,621
32719561,211.871,212,621,14425,0.00232041,0,1,305200,304579,621
32721021,212.774,212,622,14425,0.0164641,0,1,305413,304791,622
32722481,211.355,212,621,14425,0.00329282,0.01,1,305624,305003,621
32723941,211.871,212,621,14425,0.00865856,0,1,305836,305215,621
32725401,211.974,212,621,14001,0.0177317,0.01,1,306048,305427,621
32726861,211.995,212,621,14001,0.00354634,0.01,1,306260,305639,621
32728321,212.799,212,622,14001,0.000709268,0,1,306473,305851,622
32729781,223.36,223.2,622,14001,0.000141854,0,1,306699,306077,622
32731241,226.272,225.44,623,14001,0.00802837,0,1,306926,306303,623
32732701,225.254,225.888,622,14001,0.00160567,0.01,1,307151,306529,622
32734161,225.051,225.978,621,14001,0.000321135,0,1,307376,306755,621
32735621,225.81,225.996,621,14001,6.4227e-05,0.01,1,307602,306981,621
32737081,225.962,225.999,621,14001,1.28454e-05,0.01,1,307828,307207,621
32738541,226.792,226,622,14001,0.00800257,0,1,308055,307433,622
32740001,226.158,226,622,14001,0.00160051,0,1,308281,307659,622
32741461,226.032,226,622,14001,0.000320103,0,1,308507,307885,622
32742921,225.206,226,621,14001,6.40205e-05,0.01,1,308732,308111,621
32744381,225.841,226,621,14001,1.28041e-05,0,1,308958,308337,621
32745841,225.968,226,621,14001,2.56082e-06,0,1,309184,308563,621
32747301,226.794,226,622,5840,0.00800051,0,1,309411,308789,622
32748761,226.959,226,623,5840,0.0096001,0.01,1,309638,309015,623
32750221,224.592,226,621,5840,0.00192002,0,1,309862,309241,621
32751681,270.518,270.8,621,11267,0.000384004,0,1,310144,309523,621
32753141,279.704,279.76,621,11267,0.0240768,0,1,310426,309805,621
32754601,281.541,281.552,621,11267,0.00481536,0,1,310708,310087,621
32756061,281.908,281.91,621,11267,0.000963072,0.01,1,310990,310369,621
32757521,281.982,281.982,621,11267,0.00819261,0,1,311272,310651,621
32758981,282.796,281.996,622,11267,0.00963852,0,1,311555,310933,622
32760441,281.359,281.999,621,12727,0.0019277,0,1,311836,311215,621
32761901,282.672,282,622,14187,0.000385541,0.01,1,312119,311497,622
32763361,282.134,282,622,14187,7.71082e-05,0,1,312401,311779,622
32764821,236.427,237.2,621,14187,0.00801542,0,1,312626,312005,621
32766281,228.885,228.24,622,14187,0.00160308,0,1,312853,312231,622
32767741,225.777,226.448,621,14187,0.000320617,0,1,313078,312457,621
32769201,225.955,226.09,621,14187,6.41234e-05,0.01,1,313304,312683,621
32770661,226.791,226.018,622,14187,1.28247e-05,0,1,313531,312909,622
32772121,225.358,226.004,621,14187,0.00800257,0,1,313756,313135,621
32773581,225.872,226.001,621,13767,0.00160051,0.01,1,313982,313361,621
32775041,225.974,226,621,13767,0.000320103,0.01,1,314208,313587,621
32776501,226.795,226,622,13767,0.00806402,0,1,314435,313813,622
32777961,238.159,238,622,13767,0.0016128,0.01,1,314676,314054,622
32779421,239.632,240.4,621,13767,0.00832256,0,1,314916,314295,621
32780881,241.526,240.88,622,13767,0.00966451,0.01,1,315158,314536,622
32782341,241.105,240.976,622,13767,0.0019329,0,1,315399,314777,622
32783801,240.221,240.995,621,13767,0.00038658,0,1,315639,315018,621
32785261,240.844,240.999,621,13767,0.00807732,0,1,315880,315259,621
32786721,240.969,241,621,13760,0.00161546,0.01,1,316121,315500,621
32788181,240.994,241,621,13760,0.0163231,0.01,1,316362,315741,621
32789641,240.999,241,621,13760,0.0112646,0.01,1,316603,315982,621
32791101,241.8,241,622,13760,0.0102529,0.01,1,316845,316223,622
32792561,240.36,241,621,13760,0.00205058,0,1,317085,316464,621
32794021,241.672,241,622,13760,0.00841012,0,1,317327,316705,622
32795481,241.134,241,622,13760,0.00168202,0,1,317568,316946,622
32796941,241.027,241,622,13760,0.0083364,0,1,317809,317187,622
32798401,241.805,241,623,13760,0.00166728,0.01,1,318051,317428,623
32799861,240.361,241,622,13760,0.000333456,0,1,318291,317669,622
32801321,240.872,241,622,13760,0.00806669,0,1,318532,317910,622
32802781,240.974,241,622,13760,0.00161334,0,1,318773,318151,622
32804241,240.995,241,622,13760,0.000322668,0.01,1,319014,318392,622
32805701,240.199,241,621,13760,6.45335e-05,0,1,319254,318633,621
32807161,241.64,241,622,13760,1.29067e-05,0,1,319496,318874,622
32808621,241.128,241,622,13760,0.00800258,0,1,319737,319115,622
32810081,240.226,241,621,13760,0.00960052,0.01,1,319977,319356,621
32811541,240.845,241,621,13760,0.0019201,0.01,1,320218,319597,621
32813001,241.769,241,622,13760,0.00838402,0.01,1,320460,319838,622
32814461,240.354,241,621,13760,0.0176768,0.01,1,320700,320079,621
32815921,240.871,241,621,13760,0.0115354,0,1,320941,320320,621
32817381,240.974,241,621,13760,0.0103071,0,1,321182,320561,621
32818841,242.595,241,623,13760,0.00206141,0,1,321425,320802,623
32820301,239.719,241,621,13760,0.000412283,0.01,1,321664,321043,621
32821761,241.544,241,622,13357,8.24566e-05,0,1,321906,321284,622
32823221,241.109,241,622,13357,0.00801649,0,1,322147,321525,622
32824681,240.222,241,621,13357,0.0176033,0,1,322387,321766,621
32826141,254.444,253.8,622,13364,0.0195207,0,1,322645,322023,622
32827601,256.489,256.36,622,13364,0.0119041,0,1,322902,322280,622
32829061,256.898,256.872,622,13364,0.00238083,0.01,1,323159,322537,622
32830521,256.18,256.974,621,13364,0.000476165,0,1,323415,322794,621
32831981,256.836,256.995,621,13364,0.00809523,0,1,323672,323051,621
32833441,257.767,256.999,622,13364,0.00961905,0.02,1,323930,323308,622
32834901,257.153,257,622,13364,0.00192381,0,1,324187,323565,622
32836361,257.031,257,622,13364,0.00838476,0,1,324444,323822,622
32837821,256.206,257,621,13364,0.00967695,0,1,324700,324079,621
32839281,257.641,257,622,13364,0.0179354,0,1,324958,324336,622
32840741,256.328,257,621,13364,0.00358708,0.01,1,325214,324593,621
32842201,257.666,257,622,13364,0.000717416,0,1,325472,324850,622
32843661,256.333,257,621,13364,0.00814348,0,1,325728,325107,621
32845121,256.867,257,621,13364,0.0176287,0.01,1,325985,325364,621
32846581,257.773,257,622,13364,0.00352574,0.01,1,326243,325621,622
32848041,256.355,257,621,13364,0.000705148,0,1,326499,325878,621
32849501,257.671,257,622,13364,0.00014103,0,1,326757,326135,622
32850961,256.334,257,621,13364,0.00802821,0,1,327013,326392,621
32852421,257.667,257,622,13364,0.00960564,0,1,327271,326649,622
32853881,256.333,257,621,13364,0.00192113,0,1,327527,326906,621
32855341,256.867,257,621,13364,0.00838423,0,1,327784,327163,621
32856801,257.773,257,622,13364,0.00167685,0,1,328042,327420,622
32858261,257.155,257,622,13364,0.0243354,0.01,1,328299,327677,622
32859721,257.031,257,622,13364,0.00486707,0.01,1,328556,327934,622
32861181,256.206,257,621,13364,0.0249734,0.01,1,328812,328191,621
32862641,256.841,257,621,13364,0.0129947,0,1,329069,328448,621
32864101,257.768,257,622,13364,0.00259894,0.03,1,329327,328705,622
32865561,256.354,257,621,13364,0.000519787,0.01,1,329583,328962,621
32867021,256.871,257,621,13364,0.000103957,0,1,329840,329219,621
32868481,256.974,257,621,13364,0.00802079,0.01,1,330097,329476,621
32869941,257.795,257,622,13364,0.00160416,0.01,1,330355,329733,622
32871401,256.359,257,621,13364,0.000320832,0.01,1,330611,329990,621
32872861,256.872,257,621,13364,6.41663e-05,0.01,1,330868,330247,621
32874321,257.774,257,622,12980,1.28333e-05,0.02,1,331126,330504,622
32875781,257.955,257,623,12980,0.00800257,0,1,331384,330761,623
32877241,256.391,257,622,12980,0.00960051,0,1,331640,331018,622
32878701,269.678,270.6,621,12980,0.0339201,0.01,1,331913,331292,621
32880161,273.936,273.32,622,12980,0.014784,0,1,332188,331566,622
32881621,273.187,273.864,621,12980,0.0109568,0,1,332461,331840,621
32883081,273.837,273.973,621,12980,0.0101914,0,1,332735,332114,621
32884541,274.767,273.995,622,12980,0.00203827,0,1,333010,332388,622
32886001,273.354,273.999,621,12980,0.00840766,0.01,1,333283,332662,621
32887461,273.871,274,621,12980,0.00168153,0,1,333557,332936,621
32888921,273.974,274,621,12980,0.00833631,0.01,1,333831,333210,621
32890381,274.795,274,622,12980,0.00166726,0,1,334106,333484,622
32891841,273.359,274,621,12980,0.000333452,0.01,1,334379,333758,621
32893301,274.672,274,622,12980,0.0240667,0,1,334654,334032,622
32894761,274.134,274,622,12980,0.0128133,0,1,334928,334306,622
32896221,274.027,274,622,12980,0.00256267,0,1,335202,334580,622
32897681,273.205,274,621,12980,0.00851253,0,1,335475,334854,621
32899141,273.841,274,621,12980,0.00170251,0,1,335749,335128,621
32900601,274.768,274,622,12980,0.0083405,0,1,336024,335402,622
32902061,274.154,274,622,12980,0.0096681,0.01,1,336298,335676,622
32903521,273.231,274,621,12980,0.00193362,0.01,1,336571,335950,621
32904981,273.846,274,621,12980,0.00838672,0,1,336845,336224,621
32906441,273.969,274,621,12980,0.00167734,0,1,337119,336498,621
32907901,274.794,274,622,12980,0.000335469,0,1,337394,336772,622
32909361,273.359,274,621,12980,6.70938e-05,0.01,1,337667,337046,621
32910821,273.872,274,621,12980,1.34188e-05,0.01,1,337941,337320,621
32912281,273.974,274,621,12980,0.00800268,0,1,338215,337594,621
32913741,273.995,274,621,12969,0.00160054,0,1,338489,337868,621
32915201,274.799,274,622,12969,0.000320107,0.01,1,338764,338142,622
32916661,273.36,274,621,12969,0.00806402,0,1,339037,338416,621
32918121,273.872,274,621,12969,0.0016128,0,1,339311,338690,621
32919581,273.974,274,621,12969,0.000322561,0,1,339585,338964,621
32921041,274.795,274,622,12969,0.00806451,0.01,1,339860,339238,622
32922501,273.359,274,621,12969,0.0016129,0.03,1,340133,339512,621
32923961,273.872,274,621,12969,0.00032258,0,1,340407,339786,621
32925421,274.774,274,622,12969,0.00806452,0,1,340682,340060,622
32926881,273.355,274,621,12628,0.0176129,0,1,340955,340334,621
32928341,274.671,274,622,12628,0.00352258,0.01,1,341230,340608,622
32929801,273.334,274,621,12628,0.000704516,0,1,341503,340882,621
32931261,289.067,288.4,622,12628,0.0241409,0,1,341796,341174,622
32932721,291.413,291.28,622,12628,0.0128282,0,1,342088,341466,622
32934181,291.883,291.856,622,12628,0.00256564,0,1,342380,341758,622
32935641,291.177,291.971,621,12628,0.00851313,0.02,1,342671,342050,621
32937101,293.435,291.994,623,12628,0.00170263,0.01,1,342965,342342,623
32938561,292.287,291.999,623,12628,0.00834053,0.02,1,343257,342634,623
32940021,291.257,292,622,12628,0.00166811,0.01,1,343548,342926,622
32941481,291.851,292,622,12628,0.00833362,0.02,1,343840,343218,622
32942941,291.17,292,621,12628,0.00166672,0,1,344131,343510,621
32944401,291.834,292,621,12628,0.000333345,0,1,344423,343802,621
32945861,291.967,292,621,12628,6.6669e-05,0.01,1,344715,344094,621
32947321,292.793,292,622,12628,1.33338e-05,0,1,345008,344386,622
32948781,291.359,292,621,12628,2.66676e-06,0.01,1,345299,344678,621
32950241,291.872,292,621,12628,5.33352e-07,0.01,1,345591,344970,621
32951701,291.974,292,621,12628,1.0667e-07,0,1,345883,345262,621
32953161,291.995,292,621,12628,2.13341e-08,0,1,346175,345554,621
32954621,293.599,292,623,12628,0.008,0,1,346469,345846,623
32956081,290.72,292,621,12628,0.0016,0,1,346759,346138,621
32957541,292.544,292,622,12628,0.00032,0,1,347052,346430,622
32959001,291.309,292,621,12628,6.4e-05,0.01,1,347343,346722,621
32960461,291.862,292,621,12628,1.28e-05,0,1,347635,347014,621
32961921,292.772,292,622,12628,2.56e-06,0,1,347928,347306,622
32963381,292.154,292,622,12628,0.00800051,0,1,348220,347598,622
32964841,291.231,292,621,12628,0.0016001,0.01,1,348511,347890,621
32966301,291.846,292,621,12628,0.00032002,0,1,348803,348182,621
32967761,292.769,292,622,12628,0.008064,0,1,349096,348474,622
32969221,292.154,292,622,12628,0.0016128,0.03,1,349388,348766,622
32970681,291.231,292,621,12628,0.00032256,0.01,1,349679,349058,621
32972141,292.646,292,622,12628,0.00806451,0,1,349972,349350,622
32973601,291.329,292,621,12628,0.0016129,0.01,1,350263,349642,621
32975061,292.666,292,622,12302,0.00032258,0,1,350556,349934,622
32976521,291.333,292,621,12302,6.45161e-05,0.01,1,350847,350226,621
32977981,292.667,292,622,12302,0.0080129,0,1,351140,350518,622
32979441,306.533,307.2,621,12302,0.00160258,0.01,1,351450,350829,621
32980901,310.907,310.24,622,12302,0.00832052,0.01,1,351762,351140,622
32982361,310.181,310.848,621,12302,0.0016641,0.01,1,352072,351451,621
32983821,311.636,310.97,622,12302,0.000332821,0.01,1,352384,351762,622
32985281,310.327,310.994,621,12302,0.0240666,0,1,352694,352073,621
32986741,310.865,310.999,621,12302,0.00481331,0.02,1,353005,352384,621
32988201,311.773,311,622,12302,0.0169627,0,1,353317,352695,622
32989661,310.355,311,621,12302,0.00339253,0.02,1,353627,353006,621
32991121,310.871,311,621,12302,0.000678506,0.01,1,353938,353317,621
32992581,310.974,311,621,13552,0.0081357,0,1,354249,353628,621
32994041,310.995,311,621,13552,0.00162714,0.01,1,354560,353939,621
32995501,261.399,261.4,621,13552,0.000325428,0.03,1,354809,354188,621
32996961,251.48,251.48,621,13552,6.50856e-05,0,1,355058,354437,621
32998421,249.496,249.496,621,13552,0.00801302,0.01,1,355307,354686,621
32999881,249.099,249.099,621,13552,0.0016026,0,1,355556,354935,621
33001341,249.82,249.02,622,13552,0.000320521,0.03,1,355806,355184,622
33002801,248.364,249.004,621,13552,6.41041e-05,0,1,356054,355433,621
33004261,248.873,249.001,621,13552,1.28208e-05,0,1,356303,355682,621
33005721,248.975,249,621,13552,0.0240026,0.01,1,356552,355931,621
33007181,248.995,249,621,13552,0.00480051,0,1,356801,356180,621
33008641,248.999,249,621,13552,0.0089601,0.02,1,357050,356429,621
33010101,249.8,249,622,13552,0.00979202,0.01,1,357300,356678,622
33011561,248.36,249,621,13552,0.0019584,0.01,1,357548,356927,621
33013021,249.672,249,622,13552,0.00839168,0.01,1,357798,357176,622
33014481,248.334,249,621,13552,0.00167834,0.01,1,358046,357425,621
33015941,248.867,249,621,13552,0.000335667,0,1,358295,357674,621
33017401,248.973,249,621,13552,6.71334e-05,0.01,1,358544,357923,621
33018861,248.995,249,621,13552,0.00801343,0,1,358793,358172,621
33020321,248.999,249,621,13552,0.00160269,0.01,1,359042,358421,621
33021781,249,249,621,13552,0.0163205,0.01,1,359291,358670,621
33023241,249,249,621,13552,0.0112641,0,1,359540,358919,621
33024701,249.8,249,622,13552,0.0102528,0,1,359790,359168,622
33026161,249.16,249,622,13552,0.00205056,0,1,360039,359417,622
33027621,248.232,249,621,13552,0.000410113,0,1,360287,359666,621
33029081,248.846,249,621,13552,8.20226e-05,0,1,360536,359915,621
33030541,248.969,249,621,13552,1.64045e-05,0.01,1,360785,360164,621
33032001,249.794,249,622,13552,0.00800328,0.02,1,361035,360413,622
33033461,249.159,249,622,13552,0.00960066,0,1,361284,360662,622
33034921,249.832,249,623,13552,0.00992013,0,1,361534,360911,623
33036381,248.366,249,622,13552,0.00198403,0,1,361782,361160,622
33037841,248.873,249,622,13552,0.000396805,0,1,362031,361409,622
33039301,248.175,249,621,13552,0.00807936,0,1,362279,361658,621
33040761,248.835,249,621,13552,0.00961587,0,1,362528,361907,621
33042221,249.767,249,622,13168,0.00992317,0,1,362778,362156,622
33043681,249.153,249,622,13168,0.0259846,0,1,363027,362405,622
33045141,248.231,249,621,13168,0.00519693,0,1,363275,362654,621
33046601,261.646,261.8,621,13168,0.00103939,0.01,1,363540,362919,621
33048061,264.329,264.36,621,13168,0.00820788,0,1,363805,363184,621
33049521,264.866,264.872,621,13168,0.00164158,0,1,364070,363449,621
33050981,264.973,264.974,621,13168,0.000328315,0.01,1,364335,363714,621
33052441,264.995,264.995,621,13168,6.5663e-05,0.02,1,364600,363979,621
33053901,266.599,264.999,623,13168,1.31326e-05,0,1,364867,364244,623
33055361,263.72,265,621,13168,0.00800263,0,1,365130,364509,621
33056821,264.744,265,621,13168,0.00160053,0.03,1,365395,364774,621
33058281,264.949,265,621,13168,0.00832011,0,1,365660,365039,621
33059741,264.99,265,621,13168,0.00166402,0,1,365925,365304,621
33061201,265.798,265,622,13168,0.0083328,0,1,366191,365569,622
33062661,265.16,265,622,13168,0.00966656,0.01,1,366456,365834,622
33064121,265.032,265,622,13168,0.00193331,0,1,366721,366099,622
33065581,264.206,265,621,13168,0.000386662,0,1,366985,366364,621
33067041,265.641,265,622,13168,7.73325e-05,0.01,1,367251,366629,622
33068501,264.328,265,621,13168,1.54665e-05,0,1,367515,366894,621
33069961,266.466,265,623,13168,3.0933e-06,0,1,367782,367159,623
33071421,264.493,265,622,13168,6.1866e-07,0,1,368046,367424,622
33072881,264.099,265,621,13168,0.0160001,0,1,368310,367689,621
33074341,265.62,265,622,13168,0.0192,0,1,368576,367954,622
33075801,264.324,265,621,13168,0.00384,0.01,1,368840,368219,621
33077261,265.665,265,622,13168,0.008768,0,1,369106,368484,622
33078721,264.333,265,621,13168,0.0017536,0.01,1,369370,368749,621
33080181,264.867,265,621,13168,0.00035072,0.01,1,369635,369014,621
33081641,264.973,265,621,13168,0.00807014,0,1,369900,369279,621
33083101,265.795,265,622,13168,0.00161403,0.03,1,370166,369544,622
33084561,264.359,265,621,13168,0.000322806,0.01,1,370430,369809,621
33086021,264.872,265,621,13168,0.00806456,0.03,1,370695,370074,621
33087481,264.974,265,621,13168,0.00161291,0,1,370960,370339,621
33088941,264.995,265,621,13168,0.0243226,0,1,371225,370604,621
33090401,266.599,265,623,12813,0.0128645,0,1,371492,370869,623
33091861,263.72,265,621,12813,0.0025729,0,1,371755,371134,621
33093321,265.544,265,622,12813,0.00851458,0,1,372021,371399,622
33094781,277.909,278.6,621,12813,0.0257029,0.01,1,372302,371681,621
33096241,281.182,281.32,621,12813,0.0131406,0,1,372584,371963,621
33097701,281.836,281.864,621,12813,0.0106281,0,1,372866,372245,621
33099161,281.967,281.973,621,12813,0.00212562,0,1,373148,372527,621
33100621,282.793,281.995,622,12813,0.000425125,0,1,373431,372809,622
33102081,281.359,281.999,621,12813,0.00808502,0,1,373712,373091,621
33103541,281.872,282,621,12813,0.009617,0,1,373994,373373,621
33105001,282.774,282,622,12813,0.0019234,0,1,374277,373655,622
33106461,281.355,282,621,12813,0.00838468,0,1,374558,373937,621
33107921,281.871,282,621,12813,0.00967694,0.02,1,374840,374219,621
33109381,282.774,282,622,12813,0.00193539,0.01,1,375123,374501,622
33110841,282.155,282,622,12813,0.000387077,0.01,1,375405,374783,622
33112301,281.231,282,621,12813,7.74155e-05,0,1,375686,375065,621
33113761,281.846,282,621,12813,0.00801548,0.01,1,375968,375347,621
33115221,282.769,282,622,12813,0.0096031,0,1,376251,375629,622
33116681,282.154,282,622,12813,0.00992062,0,1,376533,375911,622
33118141,281.231,282,621,12813,0.00198412,0,1,376814,376193,621
33119601,282.646,282,622,12813,0.000396825,0,1,377097,376475,622
33121061,281.329,282,621,12813,7.93649e-05,0,1,377378,376757,621
33122521,282.666,282,622,12813,1.5873e-05,0,1,377661,377039,622
33123981,282.133,282,622,12813,3.1746e-06,0,1,377943,377321,622
33125441,281.227,282,621,12803,6.34919e-07,0,1,378224,377603,621
33126901,282.645,282,622,12803,0.00800013,0,1,378507,377885,622
33128361,281.329,282,621,12803,0.00160003,0.01,1,378788,378167,621
33129821,282.666,282.8,621,12803,0.000320005,0,1,379071,378450,621
33131281,283.733,282.96,622,12803,0.008064,0,1,379355,378733,622
33132741,283.147,282.992,622,12803,0.0016128,0.01,1,379638,379016,622
33134201,282.229,282.998,621,12803,0.00032256,0,1,379920,379299,621
33135661,282.846,283,621,12803,0.0160645,0,1,380203,379582,621
33137121,282.969,283,621,12803,0.0112129,0.01,1,380486,379865,621
33138581,283.794,283,622,12476,0.00224258,0.01,1,380770,380148,622
33140041,282.359,283,621,12476,0.000448516,0.01,1,381052,380431,621
33141501,282.872,283,621,12476,8.97032e-05,0.01,1,381335,380714,621
33142961,297.374,297.4,621,12476,0.00801794,0.02,1,381636,381015,621
33144421,300.275,300.28,621,12476,0.00160359,0.01,1,381937,381316,621
33145881,300.855,300.856,621,12476,0.000320718,0.03,1,382238,381617,621
33147341,300.971,300.971,621,12476,0.00806414,0,1,382539,381918,621
33148801,300.994,300.994,621,12476,0.00961283,0.01,1,382840,382219,621
33150261,300.999,300.999,621,12476,0.00192257,0,1,383141,382520,621
33151721,301,301,621,12476,0.000384513,0,1,383442,382821,621
33153181,301,301,621,12476,7.69026e-05,0,1,383743,383122,621
33154641,301,301,621,12476,1.53805e-05,0,1,384044,383423,621
33156101,302.6,301,623,12476,3.0761e-06,0.03,1,384347,383724,623
33157561,299.72,301,621,12476,6.15221e-07,0,1,384646,384025,621
33159021,301.544,301,622,12476,0.00800012,0.01,1,384948,384326,622
33160481,300.309,301,621,12476,0.00160002,0,1,385248,384627,621
33161941,300.862,301,621,12476,0.000320005,0,1,385549,384928,621
33163401,300.972,301,621,12476,0.008064,0,1,385850,385229,621
33164861,300.994,301,621,12476,0.0016128,0,1,386151,385530,621
33166321,300.999,301,621,12476,0.00032256,0.01,1,386452,385831,621
33167781,302.6,301,623,12476,0.00806451,0.01,1,386755,386132,623
33169241,299.72,301,621,12476,0.0016129,0.01,1,387054,386433,621
33170701,302.344,301,623,12476,0.00032258,0.01,1,387357,386734,623
33172161,300.469,301,622,12476,6.45161e-05,0.02,1,387657,387035,622
33173621,300.094,301,621,12476,1.29032e-05,0.01,1,387957,387336,621
33175081,301.619,301,622,12476,0.00800258,0,1,388259,387637,622
33176541,301.124,301,622,12476,0.00960052,0,1,388560,387938,622
33178001,301.025,301,622,12452,0.0099201,0,1,388861,388239,622
33179461,301.005,301,622,12452,0.033984,0.01,1,389162,388540,622
33180921,301.001,301,622,12452,0.0307968,0,1,389463,388841,622
33182381,301,301.8,621,12452,0.0141594,0.01,1,389764,389143,621
33183841,302.6,301.96,622,12452,0.00283187,0,1,390067,389445,622
33185301,302.12,301.992,622,12452,0.00856637,0,1,390369,389747,622
33186761,302.024,301.998,622,12452,0.00971327,0,1,390671,390049,622
33188221,302.005,302,622,12452,0.00194265,0,1,390973,390351,622
33189681,301.201,302,621,12452,0.000388531,0,1,391274,390653,621
33191141,301.84,302,621,12153,7.77062e-05,0,1,391576,390955,621
33192601,302.768,302,622,12153,0.00801554,0.03,1,391879,391257,622
33194061,301.354,302,621,12153,0.00960311,0,1,392180,391559,621
33195521,317.871,317.2,622,12153,0.00192062,0.01,1,392502,391880,622
33196981,319.574,320.24,621,12153,0.000384124,0,1,392822,392201,621
33198441,321.515,320.848,622,12153,7.68249e-05,0,1,393144,392522,622
33199901,321.103,320.97,622,12153,1.5365e-05,0,1,393465,392843,622
33201361,320.221,320.994,621,12153,3.07299e-06,0.02,1,393785,393164,621
33202821,320.844,320.999,621,12153,6.14599e-07,0.01,1,394106,393485,621
33204281,321.769,321,622,12153,1.2292e-07,0.02,1,394428,393806,622
33205741,320.354,321,621,12153,0.00800002,0.03,1,394748,394127,621
33207201,320.871,321,621,12153,0.0016,0,1,395069,394448,621
33208661,321.774,321,622,12153,0.01632,0,1,395391,394769,622
33210121,321.155,321,622,12153,0.003264,0,1,395712,395090,622
33211581,320.231,321,621,12153,0.0326528,0,1,396032,395411,621
33213041,320.846,321,621,12149,0.00653056,0,1,396353,395732,621
33214501,321.769,321,622,12149,0.00130611,0.01,1,396675,396053,622
33215961,320.354,321,621,12132,0.00826122,0.01,1,396995,396374,621
33217421,320.871,321,621,12132,0.00965224,0,1,397316,396695,621
33218881,321.774,321.8,621,12132,0.00993045,0,1,397638,397017,621
33220341,322.755,321.96,622,12132,0.00198609,0.01,1,397961,397339,622
33221801,321.351,321.992,621,12132,0.00839722,0.01,1,398282,397661,621
33223261,321.87,321.998,621,12132,0.0256794,0.02,1,398604,397983,621
33224721,323.574,322,623,12132,0.00513589,0.01,1,398928,398305,623
33226181,320.715,322,621,12132,0.00102718,0,1,399248,398627,621
33227641,321.743,322,621,11342,0.000205436,0,1,399570,398949,621
33229101,321.949,322,621,11342,0.00804109,0.01,1,399892,399271,621
33230561,372.39,372.4,621,11342,0.00160822,0.03,1,400277,399656,621
33232021,382.478,382.48,621,11342,0.00832164,0,1,400662,400041,621
33233481,384.496,384.496,621,11342,0.00166433,0.01,1,401047,400426,621
33234941,385.699,384.899,622,11342,0.00833287,0,1,401433,400811,622
33236401,385.14,384.98,622,11342,0.00966657,0.01,1,401818,401196,622
33237861,384.228,384.996,621,11342,0.00193331,0.01,1,402202,401581,621
33239321,384.846,384.999,621,11342,0.00838666,0,1,402587,401966,621
33240781,384.969,385,621,11342,0.00167733,0.01,1,402972,402351,621
33242241,385.794,385,622,11342,0.00833547,0.01,1,403358,402736,622
33243701,384.359,385,621,11342,0.00166709,0,1,403742,403121,621
33245161,384.872,385,621,11338,0.000333419,0.01,1,404127,403506,621
33246621,385.774,385,622,11338,0.00806668,0,1,404513,403891,622
33248081,384.355,385,621,11338,0.00161334,0,1,404897,404276,621
33249541,384.871,385,621,11338,0.000322667,0,1,405282,404661,621
33251001,385.774,385,622,11333,6.45335e-05,0,1,405668,405046,622
33252461,384.355,385,621,11333,1.29067e-05,0,1,406052,405431,621
33253921,385.671,385.8,621,11333,0.00800258,0,1,406438,405817,621
33255381,385.934,385.96,621,11333,0.00960052,0.02,1,406824,406203,621
33256841,385.987,385.992,621,11333,0.0019201,0,1,407210,406589,621
33258301,385.997,385.998,621,11333,0.000384021,0,1,407596,406975,621
33259761,386.799,386,622,11333,0.0080768,0.03,1,407983,407361,622
33261221,385.36,386,621,11333,0.00161536,0,1,408368,407747,621
33262681,385.872,386,621,10666,0.00832307,0,1,408754,408133,621
33264141,386.774,386,622,10666,0.00166461,0,1,409141,408519,622
33265601,446.955,446.8,622,10666,0.000332923,0,1,409603,408981,622
33267061,458.991,458.96,622,10666,6.65846e-05,0,1,410065,409443,622
33268521,460.598,461.392,621,10666,0.00801332,0,1,410526,409905,621
33269981,461.72,461.878,621,10666,0.00160266,0.01,1,410988,410367,621
33271441,461.944,461.976,621,10666,0.0243205,0.01,1,411450,410829,621
33272901,461.989,461.995,621,10666,0.00486411,0.01,1,411912,411291,621
33274361,461.998,461.999,621,10666,0.000972821,0.01,1,412374,411753,621
33275821,462,462,621,10666,0.00819456,0,1,412836,412215,621
33277281,462,462,621,10666,0.00163891,0,1,413298,412677,621
33278741,462,462,621,10666,0.000327783,0.01,1,413760,413139,621
33280201,462,462,621,10666,0.00806556,0,1,414222,413601,621
33281661,462.8,462,622,10666,0.00961311,0,1,414685,414063,622
33283121,462.16,462,622,10666,0.00192262,0.02,1,415147,414525,622
33284581,462.032,462,622,10666,0.000384524,0,1,415609,414987,622
33286041,462.006,462,622,10658,0.00807691,0,1,416071,415449,622
33287501,461.201,462,621,10658,0.00961538,0,1,416532,415911,621
33288961,462.64,462.8,621,10658,0.00192308,0.01,1,416995,416374,621
33290421,462.928,462.96,621,10658,0.000384615,0,1,417458,416837,621
33291881,463.786,462.992,622,10658,7.6923e-05,0,1,417922,417300,622
33293341,462.357,462.998,621,10658,1.53846e-05,0,1,418384,417763,621
33294801,462.871,463,621,10658,3.07692e-06,0,1,418847,418226,621
33296261,462.974,463,621,10658,0.00800062,0,1,419310,418689,621
33297721,462.995,463,621,10107,0.00960012,0,1,419773,419152,621
33299181,463.799,463,622,10107,0.00192002,0,1,420237,419615,622
33300641,535.16,535.8,621,10107,0.000384005,0,1,420790,420169,621
33302101,550.232,550.36,621,10107,7.6801e-05,0,1,421344,420723,621
33303561,554.046,553.272,622,10107,1.53602e-05,0,1,421899,421277,622
33305021,553.209,553.854,621,10107,3.07204e-06,0,1,422452,421831,621
33306481,553.842,553.971,621,10107,6.14408e-07,0,1,423006,422385,621
33307941,554.768,553.994,622,10107,0.0240001,0,1,423561,422939,622
33309401,553.354,553.999,621,10107,0.0208,0,1,424114,423493,621
33310861,553.871,554,621,10107,0.02816,0,1,424668,424047,621
33312321,554.774,554,622,10107,0.005632,0,1,425223,424601,622
33313781,553.355,554,621,10107,0.0011264,0,1,425776,425155,621
33315241,553.871,554,621,10107,0.00022528,0.01,1,426330,425709,621
33316701,553.974,554,621,10107,0.00804506,0,1,426884,426263,621
33318161,554.795,554,622,10107,0.00960901,0.02,1,427439,426817,622
33319621,553.359,554,621,10107,0.0099218,0,1,427992,427371,621
33321081,553.872,554,621,10099,0.00198436,0.01,1,428546,427925,621
33322541,553.974,554,621,10099,0.000396872,0.01,1,429100,428479,621
33324001,556.395,555.6,622,10099,7.93744e-05,0,1,429657,429035,622
33325461,555.279,555.92,621,10099,0.0160159,0,1,430212,429591,621
33326921,556.656,555.984,622,10099,0.0272032,0,1,430769,430147,622
33328381,556.931,555.997,623,10099,0.00544064,0,1,431326,430703,623
33329841,554.586,555.999,621,9640,0.00108813,0.03,1,431880,431259,621
33331301,555.717,556,621,9640,0.000217625,0,1,432436,431815,621
33332761,643.143,642.4,622,9640,0.00804352,0,1,433101,432479,622
33334221,792.629,793.28,621,9640,0.0096087,0,1,433931,433310,621
33335681,824.126,823.456,622,9640,0.00192174,0,1,434763,434141,622
33337141,828.825,829.491,621,9640,0.000384348,0,1,435593,434972,621
33338601,831.365,830.698,622,9640,7.68696e-05,0,1,436425,435803,622
33340061,830.273,830.94,621,9640,0.0160154,0,1,437255,436634,621
33341521,830.855,830.988,621,9640,0.00320307,0,1,438086,437465,621
33342981,831.771,830.998,622,9640,0.000640615,0,1,438918,438296,622
33344441,831.154,830.999,622,9633,0.000128123,0,1,439749,439127,622
33345901,833.431,833.4,622,9633,2.56246e-05,0,1,440583,439961,622
33347361,833.886,833.88,622,9633,0.0240051,0,1,441417,440795,622
33348821,833.177,833.976,621,8638,0.00480102,0,1,442250,441629,621
33350281,1304.24,1328.4,591,1460,0.00896021,0,1,443672,443081,591
33351741,1558.45,1538.48,622,1460,0.00179204,0,1,445294,444672,622
33353201,1448.49,1469.3,591,1460,0.000358408,0,1,446715,446124,591
33354661,1586.5,1566.66,621,1460,7.16816e-05,0,1,448336,447715,621
33356121,1454.1,1474.93,590,1460,0.00801434,0,1,449757,449167,590
33357581,1587.62,1566.99,621,1460,0.00160287,0,1,451378,450757,621
33359041,1454.32,1475,590,1460,0.00832057,0,1,452799,452209,590
33360501,1587.66,1567,621,1460,0.00166411,0,1,454420,453799,621
33361961,1454.33,1475.8,589,1460,0.000332823,0,1,455841,455252,589
33363421,1587.67,1566.36,621,1460,6.65646e-05,0,1,457462,456841,621
33364881,1455.13,1477.27,588,1460,1.33129e-05,0,1,458884,458296,588
33366341,1587.83,1565.85,621,1460,2.66258e-06,0,1,460505,459884,621
33367801,1614.37,1609.97,621,1460,5.32517e-07,0,1,462126,461505,621
33369261,1619.67,1618.79,621,1460,1.06503e-07,0,1,463747,463126,621
33370721,1621.53,1620.56,622,1460,2.13007e-08,0,1,465369,464747,622
33372181,1621.11,1621.71,621,1460,4.26013e-09,0,1,466990,466369,621
33373641,1621.02,1621.14,621,1460,0.008,0,1,468611,467990,621
33375101,1621,1621.03,621,1460,0.0016,0,1,470232,469611,621
33376561,1621.8,1621.01,622,1460,0.00032,0,1,471854,471232,622
33378021,1621.16,1621.8,621,1460,6.4e-05,0,1,473475,472854,621
33379481,1621.83,1621.16,622,1460,1.28e-05,0,1,475097,474475,622
33380941,1621.97,1621.83,622,1460,2.56e-06,0,1,476719,476097,622
33382401,1621.19,1621.97,621,1460,5.12e-07,0,1,478340,477719,621
33383861,1621.84,1621.19,622,1460,1.024e-07,0,1,479962,479340,622
33385321,1621.17,1621.84,621,1460,2.048e-08,0,1,481583,480962,621
33386781,1621.03,1621.17,621,1460,4.096e-09,0,1,483204,482583,621
33388241,1621.81,1621.03,622,1460,0.008,0,1,484826,484204,622
33389701,1621.16,1621.81,621,1460,0.0096,0,1,486447,485826,621
33391161,1621.03,1621.16,621,1460,0.00192,0,1,488068,487447,621
33392621,1621.81,1621.03,622,1460,0.000384,0,1,489690,489068,622
33394081,1621.16,1621.81,621,1460,7.68e-05,0,1,491311,490690,621
33395541,1621.83,1621.16,622,1460,0.00801536,0,1,492933,492311,622
33397001,1621.17,1621.83,621,1460,0.00160307,0,1,494554,493933,621
33398461,1621.03,1621.17,621,1460,0.000320614,0,1,496175,495554,621
33399921,1621.01,1621.03,621,1460,6.41229e-05,0,1,497796,497175,621
33401381,1621,1621.01,621,1460,0.00801282,0,1,499417,498796,621
33402841,1621.8,1621,622,1460,0.00160256,0,1,501039,500417,622
33404301,1621.16,1621.8,621,1460,0.000320513,0,1,502660,502039,621
33405761,1621.03,1621.16,621,1460,6.41026e-05,0,1,504281,503660,621
33407221,1621.01,1621.03,621,1460,1.28205e-05,0,1,505902,505281,621
33408681,1621,1621.01,621,1460,2.5641e-06,0,1,507523,506902,621
33410141,1621,1621,621,1460,5.12821e-07,0,1,509144,508523,621
33411601,1621,1621,621,1460,1.02564e-07,0,1,510765,510144,621
33413061,1621,1621,621,1460,2.05128e-08,0,1,512386,511765,621
33414521,1621,1621,621,1460,4.10256e-09,0,1,514007,513386,621
33415981,1621,1621,621,1460,8.20513e-10,0,1,515628,515007,621
33417441,1621.8,1621,622,1460,1.64103e-10,0,1,517250,516628,622
33418901,1621.96,1621.8,622,1460,3.28205e-11,0,1,518872,518250,622
33420361,1621.19,1621.96,621,1460,0.008,0,1,520493,519872,621
33421821,1621.04,1621.19,621,1460,0.0016,0,1,522114,521493,621
33423281,1621.01,1621.04,621,1460,0.00032,0,1,523735,523114,621
33424741,1621,1621.01,621,1460,6.4e-05,0,1,525356,524735,621
33426201,1621,1621,621,1460,1.28e-05,0,1,526977,526356,621
33427661,1621,1621,621,1460,2.56e-06,0,1,528598,527977,621
33429121,1621,1621,621,1460,5.12e-07,0,1,530219,529598,621
33430581,1621.8,1621,622,1460,1.024e-07,0,1,531841,531219,622
33432041,1621.16,1621.8,621,1460,2.048e-08,0,1,533462,532841,621
33433501,1621.03,1621.16,621,1460,4.096e-09,0,1,535083,534462,621
33434961,1621.01,1621.03,621,1460,8.19199e-10,0,1,536704,536083,621
33436421,1621.8,1621.01,622,1460,0.008,0,1,538326,537704,622
33437881,1621.16,1621.8,621,1460,0.0096,0,1,539947,539326,621
33439341,1621.03,1621.16,621,1460,0.00992,0,1,541568,540947,621
33440801,1621.01,1621.03,621,1460,0.001984,0,1,543189,542568,621
33442261,1621,1621.01,621,1460,0.0003968,0,1,544810,544189,621
33443721,1621,1621,621,1460,7.936e-05,0,1,546431,545810,621
33445181,1621,1621,621,1460,1.5872e-05,0,1,548052,547431,621
33446641,1621,1621,621,1460,3.1744e-06,0,1,549673,549052,621
33448101,1621,1621,621,1460,6.3488e-07,0,1,551294,550673,621
33449561,1621.8,1621,622,1460,1.26976e-07,0,1,552916,552294,622
33451021,1621.16,1621.8,621,1460,2.53952e-08,0,1,554537,553916,621
33452481,1621.03,1621.16,621,1460,5.07904e-09,0,1,556158,555537,621
33453941,1621.01,1621.03,621,1460,1.01581e-09,0,1,557779,557158,621
33455401,1621,1621.01,621,1460,2.03161e-10,0,1,559400,558779,621
33456861,1621,1621,621,1460,4.06323e-11,0,1,561021,560400,621
33458321,1621,1621,621,1460,8.12646e-12,0,1,562642,562021,621
33459781,1621,1621,621,1460,0.008,0,1,564263,563642,621
33461241,1621,1621,621,1460,0.0096,0,1,565884,565263,621
33462701,1621,1621,621,1460,0.00192,0,1,567505,566884,621
33464161,1621,1621,621,1460,0.000384,0,1,569126,568505,621
33465621,1621,1621,621,1460,7.68e-05,0,1,570747,570126,621
33467081,1621,1621,621,1460,1.536e-05,0,1,572368,571747,621
33468541,1621,1621,621,1460,3.072e-06,0,1,573989,573368,621
33470001,1621,1621,621,1460,6.144e-07,0,1,575610,574989,621
33471461,1621.8,1621,622,1460,1.2288e-07,0,1,577232,576610,622
33472921,1621.16,1621.8,621,1460,2.4576e-08,0,1,578853,578232,621
33474381,1621.03,1621.16,621,1460,4.9152e-09,0,1,580474,579853,621
33475841,1621.01,1621.03,621,1460,0.008,0,1,582095,581474,621
33477301,1621,1621.01,621,1460,0.0016,0,1,583716,583095,621
33478761,1621,1621,621,1460,0.00032,0,1,585337,584716,621
33480221,1621,1621,621,1460,0.008064,0,1,586958,586337,621
33481681,1621,1621,621,1460,0.0096128,0,1,588579,587958,621
33483141,1621.8,1621,622,1460,0.00192256,0,1,590201,589579,622
33484601,1621.16,1621.8,621,1460,0.000384512,0,1,591822,591201,621
33486061,1621.83,1621.16,622,1460,7.69024e-05,0,1,593444,592822,622
33487521,1621.17,1621.83,621,1460,0.0160154,0,1,595065,594444,621
33488981,1621.03,1621.17,621,1460,0.0112031,0,1,596686,596065,621
33490441,1621.81,1621.03,622,1460,0.00224061,0,1,598308,597686,622
33491901,1621.16,1621.81,621,1460,0.00844812,0,1,599929,599308,621
33493361,1621.03,1621.16,621,1460,0.00168962,0,1,601550,600929,621
33494821,1621.01,1621.03,621,1460,0.00833793,0,1,603171,602550,621
33496281,1621,1621.01,621,1460,0.00166758,0,1,604792,604171,621
33497741,1621,1621,621,1460,0.0163335,0,1,606413,605792,621
33499201,1621,1621,621,1460,0.0112667,0,1,608034,607413,621
33500661,1621,1621,621,1460,0.0102533,0,1,609655,609034,621
33502121,1621,1621,621,1460,0.0100507,0,1,611276,610655,621
33503581,1621,1621,621,1460,0.0100101,0,1,612897,612276,621
33505041,1621,1621,621,1460,0.010002,0,1,614518,613897,621
33506501,1621,1621,621,1460,0.0260004,0,1,616139,615518,621
33507961,1621,1621,621,1460,0.00520008,0,1,617760,617139,621
33509421,1621.8,1621,622,1460,0.00104002,0,1,619382,618760,622
33510881,1621.16,1621.8,621,1460,0.000208003,0,1,621003,620382,621
33512341,1621.83,1621.16,622,1460,4.16006e-05,0,1,622625,622003,622
33513801,1621.17,1621.83,621,1460,8.32013e-06,0,1,624246,623625,621
33515261,1621.03,1621.17,621,1460,1.66403e-06,0,1,625867,625246,621
33516721,1621.01,1621.03,621,1460,3.32805e-07,0,1,627488,626867,621
33518181,1621,1621.01,621,1460,6.6561e-08,0,1,629109,628488,621
33519641,1621,1621,621,1460,0.00800001,0,1,630730,630109,621
33521101,1621,1621,621,1460,0.0016,0,1,632351,631730,621
33522561,1621.8,1621,622,1460,0.00032,0,1,633973,633351,622
33524021,1621.96,1621.8,622,1460,0.008064,0,1,635595,634973,622
33525481,1621.99,1621.96,622,1460,0.0176128,0,1,637217,636595,622
33526941,1621.2,1621.99,621,1460,0.0115226,0,1,638838,638217,621
33528401,1621.04,1621.2,621,1460,0.0103045,0,1,640459,639838,621
33529861,1621.01,1621.04,621,1460,0.0100609,0,1,642080,641459,621
33531321,1621,1621.01,621,1460,0.0100122,0,1,643701,643080,621
33532781,1621,1621,621,1460,0.0180024,0,1,645322,644701,621
33534241,1621,1621,621,1460,0.00360049,0,1,646943,646322,621
33535701,1621,1621,621,1460,0.000720097,0,1,648564,647943,621
33537161,1621,1621,621,1460,0.000144019,0,1,650185,649564,621
33538621,1621,1621,621,1460,2.88039e-05,0,1,651806,651185,621
33540081,1621,1621,621,1460,0.00800576,0,1,653427,652806,621
33541541,1621,1621,621,1460,0.00160115,0,1,655048,654427,621
33543001,1621,1621,621,1460,0.00032023,0,1,656669,656048,621
33544461,1621,1621,621,1460,6.40461e-05,0,1,658290,657669,621
33545921,1621,1621,621,1460,1.28092e-05,0,1,659911,659290,621
33547381,1621.8,1621,622,1460,2.56184e-06,0,1,661533,660911,622
33548841,1621.16,1621.8,621,1460,5.12369e-07,0,1,663154,662533,621
33550301,1621.83,1621.16,622,1460,1.02474e-07,0,1,664776,664154,622
33551761,1621.17,1621.83,621,1460,2.04947e-08,0,1,666397,665776,621
33553221,1621.03,1621.17,621,1460,4.09895e-09,0,1,668018,667397,621
33554681,1621.01,1621.03,621,1460,8.19789e-10,0,1,669639,669018,621
33556141,1621,1621.01,621,1460,1.63958e-10,0,1,671260,670639,621
33557601,1621,1621,621,1460,3.27916e-11,0,1,672881,672260,621
33559061,1621,1621,621,1460,0.008,0,1,674502,673881,621
33560521,1621,1621,621,1460,0.0016,0,1,676123,675502,621
33561981,1621.8,1621,622,1460,0.00032,0,1,677745,677123,622
33563441,1621.16,1621.8,621,1460,6.4e-05,0,1,679366,678745,621
33564901,1621.03,1621.16,621,1460,1.28e-05,0,1,680987,680366,621
33566361,1621.01,1621.03,621,1460,2.56e-06,0,1,682608,681987,621
33567821,1621.8,1621.01,622,1460,5.12e-07,0,1,684230,683608,622
33569281,1621.16,1621.8,621,1460,1.024e-07,0,1,685851,685230,621
33570741,1621.03,1621.16,621,1460,2.048e-08,0,1,687472,686851,621
33572201,1621.01,1621.03,621,1460,4.096e-09,0,1,689093,688472,621
33573661,1621.8,1621.01,622,1460,8.19199e-10,0,1,690715,690093,622
33575121,1621.16,1621.8,621,1460,1.6384e-10,0,1,692336,691715,621
33576581,1621.83,1621.16,622,1460,0.008,0,1,693958,693336,622
33578041,1621.17,1621.83,621,1460,0.0016,0,1,695579,694958,621
33579501,1621.03,1621.17,621,1460,0.00032,0,1,697200,696579,621
33580961,1621.81,1621.03,622,1460,0.008064,0,1,698822,698200,622
33582421,1621.16,1621.81,621,1460,0.0096128,0,1,700443,699822,621
33583881,1621.03,1621.16,621,1460,0.00192256,0,1,702064,701443,621
33585341,1621.01,1621.03,621,1460,0.000384512,0,1,703685,703064,621
33586801,1621,1621.01,621,1460,7.69024e-05,0,1,705306,704685,621
33588261,1621.8,1621,622,1460,1.53805e-05,0,1,706928,706306,622
33589721,1621.16,1621.8,621,1460,0.00800308,0,1,708549,707928,621
33591181,1621.03,1621.16,621,1460,0.00160062,0,1,710170,709549,621
33592641,1621.81,1621.03,622,1460,0.000320123,0,1,711792,711170,622
33594101,1621.16,1621.81,621,1460,6.40246e-05,0,1,713413,712792,621
33595561,1621.03,1621.16,621,1460,0.00801281,0,1,715034,714413,621
33597021,1621.01,1621.03,621,1460,0.00160256,0,1,716655,716034,621
33598481,1621.8,1621.01,622,1460,0.000320512,0,1,718277,717655,622
33599941,1621.16,1621.8,621,1460,0.0080641,0,1,719898,719277,621
33601401,1621.03,1621.16,621,1460,0.00961282,0,1,721519,720898,621
33602861,1621.01,1621.03,621,1460,0.00192256,0,1,723140,722519,621
33604321,1621,1621.01,621,1460,0.000384513,0,1,724761,724140,621
33605781,1621,1621,621,1460,7.69026e-05,0,1,726382,725761,621
33607241,1621,1621,621,1460,1.53805e-05,0,1,728003,727382,621
33608701,1621.8,1621,622,1460,3.0761e-06,0,1,729625,729003,622
33610161,1621.16,1621.8,621,1460,6.1522e-07,0,1,731246,730625,621
33611621,1621.03,1621.16,621,1460,1.23044e-07,0,1,732867,732246,621
33613081,1621.01,1621.03,621,1460,2.46088e-08,0,1,734488,733867,621
33614541,1621.8,1621.01,622,1460,4.92176e-09,0,1,736110,735488,622
33616001,1621.16,1621.8,621,1460,9.84352e-10,0,1,737731,737110,621
33617461,1621.03,1621.16,621,1460,1.9687e-10,0,1,739352,738731,621
33618921,1621.01,1621.03,621,1460,3.93741e-11,0,1,740973,740352,621
33620381,1621,1621.01,621,1460,7.87482e-12,0,1,742594,741973,621
33621841,1621,1621,621,1460,1.57496e-12,0,1,744215,743594,621
33623301,1621,1621,621,1460,0.008,0,1,745836,745215,621
33624761,1621,1621,621,1460,0.0016,0,1,747457,746836,621
33626221,1621,1621,621,1460,0.00032,0,1,749078,748457,621
33627681,1621.8,1621,622,1460,6.4e-05,0,1,750700,750078,622
33629141,1621.96,1621.8,622,1460,0.0080128,0,1,752322,751700,622
33630601,1621.19,1621.96,621,1460,0.0256026,0,1,753943,753322,621
33632061,1621.04,1621.19,621,1460,0.00512051,0,1,755564,754943,621
33633521,1621.01,1621.04,621,1460,0.0010241,0,1,757185,756564,621
33634981,1621,1621.01,621,1460,0.00020482,0,1,758806,758185,621
33636441,1621.8,1621,622,1460,0.00804096,0,1,760428,759806,622
33637901,1621.16,1621.8,621,1460,0.00960819,0,1,762049,761428,621
33639361,1621.83,1621.16,622,1460,0.00192164,0,1,763671,763049,622
33640821,1621.17,1621.83,621,1460,0.000384328,0,1,765292,764671,621
33642281,1621.03,1621.17,621,1460,7.68655e-05,0,1,766913,766292,621
33643741,1621.01,1621.03,621,1460,1.53731e-05,0,1,768534,767913,621
33645201,1621,1621.01,621,1460,3.07462e-06,0,1,770155,769534,621
33646661,1621,1621,621,1460,0.0160006,0,1,771776,771155,621
33648121,1621,1621,621,1460,0.0272001,0,1,773397,772776,621
33649581,1621,1621,621,1460,0.00544002,0,1,775018,774397,621
33651041,1621,1621,621,1460,0.001088,0,1,776639,776018,621
33652501,1621.8,1621,622,1460,0.0082176,0,1,778261,777639,622
33653961,1621.16,1621.8,621,1460,0.00964352,0,1,779882,779261,621
33655421,1621.03,1621.16,621,1460,0.0099287,0,1,781503,780882,621
33656881,1621.01,1621.03,621,1460,0.00998574,0,1,783124,782503,621
33658341,1621,1621.01,621,1460,0.00999715,0,1,784745,784124,621
33659801,1621.8,1621,622,1460,0.00999943,0,1,786367,785745,622
33661261,1621.16,1621.8,621,1460,0.00999989,0,1,787988,787367,621
33662721,1621.03,1621.16,621,1460,0.00199998,0,1,789609,788988,621
33664181,1621.01,1621.03,621,1460,0.000399995,0,1,791230,790609,621
33665641,1621,1621.01,621,1460,0.00808,0,1,792851,792230,621
33667101,1621.8,1621,622,1460,0.001616,0,1,794473,793851,622
33668561,1621.16,1621.8,621,1460,0.0003232,0,1,796094,795473,621
33670021,1621.03,1621.16,621,1460,6.464e-05,0,1,797715,797094,621
33671481,1621.01,1621.03,621,1460,1.2928e-05,0,1,799336,798715,621
33672941,1621.8,1621.01,622,1460,0.00800259,0,1,800958,800336,622
33674401,1621.96,1621.8,622,1460,0.00960052,0,1,802580,801958,622
33675861,1621.99,1621.96,622,1460,0.0099201,0,1,804202,803580,622
33677321,1621.2,1621.99,621,1460,0.00998402,0,1,805823,805202,621
33678781,1621.04,1621.2,621,1460,0.0099968,0,1,807444,806823,621
33680241,1621.81,1621.04,622,1460,0.00199936,0,1,809066,808444,622
33681701,1621.96,1621.81,622,1460,0.000399872,0,1,810688,810066,622
33683161,1621.99,1621.96,622,1460,7.99744e-05,0,1,812310,811688,622
33684621,1622,1621.99,622,1460,1.59949e-05,0,1,813932,813310,622
33686081,1621.2,1622,621,1460,0.0080032,0,1,815553,814932,621
33687541,1621.04,1621.2,621,1460,0.00160064,0,1,817174,816553,621
33689001,1621.01,1621.04,621,1460,0.00832013,0,1,818795,818174,621
33690461,1621,1621.01,621,1460,0.00166403,0,1,820416,819795,621
33691921,1621,1621,621,1460,0.000332805,0,1,822037,821416,621
33693381,1621.8,1621,622,1460,6.6561e-05,0,1,823659,823037,622
33694841,1621.16,1621.8,621,1460,1.33122e-05,0,1,825280,824659,621
33696301,1621.83,1621.16,622,1460,0.00800266,0,1,826902,826280,622
33697761,1621.17,1621.83,621,1460,0.00160053,0,1,828523,827902,621
33699221,1621.03,1621.17,621,1460,0.000320106,0,1,830144,829523,621
33700681,1621.01,1621.03,621,1460,6.40213e-05,0,1,831765,831144,621
33702141,1621,1621.01,621,1460,1.28043e-05,0,1,833386,832765,621
33703601,1621.8,1621,622,1460,2.56085e-06,0,1,835008,834386,622
33705061,1621.16,1621.8,621,1460,5.1217e-07,0,1,836629,836008,621
33706521,1621.03,1621.16,621,1460,0.0080001,0,1,838250,837629,621
33707981,1621.81,1621.03,622,1460,0.00160002,0,1,839872,839250,622
33709441,1621.16,1621.81,621,1460,0.00832,0,1,841493,840872,621
33710901,1621.03,1621.16,621,1460,0.001664,0,1,843114,842493,621
33712361,1621.01,1621.03,621,1460,0.0003328,0,1,844735,844114,621
33713821,1621.8,1621.01,622,1460,6.656e-05,0,1,846357,845735,622
33715281,1621.16,1621.8,621,1460,1.3312e-05,0,1,847978,847357,621
33716741,1621.03,1621.16,621,1460,2.6624e-06,0,1,849599,848978,621
33718201,1621.01,1621.03,621,1460,5.3248e-07,0,1,851220,850599,621
33719661,1621,1621.01,621,1460,1.06496e-07,0,1,852841,852220,621
33721121,1621,1621,621,1460,2.12992e-08,0,1,854462,853841,621
33722581,1621.8,1621,622,1460,4.25984e-09,0,1,856084,855462,622
33724041,1621.16,1621.8,621,1460,8.51968e-10,0,1,857705,857084,621
33725501,1621.03,1621.16,621,1460,1.70394e-10,0,1,859326,858705,621
33726961,1621.01,1621.03,621,1460,3.40787e-11,0,1,860947,860326,621
33728421,1621,1621.01,621,1460,6.81574e-12,0,1,862568,861947,621
33729881,1621,1621,621,1460,1.36315e-12,0,1,864189,863568,621
33731341,1621,1621,621,1460,2.7263e-13,0,1,865810,865189,621
33732801,1621,1621,621,1460,0.008,0,1,867431,866810,621
33734261,1621,1621,621,1460,0.0016,0,1,869052,868431,621
33735721,1621,1621,621,1460,0.00032,0,1,870673,870052,621
33737181,1621,1621,621,1460,6.4e-05,0,1,872294,871673,621
33738641,1621,1621,621,1460,1.28e-05,0,1,873915,873294,621
33740101,1621,1621,621,1460,2.56e-06,0,1,875536,874915,621
33741561,1621.8,1621,622,1460,5.12e-07,0,1,877158,876536,622
33743021,1621.16,1621.8,621,1460,1.024e-07,0,1,878779,878158,621
33744481,1621.03,1621.16,621,1460,2.048e-08,0,1,880400,879779,621
33745941,1621.01,1621.03,621,1460,0.008,0,1,882021,881400,621
33747401,1621,1621.01,621,1460,0.0016,0,1,883642,883021,621
33748861,1621,1621,621,1460,0.00032,0,1,885263,884642,621
33750321,1621.8,1621,622,1460,6.4e-05,0,1,886885,886263,622
33751781,1621.16,1621.8,621,1460,1.28e-05,0,1,888506,887885,621
33753241,1621.03,1621.16,621,1460,0.00800256,0,1,890127,889506,621
33754701,1621.01,1621.03,621,1460,0.00160051,0,1,891748,891127,621
33756161,1621.8,1621.01,622,1460,0.000320102,0,1,893370,892748,622
33757621,1621.16,1621.8,621,1460,0.016064,0,1,894991,894370,621
33759081,1621.03,1621.16,621,1460,0.0112128,0,1,896612,895991,621
33760541,1621.81,1621.03,622,1460,0.0102426,0,1,898234,897612,622
33762001,1621.16,1621.81,621,1460,0.00204851,0,1,899855,899234,621
33763461,1621.03,1621.16,621,1460,0.000409702,0,1,901476,900855,621
33764921,1621.01,1621.03,621,1460,8.19405e-05,0,1,903097,902476,621
33766381,1621,1621.01,621,1460,1.63881e-05,0,1,904718,904097,621
33767841,1621.8,1621,622,1460,3.27762e-06,0,1,906340,905718,622
33769301,1621.16,1621.8,621,1460,6.55524e-07,0,1,907961,907340,621
33770761,1621.03,1621.16,621,1460,0.00800013,0,1,909582,908961,621
33772221,1621.01,1621.03,621,1460,0.00160003,0,1,911203,910582,621
33773681,1621,1621.01,621,1460,0.000320005,0,1,912824,912203,621
33775141,1621,1621,621,1460,0.008064,0,1,914445,913824,621
33776601,1621.8,1621,622,1460,0.0016128,0,1,916067,915445,622
33778061,1621.16,1621.8,621,1460,0.00032256,0,1,917688,917067,621
33779521,1621.03,1621.16,621,1460,6.4512e-05,0,1,919309,918688,621
33780981,1621.01,1621.03,621,1460,0.0160129,0,1,920930,920309,621
33782441,1621.8,1621.01,622,1460,0.00320258,0,1,922552,921930,622
33783901,1621.16,1621.8,621,1460,0.0166405,0,1,924173,923552,621
33785361,1621.83,1621.16,622,1460,0.0193281,0,1,925795,925173,622
33786821,1621.17,1621.83,621,1460,0.0118656,0,1,927416,926795,621
33788281,1621.83,1621.17,622,1460,0.00237312,0,1,929038,928416,622
33789741,1621.17,1621.83,621,1460,0.000474625,0,1,930659,930038,621
33791201,1621.03,1621.17,621,1460,9.4925e-05,0,1,932280,931659,621
33792661,1621.01,1621.03,621,1460,1.8985e-05,0,1,933901,933280,621
33794121,1621,1621.01,621,1460,3.797e-06,0,1,935522,934901,621
33795581,1621,1621,621,1460,7.59399e-07,0,1,937143,936522,621
33797041,1621,1621,621,1460,0.0160002,0,1,938764,938143,621
33798501,1621,1621,621,1460,0.0112,0,1,940385,939764,621
33799961,1621,1621,621,1460,0.01024,0,1,942006,941385,621
33801421,1621,1621,621,1460,0.026048,0,1,943627,943006,621
33802881,1621,1621,621,1460,0.0212096,0,1,945248,944627,621
33804341,1621,1621,621,1460,0.0122419,0,1,946869,946248,621
33805801,1621.8,1621,622,1460,0.0264484,0,1,948491,947869,622
33807261,1621.16,1621.8,621,1460,0.00528968,0,1,950112,949491,621
33808721,1621.83,1621.16,622,1460,0.00905794,0,1,951734,951112,622
33810181,1621.17,1621.83,621,1460,0.00981159,0,1,953355,952734,621
33811641,1621.03,1621.17,621,1460,0.00996232,0,1,954976,954355,621
33813101,1621.01,1621.03,621,1460,0.00999246,0,1,956597,955976,621
33814561,1621.8,1621.01,622,1460,0.0179985,0,1,958219,957597,622
33816021,1621.16,1621.8,621,1460,0.0115997,0,1,959840,959219,621
33817481,1621.83,1621.16,622,1460,0.00231994,0,1,961462,960840,622
33818941,1621.97,1621.83,622,1460,0.000463988,0,1,963084,962462,622
33820401,1621.19,1621.97,621,1460,9.27976e-05,0,1,964705,964084,621
33821861,1621.84,1621.19,622,1460,1.85595e-05,0,1,966327,965705,622
33823321,1621.97,1621.84,622,1460,3.7119e-06,0,1,967949,967327,622
33824781,1621.19,1621.97,621,1460,7.4238e-07,0,1,969570,968949,621
33826241,1621.04,1621.19,621,1460,0.00800015,0,1,971191,970570,621
33827701,1621.01,1621.04,621,1460,0.00160003,0,1,972812,972191,621
33829161,1621,1621.01,621,1460,0.00832001,0,1,974433,973812,621
33830621,1621,1621,621,1460,0.009664,0,1,976054,975433,621
33832081,1621.8,1621,622,1460,0.0019328,0,1,977676,977054,622
33833541,1621.96,1621.8,622,1460,0.00038656,0,1,979298,978676,622
33835001,1621.19,1621.96,621,1460,7.7312e-05,0,1,980919,980298,621
33836461,1621.04,1621.19,621,1460,1.54624e-05,0,1,982540,981919,621
33837921,1621.01,1621.04,621,1460,3.09248e-06,0,1,984161,983540,621
33839381,1621,1621.01,621,1460,6.18496e-07,0,1,985782,985161,621
33840841,1621,1621,621,1460,0.00800012,0,1,987403,986782,621
33842301,1621,1621,621,1460,0.00160002,0,1,989024,988403,621
33843761,1621,1621,621,1460,0.000320005,0,1,990645,990024,621
33845221,1621,1621,621,1460,6.4001e-05,0,1,992266,991645,621
33846681,1621,1621,621,1460,0.0080128,0,1,993887,993266,621
33848141,1621,1621,621,1460,0.00960256,0,1,995508,994887,621
33849601,1621,1621,621,1460,0.00192051,0,1,997129,996508,621
33851061,1621,1621,621,1460,0.000384102,0,1,998750,998129,621
33852521,1621,1621,621,1460,7.68205e-05,0,1,1000371,999750,621
33853981,1621,1621,621,1460,0.00801536,0,1,1001992,1001371,621
33855441,1621,1621,621,1460,0.00960307,0,1,1003613,1002992,621
33856901,1621.8,1621,622,1460,0.00992061,0,1,1005235,1004613,622
33858361,1621.16,1621.8,621,1460,0.00998412,0,1,1006856,1006235,621
33859821,1621.03,1621.16,621,1460,0.00199682,0,1,1008477,1007856,621
33861281,1621.81,1621.03,622,1460,0.000399365,0,1,1010099,1009477,622
33862741,1621.16,1621.81,621,1460,7.9873e-05,0,1,1011720,1011099,621
33864201,1621.03,1621.16,621,1460,0.00801597,0,1,1013341,1012720,621
33865661,1621.01,1621.03,621,1460,0.00160319,0,1,1014962,1014341,621
33867121,1621,1621.01,621,1460,0.00832064,0,1,1016583,1015962,621
33868581,1621,1621,621,1460,0.00166413,0,1,1018204,1017583,621
33870041,1621,1621,621,1460,0.00833283,0,1,1019825,1019204,621
33871501,1621,1621,621,1460,0.00166657,0,1,1021446,1020825,621
33872961,1621,1621,621,1460,0.00833331,0,1,1023067,1022446,621
33874421,1621,1621,621,1460,0.00966666,0,1,1024688,1024067,621
33875881,1621,1621,621,1460,0.00993333,0,1,1026309,1025688,621
33877341,1621,1621,621,1460,0.00198667,0,1,1027930,1027309,621
33878801,1621,1621,621,1460,0.00839733,0,1,1029551,1028930,621
33880261,1621,1621,621,1460,0.00167947,0,1,1031172,1030551,621
33881721,1621,1621,621,1460,0.000335893,0,1,1032793,1032172,621
