#Ack,ack_ewma(ms),send_ewma(ms),rtt_ratio,cwnd (Bytes),Last Router Ocupation Ack Arriaval(Packets),Last Router Ocupation Packet Sent(Packets),Network Situation,AckArrival(ms),TSInsideAck(ms),RTTAck(ms)
4381,2,0,453,16060,0.93,0.57,2,140898,140445,453
7301,2,0,455,17520,0.93,0.57,2,140900,140445,455
10221,2,0,457,18980,0.93,0.57,2,140902,140445,457
13141,2,0,459,20440,0.93,0.57,2,140904,140445,459
137241,345,345,421,21900,0.01,0.03,1,143217,142796,421
140161,106.6,83.4,450,22724,0.01,0.37,1,143264,142814,450
143081,36.52,33.48,448,22817,0.042,0.39,1,143283,142835,448
146001,26.504,21.096,454,22910,0.0324,0.41,1,143307,142853,454
148921,15.7008,19.4192,448,23003,0.01448,0.23,1,143320,142872,448
151841,28.7402,28.6838,449,23095,0.026896,0,1,143352,142903,449
154761,20.948,36.1368,430,23187,0.0293792,0,1,143371,142941,430
156221,168.99,19.2274,621,23278,0.0298758,0,1,143577,142956,621
159141,82.5979,202.245,434,23369,0.0299752,0.01,1,143638,143204,434
162061,54.9196,88.4491,422,23460,0.013995,0.05,1,143686,143264,422
164981,26.9839,32.8898,423,23550,0.026799,0.03,1,143706,143283,423
167901,24.5968,25.778,423,23640,0.0453598,0.01,1,143730,143307,423
170821,14.5194,15.5556,422,23730,0.049072,0.03,1,143742,143320,422
173741,28.5039,28.7111,422,23819,0.0338144,0.03,1,143774,143352,422
176661,20.9008,20.9422,422,23908,0.0467629,0.03,1,143793,143371,422
179581,169.78,168.988,423,23997,0.0173526,0.03,1,144000,143577,423
182501,82.756,82.5977,423,24085,0.0114705,0.01,1,144061,143638,423
185421,54.9512,54.9195,423,24173,0.0422941,0.03,1,144109,143686,423
188341,26.1902,26.9839,422,24261,0.0644588,0.05,1,144128,143706,422
191261,24.438,24.5968,422,24348,0.0848918,0.05,1,144152,143730,422
194181,14.4876,14.5194,422,24435,0.0889784,0.03,1,144164,143742,422
197101,30.8975,28.5039,425,24522,0.0577957,0.05,1,144199,143774,425
200021,18.9795,20.9008,422,24608,0.0995591,0.01,1,144215,143793,422
202941,169.396,169.78,422,24694,0.0199118,0.01,1,144422,144000,422
205861,82.6792,82.756,422,24780,0.00398236,0.05,1,144483,144061,422
208781,56.5358,54.9512,424,24866,0.00879647,0.07,1,144533,144109,424
211701,25.7072,26.1902,423,24951,0.00975929,0.09,1,144551,144128,423
214621,25.1414,24.438,424,25036,0.0579519,0.09,1,144576,144152,424
217541,14.6283,14.4876,424,25121,0.0675904,0.05,1,144588,144164,424
220461,31.7257,30.8975,425,25205,0.117518,0.11,1,144624,144199,425
223381,19.1451,18.9795,425,25289,0.127504,0,1,144640,144215,425
226301,167.029,169.396,422,25373,0.0255007,0,1,144844,144422,422
229221,82.2058,82.6792,422,25457,0.00510014,0,1,144905,144483,422
232141,55.6412,16.5358,471,25540,0.02502,0.01,1,144954,144483,471
235061,27.1282,43.3072,441,25623,0.029004,0.01,1,144974,144533,441
237981,26.2256,23.0614,449,25706,0.0298008,0.07,1,145000,144551,449
240901,14.8451,24.6123,436,25788,0.0299602,0.07,1,145012,144576,436
243821,32.569,14.5225,461,25870,0.101992,0.13,1,145049,144588,461
246741,19.3138,31.7045,441,25952,0.108398,0.13,1,145065,144624,441
249661,163.863,19.1409,625,26034,0.0216797,0,1,145265,144640,625
252581,81.5725,167.028,482,26115,0.00433594,0,1,145326,144844,482
255501,56.3145,82.2056,471,26196,0.0408672,0.03,1,145376,144905,471
258421,26.4629,55.6411,441,26277,0.0641734,0.03,1,145395,144954,441
261341,26.8926,27.1282,448,26358,0.0528347,0.03,1,145422,144974,448
264261,14.9785,26.2256,434,26438,0.0505669,0.03,1,145434,145000,434
267181,35.7957,14.8451,463,26518,0.0341134,0.12,1,145475,145012,463
270101,19.9591,32.569,442,26598,0.0308227,0.11,1,145491,145049,442
273021,159.992,19.3138,621,26678,0.0141645,0,1,145686,145065,621
275941,80.7984,163.863,482,26757,0.0268329,0,1,145747,145265,482
278861,57.7597,81.5725,473,26836,0.0453666,0.05,1,145799,145326,473
281781,25.9519,56.3145,441,26915,0.0490733,0.07,1,145817,145376,441
284701,6.79039,26.4629,424,26994,0.0498147,0.05,1,145819,145395,424
287621,22.9581,26.8926,424,27072,0.0979629,0.05,1,145846,145422,424
290541,14.9916,14.9785,425,27150,0.0915926,0.03,1,145859,145434,425
293461,34.1983,35.7957,423,27228,0.0903185,0.03,1,145898,145475,423
296381,20.4397,19.9591,424,27306,0.106064,0.01,1,145915,145491,424
299301,158.488,159.992,422,27384,0.0212127,0.03,1,146108,145686,422
302221,80.4976,80.7984,422,27461,0.0122425,0.05,1,146169,145747,422
305141,59.2995,57.7597,424,27538,0.0104485,0.05,1,146223,145799,424
308061,26.2599,25.9519,424,27615,0.0100897,0.05,1,146241,145817,424
310981,6.85198,6.79039,424,27692,0.0420179,0.11,1,146243,145819,424
313901,23.7704,22.9581,425,27768,0.0644036,0.09,1,146271,145846,425
316821,15.9541,14.9916,426,27844,0.0368807,0.09,1,146285,145859,426
319741,34.3908,34.1983,426,27920,0.0473761,0.11,1,146324,145898,426
322661,19.6782,20.4397,425,27996,0.0814752,0,1,146340,145915,425
325581,155.936,158.488,422,28072,0.016295,0.01,1,146530,146108,422
328501,79.9871,80.4976,422,28147,0.011259,0.01,1,146591,146169,422
331421,59.1974,59.2995,422,28222,0.0102518,0.01,1,146645,146223,422
334341,26.2395,26.2599,422,28297,0.0100504,0.05,1,146663,146241,422
337261,6.8479,6.85198,422,28372,0.0420101,0.05,1,146665,146243,422
340181,23.7696,1.3704,450,28447,0.048402,0.07,1,146693,146243,450
343101,17.5539,22.6741,438,28521,0.0496804,0.03,1,146709,146271,438
346021,33.9108,15.7348,462,28595,0.0499361,0.05,1,146747,146285,462
348941,19.5822,34.347,439,28669,0.0499872,0.09,1,146763,146324,439
351861,154.316,19.6694,611,28743,0.00999744,0,1,146951,146340,611
354781,79.6633,155.934,482,28817,0.0259995,0.01,1,147012,146530,482
357701,59.1327,79.9868,475,28890,0.0291999,0.01,1,147066,146591,475
360621,26.2265,59.1974,439,28963,0.02984,0.01,1,147084,146645,439
363541,6.84531,26.2395,423,29036,0.029968,0.05,1,147086,146663,423
366461,25.3691,6.84789,451,29109,0.0619936,0.05,1,147116,146665,451
369381,16.2738,23.7696,437,29182,0.0683987,0.05,1,147130,146693,437
372301,35.2548,17.5539,461,29255,0.0696797,0.05,1,147170,146709,461
375221,19.851,33.9108,439,29327,0.101936,0.05,1,147186,146747,439
378141,152.77,19.5822,609,29399,0.0283872,0,1,147372,146763,609
381061,79.354,154.316,482,29471,0.0136774,0.03,1,147433,146951,482
383981,59.8708,79.6633,476,29543,0.0427355,0.03,1,147488,147012,476
386901,26.3742,59.1327,440,29615,0.0485471,0.03,1,147506,147066,440
389821,6.87483,26.2265,424,29686,0.0497094,0.03,1,147508,147084,424
392741,26.975,6.84531,454,29757,0.0499419,0.07,1,147540,147086,454
395661,16.595,25.3691,438,29828,0.0659884,0.07,1,147554,147116,438
398581,4.919,16.2738,426,29899,0.0691977,0.07,1,147556,147130,426
401501,33.7838,35.2548,427,29970,0.0858395,0.11,1,147597,147170,427
404421,19.5568,19.851,427,30041,0.121168,0.01,1,147613,147186,427
407341,148.711,152.77,422,30111,0.0482336,0.01,1,147794,147372,422
410261,78.5423,79.354,422,30181,0.0336467,0.05,1,147855,147433,422
413181,61.3085,59.8708,424,30251,0.0307293,0.05,1,147912,147488,424
416101,26.6617,26.3742,424,30321,0.0301459,0.05,1,147930,147506,424
419021,6.93234,6.87483,424,30391,0.0620292,0.05,1,147932,147508,424
421941,27.7865,26.975,425,30461,0.0524058,0.07,1,147965,147540,425
424861,17.5573,16.595,426,30530,0.0344812,0.07,1,147980,147554,426
427781,5.11146,4.919,426,30599,0.0308962,0.09,1,147982,147556,426
430701,35.4223,33.7838,428,30668,0.0141792,0.13,1,148025,147597,428
433621,19.8845,19.5568,428,30737,0.0428359,0.03,1,148041,147613,428
436541,143.977,148.711,422,30806,0.0325672,0.03,1,148216,147794,422
439461,77.5954,78.5423,422,30875,0.0625134,0.03,1,148277,147855,422
442381,61.9191,61.3085,423,30944,0.0205027,0.03,1,148335,147912,423
445301,26.7838,26.6617,423,31012,0.0121005,0.07,1,148353,147930,423
448221,6.95676,6.93234,423,31080,0.0424201,0.05,1,148355,147932,423
451141,26.9914,27.7865,422,31148,0.016484,0.03,1,148387,147965,422
454061,17.3983,17.5573,422,31216,0.0272968,0.03,1,148402,147980,422
456981,5.07965,5.11146,422,31284,0.0294594,0.03,1,148404,147982,422
459901,34.6159,1.02229,464,31352,0.0298919,0.01,1,148446,147982,464
462821,20.5232,34.6045,438,31419,0.0459784,0.05,1,148463,148025,438
465741,143.305,19.7209,596,31486,0.00919567,0.03,1,148637,148041,596
468661,78.2609,143.944,483,31553,0.0258391,0.07,1,148699,148216,483
471581,61.2522,77.5888,479,31620,0.0291678,0.01,1,148756,148277,479
474501,26.6504,61.9178,439,31687,0.0298336,0.01,1,148774,148335,439
477421,6.93009,26.7836,423,31754,0.0299667,0.05,1,148776,148353,423
480341,26.986,6.95671,453,31821,0.0459933,0.01,1,148808,148355,453
483261,17.3972,26.9913,436,31887,0.0651987,0.03,1,148823,148387,436
486181,5.07944,17.3983,423,31953,0.0690397,0.03,1,148825,148402,423
489101,35.4159,5.07965,464,32019,0.0378079,0.03,1,148868,148404,464
492021,21.4832,34.6159,440,32085,0.0315616,0.05,1,148886,148446,440
494941,141.897,20.5232,595,32151,0.00631232,0,1,149058,148463,595
497861,78.7793,143.305,484,32217,0.0252625,0.03,1,149121,148637,484
500781,61.3559,78.2609,479,32283,0.0290525,0.03,1,149178,148699,479
503701,26.6712,61.2522,440,32349,0.0458105,0.03,1,149196,148756,440
506621,6.93423,26.6504,424,32414,0.0491621,0.03,1,149198,148774,424
509541,27.7868,6.93009,455,32479,0.0658324,0.05,1,149231,148776,455
512461,16.7574,26.986,437,32544,0.0691665,0.07,1,149245,148808,437
515381,4.95147,17.3972,424,32609,0.0698333,0.07,1,149247,148823,424
518301,35.3903,5.07944,465,32674,0.0699667,0.03,1,149290,148825,465
521221,21.4781,35.4159,440,32739,0.0699933,0.03,1,149308,148868,440
524141,5.89561,21.4832,424,32804,0.0699987,0,1,149310,148886,424
527061,137.179,141.897,422,32868,0.15,0.03,1,149480,149058,422
529981,79.4358,78.7793,424,32932,0.0539999,0.03,1,149545,149121,424
532901,61.4872,61.3559,424,32996,0.0348,0.05,1,149602,149178,424
535821,26.6974,26.6712,424,33060,0.03096,0.05,1,149620,149196,424
538741,6.93949,6.93423,424,33124,0.062192,0.07,1,149622,149198,424
541661,28.5879,27.7868,425,33188,0.0844384,0.07,1,149656,149231,425
544581,16.9176,16.7574,425,33252,0.0568877,0.07,1,149670,149245,425
547501,4.98352,4.95147,425,33316,0.0513775,0.07,1,149672,149247,425
550421,35.3967,35.3903,425,33379,0.0342755,0.07,1,149715,149290,425
553341,22.2793,21.4781,426,33442,0.0468551,0.07,1,149734,149308,426
556261,6.05587,5.89561,426,33505,0.049371,0.17,1,149736,149310,426
559181,137.211,137.179,426,33568,0.113874,0.03,1,149906,149480,426
562101,76.2422,79.4358,422,33631,0.126775,0.03,1,149967,149545,422
565021,61.6484,61.4872,423,33694,0.065355,0.03,1,150025,149602,423
567941,26.7297,26.6974,423,33757,0.053071,0.07,1,150043,149620,423
570861,6.94594,6.93949,423,33820,0.114614,0.09,1,150045,149622,423
573781,29.3892,28.5879,424,33883,0.0789228,0.05,1,150080,149656,424
576701,17.0778,16.9176,424,33945,0.103785,0.05,1,150094,149670,424
579621,5.01557,4.98352,424,34007,0.108757,0.03,1,150096,149672,424
582541,34.6031,35.3967,423,34069,0.0937514,0.05,1,150138,149715,423
585461,21.3206,22.2793,422,34131,0.0907503,0.05,1,150156,149734,422
588381,5.86412,6.05587,422,34193,0.0901501,0.13,1,150158,149736,422
591301,140.373,137.211,426,34255,0.13803,0.13,1,150332,149906,426
594221,76.0746,27.4422,486,34317,0.131606,0.13,1,150392,149906,486
597141,60.0149,54.2884,481,34379,0.290321,0.05,1,150448,149967,481
600061,28.003,57.2577,443,34441,0.322064,0.05,1,150468,150025,443
602981,7.2006,25.8515,427,34502,0.328413,0.13,1,150470,150043,427
605901,28.6401,6.77031,459,34563,0.329683,0.07,1,150504,150045,459
608821,16.928,29.3541,438,34624,0.329936,0.11,1,150518,150080,438
611741,4.9856,17.0708,426,34685,0.329987,0.11,1,150520,150094,426
614661,35.3971,5.01416,467,34746,0.361997,0.09,1,150563,150096,467
617581,21.4794,34.6028,443,34807,0.3684,0.09,1,150581,150138,443
620501,5.89588,21.3206,427,34868,0.36968,0.09,1,150583,150156,427
623421,141.979,5.86411,601,34929,0.385936,0.15,1,150759,150158,601
626341,76.3958,140.373,487,34990,0.405187,0.13,1,150819,150332,487
629261,68.0792,76.0746,493,35050,0.521037,0.33,1,150885,150392,493
632181,29.6158,60.0149,457,35110,0.544208,0.33,1,150905,150448,457
635101,7.52317,28.003,439,35170,0.548841,0.33,1,150907,150468,439
638021,28.7046,7.2006,471,35230,0.581768,0.33,1,150941,150470,471
640941,16.9409,28.6401,451,35290,0.588354,0.33,1,150955,150504,451
643861,4.98819,16.928,439,35350,0.589671,0.33,1,150957,150518,439
646781,36.9976,4.9856,482,35410,0.605934,0.37,1,151002,150520,482
649701,21.7995,35.3971,457,35470,0.609187,0.37,1,151020,150563,457
652621,5.95991,21.4794,441,35530,0.609837,0.37,1,151022,150581,441
655541,142.792,5.89588,616,35589,0.673967,0.39,1,151199,150583,616
658461,77.3584,141.979,501,35648,0.734793,0.41,1,151260,150759,501
661381,17.0717,76.3958,443,35707,0.746959,0.55,1,151262,150819,443
664301,61.0143,68.0792,449,35766,0.861392,0.55,2,151334,150885,449
667221,29.0029,29.6158,450,35825,0.900278,0.55,2,151355,150905,450
670141,7.40057,7.52317,450,35884,0.908056,0.59,2,151357,150907,450
673061,29.4801,28.7046,451,35943,0.925611,0.59,2,151392,150941,451
675981,17.096,16.9409,451,36002,0.913122,0.59,2,151406,150955,451
678901,5.0192,4.98819,451,36061,0.910624,0.61,2,151408,150957,451
681821,37.8038,36.9976,452,36120,0.926125,0.61,2,151454,151002,452
804461,38,17,532,38500,0.71,1,1,153200,152668,532
807381,38,57.8,502,38555,0.534,1,1,153238,152736,502
810301,19.6,24.36,501,38610,0.4668,1,1,153253,152752,501
813221,16.72,16.072,503,38665,0.37336,1,1,153269,152766,503
816141,16.944,48.0144,464,38720,0.306672,1,1,153286,152822,464
819061,34.5888,28.0029,480,38775,0.205334,1,1,153325,152845,480
821981,38.9178,24.0006,497,38829,0.0410669,1,1,153365,152868,497
824901,24.5836,19.2001,500,38883,0.00821337,1,1,153386,152886,500
827821,22.5167,19.84,502,38937,0.00164267,1,1,153408,152906,502
830741,21.3033,19.168,504,38991,0.00832853,1,1,153429,152925,504
833661,85.0607,103.834,480,39045,0.00166571,0.9,1,153530,153050,480
836581,78.6121,91.1667,469,39099,0.0243331,0.87,1,153607,153138,469
839501,30.9224,37.4333,464,39153,0.0608666,0.71,1,153626,153162,464
842421,26.9845,37.8867,452,39207,0.0521733,0.49,1,153652,153200,452
845341,30.1969,37.9773,445,39261,0.0664347,0.45,1,153683,153238,445
848261,14.0394,19.5955,440,39315,0.0532869,0.35,1,153693,153253,440
851181,14.0079,16.7191,438,39369,0.0506574,0.29,1,153707,153269,438
854101,14.8016,16.9438,436,39423,0.178131,0.18,1,153722,153286,436
857021,27.7603,34.5888,428,39477,0.203626,0,1,153753,153325,428
859941,33.5521,38.9178,423,39530,0.0407253,0,1,153788,153365,423
862861,23.5104,24.5836,423,39583,0.0321451,0,1,153809,153386,423
865781,21.5021,22.5167,422,39636,0.062429,0.01,1,153830,153408,422
868701,21.1004,21.3033,422,39689,0.0524858,0,1,153851,153429,422
871621,86.6201,85.0607,424,39742,0.0344972,0.03,1,153954,153530,424
874541,78.124,78.6121,423,39795,0.0148994,0.07,1,154030,153607,423
877461,30.0248,30.9224,422,39848,0.0589799,0.05,1,154048,153626,422
880381,28.405,26.9845,424,39901,0.051796,0.07,1,154076,153652,424
883301,30.481,30.1969,424,39954,0.0343592,0.05,1,154107,153683,424
886221,13.2962,14.0394,423,40007,0.0468718,0.05,1,154116,153693,423
889141,19.4592,14.0079,430,40060,0.0333744,0.05,1,154137,153707,430
892061,16.6918,2.80157,446,40113,0.0466749,0.21,1,154153,153707,446
894981,26.5384,12.5603,460,40166,0.049335,0.21,1,154182,153722,460
897901,28.5077,27.3121,458,40219,0.049867,0,1,154211,153753,458
900821,20.9015,33.4624,442,40271,0.0339734,0.03,1,154230,153788,442
903741,20.9803,23.4925,442,40323,0.0147947,0.07,1,154251,153809,442
906661,21.7961,21.4985,443,40375,0.0109589,0.05,1,154273,153830,443
909581,86.7592,21.0997,525,40427,0.0101918,0.03,1,154376,153851,525
912501,77.3518,86.6199,497,40479,0.0260384,0.01,1,154451,153954,497
915421,29.8704,78.124,439,40531,0.0292077,0.07,1,154469,154030,439
918341,28.3741,30.0248,449,40583,0.0618415,0.05,1,154497,154048,449
921261,31.2748,28.405,453,40635,0.0683683,0.03,1,154529,154076,453
924181,12.655,30.481,430,40687,0.0696737,0.05,1,154537,154107,430
927101,19.331,13.2962,442,40739,0.0859347,0.03,1,154558,154116,442
930021,18.2662,19.4592,439,40791,0.0571869,0.05,1,154576,154137,439
932941,26.8532,16.6918,452,40843,0.0514374,0.05,1,154605,154153,452
935861,28.5706,26.5384,452,40895,0.0502875,0.05,1,154634,154182,452
938781,19.3141,28.5077,440,40947,0.0660575,0.03,1,154651,154211,440
941701,20.6628,20.9015,442,40999,0.0212115,0.01,1,154672,154230,442
944621,22.5326,20.9803,444,41050,0.0042423,0.01,1,154695,154251,444
947541,86.9065,21.7961,525,41101,0.00884846,0.01,1,154798,154273,525
950461,77.3813,86.7592,497,41152,0.0257697,0.03,1,154873,154376,497
953381,29.8763,77.3518,440,41203,0.0291539,0.03,1,154891,154451,440
956301,29.9753,29.8704,452,41254,0.0298308,0.07,1,154921,154469,452
959221,31.5951,28.3741,456,41305,0.0619662,0.07,1,154953,154497,456
962141,12.719,31.2748,432,41356,0.0683932,0.07,1,154961,154529,432
965061,18.5438,12.655,444,41407,0.0696786,0.09,1,154981,154537,444
967981,18.1088,19.331,441,41458,0.0699357,0.05,1,154999,154558,441
970901,26.8218,18.2662,452,41509,0.0859872,0.05,1,155028,154576,452
973821,6.96435,26.8532,425,41560,0.0891974,0.05,1,155030,154605,425
976741,23.7929,28.5706,424,41611,0.121839,0.07,1,155058,154634,424
979661,16.7586,19.3141,422,41662,0.112368,0.01,1,155073,154651,422
982581,20.9517,20.6628,423,41713,0.0944736,0,1,155095,154672,423
985501,22.5903,22.5326,423,41764,0.0268947,0.01,1,155118,154695,423
988421,86.9181,86.9065,423,41815,0.0453789,0.03,1,155221,154798,423
991341,77.3836,77.3813,423,41865,0.0490758,0.03,1,155296,154873,423
994261,29.8767,29.8763,423,41915,0.0338152,0.03,1,155314,154891,423
997181,29.9753,29.9753,423,41965,0.046763,0.07,1,155344,154921,423
1000101,33.1951,31.5951,425,42015,0.0333526,0.07,1,155378,154953,425
1003021,13.039,12.719,425,42065,0.0146705,0.07,1,155386,154961,425
1005941,18.6078,18.5438,425,42115,0.0109341,0.07,1,155406,154981,425
1008861,18.1216,18.1088,425,42165,0.0421868,0.09,1,155424,154999,425
1011781,27.6243,26.8218,426,42215,0.0164374,0.09,1,155454,155028,426
1014701,7.12486,6.96435,426,42265,0.0112875,0.13,1,155456,155030,426
1017621,23.825,23.7929,426,42315,0.0262575,0.11,1,155484,155058,426
1020541,16.765,16.7586,426,42365,0.0612515,0.09,1,155499,155073,426
1023461,19.353,20.9517,424,42415,0.0682503,0.01,1,155519,155095,424
1026381,20.6706,22.5903,422,42465,0.0856501,0.05,1,155540,155118,422
1029301,86.5341,86.9181,422,42515,0.05713,0.05,1,155643,155221,422
1032221,78.1068,77.3836,423,42565,0.067426,0.03,1,155719,155296,423
1035141,29.2214,29.8767,422,42615,0.0694852,0.05,1,155736,155314,422
1038061,29.8443,29.9753,422,42665,0.037897,0.03,1,155766,155344,422
1040981,33.1689,33.1951,422,42714,0.0315794,0.01,1,155800,155378,422
1043901,13.0338,13.039,422,42763,0.0143159,0.01,1,155808,155386,422
1046821,18.6068,18.6078,422,42812,0.0108632,0.05,1,155828,155406,422
1049741,18.1214,18.1216,422,42861,0.0261726,0.01,1,155846,155424,422
1052661,28.4243,27.6243,423,42910,0.0612345,0.01,1,155877,155454,423
1055581,7.28485,7.12486,423,42959,0.0682469,0.03,1,155879,155456,423
1058501,23.857,23.825,423,43008,0.0376494,0.03,1,155907,155484,423
1061421,17.5714,4.76499,439,43057,0.0315299,0.07,1,155923,155484,439
1064341,19.5143,12.953,444,43106,0.030306,0.07,1,155943,155499,444
1067261,19.9029,18.5906,444,43155,0.0460612,0.09,1,155963,155519,444
1070181,87.1806,20.5181,527,43204,0.0492122,0.05,1,156067,155540,527
1073101,76.6361,86.5036,498,43253,0.0818425,0.07,1,156141,155643,498
1076021,28.9272,78.1007,439,43302,0.0723685,0.07,1,156158,155719,439
1078941,29.7854,29.2201,452,43351,0.0864737,0.03,1,156188,155736,452
1081861,32.3571,29.844,455,43400,0.0732947,0.03,1,156221,155766,455
1084781,12.8714,33.1688,429,43449,0.0706589,0.01,1,156229,155800,429
1087701,18.5743,13.0338,441,43498,0.0701318,0.01,1,156249,155808,441
1090621,19.7149,18.6068,441,43547,0.0700264,0.03,1,156269,155828,441
1093541,27.943,18.1214,453,43595,0.102005,0.07,1,156299,155846,453
1096461,7.18859,28.4243,424,43643,0.108401,0.07,1,156301,155877,424
1099381,23.8377,7.28485,450,43691,0.12568,0.03,1,156329,155879,450
1102301,17.5675,23.857,438,43739,0.129136,0.03,1,156345,155907,438
1105221,19.5135,17.5714,442,43787,0.129827,0.03,1,156365,155923,442
1108141,20.7027,19.5143,443,43835,0.129965,0.05,1,156386,155943,443
1111061,88.1405,19.9029,528,43883,0.129993,0.05,1,156491,155963,528
1113981,77.6281,87.1806,499,43931,0.113999,0.09,1,156566,156067,499
1116901,28.3256,76.6361,441,43979,0.1108,0.07,1,156582,156141,441
1119821,30.4651,28.9272,455,44027,0.14216,0.09,1,156613,156158,455
1122741,31.693,29.7854,457,44075,0.148432,0.07,1,156645,156188,457
1125661,12.7386,32.3571,432,44123,0.149686,0.07,1,156653,156221,432
1128581,18.5477,12.8714,444,44171,0.149937,0.07,1,156673,156229,444
1131501,21.3095,18.5743,446,44219,0.149987,0.07,1,156695,156249,446
1134421,29.0619,19.7149,457,44267,0.213997,0.11,1,156726,156269,457
1137341,7.41238,27.943,429,44315,0.226799,0.11,1,156728,156299,429
1140261,23.8825,7.18859,455,44363,0.22936,0.13,1,156756,156301,455
1143181,17.5765,23.8377,443,44411,0.229872,0.13,1,156772,156329,443
1146101,19.5153,17.5675,447,44458,0.229974,0.13,1,156792,156345,447
1149021,5.50306,19.5135,429,44505,0.229995,0.13,1,156794,156365,429
1151941,17.1006,20.7027,428,44552,0.261999,0.13,1,156814,156386,428
1154861,87.4201,88.1405,428,44599,0.3324,0.11,1,156919,156491,428
1157781,76.684,77.6281,427,44646,0.36248,0.11,1,156993,156566,427
1160701,28.9368,28.3256,428,44693,0.352496,0.15,1,157010,156582,428
1163621,31.3874,30.4651,429,44740,0.382499,0.15,1,157042,156613,429
1166541,31.8775,31.693,429,44787,0.4045,0.15,1,157074,156645,429
1169461,12.7755,12.7386,429,44834,0.3769,0.15,1,157082,156653,429
1172381,18.5551,18.5477,429,44881,0.37138,0.15,1,157102,156673,429
1175301,21.311,21.3095,429,44928,0.386276,0.23,1,157124,156695,429
1178221,32.2622,29.0619,433,44975,0.373255,0.23,1,157159,156726,433
1181141,8.05244,7.41238,433,45022,0.370651,0.23,1,157161,156728,433
1184061,24.0105,23.8825,433,45069,0.38613,0.23,1,157189,156756,433
1186981,17.6021,17.5765,433,45116,0.421226,0.23,1,157205,156772,433
1189901,19.5204,19.5153,433,45163,0.428245,0.23,1,157225,156792,433
1192821,5.50408,5.50306,433,45210,0.429649,0.27,1,157227,156794,433
1195741,17.1008,17.1006,433,45257,0.42993,0.35,1,157247,156814,433
1198661,90.6202,87.4201,437,45304,0.461986,0.37,1,157356,156919,437
1201581,78.124,76.684,438,45351,0.468397,0.35,1,157431,156993,438
1204501,30.0248,28.9368,439,45398,0.469679,0.39,1,157449,157010,439
1207421,32.405,31.3874,440,45444,0.485936,0.41,1,157482,157042,440
1210341,32.081,31.8775,440,45490,0.473187,0.37,1,157514,157074,440
1213261,12.8162,12.7755,440,45536,0.470637,0.37,1,157522,157082,440
1216181,18.5632,18.5551,440,45582,0.470128,0.39,1,157542,157102,440
1219101,22.1126,21.311,441,45628,0.518026,0.37,1,157565,157124,441
1222021,31.6225,32.2622,440,45674,0.511605,0.37,1,157599,157159,440
1224941,7.92451,8.05244,440,45720,0.510321,0.39,1,157601,157161,440
1227861,24.7849,24.0105,441,45766,0.494064,0.43,1,157630,157189,441
1230781,17.757,17.6021,441,45812,0.490813,0.43,1,157646,157205,441
1233701,19.5514,19.5204,441,45858,0.522163,0.43,1,157666,157225,441
1236621,5.51028,5.50408,441,45904,0.528433,0.43,1,157668,157227,441
1239541,17.1021,17.1008,441,45950,0.529687,0.43,1,157688,157247,441
1242461,91.4204,3.42016,551,45996,0.561937,0.47,1,157798,157247,551
1245381,79.8841,87.884,519,46042,0.584387,0.47,1,157875,157356,519
1248301,30.3768,77.5768,462,46088,0.588877,0.47,1,157893,157431,462
1251221,31.6754,29.9154,476,46134,0.589776,0.49,1,157925,157449,476
1254141,32.7351,32.3831,476,46180,0.573955,0.47,1,157958,157482,476
1257061,12.947,32.0766,452,46226,0.570791,0.47,1,157966,157514,452
1259981,18.5894,12.8153,464,46272,0.570158,0.47,1,157986,157522,464
1262901,22.9179,18.5631,468,46318,0.602032,0.53,1,158010,157542,468
1265821,32.5836,22.1126,480,46364,0.592406,0.51,1,158045,157565,480
1268741,8.11671,31.6225,448,46409,0.590481,0.51,1,158047,157599,448
1271661,24.0233,7.9245,474,46454,0.606096,0.49,1,158075,157601,474
1274581,18.4047,24.7849,462,46499,0.593219,0.49,1,158092,157630,462
1277501,20.4809,17.757,467,46544,0.638644,0.53,1,158113,157646,467
1280421,5.69619,19.5514,449,46589,0.647729,0.53,1,158115,157666,449
1283341,17.1392,5.51028,467,46634,0.649546,0.53,1,158135,157668,467
1286261,93.0278,17.1021,559,46679,0.617909,0.57,1,158247,157688,559
1289181,81.0056,91.4204,527,46724,0.643582,0.59,1,158325,157798,527
1292101,30.6011,79.8841,468,46769,0.648716,0.59,1,158343,157875,468
1295021,31.7202,30.3768,482,46814,0.649743,0.59,1,158375,157893,482
1297941,31.944,31.6754,482,46859,0.649949,0.57,1,158407,157925,482
1300861,12.7888,32.7351,457,46904,0.64999,0.57,1,158415,157958,457
1303781,19.3578,12.947,470,46949,0.681998,0.57,1,158436,157966,470
1306701,23.8716,18.5894,475,46994,0.6724,0.61,1,158461,157986,475
1309621,31.9743,22.9179,485,47039,0.67048,0.59,1,158495,158010,485
1312541,7.99486,32.5836,452,47084,0.670096,0.59,1,158497,158045,452
1315461,24.799,8.11671,479,47129,0.686019,0.61,1,158526,158047,479
1318381,19.3598,24.0233,469,47174,0.689204,0.59,1,158544,158075,469
1321301,21.472,18.4047,474,47219,0.689841,0.65,1,158566,158092,474
1324221,5.89439,20.4809,455,47264,0.689968,0.65,1,158568,158113,455
1327141,17.1789,5.69619,473,47309,0.721994,0.65,1,158588,158115,473
1330061,91.4358,17.1392,563,47354,0.760399,0.61,2,158698,158135,563
1332981,19.8872,93.0278,453,47399,0.76808,0.65,2,158700,158247,453
1335901,67.1774,81.0056,454,47443,0.849616,0.65,2,158779,158325,454
1338821,27.8355,30.6011,454,47487,0.865923,0.65,2,158797,158343,454
1341741,31.1671,31.7202,454,47531,0.885185,0.65,2,158829,158375,454
1344661,31.8334,31.944,454,47575,0.889037,0.65,2,158861,158407,454
1347581,12.7667,12.7888,454,47619,0.857807,0.69,2,158869,158415,454
1350501,20.9533,19.3578,456,47663,0.867561,0.67,2,158892,158436,456
1353421,23.3907,23.8716,455,47707,0.869512,0.67,2,158916,158461,455
1356341,31.8781,31.9743,455,47751,0.885902,0.67,2,158950,158495,455
1359261,7.97563,7.99486,455,47795,0.889181,0.69,2,158952,158497,455
1362181,25.5951,24.799,456,47839,0.921836,0.69,2,158982,158526,456
1365101,19.519,19.3598,456,47883,0.928367,0.69,2,159000,158544,456
1368021,22.3038,21.472,457,47927,0.929673,0.69,2,159023,158566,457
1370941,6.06076,5.89439,457,47971,0.929935,0.73,2,159025,158568,457
1373861,18.8122,17.1789,459,48015,0.913987,0.77,2,159047,158588,459
1613301,37,22,500,51488,0.83,1,2,161455,160955,500
1616221,75.4,75.6,496,51529,0.766,1,2,161540,161044,496
1619141,38.28,33.52,502,51570,0.8172,1,2,161569,161067,502
1622061,48.456,68.304,476,51611,0.82744,1,2,161620,161144,476
1624981,39.2912,33.6608,488,51652,0.797488,1,2,161657,161169,488
1627901,26.2582,25.1322,488,51693,0.807498,1,2,161680,161192,488
1630821,22.8516,17.0264,495,51734,0.761499,1,2,161702,161207,495
1633741,16.5703,30.6053,476,51775,0.7683,1,2,161717,161241,476
1636661,19.3141,6.12106,496,51816,0.80166,1,2,161737,161241,496
1639581,29.4628,18.8242,506,51857,0.744332,0.97,1,161769,161263,506
1642501,16.2926,19.7648,499,51898,0.732866,1,1,161782,161283,499
1645421,12.8585,18.353,493,51939,0.746573,1,1,161794,161301,493
1648341,16.1717,12.4706,499,51980,0.717315,1,1,161811,161312,499
1651261,16.8343,20.8941,493,52021,0.695463,1,1,161828,161335,493
1654181,23.3669,21.7788,496,52061,0.675093,1,1,161853,161357,496
1657101,16.6734,21.9558,489,52101,0.671019,0.88,1,161868,161379,489
1660021,20.1347,19.5912,491,52141,0.638204,0.83,1,161889,161398,491
1662941,25.6269,19.9182,498,52181,0.711641,0.83,1,161916,161418,498
1665861,73.9254,33.5836,547,52221,0.774328,0.75,2,162002,161455,547
1668781,37.9851,74.7167,491,52261,0.818866,0.83,2,162031,161540,491
1671701,45.997,38.1433,510,52301,0.859773,0.83,2,162079,161569,510
1674621,39.5994,48.4287,497,52341,0.899955,0.79,2,162117,161620,497
1677541,23.9199,39.2857,480,52381,0.875991,0.81,2,162137,161657,480
1680461,24.784,26.2571,482,52421,0.919198,0.75,2,162162,161680,482
1814781,19,23,489,54237,0.71,1,1,163302,162813,489
1817701,19.8,30.2,477,54276,0.614,1,1,163322,162845,477
1820621,78.36,82.04,475,54315,0.2748,1,1,163415,162940,475
1823541,49.272,39.608,488,54354,0.11096,1,1,163457,162969,488
1826461,56.2544,60.7216,480,54393,0.046192,1,1,163515,163035,480
1829381,40.0509,34.5443,488,54432,0.0332384,1,1,163551,163063,488
1832301,20.0102,21.3089,485,54471,0.0786477,1,1,163566,163081,485
1835221,24.002,22.6618,487,54510,0.0557295,1,1,163591,163104,487
1838141,21.6004,22.1324,486,54549,0.0111459,1,1,163612,163126,486
1841061,21.1201,22.0265,485,54588,0.0262292,1,1,163633,163148,485
1843981,19.424,22.0053,482,54627,0.0452458,1,1,163652,163170,482
1846901,11.8848,14.0011,480,54666,0.0170492,1,1,163662,163182,480
1849821,9.57696,12.4002,477,54704,0.00340983,1,1,163671,163194,477
1852741,12.3154,2.48004,490,54742,0.024682,0.9,1,163684,163194,490
1855661,9.66308,14.096,482,54780,0.0129364,0.89,1,163693,163211,482
1858581,12.3326,11.6192,484,54818,0.0585873,0.97,1,163706,163222,484
1861501,15.2665,15.1238,484,54856,0.0357175,0.93,1,163722,163238,484
1864421,16.6533,20.6248,479,54894,0.0151435,0.83,1,163739,163260,479
1867341,16.1307,22.525,472,54932,0.0030287,0.71,1,163755,163283,472
1870261,14.4261,19.705,467,54970,0.0406057,0.59,1,163769,163302,467
1873181,61.2852,19.941,520,55008,0.0481211,0.19,1,163842,163322,520
1876101,41.057,78.3882,463,55046,0.0336242,0.07,1,163878,163415,463
1879021,57.8114,49.2776,483,55084,0.0147248,0.03,1,163940,163457,483
1881941,38.7623,56.2555,459,55122,0.026945,0.03,1,163974,163515,459
1884861,19.7525,40.0511,438,55160,0.00538899,0.09,1,163989,163551,438
1887781,22.3505,20.0102,446,55198,0.0250778,0.05,1,164012,163566,446
1890701,21.2701,24.002,442,55236,0.0130156,0,1,164033,163591,442
1893621,22.654,21.6004,444,55274,0.00260311,0.03,1,164056,163612,444
1896541,18.1308,21.1201,440,55312,0.000520622,0.05,1,164073,163633,440
1899461,11.6262,19.424,431,55350,0.0401041,0.01,1,164083,163652,431
1902381,9.52523,11.8848,430,55388,0.0640208,0,1,164092,163662,430
1905301,12.305,9.57696,434,55426,0.0208042,0.03,1,164105,163671,434
1908221,11.261,12.3154,432,55464,0.0441608,0.01,1,164116,163684,432
1911141,11.0522,9.66308,434,55502,0.0648322,0.07,1,164127,163693,434
1914061,15.8104,12.3326,438,55540,0.0369664,0.03,1,164144,163706,438
1916981,15.9621,15.2665,438,55578,0.0313933,0.01,1,164160,163722,438
1919901,17.5924,16.6533,439,55616,0.0142787,0,1,164178,163739,439
1922821,13.9185,16.1307,436,55654,0.0428557,0.05,1,164191,163755,436
1925741,65.9837,14.4261,501,55692,0.0645711,0.05,1,164270,163769,501
1928661,36.3967,61.2852,457,55730,0.0129142,0.03,1,164299,163842,457
1931581,62.4793,41.057,490,55768,0.0265828,0.01,1,164368,163878,490
1934501,35.6959,57.8114,457,55806,0.0133166,0.03,1,164397,163940,457
1937421,17.5392,38.7623,436,55844,0.0106633,0,1,164410,163974,436
1940341,21.9078,19.7525,444,55882,0.0261327,0.03,1,164433,163989,444
1943261,21.1816,22.3505,442,55920,0.00522653,0.01,1,164454,164012,442
1946181,23.4363,21.2701,445,55958,0.00104531,0,1,164478,164033,445
1949101,19.0873,22.654,440,55996,0.000209061,0,1,164496,164056,440
1952021,11.8175,18.1308,433,56034,0.00804181,0.05,1,164506,164073,433
1954941,8.76349,11.6262,431,56072,0.0256084,0.07,1,164514,164083,431
1957861,12.1527,9.52523,435,56110,0.0131217,0.01,1,164527,164092,435
1960781,11.2305,12.305,433,56147,0.0426243,0.05,1,164538,164105,433
1963701,3.84611,11.261,424,56184,0.0165249,0.07,1,164540,164116,424
1966621,8.76922,11.0522,423,56221,0.027305,0.03,1,164550,164127,423
1969541,16.9538,15.8104,425,56258,0.013461,0.03,1,164569,164144,425
1972461,13.7908,15.9621,422,56295,0.0266922,0.01,1,164582,164160,422
1975381,17.9582,17.5924,423,56332,0.00533844,0.05,1,164601,164178,423
1978301,13.1916,13.9185,422,56369,0.00906769,0.07,1,164613,164191,422
1981221,66.6383,65.9837,423,56406,0.0258135,0,1,164693,164270,423
1984141,35.7277,36.3967,422,56443,0.00516271,0.03,1,164721,164299,422
1987061,62.3455,62.4793,422,56480,0.0250325,0.01,1,164790,164368,422
1989981,36.4691,35.6959,423,56517,0.00500651,0.01,1,164820,164397,423
1992901,17.6938,17.5392,423,56554,0.0250013,0.03,1,164833,164410,423
1995821,21.9388,21.9078,423,56591,0.0130003,0,1,164856,164433,423
1998741,21.1878,21.1816,423,56628,0.00260005,0,1,164877,164454,423
2001661,23.4376,23.4363,423,56665,0.02452,0,1,164901,164478,423
2004581,18.2875,19.0873,422,56702,0.004904,0.01,1,164918,164496,422
2007501,12.4575,11.8175,423,56739,0.0249808,0.03,1,164929,164506,423
2010421,8.8915,8.76349,423,56776,0.0129962,0.01,1,164937,164514,423
2013341,12.1783,12.1527,423,56813,0.0265992,0.05,1,164950,164527,423
2016261,11.2357,11.2305,423,56850,0.0293198,0.01,1,164961,164538,423
2019181,3.84713,3.84611,423,56887,0.029864,0.03,1,164963,164540,423
2022101,8.76943,8.76922,423,56924,0.0139728,0.01,1,164973,164550,423
2025021,16.1539,16.9538,422,56961,0.0267946,0.03,1,164991,164569,422
2027941,13.6308,13.7908,422,56998,0.0613589,0,1,165004,164582,422
2030861,17.9262,17.9582,422,57035,0.0522718,0.01,1,165023,164601,422
2033781,13.1852,13.1916,422,57072,0.0184544,0.03,1,165035,164613,422
2036701,66.637,66.6383,422,57109,0.0436909,0,1,165115,164693,422
2039621,35.7274,35.7277,422,57146,0.0327382,0.03,1,165143,164721,422
2042541,62.3455,62.3455,422,57183,0.0145476,0,1,165212,164790,422
2045461,36.4691,36.4691,422,57220,0.00290953,0.03,1,165242,164820,422
2048381,17.6938,17.6938,422,57257,0.0245819,0.01,1,165255,164833,422
2051301,21.9388,21.9388,422,57294,0.0129164,0,1,165278,164856,422
2054221,21.1878,21.1878,422,57331,0.0265833,0.03,1,165299,164877,422
2057141,24.2376,23.4376,423,57368,0.00531666,0,1,165324,164901,423
2060061,17.6475,18.2875,422,57405,0.0250633,0.03,1,165340,164918,422
2062981,12.3295,12.4575,422,57442,0.0290127,0.01,1,165351,164929,422
2065901,8.8659,8.8915,422,57479,0.0298025,0.03,1,165359,164937,422
2068821,12.1732,12.1783,422,57516,0.0779605,0.03,1,165372,164950,422
2071741,11.2346,11.2357,422,57553,0.0715921,0.03,1,165383,164961,422
2074661,3.84693,3.84713,422,57590,0.0703184,0.01,1,165385,164963,422
2077581,8.76939,8.76943,422,57627,0.0380637,0.01,1,165395,164973,422
2080501,16.9539,1.75389,441,57663,0.0476127,0.03,1,165414,164973,441
2083421,12.9908,14.7508,435,57699,0.0495225,0.07,1,165426,164991,435
2086341,16.9982,13.3502,440,57735,0.0499045,0.05,1,165444,165004,440
2089261,12.9996,17.87,433,57771,0.0499809,0.01,1,165456,165023,433
2092181,66.5999,13.174,501,57807,0.0339962,0.05,1,165536,165035,501
2095101,35.72,66.6348,449,57843,0.0307992,0.03,1,165564,165115,449
2098021,62.344,35.727,490,57879,0.0141598,0.01,1,165633,165143,490
2100941,36.4688,62.3454,451,57915,0.00283197,0,1,165663,165212,451
2103861,17.6938,36.4691,434,57951,0.00856639,0.03,1,165676,165242,434
2106781,21.9388,17.6938,444,57987,0.0417133,0.01,1,165699,165255,444
2109701,21.1878,21.9388,442,58023,0.0323427,0.03,1,165720,165278,442
2112621,25.0376,21.1878,447,58059,0.0304685,0,1,165746,165299,447
2115541,17.0075,24.2376,437,58095,0.0460937,0.03,1,165761,165324,437
2118461,13.8015,17.6475,434,58131,0.0172187,0.03,1,165774,165340,434
2121381,9.1603,12.3295,431,58167,0.0114437,0.03,1,165782,165351,431
2124301,12.2321,8.8659,436,58203,0.0262887,0.09,1,165795,165359,436
2127221,10.4464,12.1732,433,58239,0.0452578,0.07,1,165805,165372,433
2130141,3.68928,11.2346,424,58275,0.0490515,0.07,1,165807,165383,424
2133061,8.73786,3.84693,432,58311,0.0498103,0.03,1,165817,165385,432
2135981,17.7476,8.76939,442,58347,0.0499621,0.05,1,165837,165395,442
2138901,13.1495,16.9539,435,58383,0.0659924,0.05,1,165849,165414,435
2141821,17.0299,12.9908,441,58419,0.0851985,0.05,1,165867,165426,441
2144741,11.406,16.9982,433,58455,0.0890397,0.05,1,165877,165444,433
2147661,67.0812,12.9996,502,58491,0.0418079,0.03,1,165958,165456,502
2150581,35.0162,66.5999,449,58527,0.00836159,0.03,1,165985,165536,449
2153501,62.2032,35.72,490,58563,0.0256723,0.01,1,166054,165564,490
2156421,37.2407,62.344,452,58599,0.00513446,0,1,166085,165633,452
2159341,17.0481,36.4688,434,58635,0.0250269,0.01,1,166097,165663,434
2162261,21.8096,17.6938,444,58671,0.0290054,0.05,1,166120,165676,444
2165181,21.1619,21.9388,442,58707,0.0138011,0.03,1,166141,165699,442
2168101,25.8324,21.1878,448,58743,0.0267602,0.03,1,166168,165720,448
2171021,17.1665,25.0376,437,58779,0.013352,0.05,1,166183,165746,437
2173941,13.0333,17.0075,434,58815,0.0266704,0.01,1,166195,165761,434
2176861,9.00666,13.8015,429,58851,0.0293341,0.01,1,166203,165774,429
2179781,13.8013,9.1603,436,58887,0.0138668,0.03,1,166218,165782,436
2182701,10.7603,12.2321,433,58923,0.0107734,0.05,1,166228,165795,433
2185621,3.75205,10.4464,425,58959,0.0101547,0.05,1,166230,165805,425
2188541,8.75041,3.68928,433,58995,0.0260309,0.05,1,166240,165807,433
2191461,18.5501,8.73786,444,59031,0.0292062,0.05,1,166261,165817,444
2194381,13.31,17.7476,436,59067,0.0298412,0.07,1,166273,165837,436
2197301,4.262,13.1495,426,59103,0.0299682,0.09,1,166275,165849,426
2200221,15.2524,17.0299,426,59139,0.0299937,0.09,1,166293,165867,426
2203141,11.0505,11.406,426,59175,0.0459987,0.03,1,166303,165877,426
2206061,64.6101,67.0812,423,59211,0.00919975,0,1,166381,165958,423
2208981,33.722,35.0162,422,59247,0.00183995,0.03,1,166407,165985,422
2211901,61.9444,62.2032,422,59282,0.040368,0,1,166476,166054,422
2214821,37.9889,37.2407,423,59317,0.0080736,0.03,1,166508,166085,423
2217741,16.3978,17.0481,422,59352,0.0256147,0.03,1,166519,166097,422
2220661,22.4796,21.8096,423,59387,0.0131229,0.01,1,166543,166120,423
2223581,22.0959,21.1619,424,59422,0.0106246,0.03,1,166565,166141,424
2226501,25.2192,25.8324,423,59457,0.0101249,0.01,1,166591,166168,423
2229421,17.0438,17.1665,423,59492,0.026025,0.03,1,166606,166183,423
2232341,13.0088,13.0333,423,59527,0.045205,0.03,1,166618,166195,423
2235261,9.00175,9.00666,423,59562,0.049041,0.01,1,166626,166203,423
2238181,13.0004,13.8013,422,59597,0.0178082,0.01,1,166640,166218,422
2241101,11.4001,10.7603,423,59632,0.0275616,0.01,1,166651,166228,423
2244021,3.88001,3.75205,423,59667,0.0295123,0.03,1,166653,166230,423
2246941,8.776,8.75041,423,59702,0.0139025,0.03,1,166663,166240,423
2249861,18.5552,18.5501,423,59737,0.0747805,0.03,1,166684,166261,423
2252781,13.311,13.31,423,59772,0.0709561,0.03,1,166696,166273,423
2255701,4.26221,4.262,423,59807,0.102191,0.03,1,166698,166275,423
2258621,16.0524,15.2524,424,59842,0.0924383,0.05,1,166717,166293,424
2261541,11.2105,11.0505,424,59877,0.0584877,0,1,166727,166303,424
2264461,63.0421,64.6101,422,59912,0.0516975,0,1,166803,166381,422
2267381,33.4084,33.722,422,59947,0.0343395,0.05,1,166829,166407,422
2270301,61.8817,61.9444,422,59982,0.0308679,0,1,166898,166476,422
2273221,37.9763,37.9889,422,60017,0.0301736,0.03,1,166930,166508,422
2276141,16.3953,16.3978,422,60052,0.0300347,0.01,1,166941,166519,422
2279061,23.2791,22.4796,423,60087,0.0300069,0.01,1,166966,166543,423
2281981,22.2558,22.0959,423,60122,0.0300014,0.01,1,166988,166565,423
2284901,24.4512,25.2192,422,60157,0.0460003,0.03,1,167013,166591,422
2287821,16.8902,17.0438,422,60192,0.0332001,0.05,1,167028,166606,422
2290741,12.978,13.0088,422,60227,0.04664,0.05,1,167040,166618,422
2293661,8.99561,9.00175,422,60262,0.017328,0.01,1,167048,166626,422
2296581,12.9991,13.0004,422,60297,0.0434656,0.03,1,167062,166640,422
2299501,11.3998,11.4001,422,60332,0.0486931,0.03,1,167073,166651,422
2302421,3.87996,3.88001,422,60367,0.0497386,0.01,1,167075,166653,422
2305341,8.77599,8.776,422,60402,0.0179477,0.09,1,167085,166663,422
2308261,20.9552,18.5552,425,60437,0.0595895,0.07,1,167109,166684,425
2311181,13.791,13.311,425,60472,0.0999179,0.11,1,167121,166696,425
2314101,4.35821,4.26221,425,60507,0.0759836,0.09,1,167123,166698,425
2317021,15.2716,16.0524,424,60542,0.103197,0.09,1,167141,166717,424
2319941,11.0543,3.21049,434,60577,0.0766393,0.05,1,167151,166717,434
2322861,62.2109,8.6421,499,60612,0.135328,0.05,1,167226,166727,499
2325781,31.6422,62.5284,447,60647,0.115066,0.03,1,167250,166803,447
2328701,61.5284,33.3057,490,60682,0.0470131,0.03,1,167319,166829,490
2331621,37.9057,61.8611,453,60717,0.00940262,0.03,1,167351,166898,453
2334541,16.3811,37.9722,432,60752,0.0258805,0.03,1,167362,166930,432
2337461,23.2762,16.3944,446,60787,0.0291761,0.03,1,167387,166941,446
2340381,22.2552,23.2789,443,60822,0.0618352,0.03,1,167409,166966,443
2343301,24.451,22.2558,446,60857,0.020367,0.05,1,167434,166988,446
2346221,16.8902,24.4512,436,60892,0.0440734,0.03,1,167449,167013,436
2349141,12.978,16.8902,433,60927,0.0168147,0.05,1,167461,167028,433
2352061,8.99561,12.978,429,60961,0.0273629,0.01,1,167469,167040,429
2354981,13.7991,8.99561,436,60995,0.0614726,0.05,1,167484,167048,436
2357901,10.7598,12.9991,432,61029,0.0842945,0.05,1,167494,167062,432
2360821,3.75196,11.3998,423,61063,0.0888589,0.05,1,167496,167073,423
2363741,8.75039,3.87996,431,61097,0.0897718,0.01,1,167506,167075,431
2366661,23.3501,8.77599,448,61131,0.0739544,0.07,1,167533,167085,448
2369581,14.27,20.9552,436,61165,0.0707909,0.11,1,167545,167109,436
2372501,4.454,13.791,426,61199,0.0701582,0.07,1,167547,167121,426
2375421,15.2908,4.35821,442,61233,0.0860316,0.11,1,167565,167123,442
2378341,11.0582,15.2716,434,61267,0.0892063,0.07,1,167575,167141,434
2381261,65.4116,11.0543,503,61301,0.105841,0.15,1,167654,167151,503
2384181,27.4823,62.2109,446,61335,0.125168,0.11,1,167672,167226,446
2387101,59.8965,31.6422,490,61369,0.0330337,0.03,1,167740,167250,490
2390021,37.5793,61.5284,453,61403,0.00660673,0,1,167772,167319,453
2392941,16.3159,37.9057,432,61437,0.0413213,0.03,1,167783,167351,432
2395861,24.0632,16.3811,447,61471,0.0322643,0.03,1,167809,167362,447
2398781,21.6126,23.2762,443,61505,0.0464529,0.07,1,167830,167387,443
2401701,24.3225,22.2552,446,61539,0.0332906,0.01,1,167855,167409,446
2404621,16.8645,24.451,436,61573,0.0306581,0.05,1,167870,167434,436
2407541,13.7729,16.8902,434,61607,0.0141316,0.01,1,167883,167449,434
2410461,9.95458,12.978,431,61641,0.0428263,0.03,1,167892,167461,431
2413381,15.5909,8.99561,440,61675,0.0325653,0.07,1,167909,167469,440
2416301,11.1182,13.7991,435,61709,0.0625131,0.09,1,167919,167484,435
2419221,3.82364,10.7598,427,61743,0.0685026,0.09,1,167921,167494,427
2422141,8.76473,3.75196,435,61777,0.0697005,0.09,1,167931,167496,435
2425061,22.5529,8.75039,451,61811,0.0859401,0.07,1,167957,167506,451
2427981,14.9106,23.3501,437,61845,0.073188,0.07,1,167970,167533,437
2430901,4.58212,14.27,427,61879,0.0706376,0.07,1,167972,167545,427
2433821,15.3164,4.454,443,61913,0.0701275,0.09,1,167990,167547,443
2436741,11.8633,15.2908,436,61947,0.0860255,0.09,1,168001,167565,436
2439661,65.5727,11.0582,505,61981,0.0892051,0.11,1,168080,167575,505
2442581,14.7145,65.4116,428,62015,0.089841,0.13,1,168082,167654,428
2445501,17.3429,27.4823,428,62049,0.105968,0.01,1,168100,167672,428
2448421,53.0686,59.8965,422,62083,0.0291936,0,1,168162,167740,422
2451341,37.0137,37.5793,423,62117,0.0138387,0.05,1,168195,167772,423
2454261,15.4027,16.3159,422,62151,0.00276775,0.03,1,168205,167783,422
2457181,24.6805,24.0632,423,62185,0.0405536,0.05,1,168232,167809,423
2460101,22.5361,21.6126,424,62219,0.0161107,0.03,1,168254,167830,424
2463021,22.9072,24.3225,422,62253,0.0592221,0.03,1,168277,167855,422
2465941,17.3814,16.8645,423,62287,0.0118444,0.01,1,168293,167870,423
2468861,13.8763,13.7729,423,62321,0.0263689,0.05,1,168306,167883,423
2471781,10.7753,9.95458,424,62355,0.0132738,0.03,1,168316,167892,424
2474701,16.5551,15.5909,425,62389,0.0266548,0.07,1,168334,167909,425
2477621,11.311,11.1182,425,62423,0.029331,0.07,1,168344,167919,425
2480541,3.8622,3.82364,425,62457,0.0618662,0.07,1,168346,167921,425
2483461,9.57244,8.76473,426,62491,0.0523732,0.09,1,168357,167931,426
2486381,22.7145,22.5529,426,62525,0.0664746,0.07,1,168383,167957,426
2489301,14.1429,14.9106,425,62559,0.0372949,0.07,1,168395,167970,425
2492221,4.42858,4.58212,425,62593,0.063459,0.07,1,168397,167972,425
2495141,15.2857,15.3164,425,62627,0.0686918,0.09,1,168415,167990,425
2498061,12.6571,11.8633,426,62661,0.0537384,0.09,1,168427,168001,426
2500981,66.5314,65.5727,427,62695,0.0827477,0.09,1,168507,168080,427
2503901,14.9063,14.7145,427,62728,0.0885495,0.11,1,168509,168082,427
2506821,17.3813,17.3429,427,62761,0.0897099,0.01,1,168527,168100,427
2509741,49.0763,53.0686,422,62794,0.121942,0.01,1,168584,168162,422
2512661,36.2152,37.0137,422,62827,0.0323884,0,1,168617,168195,422
2515581,15.243,15.4027,422,62860,0.00647768,0.05,1,168627,168205,422
2518501,24.6486,24.6805,422,62893,0.0412955,0.01,1,168654,168232,422
2521421,23.3297,22.5361,423,62926,0.0322591,0.07,1,168677,168254,423
2524341,23.0659,22.9072,423,62959,0.0144518,0,1,168700,168277,423
2527261,16.6132,17.3814,422,62992,0.0428904,0.03,1,168715,168293,422
2530181,13.7226,13.8763,422,63025,0.0325781,0.01,1,168728,168306,422
2533101,11.5445,10.7753,423,63058,0.0305156,0.03,1,168739,168316,423
2536021,16.7089,16.5551,423,63091,0.0461031,0.03,1,168757,168334,423
2538941,11.3418,11.311,423,63124,0.0172206,0.07,1,168767,168344,423
2541861,3.86836,3.8622,423,63157,0.0434441,0.05,1,168769,168346,423
2544781,9.57367,9.57244,423,63190,0.0326888,0.07,1,168780,168357,423
2547701,22.7147,22.7145,423,63223,0.0465378,0.03,1,168806,168383,423
2550621,14.1429,14.1429,423,63256,0.0493076,0.07,1,168818,168395,423
2553541,4.42859,4.42858,423,63289,0.0498615,0.07,1,168820,168397,423
2556461,16.0857,15.2857,424,63322,0.0499723,0.05,1,168839,168415,424
2559381,13.6171,12.6571,425,63355,0.0659945,0.09,1,168852,168427,425
2562301,67.5234,66.5314,426,63388,0.117199,0.09,1,168933,168507,426
2565221,15.1047,14.9063,426,63421,0.0954398,0.09,1,168935,168509,426
2568141,17.4209,17.3813,426,63454,0.139088,0.09,1,168953,168527,426
2571061,46.6842,3.47625,480,63487,0.163818,0.13,1,169007,168527,480
2573981,34.1368,46.2953,454,63520,0.120764,0.01,1,169038,168584,454
2576901,14.8274,35.659,431,63553,0.0481527,0,1,169048,168617,431
2579821,24.5655,15.1318,448,63586,0.0176305,0.05,1,169075,168627,448
2582741,23.3131,24.6264,444,63619,0.0435261,0.03,1,169098,168654,444
2585661,23.8626,23.3253,445,63652,0.0167052,0.01,1,169122,168677,445
2588581,15.9725,23.0651,436,63685,0.027341,0.05,1,169136,168700,436
2591501,13.5945,16.613,434,63718,0.0454682,0.03,1,169149,168715,434
2594421,11.5189,13.7226,432,63751,0.0650936,0.03,1,169160,168728,432
2597341,16.7038,11.5445,439,63784,0.0370187,0.05,1,169178,168739,439
2600261,11.3408,16.7089,431,63817,0.0314037,0.01,1,169188,168757,431
2603181,3.86815,11.3418,423,63850,0.0302808,0.05,1,169190,168767,423
2606101,9.57363,3.86836,432,63883,0.0460562,0.03,1,169201,168769,432
2609021,22.7147,9.57367,447,63916,0.0492112,0.05,1,169227,168780,447
2611941,14.9429,22.7147,434,63949,0.0658422,0.05,1,169240,168806,434
2614861,4.58859,14.1429,424,63982,0.0371684,0.05,1,169242,168818,424
2617781,16.9177,4.42859,442,64015,0.0634337,0.05,1,169262,168820,442
2620701,13.7835,16.0857,436,64048,0.100687,0.07,1,169275,168839,436
2623621,69.9567,13.6171,507,64081,0.0761373,0.13,1,169359,168852,507
2626541,15.5913,67.5234,428,64114,0.0712275,0.09,1,169361,168933,428
2629461,18.3183,15.1047,445,64147,0.0862455,0.15,1,169380,168935,445
2632381,48.4637,17.4209,483,64180,0.121249,0.17,1,169436,168953,483
2635301,28.8927,46.6842,453,64213,0.12825,0.11,1,169460,169007,453
2638221,12.9785,34.1368,431,64246,0.11365,0.03,1,169469,169038,431
2641141,24.1957,14.8274,448,64279,0.09473,0.01,1,169496,169048,448
2644061,23.2391,24.5655,444,64312,0.042946,0.05,1,169519,169075,444
2646981,24.6478,23.3131,446,64345,0.0165892,0.01,1,169544,169098,446
2649901,17.7296,23.8626,438,64378,0.0273178,0.03,1,169560,169122,438
2652821,13.1459,15.9725,436,64411,0.0774636,0.05,1,169572,169136,436
2655741,10.6292,13.5945,433,64444,0.0874927,0.07,1,169582,169149,433
2658661,16.5258,11.5189,440,64477,0.0894985,0.03,1,169600,169160,440
2661581,11.3052,16.7038,432,64510,0.0898997,0.03,1,169610,169178,432
2664501,3.86103,11.3408,424,64543,0.0899799,0.03,1,169612,169188,424
2667421,8.77221,3.86815,432,64576,0.089996,0.05,1,169622,169190,432
2670341,24.1544,9.57363,449,64609,0.0899992,0.05,1,169650,169201,449
2673261,16.0309,22.7147,437,64641,0.0899998,0.07,1,169664,169227,437
2676181,4.80618,14.9429,426,64673,0.09,0.03,1,169666,169240,426
2679101,16.9612,4.58859,444,64705,0.09,0.07,1,169686,169242,444
2682021,13.7922,16.9177,437,64737,0.122,0.11,1,169699,169262,437
2684941,69.9585,13.7835,508,64769,0.1284,0.07,1,169783,169275,508
2687861,15.5917,69.9567,426,64801,0.12968,0.07,1,169785,169359,426
2690781,19.1183,15.5913,444,64833,0.129936,0.09,1,169805,169361,444
2693701,50.2237,18.3183,483,64865,0.113987,0.13,1,169863,169380,483
2696621,30.0447,48.4637,452,64897,0.110797,0.13,1,169888,169436,452
2699541,7.60895,28.8927,430,64929,0.142159,0.11,1,169890,169460,430
2702461,7.92179,12.9785,429,64961,0.116432,0.09,1,169898,169469,429
2705381,19.1844,24.1957,424,64993,0.111286,0.03,1,169920,169496,424
2708301,21.4369,23.2391,423,65025,0.110257,0.01,1,169942,169519,423
2711221,24.2874,24.6478,423,65057,0.0940515,0.03,1,169967,169544,423
2714141,20.0575,17.7296,426,65089,0.0748103,0.09,1,169986,169560,426
2717061,13.6115,13.1459,426,65121,0.102962,0.09,1,169998,169572,426
2719981,10.7223,10.6292,426,65153,0.0925924,0.09,1,170008,169582,426
2722901,16.5445,16.5258,426,65185,0.106518,0.09,1,170026,169600,426
2725821,11.3089,11.3052,426,65217,0.109304,0.09,1,170036,169610,426
2728741,3.86178,3.86103,426,65249,0.141861,0.09,1,170038,169612,426
2731661,8.77236,8.77221,426,65281,0.116372,0.09,1,170048,169622,426
2734581,24.1545,24.1544,426,65313,0.143274,0.09,1,170076,169650,426
2737501,16.0309,16.0309,426,65345,0.164655,0.09,1,170090,169664,426
2740421,4.80618,4.80618,426,65377,0.136931,0.09,1,170092,169666,426
2743341,16.9612,16.9612,426,65409,0.131386,0.13,1,170112,169686,426
2746261,16.1922,13.7922,429,65441,0.146277,0.13,1,170128,169699,429
2749181,69.6385,69.9585,428,65473,0.197255,0.13,1,170211,169783,428
2752101,15.5277,15.5917,428,65505,0.207451,0.13,1,170213,169785,428
2755021,19.9055,19.1183,429,65537,0.19349,0.11,1,170234,169805,429
2757941,49.5811,50.2237,428,65569,0.190698,0.11,1,170291,169863,428
2760861,29.1162,30.0447,427,65601,0.19014,0.15,1,170315,169888,427
2763781,7.42324,7.60895,427,65633,0.222028,0.11,1,170317,169890,427
2766701,7.88465,7.92179,427,65665,0.196406,0.11,1,170325,169898,427
2769621,19.1769,19.1844,427,65697,0.207281,0.11,1,170347,169920,427
2772541,21.4354,21.4369,427,65729,0.225456,0.09,1,170369,169942,427
2775461,21.8871,24.2874,424,65761,0.229091,0.07,1,170391,169967,424
2778381,20.3774,20.0575,425,65793,0.245818,0.11,1,170411,169986,425
2781301,14.4755,13.6115,426,65825,0.281164,0.09,1,170424,169998,426
2784221,11.6951,10.7223,427,65857,0.440233,0.11,1,170435,170008,427
2787141,16.739,16.5445,427,65889,0.464047,0.11,1,170453,170026,427
2790061,11.3478,11.3089,427,65921,0.436809,0.15,1,170463,170036,427
2792981,3.86956,3.86178,427,65953,0.463362,0.11,1,170465,170038,427
2795901,8.77391,8.77236,427,65985,0.436672,0.15,1,170475,170048,427
2798821,24.1548,24.1545,427,66017,0.463335,0.17,1,170503,170076,427
2801741,16.831,16.0309,428,66049,0.452667,0.13,1,170518,170090,428
2804661,4.96619,4.80618,428,66081,0.450533,0.13,1,170520,170092,428
2807581,17.7932,16.9612,429,66113,0.434107,0.15,1,170541,170112,429
2810501,14.7586,16.1922,427,66145,0.414821,0.21,1,170555,170128,427
2813421,71.7517,69.6385,430,66177,0.458964,0.21,1,170641,170211,430
2816341,15.9503,15.5277,430,66209,0.435793,0.19,1,170643,170213,430
2819261,19.1901,19.9055,429,66241,0.479159,0.19,1,170663,170234,429
2822181,51.038,49.5811,431,66273,0.503832,0.19,1,170722,170291,431
2825101,29.4076,29.1162,431,66305,0.524766,0.23,1,170746,170315,431
2828021,7.48152,7.42324,431,66337,0.496953,0.19,1,170748,170317,431
2830941,8.6963,7.88465,432,66369,0.507391,0.21,1,170757,170325,432
2833861,19.3393,19.1769,432,66401,0.557478,0.21,1,170779,170347,432
2836781,21.4679,3.83539,454,66433,0.535496,0.23,1,170801,170347,454
2839701,21.8936,18.3671,454,66465,0.531099,0.23,1,170823,170369,454
2842621,21.9787,21.2734,454,66497,0.53022,0.25,1,170845,170391,454
2845541,13.9957,20.2547,446,66529,0.530044,0.29,1,170857,170411,446
2848461,18.7991,14.4509,453,66561,0.578009,0.48,1,170877,170424,453
2851381,18.1598,11.6902,460,66593,0.603602,0.47,1,170895,170435,460
2854301,11.632,16.738,452,66625,0.60872,0.43,1,170905,170453,452
2857221,3.92639,11.3476,444,66656,0.609744,0.47,1,170907,170463,444
2860141,8.78528,3.86952,452,66687,0.609949,0.43,1,170917,170465,452
2863061,24.1571,8.7739,470,66718,0.64199,0.47,1,170945,170475,470
2865981,16.0314,24.1548,456,66749,0.648398,0.45,1,170959,170503,456
2868901,4.80628,16.831,443,66780,0.64968,0.45,1,170961,170518,443
2871821,17.7613,4.96619,462,66811,0.665936,0.43,1,170982,170520,462
2874741,14.7523,17.7932,455,66842,0.637187,0.41,1,170996,170541,455
2877661,72.5504,14.7586,528,66873,0.727437,0.47,1,171083,170555,528
2880581,16.1101,71.7517,444,66904,0.745487,0.43,1,171085,170641,444
2883501,20.022,15.9503,463,66935,0.733098,0.49,1,171106,170643,463
2886421,52.0044,19.1901,503,66966,0.746619,0.51,1,171166,170663,503
2889341,30.4009,51.038,469,66997,0.781324,0.53,2,171191,170722,469
2892261,7.68018,29.4076,447,67028,0.788265,0.49,2,171193,170746,447
2895181,9.53604,7.48152,455,67059,0.789653,0.51,2,171203,170748,455
2898101,20.3072,8.6963,469,67090,0.789931,0.57,2,171226,170757,469
2901021,21.6614,19.3393,469,67121,0.789986,0.53,2,171248,170779,469
2903941,21.9323,21.4679,469,67152,0.789997,0.53,2,171270,170801,469
2906861,21.9865,21.8936,469,67183,0.805999,0.53,2,171292,170823,469
2909781,13.9973,21.9787,459,67214,0.8412,0.53,2,171304,170845,459
2912701,21.9995,13.9957,471,67245,0.94424,0.59,2,171328,170857,471
3214921,61,24,458,32914,0.05,0.05,1,173712,173254,458
3217841,25,40.8,429,32978,0.01,0.01,1,173728,173299,429
3220761,17.8,21.76,428,33042,0.026,0.01,1,173744,173316,428
3223681,17.96,13.152,435,33106,0.0452,0.01,1,173762,173327,435
3226601,29.192,26.6304,437,33170,0.00904,0,1,173794,173357,437
3229521,49.0384,38.1261,450,33234,0.009808,0.03,1,173848,173398,450
3232441,54.6077,52.4252,450,33298,0.0419616,0.03,1,173904,173454,450
3235361,52.5215,50.485,452,33362,0.0323923,0.07,1,173956,173504,452
3238281,49.7043,52.497,448,33425,0.0464785,0.03,1,174005,173557,448
3241201,39.5409,46.4994,440,33488,0.0332957,0,1,174042,173602,440
3244121,31.9082,39.6999,432,33551,0.0306591,0.05,1,174072,173640,432
3247041,56.7816,65.54,423,33614,0.0301318,0,1,174135,173712,423
3249961,23.3563,25.908,422,33677,0.00602637,0.03,1,174150,173728,422
3252881,19.0713,17.9816,424,33740,0.00120527,0.05,1,174168,173744,424
3255801,18.2143,17.9963,424,33803,0.00824105,0,1,174186,173762,424
3258721,28.4429,29.1993,423,33866,0.0256482,0.01,1,174217,173794,423
3261641,48.0886,49.0399,422,33928,0.0131296,0.05,1,174270,173848,422
3264561,57.6177,54.608,426,33990,0.0106259,0.03,1,174330,173904,426
3267481,50.7235,52.5216,423,34052,0.0101252,0.05,1,174379,173956,423
3270401,48.5447,49.7043,422,34114,0.026025,0.03,1,174427,174005,422
3273321,41.7089,39.5409,425,34176,0.045205,0.03,1,174467,174042,425
3276241,29.9418,31.9082,422,34238,0.033041,0.03,1,174494,174072,422
3279161,55.5884,6.38163,484,34300,0.0146082,0.03,1,174556,174072,484
3282081,23.9177,51.6763,437,34362,0.00292164,0,1,174572,174135,437
3285001,18.3835,22.3353,439,34424,0.0245843,0,1,174589,174150,439
3287921,18.0767,18.8671,439,34485,0.0289169,0.01,1,174607,174168,439
3290841,29.2153,18.1734,453,34546,0.0137834,0.03,1,174639,174186,453
3293761,47.4431,28.4347,474,34607,0.0267567,0.01,1,174691,174217,474
3296681,57.4886,48.0869,481,34668,0.0293513,0.01,1,174751,174270,481
3299601,50.6977,57.6174,470,34729,0.0458703,0.01,1,174800,174330,470
3302521,50.1395,50.7235,471,34790,0.0491741,0.03,1,174850,174379,471
3305441,40.4279,48.5447,461,34851,0.0498348,0.05,1,174888,174427,461
3308361,29.6856,41.7089,448,34912,0.033967,0.03,1,174915,174467,448
3311281,55.5371,29.9418,483,34973,0.0147934,0.01,1,174977,174494,483
3314201,25.5074,55.5884,439,35033,0.0269587,0,1,174995,174556,439
3317121,17.9015,23.9177,439,35093,0.0293917,0.03,1,175011,174572,439
3320041,18.7803,18.3835,441,35153,0.0458783,0.03,1,175030,174589,441
3322961,27.7561,18.0767,453,35213,0.0331757,0.01,1,175060,174607,453
3325881,47.1512,29.2153,473,35273,0.0306351,0.03,1,175112,174639,473
3328801,57.4302,47.4431,481,35333,0.030127,0.03,1,175172,174691,481
3331721,51.486,57.4886,471,35393,0.0140254,0.05,1,175222,174751,471
3334641,51.0972,50.6977,473,35453,0.0588051,0.05,1,175273,174800,473
3337561,40.6194,50.1395,461,35513,0.083761,0.05,1,175311,174850,461
3340481,28.1239,40.4279,448,35573,0.104752,0.03,1,175336,174888,448
3343401,56.8248,29.6856,485,35632,0.0449504,0.01,1,175400,174915,485
3346321,24.165,55.5371,439,35691,0.0329901,0.03,1,175416,174977,439
3349241,6.43299,25.5074,423,35750,0.00659802,0.03,1,175418,174995,423
3352161,13.2866,17.9015,422,35809,0.0253196,0.05,1,175433,175011,422
3355081,18.6573,18.7803,423,35868,0.0450639,0.03,1,175453,175030,423
3358001,28.5315,27.7561,424,35927,0.00901278,0.03,1,175484,175060,424
3360921,45.7063,47.1512,422,35986,0.00980256,0.03,1,175534,175112,422
3363841,57.1413,57.4302,422,36045,0.0259605,0.01,1,175594,175172,422
3366761,51.4283,51.486,422,36104,0.0131921,0.07,1,175644,175222,422
3369681,53.4857,51.0972,425,36163,0.0746384,0.09,1,175698,175273,425
3372601,41.8971,40.6194,426,36221,0.0389277,0.11,1,175737,175311,426
3375521,25.1794,28.1239,422,36279,0.0637855,0.03,1,175758,175336,422
3378441,57.0359,56.8248,423,36337,0.0127571,0.03,1,175823,175400,423
3381361,23.4072,24.165,422,36395,0.0425514,0,1,175838,175416,422
3384281,6.28144,6.43299,422,36453,0.0165103,0.03,1,175840,175418,422
3387201,13.2563,13.2866,422,36511,0.0433021,0.05,1,175855,175433,422
3390121,18.6513,18.6573,422,36569,0.0166604,0,1,175875,175453,422
3393041,28.5303,28.5315,422,36627,0.0273321,0.01,1,175906,175484,422
3395961,45.7061,45.7063,422,36685,0.0134664,0.03,1,175956,175534,422
3398881,57.1412,57.1413,422,36743,0.0266933,0.01,1,176016,175594,422
3401801,51.4282,51.4283,422,36801,0.0133387,0.09,1,176066,175644,422
3404721,55.0856,53.4857,424,36858,0.0426677,0.03,1,176122,175698,424
3407641,42.2171,41.8971,424,36915,0.0485335,0.07,1,176161,175737,424
3410561,24.4434,25.1794,423,36972,0.0817067,0,1,176181,175758,423
3413481,56.8887,57.0359,423,37029,0.0403413,0.05,1,176246,175823,423
3416401,22.5777,23.4072,422,37086,0.0160683,0.01,1,176260,175838,422
3419321,6.11555,6.28144,422,37143,0.0112137,0.01,1,176262,175840,422
3422241,12.4231,1.25629,436,37200,0.0102427,0.05,1,176276,175840,436
3425161,19.2846,12.2513,442,37257,0.0100485,0.01,1,176297,175855,442
3428081,27.8569,18.4503,452,37314,0.0900097,0.03,1,176327,175875,452
3431001,45.5714,28.4901,471,37371,0.0900019,0.01,1,176377,175906,471
3433921,57.1143,45.698,481,37428,0.0260004,0.03,1,176437,175956,481
3436841,51.4229,57.1396,471,37484,0.0452001,0.01,1,176487,176016,471
3439761,55.0846,51.4279,477,37540,0.03304,0.05,1,176543,176066,477
3442681,43.8169,55.0856,462,37596,0.030608,0.05,1,176584,176122,462
3445601,24.7634,42.2171,443,37652,0.0461216,0.09,1,176604,176161,443
3448521,55.3527,24.4434,486,37708,0.0332243,0.03,1,176667,176181,486
3451441,22.2705,56.8887,435,37764,0.0306449,0.01,1,176681,176246,435
3454361,6.05411,22.5777,423,37820,0.030129,0.01,1,176683,176260,423
3457281,12.4108,6.11555,435,37876,0.0300258,0.01,1,176697,176262,435
3460201,21.6822,12.4231,445,37932,0.0140052,0.01,1,176721,176276,445
3463121,28.3364,19.2846,454,37988,0.058801,0.11,1,176751,176297,454
3466041,44.8673,27.8569,473,38044,0.0677602,0.09,1,176800,176327,473
3468961,55.3735,45.5714,481,38100,0.021552,0.01,1,176858,176377,481
3471881,51.0747,57.1143,471,38155,0.0443104,0.05,1,176908,176437,471
3474801,56.6149,51.4229,479,38210,0.00886208,0.03,1,176966,176487,479
3477721,44.123,55.0846,464,38265,0.0417724,0.03,1,177007,176543,464
3480641,25.6246,43.8169,444,38320,0.0323545,0.05,1,177028,176584,444
3483561,53.9249,24.7634,485,38375,0.0304709,0.03,1,177089,176604,485
3486481,21.985,55.3527,436,38430,0.0300942,0.03,1,177103,176667,436
3489401,5.997,22.2705,424,38485,0.0300188,0.03,1,177105,176681,424
3492321,12.3994,6.05411,436,38540,0.0300038,0.03,1,177119,176683,436
3495241,22.4799,12.4108,447,38595,0.0300008,0.01,1,177144,176697,447
3498161,6.09598,21.6822,425,38650,0.0300002,0.07,1,177146,176721,425
3501081,25.2192,28.3364,425,38705,0.046,0.07,1,177176,176751,425
3504001,44.2438,44.8673,425,38760,0.0652,0.01,1,177225,176800,425
3506921,53.6488,55.3735,423,38814,0.03704,0.05,1,177281,176858,423
3509841,51.5298,51.0747,424,38868,0.015408,0,1,177332,176908,424
3512761,56.706,56.6149,424,38922,0.0030816,0.05,1,177390,176966,424
3515681,44.1412,44.123,424,38976,0.0886163,0.03,1,177431,177007,424
3518601,26.4282,25.6246,425,39030,0.0737233,0.03,1,177453,177028,425
3521521,52.4856,53.9249,423,39084,0.0387447,0.03,1,177512,177089,423
3524441,20.8971,21.985,422,39138,0.0317489,0.03,1,177525,177103,422
3527361,5.77943,5.997,422,39192,0.0303498,0.03,1,177527,177105,422
3530281,12.3559,12.3994,422,39246,0.03007,0.03,1,177541,177119,422
3533201,22.4712,22.4799,422,39300,0.014014,0.03,1,177566,177144,422
3536121,6.09424,6.09598,422,39354,0.0108028,0.05,1,177568,177146,422
3539041,26.8188,25.2192,424,39408,0.0421606,0.07,1,177600,177176,424
3541961,43.7638,44.2438,423,39462,0.112432,0.03,1,177648,177225,423
3544881,52.7528,53.6488,422,39516,0.110486,0.01,1,177703,177281,422
3547801,51.3505,51.5298,422,39569,0.0780973,0,1,177754,177332,422
3550721,56.6701,56.706,422,39622,0.0716195,0.11,1,177812,177390,422
3553641,46.534,44.1412,425,39675,0.102324,0.07,1,177856,177431,425
3556561,26.9068,26.4282,425,39728,0.0924648,0.03,1,177878,177453,425
3559481,50.1814,52.4856,422,39781,0.058493,0.03,1,177934,177512,422
3562401,20.4363,20.8971,422,39834,0.0356986,0.03,1,177947,177525,422
3565321,5.68725,5.77943,422,39887,0.0311397,0.03,1,177949,177527,422
3568241,12.3375,12.3559,422,39940,0.0142279,0.01,1,177963,177541,422
3571161,22.4675,22.4712,422,39993,0.0108456,0.01,1,177988,177566,422
3574081,6.0935,6.09424,422,40046,0.0101691,0.05,1,177990,177568,422
3577001,28.4187,26.8188,424,40099,0.0580338,0.05,1,178024,177600,424
3579921,44.8837,5.36377,473,40152,0.0996068,0.13,1,178073,177600,473
3582841,52.9767,39.4728,480,40205,0.123921,0.11,1,178128,177648,480
3585761,50.5953,51.8946,475,40258,0.144784,0.07,1,178178,177703,475
3588681,56.5191,51.1789,482,40310,0.148957,0.07,1,178236,177754,482
3591601,47.3038,56.6358,469,40362,0.133791,0.11,1,178281,177812,469
3594521,27.0608,46.5272,447,40414,0.162758,0.09,1,178303,177856,447
3597441,47.0122,26.9054,477,40466,0.168552,0.05,1,178355,177878,477
3600361,19.8024,50.1811,434,40518,0.15371,0.03,1,178368,177934,434
3603281,5.56049,20.4362,423,40570,0.150742,0.03,1,178370,177947,423
3606201,12.3121,5.68724,435,40622,0.166148,0.01,1,178384,177949,435
3609121,22.4624,12.3374,446,40674,0.12123,0.01,1,178409,177963,446
3612041,6.09248,22.4675,423,40726,0.112246,0.01,1,178411,177988,423
3614961,31.6185,6.0935,459,40778,0.0784492,0.07,1,178449,177990,459
3617881,46.3237,28.4187,475,40830,0.0716898,0.11,1,178499,178024,475
3620801,54.0647,44.8837,482,40882,0.102338,0.13,1,178555,178073,482
3623721,51.6129,52.9767,478,40934,0.124468,0.15,1,178606,178128,478
3626641,56.7226,50.5953,486,40986,0.160894,0.15,1,178664,178178,486
3629561,46.5445,56.5191,472,41038,0.168179,0.13,1,178708,178236,472
3632481,28.5089,47.3038,451,41089,0.169636,0.17,1,178732,178281,451
3635401,47.3018,27.0608,481,41140,0.185927,0.17,1,178784,178303,481
3638321,19.0604,47.0122,441,41191,0.189185,0.15,1,178796,178355,441
3641241,5.41207,19.8024,430,41242,0.189837,0.15,1,178798,178368,430
3644161,11.4824,5.56049,441,41293,0.205967,0.17,1,178811,178370,441
3647081,19.8965,12.3121,449,41344,0.209193,0.11,1,178833,178384,449
3650001,5.5793,22.4624,426,41395,0.209839,0.11,1,178835,178409,426
3652921,30.7159,6.09248,461,41446,0.193968,0.07,1,178872,178411,461
3655841,46.9432,31.6185,474,41497,0.222794,0.07,1,178923,178449,474
3658761,10.9886,46.3237,426,41548,0.228559,0.11,1,178925,178499,426
3661681,47.7977,54.0647,427,41599,0.277712,0.13,1,178982,178555,427
3664601,51.1595,51.6129,428,41650,0.255542,0.17,1,179034,178606,428
3667521,58.2319,56.7226,430,41701,0.235108,0.17,1,179094,178664,430
3670441,46.8464,46.5445,430,41752,0.263022,0.17,1,179138,178708,430
3673361,28.5693,28.5089,430,41803,0.236604,0.19,1,179162,178732,430
3676281,48.1139,47.3018,431,41853,0.279321,0.19,1,179215,178784,431
3679201,19.2228,19.0604,431,41903,0.319864,0.19,1,179227,178796,431
3682121,5.44455,5.41207,431,41953,0.327973,0.21,1,179229,178798,431
3685041,12.2889,11.4824,432,42003,0.297595,0.21,1,179243,178811,432
3687961,20.0578,19.8965,432,42053,0.323519,0.21,1,179265,178833,432
3690881,5.61156,5.5793,432,42103,0.328704,0.19,1,179267,178835,432
3693801,31.5223,30.7159,433,42153,0.313741,0.23,1,179305,178872,433
3696721,47.9045,46.9432,434,42203,0.342748,0.23,1,179357,178923,434
3699641,11.1809,10.9886,434,42253,0.34855,0.29,1,179359,178925,434
3702561,47.8362,47.7977,434,42303,0.33371,0.25,1,179416,178982,434
3705481,51.1672,51.1595,434,42353,0.378742,0.23,1,179468,179034,434
3708401,57.4334,58.2319,433,42403,0.435748,0.27,1,179527,179094,433
3711321,46.6867,46.8464,433,42453,0.49515,0.23,1,179571,179138,433
3714241,29.3373,28.5693,434,42503,0.49103,0.29,1,179596,179162,434
3717161,49.8675,48.1139,436,42553,0.522206,0.33,1,179651,179215,436
3720081,19.5735,19.2228,436,42603,0.528441,0.33,1,179663,179227,436
3723001,5.5147,5.44455,436,42653,0.529688,0.29,1,179665,179229,436
3725921,12.3029,12.2889,436,42702,0.497938,0.33,1,179679,179243,436
3728841,20.8606,20.0578,437,42751,0.507587,0.33,1,179702,179265,437
3731761,5.77212,5.61156,437,42800,0.509517,0.31,1,179704,179267,437
3734681,31.5544,31.5223,437,42849,0.541903,0.35,1,179742,179305,437
3737601,49.5109,47.9045,439,42898,0.516381,0.35,1,179796,179357,439
3740521,11.5022,11.1809,439,42947,0.511276,0.33,1,179798,179359,439
3743441,47.9004,47.8362,439,42996,0.574255,0.33,1,179855,179416,439
3746361,52.7801,9.56724,493,43045,0.586851,0.39,1,179909,179416,493
3749281,59.356,43.5134,502,43094,0.60537,0.45,1,179970,179468,502
3752201,47.8712,55.9027,488,43143,0.649074,0.51,1,180015,179527,488
3755121,28.7742,46.3805,468,43192,0.657815,0.49,1,180039,179571,468
3758041,51.3549,29.2761,500,43241,0.667563,0.53,1,180096,179596,500
3760961,19.871,49.8552,457,43290,0.669513,0.53,1,180108,179651,457
3763881,5.57419,19.571,447,43339,0.669903,0.53,1,180110,179663,447
3766801,12.3148,5.51421,459,43388,0.669981,0.49,1,180124,179665,459
3769721,20.063,12.3028,467,43437,0.669996,0.51,1,180146,179679,467
3772641,5.61259,20.8606,446,43486,0.669999,0.51,1,180148,179702,446
3775561,33.1225,5.77211,484,43535,0.67,0.55,1,180188,179704,484
3778481,49.8245,31.5544,500,43583,0.686,0.51,1,180242,179742,500
3781401,11.5649,49.5109,448,43631,0.6892,0.51,1,180244,179796,448
3784321,51.113,11.5022,507,43679,0.67384,0.59,1,180305,179798,507
3787241,53.4226,47.9004,504,43727,0.686768,0.59,1,180359,179855,504
3790161,61.0845,52.7801,513,43775,0.753354,0.61,2,180422,179909,513
3962441,93,50,560,46533,0.53,1,1,182325,181765,560
3965361,35.4,69.2,507,46578,0.37,1,1,182346,181839,507
3968281,27.08,29.04,513,46623,0.178,1,1,182371,181858,513
3971201,23.816,25.008,512,46668,0.0436,1,1,182394,181882,512
3974121,44.7632,22.6016,540,46713,0.01672,1,1,182444,181904,540
3977041,30.5526,56.5203,502,46758,0.043344,1,1,182471,181969,502
3979961,24.5105,29.7041,502,46803,0.0166688,1,1,182494,181992,502
3982881,18.5021,21.1408,500,46848,0.0273338,1,1,182511,182011,500
3985801,24.5004,20.2282,506,46893,0.00546675,1,1,182537,182031,506
3988721,19.3001,18.4456,506,46938,0.00109335,1,1,182555,182049,506
3991641,24.66,15.6891,517,46983,0.00821867,1,1,182581,182064,517
3994561,21.732,23.9378,512,47028,0.00964373,1,1,182602,182090,512
3997481,17.1464,24.7876,503,47073,0.0259287,1,1,182618,182115,503
4000401,41.0293,21.7575,529,47118,0.0291857,0.89,1,182665,182136,529
4003321,34.6059,47.5515,508,47163,0.0138372,0.89,1,182698,182190,508
4006241,62.9212,43.1103,536,47208,0.0107674,0.53,1,182768,182232,536
4009161,22.9842,83.0221,456,47253,0.0581535,0.33,1,182781,182325,456
4012081,18.1968,33.4044,452,47298,0.0196307,0.13,1,182798,182346,452
4015001,17.2394,26.6809,444,47343,0.0439261,0.01,1,182815,182371,444
4017921,43.4479,23.7362,471,47388,0.0647852,0.01,1,182865,182394,471
4020841,10.2896,44.7472,423,47432,0.068957,0.05,1,182867,182444,423
4023761,22.8579,30.5494,422,47476,0.0377914,0.01,1,182893,182471,422
4026681,24.5716,24.5099,424,47520,0.0315583,0.03,1,182918,182494,424
4029601,16.9143,18.502,422,47564,0.0783117,0,1,182933,182511,422
4032521,26.5829,24.5004,425,47608,0.0396623,0,1,182962,182537,425
4035441,17.3166,19.3001,422,47652,0.0319325,0.01,1,182977,182555,422
4038361,26.6633,24.66,425,47696,0.0303865,0.01,1,183006,182581,425
4041281,21.3327,21.732,424,47740,0.0460773,0.03,1,183026,182602,424
4044201,17.0665,17.1464,424,47784,0.0172155,0.03,1,183042,182618,424
4047121,39.4133,41.0293,422,47828,0.0434431,0.01,1,183087,182665,422
4050041,35.0827,34.6059,423,47872,0.0486886,0.01,1,183121,182698,423
4052961,64.6165,62.9212,425,47916,0.0977377,0.07,1,183193,182768,425
4055881,23.3233,22.9842,425,47960,0.0595475,0.01,1,183206,182781,425
4058801,16.6647,18.1968,423,48004,0.0359095,0.05,1,183221,182798,423
4061721,16.1329,17.2394,422,48048,0.0471819,0.07,1,183237,182815,422
4064641,43.2266,43.4479,422,48092,0.0174364,0.07,1,183287,182865,422
4067561,10.2453,10.2896,422,48136,0.0114873,0.03,1,183289,182867,422
4070481,25.2491,22.8579,425,48180,0.0262975,0.03,1,183318,182893,425
4073401,22.6498,24.5716,422,48224,0.0132595,0.09,1,183340,182918,422
4076321,18.13,16.9143,424,48268,0.0586519,0.03,1,183357,182933,424
4079241,25.226,26.5829,422,48312,0.0197304,0.03,1,183384,182962,422
4082161,17.0452,17.3166,422,48356,0.0279461,0.03,1,183399,182977,422
4085081,26.609,26.6633,422,48400,0.0295892,0.05,1,183428,183006,422
4088001,21.3218,21.3327,422,48444,0.0139178,0.01,1,183448,183026,422
4090921,17.0644,17.0665,422,48488,0.0107836,0.05,1,183464,183042,422
4093841,39.4129,39.4133,422,48531,0.0421567,0.05,1,183509,183087,422
4096761,35.0826,35.0827,422,48574,0.0644313,0.11,1,183543,183121,422
4099681,67.0165,64.6165,425,48617,0.0528863,0.05,1,183618,183193,425
4102601,21.4033,23.3233,422,48660,0.0185773,0.03,1,183628,183206,422
4105521,16.2807,16.6647,422,48703,0.0277155,0.05,1,183643,183221,422
4108441,16.0561,16.1329,422,48746,0.0135431,0.01,1,183659,183237,422
4111361,43.2112,43.2266,422,48789,0.0427086,0.01,1,183709,183287,422
4114281,10.2422,10.2453,422,48832,0.0485417,0.01,1,183711,183289,422
4117201,25.2484,2.04906,451,48875,0.0657083,0.03,1,183740,183289,451
4120121,21.8497,23.6098,443,48918,0.0211417,0.01,1,183761,183318,443
4123041,18.7699,22.322,439,48961,0.0282283,0.07,1,183779,183340,439
4125961,24.554,18.0644,448,49004,0.0296457,0.01,1,183805,183357,448
4128881,16.9108,25.2129,436,49047,0.00592913,0.03,1,183820,183384,436
4131801,26.5822,17.0426,450,49090,0.0571858,0.03,1,183849,183399,450
4134721,21.3164,26.6085,441,49133,0.0354372,0.01,1,183869,183428,441
4137641,17.0633,21.3217,437,49176,0.0310874,0.01,1,183885,183448,437
4140561,39.4127,17.0643,466,49219,0.0302175,0.05,1,183930,183464,466
4143481,35.8825,39.4129,456,49262,0.0140435,0.07,1,183965,183509,456
4146401,66.3765,35.0826,496,49305,0.0268087,0.05,1,184039,183543,496
4149321,21.2753,67.0165,431,49348,0.0453617,0.01,1,184049,183618,431
4152241,16.2551,21.4033,436,49391,0.0490723,0.03,1,184064,183628,436
4155161,16.051,16.2807,437,49434,0.0498145,0.01,1,184080,183643,437
4158081,43.2102,16.0561,471,49477,0.0339629,0.05,1,184130,183659,471
4161001,10.242,43.2112,423,49520,0.0307926,0.05,1,184132,183709,423
4163921,27.6484,10.2422,453,49563,0.0621585,0.07,1,184164,183711,453
4166841,19.9297,25.2484,442,49606,0.0844317,0.01,1,184182,183740,442
4169761,19.1859,21.8497,440,49648,0.0568863,0.03,1,184201,183761,440
4172681,23.8372,18.7699,447,49690,0.0113773,0.03,1,184226,183779,447
4175601,16.7674,24.554,436,49732,0.0262755,0,1,184241,183805,436
4178521,26.5535,16.9108,450,49774,0.0132551,0.07,1,184270,183820,450
4181441,22.1107,26.5822,442,49816,0.026651,0.03,1,184291,183849,442
4184361,16.4221,21.3164,437,49858,0.0453302,0.03,1,184306,183869,437
4187281,39.2844,17.0633,466,49900,0.017066,0.03,1,184351,183885,466
4190201,37.4569,39.4127,458,49942,0.00341321,0.01,1,184388,183930,458
4193121,66.6914,35.8825,497,49984,0.00868264,0.03,1,184462,183965,497
4196041,22.1383,66.3765,434,50026,0.0577365,0.05,1,184473,184039,434
4198961,15.6277,21.2753,438,50068,0.0675473,0.05,1,184487,184049,438
4201881,16.7255,16.2551,440,50110,0.0695095,0.05,1,184504,184064,440
4204801,40.9451,16.051,471,50152,0.0379019,0.03,1,184551,184080,471
4207721,9.78902,43.2102,423,50194,0.00758038,0.03,1,184553,184130,423
4210641,30.7578,10.242,457,50236,0.0255161,0.07,1,184589,184132,457
4213561,18.9516,27.6484,441,50278,0.0611032,0.09,1,184605,184164,441
4216481,5.39031,19.9297,425,50320,0.0682206,0.05,1,184607,184182,425
4219401,15.4781,19.1859,424,50362,0.101644,0,1,184625,184201,424
4222321,23.0956,23.8372,424,50404,0.0443288,0.03,1,184650,184226,424
4225241,15.0191,16.7674,422,50446,0.0328658,0.01,1,184663,184241,422
4228161,27.0038,26.5535,423,50488,0.0305732,0.03,1,184693,184270,423
4231081,22.2008,22.1107,423,50530,0.0141146,0.05,1,184714,184291,423
4234001,16.4402,16.4221,423,50572,0.0268229,0.01,1,184729,184306,423
4236921,39.288,39.2844,423,50614,0.0133646,0,1,184774,184351,423
4239841,37.4576,37.4569,423,50656,0.0106729,0.01,1,184811,184388,423
4242761,67.4915,66.6914,424,50698,0.0101346,0.07,1,184886,184462,424
4245681,23.0983,22.1383,425,50740,0.0100269,0.07,1,184898,184473,425
4248601,16.6197,15.6277,426,50782,0.0580054,0.07,1,184913,184487,426
4251521,16.1239,16.7255,425,50823,0.0996011,0.03,1,184929,184504,425
4254441,38.4248,40.9451,422,50864,0.0279202,0,1,184973,184551,422
4257361,9.28496,9.78902,422,50905,0.00558404,0.03,1,184975,184553,422
4260281,33.057,30.7578,425,50946,0.0411168,0.07,1,185014,184589,425
4263201,19.4114,18.9516,425,50987,0.0642234,0.07,1,185030,184605,425
4266121,5.48228,5.39031,425,51028,0.0688447,0.11,1,185032,184607,425
4269041,16.2965,15.4781,426,51069,0.0537689,0.03,1,185051,184625,426
4271961,20.0593,23.0956,422,51110,0.0507538,0.03,1,185072,184650,422
4274881,14.4119,15.0191,422,51151,0.0501508,0.03,1,185085,184663,422
4277801,26.8824,27.0038,422,51192,0.0340302,0.01,1,185115,184693,422
4280721,22.1765,22.2008,422,51233,0.014806,0.03,1,185136,184714,422
4283641,16.4353,16.4402,422,51274,0.0429612,0.01,1,185151,184729,422
4286561,39.2871,39.288,422,51315,0.0165922,0.01,1,185196,184774,422
4289481,37.4574,37.4576,422,51356,0.0433184,0.01,1,185233,184811,422
4292401,67.4915,67.4915,422,51397,0.0166637,0.01,1,185308,184886,422
4295321,24.6983,23.0983,424,51438,0.0433327,0.07,1,185322,184898,424
4298241,17.7397,16.6197,425,51479,0.0166665,0.11,1,185338,184913,425
4301161,16.3479,16.1239,425,51520,0.0593333,0.01,1,185354,184929,425
4304081,36.0696,38.4248,422,51561,0.0198667,0,1,185395,184973,422
4307001,8.81392,9.28496,422,51602,0.0279733,0.05,1,185397,184975,422
4309921,33.7628,33.057,423,51643,0.0455947,0.07,1,185437,185014,423
4312841,19.5526,19.4114,423,51684,0.0491189,0.07,1,185453,185030,423
4315761,5.51051,5.48228,423,51725,0.0658238,0.05,1,185455,185032,423
4318681,15.5021,16.2965,422,51766,0.0371648,0.05,1,185473,185051,422
4321601,19.9004,3.25929,443,51807,0.063433,0.05,1,185494,185051,443
4324521,13.5801,17.4519,434,51848,0.0206866,0.05,1,185506,185072,434
4327441,26.716,13.8904,451,51889,0.00413732,0.03,1,185536,185085,451
4330361,22.9432,26.7781,443,51930,0.0248275,0.01,1,185558,185115,443
4333281,15.7886,22.1556,436,51971,0.0449655,0.05,1,185572,185136,436
4336201,39.1577,16.4311,466,52012,0.0969931,0.01,1,185617,185151,466
4339121,37.4315,39.2862,458,52052,0.0593986,0.05,1,185654,185196,458
4342041,67.4863,37.4572,496,52092,0.0838797,0.01,1,185729,185233,496
4344961,24.6973,67.4914,435,52132,0.0887759,0.05,1,185743,185308,435
4347881,18.5395,24.6983,438,52172,0.0897552,0.01,1,185760,185322,438
4350801,16.5079,17.7397,438,52212,0.089951,0.07,1,185776,185338,438
4353721,35.3016,16.3479,462,52252,0.0579902,0.01,1,185816,185354,462
4356641,8.66032,36.0696,423,52292,0.051598,0.03,1,185818,185395,423
4359561,33.7321,8.81392,461,52332,0.0663196,0.05,1,185858,185397,461
4362481,20.3464,33.7628,438,52372,0.0852639,0.05,1,185875,185437,438
4365401,5.66928,19.5526,424,52412,0.0890528,0.07,1,185877,185453,424
4368321,16.3339,5.51051,441,52452,0.0738106,0.03,1,185896,185455,441
4371241,18.4668,15.5021,442,52492,0.0867621,0.07,1,185915,185473,442
4374161,13.2934,19.9004,433,52532,0.121352,0.01,1,185927,185494,433
4377081,26.6587,13.5801,451,52572,0.0322705,0,1,185957,185506,451
4380001,24.5317,26.716,445,52612,0.0144541,0.03,1,185981,185536,445
4382921,16.1063,22.9432,437,52652,0.0268908,0.05,1,185995,185558,437
4385841,40.0213,15.7886,469,52692,0.109378,0.11,1,186041,185572,469
4388761,36.8043,39.1577,460,52732,0.125876,0.05,1,186077,185617,460
4391681,68.9609,37.4315,500,52772,0.0811751,0.09,1,186154,185654,500
4394601,25.7922,67.4863,440,52812,0.056235,0.09,1,186169,185729,440
4397521,17.9584,24.6973,442,52852,0.051247,0.09,1,186185,185743,442
4400441,16.3917,18.5395,441,52892,0.0502494,0.09,1,186201,185760,441
4403361,32.0783,16.5079,461,52932,0.0500499,0.05,1,186237,185776,461
4406281,8.01567,35.3016,423,52972,0.05001,0.05,1,186239,185816,423
4409201,36.0031,8.66032,464,53012,0.034002,0.07,1,186282,185818,464
4412121,21.6006,33.7321,442,53052,0.0308004,0.09,1,186300,185858,442
4415041,5.92013,20.3464,427,53092,0.0301601,0.09,1,186302,185875,427
4417961,17.184,5.66928,445,53132,0.046032,0.07,1,186322,185877,445
4420881,19.4368,16.3339,446,53172,0.0652064,0.09,1,186342,185896,446
4423801,11.8874,18.4668,437,53212,0.0690413,0.13,1,186352,185915,437
4426721,3.97747,13.2934,427,53252,0.0698083,0.01,1,186354,185927,427
4429641,21.5955,26.6587,423,53292,0.133962,0.01,1,186380,185957,423
4432561,23.5191,24.5317,423,53331,0.114792,0.03,1,186404,185981,423
4435481,15.9038,16.1063,423,53370,0.0789585,0.13,1,186418,185995,423
4438401,43.9808,40.0213,428,53409,0.0557917,0.13,1,186469,186041,428
4441321,37.5962,36.8043,428,53448,0.0511583,0.07,1,186505,186077,428
4444241,66.7192,68.9609,425,53487,0.0502317,0.05,1,186579,186154,425
4447161,24.5438,25.7922,424,53526,0.0980463,0.05,1,186593,186169,424
4450081,17.7088,17.9584,424,53565,0.107609,0.05,1,186609,186185,424
4453001,16.3418,16.3917,424,53604,0.109522,0.05,1,186625,186201,424
4455921,30.4684,32.0783,422,53643,0.0939044,0.05,1,186659,186237,422
4458841,7.69367,8.01567,422,53682,0.122781,0.03,1,186661,186239,422
4461761,36.7387,36.0031,423,53721,0.0645562,0.03,1,186705,186282,423
4464681,21.7477,21.6006,423,53760,0.0209112,0.03,1,186723,186300,423
4467601,5.94955,5.92013,423,53799,0.0121822,0.05,1,186725,186302,423
4470521,17.9899,17.184,424,53838,0.0264364,0.07,1,186746,186322,424
4473441,20.398,19.4368,425,53877,0.0612873,0.07,1,186767,186342,425
4476361,13.6796,11.8874,427,53916,0.0522575,0.07,1,186779,186352,427
4479281,4.33592,3.97747,427,53955,0.0504515,0.15,1,186781,186354,427
4482201,21.6672,21.5955,427,53994,0.0660903,0.11,1,186807,186380,427
4485121,21.9334,23.5191,425,54033,0.0852181,0.07,1,186829,186404,425
4488041,15.5867,15.9038,425,54072,0.0570436,0.05,1,186843,186418,425
4490961,41.5173,43.9808,422,54111,0.115409,0.05,1,186891,186469,422
4493881,37.1035,37.5962,422,54150,0.175082,0.05,1,186927,186505,422
4496801,69.0207,66.7192,425,54189,0.203016,0.11,1,187004,186579,425
4499721,25.0041,24.5438,425,54228,0.240603,0.11,1,187018,186593,425
4502641,17.8008,17.7088,425,54267,0.248121,0.11,1,187034,186609,425
4505561,17.1602,16.3418,426,54306,0.233624,0.09,1,187051,186625,426
4508481,30.632,30.4684,426,54345,0.262725,0.13,1,187085,186659,426
4511401,7.72641,7.69367,426,54384,0.236545,0.05,1,187087,186661,426
4514321,33.5453,36.7387,422,54423,0.231309,0.01,1,187127,186705,422
4517241,21.1091,21.7477,422,54462,0.230262,0.01,1,187145,186723,422
4520161,5.82181,5.94955,422,54501,0.230052,0.03,1,187147,186725,422
4523081,19.5644,17.9899,424,54540,0.21401,0.07,1,187170,186746,424
4526001,20.7129,20.398,424,54579,0.210802,0.05,1,187191,186767,424
4528921,12.1426,13.6796,422,54618,0.17816,0.05,1,187201,186779,422
4531841,4.02851,4.33592,422,54657,0.203632,0.07,1,187203,186781,422
4534761,22.4057,21.6672,423,54695,0.176726,0.07,1,187230,186807,423
4537681,22.0811,4.33344,445,54733,0.171345,0.09,1,187252,186807,445
4540601,15.6162,18.4667,437,54771,0.170269,0.05,1,187266,186829,437
4543521,44.7232,14.8933,475,54809,0.186054,0.13,1,187318,186843,475
4546441,38.5446,41.3787,464,54847,0.253211,0.19,1,187355,186891,464
4549361,71.7089,37.0757,508,54885,0.298642,0.21,1,187435,186927,508
4552281,25.5418,69.0151,445,54923,0.307728,0.25,1,187449,187004,445
4555201,17.9084,25.003,447,54961,0.309546,0.25,1,187465,187018,447
4558121,17.9817,17.8006,449,54999,0.309909,0.23,1,187483,187034,449
4561041,30.7963,17.1601,466,55037,0.341982,0.27,1,187517,187051,466
4563961,7.75927,30.632,434,55075,0.348396,0.23,1,187519,187085,434
4566881,31.9519,7.7264,470,55113,0.349679,0.23,1,187557,187087,470
4569801,20.7904,33.5453,448,55151,0.349936,0.23,1,187575,187127,448
4572721,5.75807,21.1091,432,55189,0.349987,0.23,1,187577,187145,432
4575641,18.7516,5.82181,452,55227,0.349997,0.21,1,187599,187147,452
4578561,20.5503,19.5644,450,55265,0.365999,0.21,1,187620,187170,450
4581481,12.9101,20.7129,440,55303,0.3852,0.17,1,187631,187191,440
4584401,4.18201,12.1426,432,55341,0.38904,0.21,1,187633,187201,432
4587321,21.6364,4.02851,456,55379,0.373808,0.17,1,187659,187203,456
4590241,21.9273,22.4057,451,55417,0.370762,0.17,1,187681,187230,451
4593161,16.3855,22.0811,444,55455,0.402152,0.17,1,187696,187252,444
4596081,46.4771,15.6162,484,55493,0.44043,0.19,1,187750,187266,484
4599001,40.4954,44.7232,471,55531,0.480086,0.27,1,187789,187318,471
4601921,73.6991,38.5446,516,55569,0.520017,0.31,1,187871,187355,516
4604841,25.9398,71.7089,450,55607,0.528003,0.31,1,187885,187435,450
4607761,17.988,25.5418,452,55645,0.529601,0.31,1,187901,187449,452
4610681,17.9976,17.9084,454,55683,0.52992,0.31,1,187919,187465,454
4613601,32.3995,17.9817,472,55721,0.497984,0.35,1,187955,187483,472
4616521,8.0799,30.7963,440,55759,0.491597,0.35,1,187957,187517,440
4619441,32.016,7.75927,476,55797,0.490319,0.35,1,187995,187519,476
4622361,20.8032,31.9519,456,55835,0.490064,0.35,1,188013,187557,456
4625281,5.76064,20.7904,440,55873,0.490013,0.35,1,188015,187575,440
4628201,18.7521,5.75807,460,55911,0.490003,0.35,1,188037,187577,460
4631121,21.3504,18.7516,460,55949,0.49,0.37,1,188059,187599,460
4634041,12.2701,20.5503,449,55987,0.506,0.39,1,188069,187620,449
4636961,4.05402,12.9101,440,56025,0.5092,0.39,1,188071,187631,440
4639881,22.4108,4.18201,465,56063,0.52584,0.37,1,188098,187633,465
4642801,22.0822,21.6364,461,56101,0.529168,0.37,1,188120,187659,461
4645721,18.0164,21.9273,456,56138,0.545834,0.41,1,188137,187681,456
4648641,5.20329,16.3855,443,56175,0.549167,0.45,1,188139,187696,443
4651561,45.0407,46.4771,444,56212,0.565833,0.49,1,188194,187750,444
4654481,43.4081,40.4954,448,56249,0.601167,0.53,1,188237,187789,448
4657401,74.2816,73.6991,448,56286,0.560233,0.53,1,188319,187871,448
4660321,26.0563,25.9398,448,56323,0.584047,0.53,1,188333,187885,448
4663241,18.0113,17.988,448,56360,0.588809,0.53,1,188349,187901,448
4666161,18.0023,17.9976,448,56397,0.589762,0.49,1,188367,187919,448
4669081,30.8005,32.3995,446,56434,0.557952,0.49,1,188401,187955,446
4672001,7.76009,8.0799,446,56471,0.59959,0.49,1,188403,187957,446
4674921,31.952,32.016,446,56508,0.639918,0.49,1,188441,187995,446
4677841,20.7904,20.8032,446,56545,0.615984,0.49,1,188459,188013,446
4680761,5.75808,5.76064,446,56582,0.611197,0.49,1,188461,188015,446
4683681,18.7516,18.7521,446,56619,0.610239,0.49,1,188483,188037,446
4686601,22.1503,21.3504,447,56656,0.626048,0.51,1,188506,188059,447
4689521,12.4301,12.2701,447,56693,0.61321,0.51,1,188516,188069,447
4692441,4.08601,4.05402,447,56730,0.610642,0.53,1,188518,188071,447
4695361,23.2172,22.4108,448,56767,0.642128,0.53,1,188546,188098,448
4698281,22.2434,22.0822,448,56804,0.664426,0.55,1,188568,188120,448
4701201,18.8487,18.0164,449,56841,0.636885,0.55,1,188586,188137,449
4704121,5.36974,5.20329,449,56878,0.631377,0.57,1,188588,188139,449
4707041,45.8739,45.0407,450,56915,0.678275,0.61,1,188644,188194,450
4709961,41.9748,43.4081,448,56952,0.687655,0.55,1,188685,188237,448
4712881,74.795,74.2816,449,56989,0.737531,0.59,1,188768,188319,449
4715801,26.159,26.0563,449,57026,0.779506,0.59,2,188782,188333,449
4718721,18.0318,18.0113,449,57063,0.803901,0.59,2,188798,188349,449
4721641,18.0064,18.0023,449,57100,0.80878,0.55,2,188816,188367,449
4724561,31.6013,30.8005,450,57137,0.793756,0.61,2,188851,188401,450
4727481,7.92025,7.76009,450,57174,0.790751,0.65,2,188853,188403,450
4730401,33.5841,31.952,452,57211,0.85415,0.61,2,188893,188441,452
4733321,21.1168,20.7904,452,57248,0.86683,0.61,2,188911,188459,452
4736241,5.82336,5.75808,452,57285,0.869366,0.61,2,188913,188461,452
4739161,18.7647,18.7516,452,57322,0.837873,0.63,2,188935,188483,452
4742081,22.1529,22.1503,452,57359,0.847575,0.61,2,188958,188506,452
4745001,12.4306,12.4301,452,57396,0.817515,0.61,2,188968,188516,452
4747921,4.08612,4.08601,452,57433,0.843503,0.65,2,188970,188518,452
4750841,23.2172,23.2172,452,57470,0.816701,0.67,2,188998,188546,452
4753761,23.0434,22.2434,453,57507,0.79534,0.63,2,189021,188568,453
4756681,19.0087,18.8487,453,57544,0.823068,0.63,2,189039,188586,453
4759601,5.40174,5.36974,453,57581,0.828614,0.69,2,189041,188588,453
4762521,46.6803,45.8739,454,57618,0.829723,0.69,2,189098,188644,454
4765441,42.1361,9.17479,495,57654,0.781945,0.69,2,189139,188644,495
4768361,78.0272,34.635,541,57690,0.884389,0.75,2,189226,188685,541
4771281,26.8054,73.327,472,57726,0.904878,0.79,2,189240,188768,472
4774201,18.9611,25.8654,475,57762,0.924976,0.81,2,189257,188782,475
4777121,18.1922,17.9731,477,57798,0.928995,0.81,2,189275,188798,477
4780041,32.4384,17.9946,495,57834,0.929799,0.79,2,189311,188816,495
4782961,8.08769,31.5989,462,57870,0.92996,0.79,2,189313,188851,462
5038461,93,109,421,27740,0.03,0.03,1,191833,191412,421
5066201,161,162.6,423,27740,0.078,0.03,1,192011,191588,423
5069121,80.2,61.32,447,28544,0.0716,0.05,1,192071,191624,447
5072041,42.44,48.264,435,28618,0.10232,0.07,1,192104,191669,435
5074961,39.688,27.2528,452,28692,0.124464,0.11,1,192143,191691,452
5077881,28.7376,44.6506,429,28766,0.128893,0.15,1,192169,191740,429
5080801,31.3475,21.7301,445,28840,0.0977786,0.13,1,192201,191756,445
5083721,39.0695,27.546,457,28913,0.107556,0.03,1,192242,191785,457
5086641,30.2139,43.9092,437,28986,0.0615111,0.05,1,192270,191833,437
5089561,14.0428,28.7818,422,29059,0.0523022,0.09,1,192280,191858,422
5092481,67.6086,27.3564,476,29132,0.25846,0.09,1,192361,191885,476
5095401,122.322,106.271,486,29205,0.363692,0.07,1,192497,192011,486
5098321,49.2643,69.2543,457,29277,0.368738,0.11,1,192528,192071,457
5101241,43.4529,40.2508,466,29349,0.449748,0.13,1,192570,192104,466
5104161,29.4906,39.2502,453,29421,0.46595,0.13,1,192596,192143,453
5107081,31.4981,28.65,459,29493,0.48519,0.09,1,192628,192169,459
5110001,35.0996,31.33,463,29565,0.489038,0.11,1,192664,192201,463
5112921,30.2199,39.066,451,29637,0.409808,0.05,1,192693,192242,451
5115841,14.844,30.2132,434,29708,0.441962,0.05,1,192704,192270,434
5118761,78.1688,14.0426,518,29779,0.784392,0.31,2,192798,192280,518
5121681,17.2338,67.6085,439,29850,0.868878,0.39,2,192800,192361,439
5124601,112.247,122.322,439,29921,0.917776,0.37,2,192936,192497,439
5229721,30,49,496,32369,0.83,1,2,194569,194073,496
5232641,40.4,33,510,32434,0.734,1,1,194612,194102,510
5235561,70.48,26.6,563,32499,0.4748,1,1,194690,194127,563
5238481,50.896,79.72,516,32564,0.27896,1,1,194736,194220,516
5241401,56.5792,45.544,537,32629,0.175792,1,1,194794,194257,537
5244321,74.5158,67.5088,543,32694,0.0591584,1,1,194873,194330,543
5247241,35.7032,61.5018,509,32759,0.0358317,1,1,194899,194390,509
5250161,30.3406,43.5004,499,32824,0.0311663,1,1,194928,194429,499
5253081,22.8681,34.3001,488,32888,0.0622333,0.79,1,194949,194461,488
5256001,28.5736,46.06,469,32952,0.0684467,0.85,1,194979,194510,469
5258921,25.7147,32.412,465,33016,0.0216893,0.83,1,195004,194539,465
5261841,25.9429,30.4824,461,33080,0.0443379,0.71,1,195030,194569,461
5264761,36.3886,40.4965,457,33144,0.0808676,0.41,1,195069,194612,457
5267681,56.0777,70.4993,440,33208,0.0241735,0.23,1,195130,194690,440
5270601,39.2155,50.8999,429,33272,0.0288347,0.15,1,195165,194736,429
5273521,48.6431,56.58,422,33336,0.541767,0.03,1,195216,194794,422
5276441,73.7286,74.516,423,33399,0.324353,0.03,1,195296,194873,423
5279361,37.9457,35.7032,426,33462,0.200871,0.03,1,195325,194899,426
5282281,29.9891,30.3406,425,33525,0.144174,0.07,1,195353,194928,425
5285201,21.9978,22.8681,424,33588,0.148835,0.07,1,195373,194949,424
5288121,27.5996,28.5736,423,33651,0.149767,0.01,1,195402,194979,423
5291041,24.7199,25.7147,422,33714,0.117953,0.05,1,195426,195004,422
5293961,27.344,25.9429,424,33777,0.111591,0.09,1,195454,195030,424
5296881,35.8688,36.3886,423,33840,0.158318,0.01,1,195492,195069,423
5299801,55.1738,56.0777,422,33902,0.151664,0.03,1,195552,195130,422
5302721,39.0348,39.2155,422,33964,0.166333,0.67,1,195587,195165,422
5305641,71.8069,48.6431,451,34026,0.0412665,0.27,1,195667,195216,451
5308561,63.9614,73.7286,433,34088,0.0642533,0.17,1,195729,195296,433
5311481,31.9923,37.9457,428,34150,0.0688507,0.13,1,195753,195325,428
5314401,27.1985,29.9891,426,34212,0.0377701,0.13,1,195779,195353,426
5317321,21.4397,5.99783,446,34274,0.031554,0.15,1,195799,195353,446
5320241,27.4879,17.1996,455,34336,0.0623108,0.15,1,195828,195373,455
5323161,24.6976,26.6399,450,34398,0.0844622,0.11,1,195852,195402,450
5326081,27.3395,24.528,454,34459,0.120892,0.11,1,195880,195426,454
5329001,38.2679,27.3056,467,34520,0.128178,0.17,1,195921,195454,467
5331921,51.6536,35.8611,484,34581,0.161636,0.15,1,195976,195492,484
5334841,40.7307,55.1722,462,34642,0.152327,0.17,1,196014,195552,462
5337761,67.3461,39.0344,501,34703,0.150465,0.01,1,196088,195587,501
5340681,63.8692,71.8069,484,34764,0.134093,0.07,1,196151,195667,484
5343601,31.9738,63.9614,446,34825,0.130819,0.07,1,196175,195729,446
5346521,27.1948,31.9923,448,34886,0.130164,0.03,1,196201,195753,448
5349441,22.239,27.1985,443,34947,0.114033,0.03,1,196222,195779,443
5352361,28.4478,21.4397,453,35007,0.110807,0.07,1,196252,195799,453
5355281,27.2896,27.4879,451,35067,0.158161,0.09,1,196279,195828,451
5358201,28.6579,24.6976,456,35127,0.183632,0.13,1,196308,195852,456
5361121,38.5316,27.3395,469,35187,0.172726,0.13,1,196349,195880,469
5364041,50.9063,38.2679,482,35247,0.154545,0.17,1,196403,195921,482
5366961,41.3813,51.6536,466,35307,0.182909,0.15,1,196442,195976,466
5369881,67.4763,40.7307,502,35367,0.236582,0.15,1,196516,196014,502
5372801,63.0953,67.3461,490,35427,0.247316,0.13,1,196578,196088,490
5375721,31.8191,63.8692,451,35487,0.265463,0.13,1,196602,196151,451
5378641,27.1638,31.9738,453,35547,0.285093,0.13,1,196628,196175,453
5381561,21.4328,27.1948,447,35606,0.289019,0.11,1,196648,196201,447
5384481,29.0866,22.239,457,35665,0.273804,0.11,1,196679,196222,457
5387401,7.41731,28.4478,429,35724,0.270761,0.17,1,196681,196252,429
5390321,23.8835,27.2896,430,35783,0.302152,0.19,1,196709,196279,430
5393241,27.1767,28.6579,429,35842,0.32443,0.17,1,196737,196308,429
5396161,37.4353,38.5316,428,35901,0.360886,0.15,1,196777,196349,428
5399081,51.4871,50.9063,429,35960,0.368177,0.19,1,196832,196403,429
5402001,43.8974,41.3813,432,36019,0.401635,0.25,1,196874,196442,432
5404921,69.5795,67.4763,434,36078,0.424327,0.25,1,196950,196516,434
5407841,64.3159,63.0953,435,36137,0.460865,0.27,1,197013,196578,435
5410761,32.8632,31.8191,436,36195,0.484173,0.29,1,197038,196602,436
5413681,27.3726,27.1638,436,36253,0.520835,0.29,1,197064,196628,436
5416601,21.4745,21.4328,436,36311,0.528167,0.27,1,197084,196648,436
5419521,28.2949,29.0866,435,36369,0.497633,0.27,1,197114,196679,435
5422441,7.25898,7.41731,435,36427,0.491527,0.31,1,197116,196681,435
5425361,23.8518,23.8835,435,36485,0.522305,0.33,1,197144,196709,435
5428281,28.7704,27.1767,437,36543,0.528461,0.37,1,197174,196737,437
5431201,38.5541,37.4353,438,36601,0.513692,0.37,1,197215,196777,438
5434121,52.5108,51.4871,439,36659,0.542738,0.41,1,197271,196832,439
5437041,44.9022,43.8974,440,36717,0.532548,0.43,1,197314,196874,440
5439961,72.1804,69.5795,443,36775,0.56251,0.47,1,197393,196950,443
5442881,66.4361,64.3159,445,36832,0.648502,0.49,1,197458,197013,445
5445801,34.0872,32.8632,446,36889,0.6817,0.53,1,197484,197038,446
5448721,27.6174,27.3726,446,36946,0.65634,0.53,1,197510,197064,446
5451641,21.5235,21.4745,446,37003,0.699268,0.49,1,197530,197084,446
5454561,28.3047,28.2949,446,37060,0.707854,0.49,1,197560,197114,446
5457481,7.26094,7.25898,446,37117,0.709571,0.53,1,197562,197116,446
5460401,23.8522,23.8518,446,37174,0.693914,0.53,1,197590,197144,446
5463321,27.9704,4.77036,475,37231,0.706783,0.53,1,197619,197144,475
5466241,39.1941,24.9541,487,37288,0.709357,0.51,1,197661,197174,487
5469161,54.2388,37.7908,504,37345,0.741871,0.55,1,197719,197215,504
5472081,45.2478,52.3582,491,37402,0.780374,0.53,2,197762,197271,491
5475001,73.8496,44.8716,529,37458,0.788075,0.57,2,197843,197314,529
5477921,69.1699,72.1743,518,37514,0.853615,0.67,2,197911,197393,518
5480841,34.634,66.4349,479,37570,0.834723,0.69,2,197937,197458,479
5483761,28.5268,34.087,480,37626,0.814945,0.65,2,197964,197484,480
5486681,21.7054,27.6174,474,37682,0.810989,0.71,2,197984,197510,474
5489601,28.3411,21.5235,484,37738,0.810198,0.71,2,198014,197530,484
5492521,7.26821,28.3047,456,37794,0.81004,0.71,2,198016,197560,456
5495441,24.6536,7.26094,483,37850,0.794008,0.69,2,198045,197562,483
5498361,28.9307,23.8522,485,37906,0.790802,0.71,2,198075,197590,485
5501281,40.9861,27.9704,500,37962,0.82216,0.71,2,198119,197619,500
5504201,55.3972,39.1941,517,38018,0.844432,0.75,2,198178,197661,517
5507121,47.8794,54.2388,505,38074,0.816886,0.79,2,198224,197719,505
5510041,72.7759,45.2478,541,38129,0.843377,0.79,2,198303,197762,541
5512961,70.5552,73.8496,530,38184,0.880675,0.87,2,198373,197843,530
5515881,34.911,69.1699,488,38239,0.888135,0.83,2,198399,197911,488
5518801,27.7822,34.634,488,38294,0.921627,0.81,2,198425,197937,488
5702761,78,91,491,41625,0.27,1,1,200670,200179,491
5705681,78.8,86.2,485,41676,0.054,1,1,200749,200264,485
5708601,41.36,37.24,492,41727,0.0828,1,1,200781,200289,492
5711521,34.672,27.448,500,41778,0.07256,1,1,200814,200314,500
5714441,29.3344,29.4896,498,41829,0.054512,1,1,200842,200344,498
5717361,19.4669,28.2979,487,41879,0.0189024,1,1,200859,200372,487
5720281,24.6934,24.0596,490,41929,0.0117805,1,1,200885,200395,490
5723201,24.9387,20.0119,496,41979,0.0263561,1,1,200910,200414,496
5726121,16.9877,28.0024,481,42029,0.0452712,1,1,200925,200444,481
5729041,37.7975,28.8005,495,42079,0.0810542,1,1,200968,200473,495
5731961,25.1595,29.7601,487,42129,0.0722108,1,1,200990,200503,487
5734881,24.2319,36.352,473,42179,0.0864422,0.74,1,201014,200541,473
5737801,17.6464,24.8704,467,42229,0.105288,0.75,1,201030,200563,467
5740721,17.9293,28.1741,456,42279,0.109058,0.27,1,201048,200592,456
5743641,45.9859,68.0348,431,42329,0.125812,0,1,201101,200670,431
5746561,66.7972,76.807,424,42379,0.0251623,0.09,1,201173,200749,424
5749481,37.3594,40.9614,422,42429,0.0450325,0.07,1,201203,200781,422
5752401,33.8719,34.5923,422,42479,0.0170065,0.05,1,201236,200814,422
5755321,29.9744,29.3185,423,42529,0.0274013,0.01,1,201265,200842,423
5758241,20.3949,19.4637,424,42579,0.0454803,0.01,1,201283,200859,424
5761161,23.279,24.6927,422,42629,0.0330961,0.03,1,201307,200885,422
5764081,24.6558,24.9385,422,42679,0.0786192,0.05,1,201332,200910,422
5767001,16.9312,16.9877,422,42728,0.0397238,0.09,1,201347,200925,422
5769921,44.1862,37.7975,430,42777,0.111945,0.07,1,201398,200968,430
5772841,24.0372,25.1595,427,42826,0.110389,0.09,1,201417,200990,427
5775761,23.2074,24.2319,426,42875,0.190078,0.11,1,201440,201014,426
5778681,16.6415,17.6464,425,42924,0.254016,0.11,1,201455,201030,425
5781601,17.7283,17.9293,425,42973,0.266803,0.13,1,201473,201048,425
5784521,48.3457,45.9859,428,43022,0.285361,0.13,1,201529,201101,428
5787441,61.6691,9.19717,493,43071,0.113072,0,1,201594,201101,493
5790361,37.9338,59.4394,453,43120,0.0466144,0.05,1,201626,201173,453
5793281,32.3868,35.8879,454,43169,0.0493229,0.01,1,201657,201203,454
5796201,29.6774,33.5776,450,43218,0.0178646,0.03,1,201686,201236,450
5799121,20.3355,29.9155,439,43267,0.0275729,0.05,1,201704,201265,439
5802041,23.2671,20.3831,445,43316,0.0135146,0.03,1,201728,201283,445
5804961,24.6534,23.2766,446,43365,0.0427029,0.09,1,201753,201307,446
5807881,19.3307,24.6553,439,43414,0.00854058,0.03,1,201771,201332,439
5810801,47.0661,16.9311,478,43463,0.153708,0.13,1,201825,201347,478
5813721,25.4132,44.1862,447,43512,0.198742,0.11,1,201845,201398,447
5816641,27.4826,24.0372,456,43560,0.319748,0.21,1,201873,201417,456
5819561,16.6965,23.2074,447,43608,0.31195,0.27,1,201887,201440,447
5822481,20.1393,16.6415,453,43656,0.29439,0.27,1,201908,201455,453
5825401,48.8279,17.7283,491,43704,0.370878,0.29,1,201964,201473,491
5828321,51.3656,48.3457,487,43752,0.386176,0.07,1,202016,201529,487
5831241,35.8731,61.6691,454,43800,0.389235,0.03,1,202048,201594,454
5834161,31.1746,37.9338,452,43848,0.421847,0.05,1,202078,201626,452
5837081,29.4349,32.3868,450,43896,0.252369,0.01,1,202107,201657,450
5840001,21.087,29.6774,440,43944,0.202474,0.03,1,202126,201686,440
5842921,22.6174,20.3355,445,43992,0.144495,0.01,1,202149,201704,445
5845841,26.1235,23.2671,448,44040,0.052899,0.05,1,202176,201728,448
5848761,19.6247,24.6534,441,44088,0.0185798,0,1,202194,201753,441
5851681,52.7249,19.3307,484,44136,0.091716,0.19,1,202255,201771,484
5854601,29.745,47.0661,454,44184,0.186343,0.21,1,202279,201825,454
5857521,29.949,25.4132,464,44232,0.349269,0.35,1,202309,201845,464
5860441,17.1898,27.4826,450,44280,0.397854,0.31,1,202323,201873,450
5863361,21.838,16.6965,459,44328,0.423571,0.29,1,202346,201887,459
5866281,50.7676,20.1393,496,44376,0.444714,0.39,1,202404,201908,496
5869201,51.7535,48.8279,492,44424,0.464943,0.39,1,202456,201964,492
5872121,11.9507,51.3656,442,44471,0.468989,0.39,1,202458,202016,442
5875041,27.1901,35.8731,441,44518,0.517798,0.43,1,202489,202048,441
5877961,29.438,31.1746,441,44565,0.54356,0.21,1,202519,202078,441
5880881,21.8876,29.4349,432,44612,0.596712,0.19,1,202539,202107,432
5883801,18.7775,21.087,431,44659,0.575342,0.13,1,202557,202126,431
5886721,18.1555,22.6174,426,44706,0.571069,0.03,1,202575,202149,426
5889641,22.8311,26.1235,423,44753,0.570214,0.01,1,202599,202176,423
5892561,18.9662,19.6247,423,44800,0.538043,0.11,1,202617,202194,423
5895481,57.3932,52.7249,429,44847,0.627609,0.21,1,202684,202255,429
5898401,36.2786,29.745,436,44894,0.709522,0.39,1,202715,202279,436
5901321,36.0557,29.949,442,44941,0.917904,0.41,2,202751,202309,442
6075061,70,82,468,22093,0,0,1,204692,204224,468
6077981,69.2,82.8,454,22189,0.6,0.01,1,204761,204307,454
6080901,83.44,81.36,460,22285,0.448,0.05,1,204848,204388,460
6083821,47.088,66.672,435,22380,0.3536,0.03,1,204886,204451,435
6086741,36.6176,35.7344,441,22475,0.25472,0.01,1,204920,204479,441
6089661,21.7235,23.1469,439,22569,0.234944,0,1,204938,204499,439
6092581,89.1447,31.0294,512,22663,0.0549888,0.01,1,205044,204532,512
6095501,73.8289,78.2059,492,22757,0.0109978,0,1,205114,204622,492
6098421,95.5658,71.6412,523,22850,0.1062,0.75,1,205215,204692,523
6101341,76.7132,69.5282,526,22943,0.15724,0.41,1,205287,204761,526
6104261,44.9426,83.5056,476,23035,0.215448,0.33,1,205324,204848,476
6107181,31.3885,47.1011,466,23127,0.22709,0.23,1,205352,204886,466
6110101,20.6777,36.6202,450,23219,0.229418,0.23,1,205370,204920,450
6113021,80.1355,21.724,527,23310,0.133884,0.01,1,205465,204938,527
6115941,73.6271,89.1448,493,23401,0.0347767,0,1,205537,205044,493
6118861,98.7254,73.829,528,23492,0.0469553,0.13,1,205642,205114,528
6121781,79.7451,95.5658,502,23582,0.129391,0.17,1,205717,205215,502
6124701,47.149,76.7132,469,23672,0.129878,0.23,1,205756,205287,469
6127621,31.8298,44.9426,460,23762,0.145976,0.23,1,205784,205324,460
6130541,20.766,31.3885,450,23851,0.165195,0.23,1,205802,205352,450
6133461,76.1532,20.6777,522,23940,0.201039,0.11,1,205892,205370,522
6136381,16.8306,80.1355,429,24029,0.208208,0.01,1,205894,205465,429
6139301,56.1661,73.6271,423,24117,0.161642,0.05,1,205960,205537,423
6142221,96.8332,98.7254,425,24205,0.232328,0.15,1,206067,205642,425
6145141,82.5666,79.7451,429,24293,0.198466,0.13,1,206146,205717,429
6148061,46.9133,47.149,428,24380,0.223693,0.15,1,206184,205756,428
6150981,33.3827,31.8298,430,24467,0.292739,0.17,1,206214,205784,430
6153901,21.0765,20.766,430,24554,0.306548,0.21,1,206232,205802,430
6156821,76.2153,76.1532,430,24640,0.29331,0.21,1,206322,205892,430
6159741,16.8431,16.8306,430,24726,0.322662,0.15,1,206324,205894,430
6162661,55.3686,56.1661,429,24812,0.312532,0.25,1,206389,205960,429
6165581,99.0737,96.8332,432,24897,0.358506,0.19,1,206499,206067,432
6168501,83.0147,82.5666,432,24982,0.367701,0.23,1,206578,206146,432
6171421,47.8029,46.9133,433,25067,0.41754,0.31,1,206617,206184,433
6174341,35.1606,33.3827,435,25152,0.427508,0.31,1,206649,206214,435
6177261,21.4321,21.0765,435,25236,0.445502,0.29,1,206667,206232,435
6180181,77.0864,76.2153,436,25320,0.4171,0.33,1,206758,206322,436
6183101,17.0173,16.8431,436,25404,0.41142,0.31,1,206760,206324,436
6186021,54.6035,55.3686,435,25487,0.442284,0.31,1,206824,206389,435
6188941,100.521,11.0737,547,25570,0.448457,0.37,1,206936,206389,547
6191861,84.9041,90.2147,518,25653,0.481691,0.37,1,207017,206499,518
6194781,48.9808,81.2429,479,25736,0.536338,0.43,1,207057,206578,479
6197701,36.1962,47.4486,473,25818,0.595268,0.43,1,207090,206617,473
6200621,21.6392,35.0897,459,25900,0.575054,0.45,1,207108,206649,459
6203541,77.1278,21.4179,532,25982,0.619011,0.41,1,207199,206667,532
6206461,17.0256,77.0836,443,26064,0.627802,0.41,1,207201,206758,443
6209381,54.6051,17.0167,505,26145,0.62956,0.45,1,207265,206760,505
6212301,102.121,54.6033,555,26226,0.645912,0.45,1,207379,206824,555
6215221,87.6242,100.521,527,26307,0.681182,0.49,1,207463,206936,527
6218141,51.1248,84.9041,488,26388,0.704236,0.55,1,207505,207017,488
6221061,37.425,48.9808,482,26468,0.740847,0.61,1,207539,207057,482
6223981,21.885,36.1962,467,26548,0.748169,0.57,1,207557,207090,467
6226901,79.577,21.6392,543,26628,0.797634,0.63,2,207651,207108,543
6229821,17.5154,77.1278,454,26708,0.807527,0.63,2,207653,207199,454
6232741,54.7031,17.0256,516,26787,0.841505,0.63,2,207717,207201,516
6235661,102.941,54.6051,567,26866,0.848301,0.65,2,207832,207265,567
6238581,22.1881,102.121,455,26945,0.84966,0.69,2,207834,207379,455
6241501,72.4376,87.6242,456,27024,0.913932,0.71,2,207919,207463,456
6375821,70,64,493,30419,0.43,1,1,210293,209800,493
6378741,42.8,41.6,493,30489,0.366,1,1,210329,209836,493
6381661,30.96,28.32,496,30558,0.3372,1,1,210357,209861,496
6384581,22.192,29.664,486,30627,0.31544,1,1,210377,209891,486
6387501,28.4384,31.5328,484,30696,0.295088,0.96,1,210407,209923,484
6390421,77.6877,83.1066,478,30765,0.387018,0.88,1,210497,210019,478
6393341,42.7375,41.4213,481,30834,0.405404,0.99,1,210531,210050,481
6396261,22.9475,30.6843,471,30903,0.393081,0.63,1,210549,210078,471
6399181,75.7895,90.9369,454,30971,0.374616,0.47,1,210638,210184,454
6402101,41.5579,49.3874,448,31039,0.418923,0.43,1,210671,210223,448
6405021,57.9116,65.8775,440,31107,0.395785,0.35,1,210733,210293,440
6407941,37.1823,41.9755,436,31175,0.391157,0.33,1,210765,210329,436
6410861,27.4365,30.7951,433,31243,0.406231,0.31,1,210790,210357,433
6413781,20.6873,22.159,432,31311,0.393246,0.31,1,210809,210377,432
6416701,28.9375,4.4318,463,31379,0.374649,0.29,1,210840,210377,463
6419621,80.9875,24.8864,527,31446,0.43493,0.41,1,210934,210407,527
6422541,47.3975,76.9773,476,31513,0.478986,0.41,1,210973,210497,476
6425461,22.2795,42.5955,458,31580,0.503797,0.39,1,210989,210531,458
6428381,75.6559,22.9191,529,31647,0.588759,0.37,1,211078,210549,529
6431301,41.5312,75.7838,473,31714,0.621752,0.43,1,211111,210638,473
6434221,57.9062,41.5568,502,31781,0.67635,0.39,1,211173,210671,502
6437141,37.1812,57.9114,472,31848,0.68727,0.39,1,211205,210733,472
6440061,26.6362,37.1823,464,31914,0.689454,0.41,1,211229,210765,464
6442981,21.3272,27.4365,459,31980,0.705891,0.39,1,211249,210790,459
6445901,28.2654,20.6873,470,32046,0.709178,0.37,1,211279,210809,470
6448821,84.0531,28.9375,537,32112,0.869836,0.45,2,211377,210840,537
6451741,50.4106,80.9875,485,32178,0.917967,0.49,2,211419,210934,485
6553941,90,28,573,34404,0.31,1,1,212981,212408,573
6556861,46.8,76,521,34465,0.262,1,1,213017,212496,521
6559781,55.76,43.2,544,34526,0.1244,1,1,213075,212531,544
6562701,32.752,59.04,508,34587,0.09688,1,1,213102,212594,508
6565621,34.5504,35.008,514,34648,0.107376,1,1,213137,212623,514
6568541,28.5101,30.2016,512,34709,0.0294752,1,1,213164,212652,512
6571461,28.102,24.4403,517,34770,0.00589504,1,1,213192,212675,517
6574381,48.8204,28.0881,542,34831,0.041179,1,1,213246,212704,542
6577301,26.5641,64.8176,489,34892,0.0322358,1,1,213267,212778,489
6580221,49.3128,25.7635,528,34953,0.0144472,0.82,1,213322,212794,528
6583141,29.0626,59.5527,484,35013,0.0108894,0.75,1,213346,212862,484
6586061,65.0125,35.1105,529,35073,0.0101779,0.31,1,213420,212891,529
6588981,36.2025,79.0221,468,35133,0.0100356,0.25,1,213449,212981,468
6591901,48.0405,44.6044,483,35193,0.0260071,0.09,1,213500,213017,483
6594821,29.6081,55.3209,450,35253,0.0292014,0.09,1,213525,213075,450
6597741,33.1216,32.6642,457,35313,0.0618403,0.11,1,213559,213102,457
6600661,28.2243,34.5328,449,35373,0.0363681,0.01,1,213586,213137,449
6603581,29.6449,28.5066,452,35433,0.0312736,0,1,213616,213164,452
6606501,49.929,28.1013,479,35493,0.0782547,0.05,1,213671,213192,479
6609421,23.5858,48.8203,442,35553,0.0556509,0.03,1,213688,213246,442
6612341,49.5172,26.5641,477,35612,0.0671302,0.01,1,213744,213267,477
6615261,28.3034,49.3128,445,35671,0.053426,0.01,1,213767,213322,445
6618181,7.26069,29.0626,423,35730,0.0186852,0.01,1,213769,213346,423
6621101,59.8521,65.0125,422,35789,0.043737,0.01,1,213842,213420,422
6624021,35.9704,36.2025,423,35848,0.0647474,0.03,1,213872,213449,423
6626941,47.9941,48.0405,423,35907,0.0129495,0.03,1,213923,213500,423
6629861,28.7988,29.6081,422,35966,0.0425899,0.07,1,213947,213525,422
6632781,35.3598,33.1216,425,36025,0.016518,0.03,1,213984,213559,425
6635701,27.072,28.2243,423,36084,0.0753036,0.03,1,214009,213586,423
6638621,28.6144,29.6449,422,36143,0.0390607,0.09,1,214038,213616,422
6641541,51.3229,49.929,424,36201,0.0318121,0.05,1,214095,213671,424
6644461,23.8646,23.5858,424,36259,0.0463624,0.07,1,214112,213688,424
6647381,50.3729,49.5172,425,36317,0.0332725,0.05,1,214169,213744,425
6650301,26.0746,28.3034,422,36375,0.0306545,0.01,1,214189,213767,422
6653221,6.81492,7.26069,422,36433,0.0301309,0.05,1,214191,213769,422
6656141,62.163,59.8521,425,36491,0.0300262,0.07,1,214267,213842,425
6659061,35.6326,35.9704,424,36549,0.0460052,0,1,214296,213872,424
6661981,46.3265,47.9941,422,36607,0.081201,0.05,1,214345,213923,422
6664901,28.4653,28.7988,422,36665,0.0242402,0.01,1,214369,213947,422
6667821,35.2931,35.3598,422,36723,0.012848,0.09,1,214406,213984,422
6670741,27.8586,27.072,423,36781,0.0425696,0.03,1,214432,214009,423
6673661,27.9717,28.6144,422,36838,0.0485139,0.03,1,214460,214038,422
6676581,51.9943,51.3229,423,36895,0.0817028,0.05,1,214518,214095,423
6679501,24.7989,23.8646,424,36952,0.0883406,0.03,1,214536,214112,424
6682421,49.7598,50.3729,423,37009,0.0256681,0.03,1,214592,214169,423
6685341,25.152,26.0746,422,37066,0.0291336,0.03,1,214611,214189,422
6688261,6.63039,6.81492,422,37123,0.0298267,0.03,1,214613,214191,422
6691181,62.1261,62.163,422,37180,0.0459653,0.03,1,214689,214267,422
6694101,34.8252,12.4326,450,37237,0.0331931,0.05,1,214717,214267,450
6697021,46.165,25.6865,470,37294,0.0466386,0.09,1,214766,214296,470
6699941,28.433,44.3373,445,37351,0.0333277,0.01,1,214790,214345,445
6702861,36.0866,28.0675,459,37408,0.0626655,0.01,1,214828,214369,459
6705781,27.2173,35.2135,447,37464,0.0525331,0.05,1,214853,214406,447
6708701,27.8435,27.8427,449,37520,0.0185066,0.05,1,214881,214432,449
6711621,53.5687,27.9685,481,37576,0.0757013,0.09,1,214941,214460,481
6714541,25.1137,51.9937,441,37632,0.10314,0.09,1,214959,214518,441
6717461,48.2227,24.7987,477,37688,0.124628,0.01,1,215013,214536,477
6720381,24.8445,49.7597,440,37744,0.112926,0.03,1,215032,214592,440
6723301,6.56891,25.1519,423,37800,0.142585,0.03,1,215034,214611,423
6726221,62.1138,6.63039,497,37856,0.084517,0.05,1,215110,214613,497
6729141,35.6228,62.1261,450,37912,0.0569034,0.03,1,215139,214689,450
6732061,45.5246,34.8252,470,37968,0.0833807,0.05,1,215187,214717,470
6734981,29.9049,46.165,447,38024,0.120676,0.03,1,215213,214766,447
6737901,37.181,28.433,462,38080,0.144135,0.07,1,215252,214790,462
6740821,26.6362,36.0866,448,38135,0.164827,0.05,1,215276,214828,448
6743741,26.1272,27.2173,449,38190,0.168965,0.01,1,215302,214853,449
6746661,57.2254,27.8435,486,38245,0.121793,0.09,1,215367,214881,486
6749581,25.8451,53.5687,444,38300,0.112359,0.11,1,215385,214941,444
6752501,49.169,25.1137,481,38355,0.0944717,0.13,1,215440,214959,481
6755421,24.2338,48.2227,445,38410,0.0908943,0.11,1,215458,215013,445
6758341,6.44676,24.8445,428,38465,0.0901789,0.15,1,215460,215032,428
6761261,60.4894,6.56891,500,38520,0.154036,0.07,1,215534,215034,500
6764181,34.4979,62.1138,452,38575,0.166807,0.05,1,215562,215110,452
6767101,8.49957,35.6228,425,38630,0.169361,0.09,1,215564,215139,425
6770021,41.6999,45.5246,427,38685,0.185872,0.13,1,215614,215187,427
6772941,29.94,29.9049,428,38740,0.173174,0.15,1,215641,215213,428
6775861,38.788,37.181,430,38795,0.202635,0.17,1,215682,215252,430
6778781,26.9576,26.6362,430,38849,0.224527,0.17,1,215706,215276,430
6781701,22.9915,26.1272,426,38903,0.196905,0.11,1,215728,215302,426
6784621,57.3983,57.2254,427,38957,0.239381,0.11,1,215794,215367,427
6787541,25.8797,25.8451,427,39011,0.263876,0.09,1,215812,215385,427
6790461,48.3759,49.169,426,39065,0.316775,0.09,1,215866,215440,426
6793381,24.0752,24.2338,426,39119,0.359355,0.09,1,215884,215458,426
6796301,6.41504,6.44676,426,39173,0.335871,0.17,1,215886,215460,426
6799221,63.683,60.4894,430,39227,0.283174,0.17,1,215964,215534,430
6802141,35.9366,34.4979,431,39281,0.288635,0.17,1,215993,215562,431
6805061,8.78732,8.49957,431,39335,0.289727,0.19,1,215995,215564,431
6807981,40.1575,41.6999,429,39389,0.337945,0.17,1,216043,215614,429
6810901,30.4315,29.94,430,39443,0.331589,0.21,1,216071,215641,430
6813821,39.6863,38.788,431,39497,0.346318,0.23,1,216113,215682,431
6816741,27.1373,26.9576,431,39550,0.333264,0.19,1,216137,215706,431
6819661,23.0275,22.9915,431,39603,0.362653,0.25,1,216159,215728,431
6822581,60.6055,57.3983,435,39656,0.352531,0.27,1,216229,215794,435
6825501,27.3211,25.8797,436,39709,0.350506,0.33,1,216248,215812,436
6828421,50.2642,48.3759,438,39762,0.334101,0.37,1,216304,215866,438
6831341,24.4528,24.0752,438,39815,0.36282,0.33,1,216322,215884,438
6834261,6.49057,6.41504,438,39868,0.368564,0.27,1,216324,215886,438
6837181,61.2981,63.683,435,39921,0.401713,0.29,1,216399,215964,435
6840101,36.2596,35.9366,436,39974,0.392343,0.29,1,216429,215993,436
6843021,8.85192,8.78732,436,40027,0.390469,0.35,1,216431,215995,436
6845941,40.9704,40.1575,437,40080,0.406094,0.35,1,216480,216043,437
6848861,30.5941,8.03149,465,40133,0.441219,0.33,1,216508,216043,465
6851781,38.9188,24.0063,478,40186,0.448244,0.35,1,216549,216071,478
6854701,27.7838,38.4013,461,40239,0.465649,0.33,1,216574,216113,461
6857621,23.1568,26.8803,459,40291,0.48513,0.37,1,216596,216137,459
6860541,60.6314,22.9761,507,40343,0.505026,0.35,1,216666,216159,507
6863461,26.5263,60.5952,455,40395,0.509005,0.35,1,216684,216229,455
6866381,50.9053,27.319,493,40447,0.541801,0.33,1,216741,216248,493
6869301,24.5811,50.2638,455,40499,0.54836,0.37,1,216759,216304,455
6872221,6.51621,24.4528,439,40551,0.549672,0.37,1,216761,216322,439
6875141,63.7032,6.49055,515,40603,0.613934,0.41,1,216839,216324,515
6878061,36.7406,61.2981,470,40655,0.626787,0.39,1,216869,216399,470
6880981,8.94813,36.2596,442,40707,0.629357,0.39,1,216871,216429,442
6883901,42.5896,8.85192,491,40759,0.613871,0.41,1,216922,216431,491
6886821,31.7179,40.9704,471,40811,0.658774,0.45,1,216951,216480,471
6889741,39.1436,30.5941,484,40863,0.667755,0.45,1,216992,216508,484
6892661,29.4287,38.9188,470,40915,0.701551,0.47,1,217019,216549,470
6895581,23.4857,27.7838,467,40967,0.70831,0.49,1,217041,216574,467
6898501,61.4971,23.1568,516,41019,0.757662,0.51,2,217112,216596,516
6901421,27.4994,60.6314,465,41070,0.751532,0.51,2,217131,216666,465
6904341,51.8999,26.5263,505,41121,0.846306,0.55,2,217189,216684,505
6907261,24.78,50.9053,466,41172,0.865261,0.55,2,217207,216741,466
6910181,6.556,24.5811,450,41223,0.869052,0.55,2,217209,216759,450
6913101,66.9112,6.51621,530,41274,0.85381,0.63,2,217291,216761,530
6916021,37.3822,63.7032,482,41325,0.850762,0.63,2,217321,216839,482
6918941,9.07645,36.7406,454,41376,0.850152,0.63,2,217323,216869,454
6921861,43.4153,8.94813,504,41427,0.88203,0.61,2,217375,216871,504
6924781,32.6831,42.5896,483,41478,0.904406,0.67,2,217405,216922,483
6927701,39.3366,31.7179,495,41529,0.908881,0.67,2,217446,216951,495
6930621,9.46732,39.1436,456,41580,0.909776,0.71,2,217448,216992,456
6933541,24.2935,29.4287,457,41631,0.941955,0.71,2,217476,217019,457
6936461,23.2587,23.4857,458,41682,0.932391,0.77,2,217499,217041,458
7126261,37,33,489,44852,0.57,1,1,219729,219240,489
7129181,28.2,24.2,493,44899,0.522,1,1,219755,219262,493
7132101,24.84,29.64,486,44946,0.4964,1,1,219779,219293,486
7135021,30.568,32.328,485,44993,0.41128,1,1,219811,219326,485
7137941,31.7136,30.4656,487,45040,0.314256,1,1,219843,219356,487
7140861,28.7427,31.6931,483,45087,0.166851,1,1,219871,219388,483
7143781,24.1485,24.7386,483,45134,0.10537,1,1,219894,219411,483
7146701,29.6297,27.3477,486,45181,0.077074,1,1,219925,219439,486
7149621,32.3259,30.2695,488,45228,0.0394148,1,1,219958,219470,488
7152541,28.8652,29.2539,487,45275,0.031883,0.96,1,219986,219499,487
7155461,44.973,54.6508,475,45322,0.0303766,1,1,220035,219560,475
7158381,34.5946,30.9302,482,45369,0.0300753,1,1,220067,219585,482
7161301,23.7189,32.586,470,45415,0.0620151,0.71,1,220088,219618,470
7164221,33.5438,44.9172,458,45461,0.020403,0.69,1,220124,219666,458
7167141,27.5088,29.7834,458,45507,0.0600806,0.57,1,220150,219692,458
7170061,31.9018,35.5567,454,45553,0.0680161,0.51,1,220183,219729,454
7172981,22.3803,27.9113,448,45599,0.0216032,0.49,1,220203,219755,448
7175901,19.6761,24.7823,443,45645,0.0443206,0.39,1,220222,219779,443
7178821,26.3352,30.5565,439,45691,0.0648641,0.29,1,220250,219811,439
7181741,26.867,31.7113,434,45737,0.0529728,0.13,1,220277,219843,434
7184661,24.5734,28.7423,430,45783,0.0825946,0.09,1,220301,219871,430
7187581,22.5147,24.1485,429,45829,0.0885189,0.07,1,220323,219894,429
7190501,23.7029,29.6297,422,45875,0.0577038,0.03,1,220347,219925,422
7193421,31.9406,32.3259,423,45921,0.0995408,0.03,1,220381,219958,423
7196341,27.1881,6.46519,449,45967,0.0439082,0.03,1,220407,219958,449
7199261,44.6376,23.693,470,46013,0.160782,0.03,1,220456,219986,470
7202181,36.1275,43.9386,455,46059,0.184156,0.03,1,220490,220035,455
7205101,23.2255,34.3877,443,46105,0.124831,0.07,1,220510,220067,443
7208021,32.6451,23.6775,457,46151,0.128966,0.01,1,220545,220088,457
7210941,27.329,33.5355,447,46197,0.113793,0.07,1,220571,220124,447
7213861,31.8658,27.5071,454,46243,0.174759,0.07,1,220604,220150,454
7216781,23.9732,31.9014,443,46289,0.186952,0.01,1,220626,220183,443
7219701,18.3946,22.3803,440,46335,0.14139,0.05,1,220643,220203,440
7222621,30.0789,19.6761,454,46381,0.164278,0.07,1,220676,220222,454
7225541,23.6158,26.3352,448,46426,0.184856,0.05,1,220698,220250,448
7228461,27.1232,26.867,449,46471,0.188971,0.09,1,220726,220277,449
7231381,23.0246,24.5734,447,46516,0.189794,0.09,1,220748,220301,447
7234301,22.2049,22.5147,447,46561,0.205959,0.05,1,220770,220323,447
7237221,32.441,23.7029,458,46606,0.241192,0.11,1,220805,220347,458
7240141,24.8882,31.9406,447,46651,0.232238,0.03,1,220828,220381,447
7243061,52.9776,27.1881,481,46696,0.230448,0.19,1,220888,220407,481
7245981,34.5955,44.6376,462,46741,0.24609,0.19,1,220918,220456,462
7248901,22.9191,36.1275,448,46786,0.265218,0.11,1,220938,220490,448
7251821,30.1838,23.2255,460,46831,0.269044,0.13,1,220970,220510,460
7254741,29.2368,32.6451,454,46876,0.285809,0.11,1,220999,220545,454
7257661,32.2474,27.329,461,46921,0.321162,0.19,1,221032,220571,461
7260581,24.0495,31.8658,450,46966,0.360232,0.19,1,221054,220604,450
7263501,18.4099,23.9732,445,47011,0.384046,0.13,1,221071,220626,445
7266421,31.682,18.3946,463,47056,0.452809,0.17,1,221106,220643,463
7269341,23.9364,30.0789,452,47101,0.482562,0.19,1,221128,220676,452
7272261,27.1873,23.6158,458,47146,0.488512,0.19,1,221156,220698,458
7275181,23.0375,27.1232,452,47191,0.489702,0.19,1,221178,220726,452
7278101,23.8075,23.0246,454,47236,0.45794,0.21,1,221202,220748,454
7281021,33.5615,22.2049,468,47281,0.451588,0.25,1,221238,220770,468
7283941,24.3123,32.441,455,47326,0.466318,0.23,1,221260,220805,455
7286861,52.8625,24.8882,492,47371,0.613263,0.23,1,221320,220828,492
7289781,12.1725,52.9776,434,47415,0.642653,0.25,1,221322,220888,434
7292701,27.2345,34.5955,435,47459,0.664531,0.27,1,221353,220918,435
7295621,21.4469,22.9191,435,47503,0.636906,0.27,1,221373,220938,435
7298541,29.8894,30.1838,435,47547,0.631381,0.29,1,221405,220970,435
7301461,29.9779,29.2368,436,47591,0.662276,0.33,1,221435,220999,436
7304381,33.9956,32.2474,438,47635,0.652455,0.37,1,221470,221032,438
7307301,25.9991,24.0495,440,47679,0.650491,0.39,1,221494,221054,440
7310221,21.9998,18.4099,444,47723,0.650098,0.47,1,221515,221071,444
7313141,33.2,31.682,445,47767,0.68202,0.49,1,221551,221106,445
7316061,25.04,23.9364,446,47811,0.672404,0.49,1,221574,221128,446
7318981,27.408,27.1873,446,47855,0.670481,0.49,1,221602,221156,446
7321901,23.0816,23.0375,446,47899,0.702096,0.45,1,221624,221178,446
7324821,22.2163,23.8075,444,47943,0.724419,0.45,1,221646,221202,444
7327741,34.0433,33.5615,445,47987,0.712884,0.47,1,221683,221238,445
7330661,24.4087,24.3123,445,48031,0.726577,0.65,1,221705,221260,445
7333581,60.0817,52.8625,454,48075,0.841315,0.65,2,221774,221320,454
7336501,13.6163,12.1725,454,48119,0.864263,0.67,2,221776,221322,454
7339421,26.7233,27.2345,453,48163,0.852853,0.63,2,221806,221353,453
7342341,21.3447,21.4469,453,48207,0.898571,0.63,2,221826,221373,453
7345261,29.8689,29.8894,453,48251,0.907714,0.67,2,221858,221405,453
7348181,31.5738,29.9779,455,48295,0.925543,0.65,2,221890,221435,455
7351101,33.5148,33.9956,454,48339,0.945109,0.65,2,221924,221470,454
7354021,24.303,25.9991,452,48383,0.917022,0.65,2,221946,221494,452
7488341,33,33,523,50345,0.67,1,1,223347,222824,523
7491261,31.4,23.4,533,50387,0.606,1,1,223378,222845,533
7492721,35.08,22.28,547,50429,0.5452,1,1,223414,222867,547
7505861,387.016,467.656,443,23360,0.14904,0.07,1,223889,223446,443
7513161,151.003,184.731,421,23360,0.053808,0.03,1,223981,223560,421
7549661,86.2006,92.9462,421,23360,0.0347616,0.11,1,224051,223630,421
7552581,66.8401,41.7892,454,23451,0.0629523,0.03,1,224113,223659,454
7555501,76.568,69.9579,456,23541,0.0685905,0.01,1,224192,223736,456
7558421,59.3136,67.5916,444,23631,0.0137181,0,1,224247,223803,444
7561341,36.6627,31.9183,452,23721,0.0907436,0.05,1,224278,223826,452
7564261,21.7325,31.9837,438,23810,0.138149,0.05,1,224296,223858,438
7567181,47.5465,31.1967,461,23899,0.0676297,0.03,1,224350,223889,461
7570101,51.1093,59.8393,446,23988,0.0535259,0.05,1,224402,223956,446
7573021,68.6219,64.7679,453,24076,0.0347052,0.07,1,224475,224022,453
7575941,61.7244,85.7536,422,24164,0.062941,0.07,1,224535,224113,422
7578861,76.3449,80.3507,423,24252,0.0685882,0,1,224615,224192,423
7581781,61.669,60.0701,426,24339,0.0537176,0.11,1,224673,224247,426
7584701,39.5338,36.814,429,24426,0.0507435,0.15,1,224707,224278,429
7587621,21.5068,21.7628,428,24513,0.0661487,0.05,1,224724,224296,428
7590541,43.5014,47.5526,423,24599,0.10123,0.05,1,224773,224350,423
7593461,50.3003,51.1105,423,24685,0.092246,0.03,1,224825,224402,423
7596381,70.8601,68.6221,426,24771,0.0584492,0.07,1,224901,224475,426
7599301,58.972,61.7244,422,24857,0.13169,0.07,1,224957,224535,422
7602221,78.1944,76.3449,425,24942,0.050338,0.05,1,225040,224615,425
7605141,61.2389,61.669,424,25027,0.0180676,0.05,1,225097,224673,424
7608061,39.4478,39.5338,424,25112,0.0116135,0.07,1,225131,224707,424
7610981,20.6896,21.5068,423,25196,0.0423227,0.11,1,225147,224724,423
7613901,44.9379,43.5014,425,25280,0.0484645,0.09,1,225198,224773,425
7616821,49.7876,50.3003,424,25364,0.0816929,0.05,1,225249,224825,424
7619741,70.7575,70.8601,424,25448,0.0243386,0.05,1,225325,224901,424
7622661,60.5515,14.172,482,25531,0.0448677,0.15,1,225383,224901,482
7625581,75.3103,47.6344,505,25614,0.0809736,0.03,1,225462,224957,505
7628501,59.8621,75.9269,478,25697,0.0401947,0.01,1,225518,225040,478
7631421,39.9724,60.7854,456,25779,0.0160389,0.01,1,225553,225097,456
7634341,21.5945,39.3571,439,25861,0.0112078,0.05,1,225570,225131,439
7637261,45.9189,20.6714,475,25943,0.0422416,0.05,1,225622,225147,475
7640181,50.7838,44.9343,476,26025,0.0484483,0.09,1,225674,225198,476
7643101,67.7568,49.7869,497,26106,0.0976897,0.01,1,225746,225249,497
7646021,61.5514,70.7574,481,26187,0.0755379,0.05,1,225806,225325,481
7648941,77.1103,60.5515,504,26268,0.0551076,0.09,1,225887,225383,504
7651861,57.8221,75.3103,478,26349,0.0350215,0.03,1,225940,225462,478
7654781,39.5644,59.8621,457,26429,0.0470043,0.01,1,225975,225518,457
7657701,21.5129,39.9724,439,26509,0.0494009,0.01,1,225992,225553,439
7660621,45.1026,21.5945,473,26589,0.0498802,0.05,1,226043,225570,473
7663541,52.2205,45.9189,475,26669,0.065976,0.05,1,226097,225622,475
7666461,70.4441,50.7838,498,26748,0.0851952,0.11,1,226172,225674,498
7669381,60.4888,67.7568,484,26827,0.089039,0.07,1,226230,225746,484
7672301,76.8978,61.5514,505,26906,0.153808,0.05,1,226311,225806,505
7675221,16.9796,77.1103,426,26985,0.198762,0.03,1,226313,225887,426
7678141,43.3959,57.8221,423,27063,0.303752,0.05,1,226363,225940,423
7681061,36.6792,39.5644,423,27141,0.32475,0.05,1,226398,225975,423
7683981,20.9358,21.5129,423,27219,0.31295,0.05,1,226415,225992,423
7686901,45.7872,45.1026,424,27297,0.31059,0.07,1,226467,226043,424
7689821,53.1574,52.2205,425,27375,0.342118,0.09,1,226522,226097,425
7692741,71.4315,70.4441,426,27452,0.380424,0.09,1,226598,226172,426
7695661,60.6863,60.4888,426,27529,0.372085,0.17,1,226656,226230,426
7698581,82.5373,76.8978,433,27606,0.450417,0.21,1,226744,226311,433
7701501,18.1075,16.9796,433,27683,0.466083,0.33,1,226746,226313,433
7704421,46.0215,43.3959,436,27760,0.453217,0.33,1,226799,226363,436
7707341,37.2043,36.6792,436,27836,0.482643,0.31,1,226834,226398,436
7710261,20.2409,20.9358,435,27912,0.488529,0.31,1,226850,226415,435
7713181,47.2482,45.7872,437,27988,0.489706,0.35,1,226904,226467,437
7716101,55.0496,53.1574,439,28064,0.505941,0.39,1,226961,226522,439
7719021,71.8099,71.4315,439,28139,0.541188,0.37,1,227037,226598,439
7721941,61.562,60.6863,440,28214,0.548238,0.47,1,227096,226656,440
7724861,86.7124,82.5373,445,28289,0.597647,0.47,1,227189,226744,445
7727781,18.9425,18.1075,445,28364,0.607529,0.47,1,227191,226746,445
7730701,44.5885,3.62149,496,28439,0.625506,0.45,1,227242,226746,496
7733621,38.5177,43.1243,480,28513,0.629101,0.49,1,227279,226799,480
7736541,20.5035,36.6249,461,28587,0.62982,0.49,1,227295,226834,461
7739461,47.3007,20.125,499,28661,0.661964,0.49,1,227349,226850,499
7742381,56.6601,47.225,504,28735,0.652393,0.51,1,227408,226904,504
7745301,72.932,55.045,524,28809,0.618479,0.55,1,227485,226961,524
7748221,61.7864,71.809,507,28882,0.627696,0.55,1,227544,227037,507
7751141,89.1573,61.5618,544,28955,0.613539,0.61,1,227640,227096,544
7754061,19.4315,86.7124,453,29028,0.610708,0.61,1,227642,227189,453
7756981,45.4863,18.9425,503,29101,0.658142,0.63,1,227694,227191,503
7759901,38.6973,44.5885,489,29174,0.651628,0.63,1,227731,227242,489
7762821,20.5395,38.5177,468,29247,0.666326,0.63,1,227747,227279,468
7765741,48.9079,20.5035,508,29319,0.717265,0.67,1,227803,227295,508
7768661,54.5816,47.3007,510,29391,0.743453,0.65,1,227859,227349,510
7771581,72.5163,56.6601,528,29463,0.796691,0.61,2,227936,227408,528
7774501,62.5033,72.932,511,29535,0.823338,0.63,2,227996,227485,511
7777421,89.3007,61.7864,548,29607,0.908668,0.61,2,228092,227544,548
7780341,19.4601,89.1573,454,29678,0.925734,0.61,2,228094,227640,454
7783261,47.092,19.4315,506,29749,0.897147,0.67,2,228148,227642,506
7786181,38.2184,45.4863,490,29820,0.907429,0.65,2,228184,227694,490
7789101,9.24368,38.6973,455,29891,0.909486,0.67,2,228186,227731,455
7900061,26,31,512,32473,0.71,1,1,230048,229536,512
7902981,27.6,32.6,507,32538,0.662,1,1,230076,229569,507
7905901,35.12,32.12,512,32603,0.6204,1,1,230113,229601,512
7908821,30.224,33.624,507,32668,0.53208,0.96,1,230142,229635,507
7911741,34.0448,32.3248,510,32733,0.450416,1,1,230177,229667,510
7914661,28.409,31.265,506,32798,0.418083,1,1,230204,229698,506
7917581,28.8818,35.053,499,32862,0.347617,1,1,230233,229734,499
7920501,54.5764,66.2106,486,32926,0.269523,1,1,230294,229808,486
7923421,62.9153,71.6421,478,32990,0.349905,0.87,1,230359,229881,478
7926341,73.3831,85.5284,465,33054,0.317981,0.72,1,230435,229970,465
7929261,48.2766,58.7057,455,33118,0.479596,0.71,1,230477,230022,455
7932181,30.4553,32.5411,455,33182,0.471919,0.65,1,230503,230048,455
7935101,28.4911,28.9082,455,33246,0.470384,0.61,1,230531,230076,455
7938021,30.4982,35.3816,449,33310,0.518077,0.51,1,230562,230113,449
7940941,26.0996,30.2763,445,33373,0.559615,0.43,1,230587,230142,445
7943861,30.0199,34.0553,441,33436,0.519923,0.41,1,230618,230177,441
7946781,29.204,28.4111,443,33499,0.639985,0.33,1,230647,230204,443
7949701,23.4408,28.8822,436,33562,0.631997,0.25,1,230669,230233,436
7952621,51.0882,54.5764,433,33625,0.694399,0.37,1,230727,230294,433
7955541,66.2176,62.9153,438,33688,0.75488,0.31,2,230797,230359,438
7958461,73.2435,73.3831,437,33751,0.798976,0.52,2,230872,230435,437
7961381,56.2487,48.2766,447,33814,0.871795,0.47,2,230924,230477,447
7964301,30.4497,30.4553,445,33877,0.886359,0.47,2,230948,230503,445
7967221,30.0899,28.4911,447,33939,0.905272,0.53,2,230978,230531,447
7970141,31.618,30.4982,448,34001,0.909054,0.57,2,231010,230562,448
7973061,26.3236,26.0996,448,34063,0.941811,0.51,2,231035,230587,448
7975981,32.4647,30.0199,451,34125,0.916362,0.67,2,231069,230618,451
7978901,31.2929,29.204,453,34187,0.927272,0.63,2,231100,230647,453
8101541,39,48,493,36696,0.63,1,1,232900,232407,493
8104461,30.2,38.4,485,36754,0.598,1,1,232928,232443,485
8107381,46.04,31.68,505,36811,0.3356,1,1,232978,232473,505
8110301,37.208,28.736,512,36868,0.12312,1,1,233013,232501,512
8113221,32.2416,32.1472,510,36925,0.032624,1,1,233044,232534,510
8116141,31.2483,36.0294,504,36982,0.0305248,1,1,233075,232571,504
8119061,40.6497,51.2059,492,37039,0.00610496,1,1,233118,232626,492
8121981,34.5299,38.2412,490,37096,0.00922099,1,1,233151,232661,490
8124901,26.106,27.6482,489,37153,0.0098442,1,1,233175,232686,489
8127821,60.4212,5.52965,558,37210,0.0579688,1,1,233244,232686,558
8130741,44.8842,66.7059,517,37267,0.0995938,0.93,1,233285,232768,517
8133661,32.1768,53.3412,496,37324,0.0199188,0.77,1,233314,232818,496
8136581,33.6354,45.0682,487,37381,0.0439838,0.63,1,233348,232861,487
8139501,25.9271,40.2136,472,37438,0.0487968,0.59,1,233372,232900,472
8142421,33.1854,30.4427,479,37494,0.0657593,0.27,1,233407,232928,479
8145341,31.4371,46.0885,460,37550,0.0371519,0.07,1,233438,232978,460
8148261,28.6874,37.2177,453,37606,0.0474304,0.01,1,233466,233013,453
8151181,29.7375,32.2435,452,37662,0.0174861,0.03,1,233496,233044,452
8154101,41.9475,31.2487,466,37718,0.00349721,0,1,233541,233075,466
8157021,36.3895,40.6497,458,37774,0.0246994,0.01,1,233576,233118,458
8159941,25.6779,34.5299,448,37830,0.12494,0.01,1,233599,233151,448
8162861,60.3356,26.106,493,37886,0.064988,0.07,1,233668,233175,493
8165781,43.2671,60.4212,463,37942,0.0209976,0.11,1,233707,233244,463
8168701,31.8534,44.8842,451,37998,0.00419952,0,1,233736,233285,451
8171621,34.3707,32.1768,457,38054,0.0088399,0.05,1,233771,233314,457
8174541,27.6741,33.6354,449,38110,0.025768,0.05,1,233797,233348,449
8177461,34.3348,25.9271,461,38165,0.0291536,0.07,1,233833,233372,461
8180381,30.867,33.1854,456,38220,0.0938307,0.03,1,233863,233407,456
8183301,27.7734,31.4371,452,38275,0.0747661,0.05,1,233890,233438,452
8186221,27.9547,28.6874,452,38330,0.0229532,0.01,1,233918,233466,452
8189141,40.7909,29.7375,466,38385,0.0125906,0,1,233962,233496,466
8192061,37.7582,41.9475,458,38440,0.00251813,0.03,1,233999,233541,458
8194981,31.5516,36.3895,453,38495,0.0245036,0.15,1,234029,233576,453
8197901,59.1103,25.6779,496,38550,0.0289007,0.05,1,234095,233599,496
8200821,39.8221,60.3356,462,38605,0.0297801,0.01,1,234130,233668,462
8203741,9.56441,43.2671,425,38660,0.029956,0,1,234132,233707,425
8206661,23.5129,31.8534,423,38715,0.0299912,0.01,1,234159,233736,423
8209581,33.5026,34.3707,424,38770,0.0139982,0.03,1,234195,233771,424
8212501,25.9005,27.6741,422,38824,0.0747996,0.03,1,234219,233797,422
8215421,37.1801,34.3348,426,38878,0.10296,0.11,1,234259,233833,426
8218341,31.436,30.867,426,38932,0.108592,0.07,1,234289,233863,426
8221261,26.2872,27.7734,424,38986,0.141718,0.01,1,234314,233890,424
8224181,26.8574,27.9547,423,39040,0.148344,0.01,1,234341,233918,423
8227101,39.7715,40.7909,422,39094,0.0376687,0,1,234384,233962,422
8230021,37.5543,37.7582,422,39148,0.0315337,0.03,1,234421,233999,422
8232941,32.3109,31.5516,423,39202,0.0303067,0.03,1,234452,234029,423
8235861,60.8622,59.1103,425,39256,0.0140613,0.03,1,234520,234095,425
8238781,38.5724,39.8221,423,39310,0.0588123,0.03,1,234553,234130,423
8241701,9.31449,9.56441,423,39364,0.0357625,0.03,1,234555,234132,423
8244621,22.6629,23.5129,422,39418,0.0951525,0.01,1,234581,234159,422
8247541,34.1326,33.5026,423,39472,0.0750305,0.09,1,234618,234195,423
8250461,27.6265,25.9005,425,39526,0.0710061,0.11,1,234644,234219,425
8253381,37.5253,37.1801,425,39579,0.0542012,0.11,1,234684,234259,425
8256301,33.1051,31.436,427,39632,0.13084,0.15,1,234716,234289,427
8259221,26.621,26.2872,427,39685,0.098168,0.15,1,234741,234314,427
8262141,25.3242,26.8574,425,39738,0.0756336,0.01,1,234766,234341,425
8265061,37.0648,39.7715,422,39791,0.0711267,0.03,1,234806,234384,422
8267981,37.013,37.5543,422,39844,0.0382253,0.03,1,234843,234421,422
8270901,33.0026,32.3109,423,39897,0.0316451,0.01,1,234875,234452,423
8273821,60.2005,60.8622,422,39950,0.030329,0.07,1,234942,234520,422
8276741,40.0401,38.5724,424,40003,0.0620658,0.03,1,234977,234553,424
8279661,9.60802,9.31449,424,40056,0.0684132,0.11,1,234979,234555,424
8282581,21.9216,22.6629,423,40109,0.0696826,0.11,1,235004,234581,423
8285501,33.1843,4.53258,459,40162,0.0379365,0.07,1,235040,234581,459
8288421,27.4369,30.5065,448,40215,0.0635873,0.07,1,235066,234618,448
8291341,39.0874,26.9013,464,40268,0.0847175,0.05,1,235108,234644,464
8294261,35.0175,37.3803,458,40320,0.0409435,0.15,1,235142,234684,458
8297181,26.2035,33.0761,450,40372,0.0481887,0.09,1,235166,234716,450
8300101,24.4407,26.6152,449,40424,0.0656377,0.07,1,235190,234741,449
8303021,36.0881,25.323,463,40476,0.101128,0.07,1,235229,234766,463
8305941,35.2176,37.0646,458,40528,0.0202255,0.03,1,235264,234806,458
8308861,33.4435,37.0129,454,40580,0.0280451,0.03,1,235297,234843,454
8311781,60.2887,33.0026,489,40632,0.045609,0.03,1,235364,234875,489
8314701,40.0577,60.2005,457,40684,0.0331218,0.07,1,235399,234942,457
8317621,9.61155,40.0401,424,40736,0.0306244,0.07,1,235401,234977,424
8320541,21.9223,9.60802,447,40788,0.0141249,0.07,1,235426,234979,447
8323461,33.9845,21.9216,459,40840,0.074825,0.03,1,235463,235004,459
8326381,29.1969,33.1843,451,40892,0.118965,0.07,1,235491,235040,451
8329301,37.8394,27.4369,465,40944,0.111793,0.09,1,235531,235066,465
8332221,33.9679,39.0874,456,40996,0.0943586,0.03,1,235564,235108,456
8335141,26.7936,35.0175,447,41047,0.106872,0.05,1,235589,235142,447
8338061,25.3587,26.2035,448,41098,0.125374,0.07,1,235614,235166,448
8340981,36.2717,24.4407,463,41149,0.177075,0.11,1,235653,235190,463
8343901,32.8543,36.0881,456,41200,0.139415,0,1,235685,235229,456
8346821,33.7709,35.2176,455,41251,0.147883,0.03,1,235719,235264,455
8349741,61.1542,33.4435,490,41302,0.149577,0.05,1,235787,235297,490
8352661,39.4308,60.2887,457,41353,0.149915,0.03,1,235821,235364,457
8355581,9.48617,40.0577,424,41404,0.149983,0.03,1,235823,235399,424
8358501,21.8972,9.61155,447,41455,0.165997,0.01,1,235848,235401,447
8361421,36.3794,21.9223,462,41506,0.169199,0.09,1,235888,235426,462
8364341,8.87589,33.9845,427,41557,0.18584,0.13,1,235890,235463,427
8367261,23.3752,29.1969,426,41608,0.253168,0.11,1,235917,235491,426
8370181,37.475,37.8394,427,41659,0.218634,0.09,1,235958,235531,427
8373101,33.095,33.9679,426,41710,0.211727,0.11,1,235990,235564,426
8376021,27.419,26.7936,427,41761,0.242345,0.13,1,236016,235589,427
8378941,26.2838,25.3587,428,41812,0.280469,0.19,1,236042,235614,428
8381861,38.8568,36.2717,431,41862,0.304094,0.13,1,236084,235653,431
8384781,30.9714,32.8543,428,41912,0.388819,0.15,1,236113,235685,428
8387701,34.1943,33.7709,429,41962,0.389764,0.15,1,236148,235719,429
8390621,61.2389,61.1542,429,42012,0.389953,0.15,1,236216,235787,429
8393541,39.4478,39.4308,429,42062,0.421991,0.15,1,236250,235821,429
8396461,9.48955,9.48617,429,42112,0.396398,0.17,1,236252,235823,429
8399381,22.6979,21.8972,430,42162,0.39128,0.17,1,236278,235848,430
8402301,37.3396,36.3794,431,42212,0.422256,0.19,1,236319,235888,431
8405221,9.06792,8.87589,431,42262,0.428451,0.27,1,236321,235890,431
8408141,25.0136,23.3752,433,42312,0.46169,0.21,1,236350,235917,433
8411061,37.0027,37.475,432,42362,0.532338,0.21,1,236390,235958,432
8413981,33.8005,33.095,433,42412,0.562468,0.25,1,236423,235990,433
8416901,28.3601,27.419,434,42462,0.552494,0.29,1,236450,236016,434
8419821,27.272,26.2838,435,42512,0.582499,0.31,1,236477,236042,435
8422741,42.2544,38.8568,439,42562,0.6045,0.41,1,236523,236084,439
8425661,32.4509,30.9714,440,42612,0.6249,0.39,1,236553,236113,440
8428581,35.2902,34.1943,441,42662,0.64498,0.39,1,236589,236148,441
8431501,61.458,61.2389,441,42711,0.680996,0.43,1,236657,236216,441
8434421,39.4916,39.4478,441,42760,0.688199,0.39,1,236691,236250,441
8437341,9.49832,9.48955,441,42809,0.68964,0.39,1,236693,236252,441
8440261,22.6997,22.6979,441,42858,0.705928,0.43,1,236719,236278,441
8443181,38.1399,37.3396,442,42907,0.741186,0.43,1,236761,236319,442
8446101,9.22799,9.06792,442,42956,0.748237,0.47,1,236763,236321,442
8449021,28.2456,25.0136,446,43005,0.701647,0.47,1,236796,236350,446
8451941,39.2491,5.00272,488,43054,0.692329,0.55,1,236838,236350,488
8454861,35.0498,33.0005,482,43103,0.706466,0.57,1,236872,236390,482
8457781,28.61,33.0001,476,43152,0.709293,0.55,1,236899,236423,476
8460701,28.122,28.2,477,43201,0.725859,0.59,1,236927,236450,477
8463621,43.2244,27.24,497,43250,0.729172,0.61,1,236974,236477,497
8466541,33.4449,42.248,482,43299,0.729834,0.63,1,237005,236523,482
8469461,37.089,32.4496,490,43348,0.713967,0.65,1,237043,236553,490
8472381,62.6178,35.2899,523,43397,0.710793,0.69,1,237112,236589,523
8475301,40.5236,61.458,490,43446,0.710159,0.69,1,237147,236657,490
8478221,9.70471,39.4916,458,43495,0.742032,0.69,1,237149,236691,458
8481141,22.7409,9.49832,482,43544,0.748406,0.71,1,237175,236693,482
8484061,38.1482,22.6997,498,43592,0.749681,0.75,1,237217,236719,498
8486981,9.22964,38.1399,458,43640,0.749936,0.75,1,237219,236761,458
8489901,25.8459,9.22799,486,43688,0.765987,0.69,2,237249,236763,486
8492821,41.1692,28.2456,498,43736,0.833197,0.69,2,237294,236796,498
8495741,35.4338,39.2491,490,43784,0.81464,0.71,2,237328,236838,490
8498661,29.4868,35.0498,484,43832,0.874928,0.71,2,237356,236872,484
8501581,28.2974,28.61,485,43880,0.870986,0.73,2,237384,236899,485
8504501,44.0595,28.122,505,43928,0.902197,0.73,2,237432,236927,505
8507421,33.6119,43.2244,489,43976,0.892439,0.73,2,237463,236974,489
8510341,36.3224,33.4449,495,44024,0.890488,0.71,2,237500,237005,495
8513261,61.6645,37.089,525,44072,0.938098,0.71,2,237568,237043,525
8516181,41.9329,62.6178,493,44120,0.931619,0.71,2,237605,237112,493
8519101,9.98658,40.5236,460,44168,0.946324,0.75,2,237607,237147,460
8673861,31,28,516,46632,0.73,1,1,239292,238776,516
8676781,35,29.6,522,46677,0.682,1,1,239328,238806,522
8679701,30.2,29.92,521,46722,0.5924,1,1,239357,238836,521
8682621,32.44,25.984,529,46767,0.59048,1,1,239390,238861,529
8685541,33.688,31.5968,530,46812,0.510096,1,1,239424,238894,530
8688461,37.9376,31.1194,538,46857,0.334019,1,1,239463,238925,538
8691381,33.9875,54.2239,511,46902,0.282804,1,1,239496,238985,511
8694301,30.7975,46.8448,496,46947,0.224561,1,1,239526,239030,496
8697221,35.7595,33.369,503,46992,0.244912,1,1,239563,239060,503
8700141,32.7519,27.4738,509,47037,0.152982,0.98,1,239595,239086,509
8703061,18.5504,28.6948,495,47082,0.262596,1,1,239610,239115,495
8705981,10.1101,22.539,482,47127,0.220519,1,1,239618,239136,482
8708901,26.022,15.7078,498,47172,0.212104,0.99,1,239648,239150,498
8711821,30.0044,27.9416,498,47217,0.226421,0.89,1,239679,239181,498
8714741,38.0009,33.5883,503,47262,0.229284,0.77,1,239719,239216,503
8717661,28.4002,42.7177,484,47307,0.213857,0.73,1,239745,239261,484
8720581,32.08,33.3435,486,47352,0.210771,0.67,1,239778,239292,486
8723501,8.01601,35.4687,452,47397,0.210154,0.57,1,239780,239328,452
8726421,22.4032,30.2937,449,47441,0.226031,0.59,1,239806,239357,449
8729341,27.6806,32.4587,445,47485,0.197206,0.49,1,239835,239390,445
8732261,29.5361,33.6917,441,47529,0.239441,0.29,1,239865,239424,441
8735181,37.9072,37.9384,442,47573,0.263888,0.27,1,239905,239463,442
8738101,33.1814,33.9877,441,47617,0.236778,0.21,1,239937,239496,441
8741021,29.0363,30.7975,439,47661,0.311356,0.25,1,239965,239526,439
8743941,28.2073,35.7595,430,47705,0.374271,0.13,1,239993,239563,430
8746861,32.0415,32.7519,431,47749,0.378854,0.29,1,240026,239595,431
8749781,19.2083,18.5504,432,47793,0.387771,0.21,1,240042,239610,432
8752701,10.2417,10.1101,432,47837,0.389554,0.21,1,240050,239618,432
8755621,26.8483,26.022,433,47881,0.405911,0.23,1,240081,239648,433
8758541,30.9697,30.0044,434,47925,0.457182,0.23,1,240113,239679,434
8761461,37.3939,38.0009,433,47969,0.499436,0.21,1,240152,239719,433
8764381,27.4788,28.4002,432,48013,0.491887,0.21,1,240177,239745,432
8767301,33.4958,32.08,434,48057,0.474377,0.21,1,240212,239778,434
8770221,8.29915,8.01601,434,48101,0.502876,0.23,1,240214,239780,434
8773141,21.6598,22.4032,433,48145,0.524575,0.19,1,240239,239806,433
8776061,25.132,27.6806,430,48189,0.560915,0.25,1,240265,239835,430
8778981,32.2264,29.5361,434,48233,0.584183,0.27,1,240299,239865,434
8781901,37.6453,37.9072,433,48277,0.540837,0.23,1,240338,239905,433
8784821,33.9291,33.1814,434,48321,0.548167,0.33,1,240371,239937,434
8787741,32.3858,29.0363,438,48365,0.549633,0.39,1,240403,239965,438
8790661,29.6772,28.2073,439,48409,0.565927,0.38,1,240432,239993,439
8793581,33.9354,32.0415,441,48453,0.737185,0.39,1,240467,240026,441
8796501,19.5871,19.2083,441,48496,0.731437,0.39,1,240483,240042,441
8799421,10.3174,10.2417,441,48539,0.746287,0.41,1,240491,240050,441
8802341,27.6635,26.8483,442,48582,0.781257,0.47,2,240523,240081,442
8805261,33.5327,30.9697,445,48625,0.836251,0.51,2,240558,240113,445
8808181,37.9065,37.3939,445,48668,0.86325,0.49,2,240597,240152,445
8811101,26.7813,27.4788,444,48711,0.83665,0.47,2,240621,240177,444
8814021,34.1563,33.4958,445,48754,0.83133,0.51,2,240657,240212,445
8816941,8.43125,8.29915,445,48797,0.862266,0.53,2,240659,240214,445
8819861,23.2863,21.6598,447,48840,0.884453,0.53,2,240686,240239,447
8822781,25.4573,4.33197,473,48883,0.888891,0.57,2,240712,240239,473
8825701,31.4914,21.6664,480,48926,0.873778,0.59,2,240745,240265,480
8828621,38.2983,31.5333,486,48969,0.886756,0.53,2,240785,240299,486
8831541,33.2597,37.5067,479,49012,0.905351,0.55,2,240817,240338,479
8834461,33.8519,33.9013,480,49055,0.92507,0.55,2,240851,240371,480
9024261,55,60,488,23541,0.09,0.53,1,242816,242328,488
9027181,48.6,60.8,474,23631,0.058,0.29,1,242863,242389,474
9030101,68.12,73.76,470,23721,0.0516,0.05,1,242936,242466,470
9033021,62.424,79.552,450,23810,0.06632,0.05,1,242997,242547,450
9035941,62.8848,55.1104,464,23899,0.037264,0.07,1,243060,242596,464
9038861,34.177,55.0221,436,23988,0.0634528,0,1,243087,242651,436
9041781,31.6354,30.2044,443,24076,0.0526906,0.05,1,243118,242675,443
9044701,59.1271,74.8409,423,24164,0.0505381,0.09,1,243184,242761,423
9047621,55.8254,58.9682,423,24252,0.0661076,0.05,1,243239,242816,423
9050541,51.1651,49.3936,426,24339,0.0852215,0.05,1,243289,242863,426
9053461,66.233,68.2787,423,24426,0.121044,0.07,1,243359,242936,423
9056381,62.0466,62.4557,423,24513,0.128209,0.03,1,243420,242997,423
9059301,62.8093,62.8911,423,24599,0.161642,0.07,1,243483,243060,423
9062221,33.3619,34.1782,422,24685,0.184328,0.05,1,243509,243087,422
9065141,33.0724,31.6356,424,24771,0.156866,0.05,1,243542,243118,424
9068061,60.2145,59.1271,425,24857,0.151373,0.07,1,243609,243184,425
9070981,56.0429,55.8254,425,24942,0.134275,0.09,1,243664,243239,425
9073901,51.2086,51.1651,425,25027,0.130855,0.13,1,243714,243289,425
9076821,67.0417,66.233,426,25112,0.130171,0.13,1,243785,243359,426
9079741,62.2083,62.0466,426,25196,0.210034,0.17,1,243846,243420,426
9082661,65.2417,62.8093,429,25280,0.194007,0.19,1,243912,243483,429
9085581,32.2483,33.3619,427,25364,0.190801,0.15,1,243936,243509,427
9088501,32.8497,33.0724,427,25448,0.23816,0.15,1,243969,243542,427
9091421,59.3699,6.61447,493,25531,0.263632,0.15,1,244035,243542,493
9094341,56.674,54.9229,482,25614,0.300726,0.13,1,244091,243609,482
9097261,50.5348,54.9846,476,25697,0.308145,0.13,1,244140,243664,476
9100181,66.107,50.9969,496,25779,0.341629,0.13,1,244210,243714,496
9103101,66.0214,66.9994,491,25861,0.364326,0.23,1,244276,243785,491
9106021,66.0043,62.1999,496,25943,0.432865,0.19,1,244342,243846,496
9108941,32.4009,65.24,454,26025,0.462573,0.19,1,244366,243912,454
9111861,35.2802,32.248,466,26106,0.484515,0.25,1,244402,243936,466
9114781,61.456,32.8496,501,26187,0.504903,0.27,1,244470,243969,501
9117701,57.8912,59.3699,492,26268,0.492981,0.31,1,244527,244035,492
9120621,50.7782,56.674,485,26349,0.554596,0.31,1,244576,244091,485
9123541,67.7557,50.5348,508,26429,0.598919,0.35,1,244648,244140,508
9126461,67.9511,66.107,506,26509,0.639784,0.37,1,244716,244210,506
9129381,69.5902,66.0214,510,26589,0.679957,0.45,1,244786,244276,510
9132301,33.918,66.0043,469,26669,0.703991,0.47,1,244811,244342,469
9135221,35.5836,32.4009,481,26748,0.724798,0.49,1,244847,244366,481
9138141,62.3167,35.2802,514,26827,0.72896,0.51,1,244916,244402,514
9141061,57.2633,61.456,502,26906,0.745792,0.49,1,244972,244470,502
9143981,13.0527,57.8912,447,26985,0.749158,0.57,1,244974,244527,447
9146901,44.2105,50.7782,450,27063,0.781832,0.61,2,245026,244576,450
9149821,68.8421,67.7557,453,27141,0.836366,0.65,2,245101,244648,453
9152741,68.9684,67.9511,454,27219,0.831273,0.69,2,245170,244716,454
9155661,71.3937,69.5902,456,27297,0.926255,0.71,2,245242,244786,456
9158581,35.0787,33.918,457,27375,0.929251,0.73,2,245268,244811,457
9281221,33,32,513,30453,0.53,1,1,247414,246901,513
9284141,53,73.6,487,30522,0.45,1,1,247472,246985,487
9287061,33.8,37.92,487,30591,0.386,1,1,247501,247014,487
9289981,49.16,42.784,496,30660,0.2932,1,1,247554,247058,496
9292901,61.832,70.1568,484,30729,0.16264,0.99,1,247619,247135,484
9295821,37.1664,40.4314,482,30798,0.088528,1,1,247650,247168,482
9298741,43.4333,50.4863,474,30867,0.153706,1,1,247695,247221,474
9301661,31.8867,38.0973,468,30936,0.118741,0.79,1,247724,247256,468
9304581,69.5773,77.2194,460,31004,0.0957482,0.63,1,247803,247343,460
9307501,39.5155,45.8439,454,31072,0.13915,0.53,1,247835,247381,454
9310421,31.9031,35.5688,451,31140,0.11583,0.43,1,247865,247414,451
9313341,43.1806,53.5138,439,31208,0.111166,0.37,1,247911,247472,439
9316261,30.2361,33.9028,437,31276,0.158233,0.37,1,247938,247501,437
9319181,46.0472,6.78055,487,31344,0.167647,0.27,1,247988,247501,487
9322101,54.0094,43.7561,490,31412,0.153529,0.13,1,248044,247554,490
9325021,35.6019,60.7512,456,31479,0.166706,0.07,1,248075,247619,456
9327941,40.7204,36.9502,467,31546,0.169341,0.17,1,248117,247650,467
9330861,36.1441,43.39,457,31613,0.169868,0.11,1,248152,247695,457
9333781,68.8288,31.878,505,31680,0.249974,0.09,1,248229,247724,505
9336701,39.3658,69.5756,458,31747,0.281995,0.15,1,248261,247803,458
9339621,31.0732,39.5151,455,31814,0.320399,0.11,1,248290,247835,455
9342541,43.8146,31.903,472,31881,0.34408,0.11,1,248337,247865,472
9345461,29.5629,43.1806,452,31947,0.364816,0.17,1,248363,247911,452
9348381,49.1126,30.2361,479,32013,0.384963,0.17,1,248417,247938,479
9351301,55.4225,46.0472,486,32079,0.436993,0.15,1,248474,247988,486
9354221,35.0845,54.0094,460,32145,0.463399,0.17,1,248504,248044,460
9357141,40.6169,35.6019,471,32211,0.46868,0.17,1,248546,248075,471
9360061,36.1234,40.7204,464,32277,0.533736,0.17,1,248581,248117,464
9362981,72.8247,36.1441,511,32343,0.546747,0.27,1,248663,248152,511
9365901,40.9649,68.8288,467,32408,0.565349,0.29,1,248696,248229,467
9368821,32.993,39.3658,466,32473,0.55307,0.33,1,248727,248261,466
9371741,44.9986,31.0732,485,32538,0.566614,0.35,1,248775,248290,485
9374661,30.5997,43.8146,465,32603,0.585323,0.37,1,248802,248337,465
9377581,50.9199,29.5629,495,32668,0.589065,0.39,1,248858,248363,495
9380501,57.384,49.1126,500,32733,0.637813,0.45,1,248917,248417,500
9383421,13.0768,55.4225,445,32798,0.647563,0.47,1,248919,248474,445
9386341,26.6154,35.0845,445,32862,0.697513,0.47,1,248949,248504,445
9389261,38.9231,40.6169,445,32926,0.707503,0.55,1,248991,248546,445
9392181,39.7846,36.1234,450,32990,0.7095,0.55,1,249031,248581,450
9395101,72.7569,72.8247,449,33054,0.7579,0.57,2,249112,248663,449
9398021,41.7514,40.9649,450,33118,0.83158,0.55,2,249146,248696,450
9400941,32.3503,32.993,449,33182,0.830316,0.57,2,249176,248727,449
9403861,45.6701,44.9986,450,33246,0.814063,0.59,2,249225,248775,450
9406781,31.534,30.5997,451,33310,0.874813,0.59,2,249253,248802,451
9409701,51.1068,50.9199,451,33373,0.854963,0.65,2,249309,248858,451
9412621,59.8214,57.384,454,33436,0.834993,0.65,2,249371,248917,454
9415541,13.5643,13.0768,454,33499,0.830999,0.71,2,249373,248919,454
9418461,27.5129,26.6154,455,33562,0.8142,0.71,2,249404,248949,455
9421381,39.1026,38.9231,455,33625,0.84284,0.71,2,249446,248991,455
9424301,41.4205,39.7846,457,33688,0.864568,0.77,2,249488,249031,457
9549861,32,28,510,36290,0.77,1,2,251341,250831,510
9552781,33.6,31.2,512,36348,0.674,1,1,251375,250863,512
9555701,33.92,28.64,518,36406,0.5268,1,1,251409,250891,518
9558621,29.184,24.128,523,36464,0.41736,1,1,251437,250914,523
9561541,38.6368,60.0256,495,36522,0.347472,1,1,251478,250983,495
9564461,62.9274,66.4051,496,36580,0.0694944,1,1,251547,251051,496
9567381,45.3855,44.481,498,36638,0.0138989,1,1,251588,251090,498
9570301,34.6771,35.2962,497,36696,0.0427798,1,1,251620,251123,497
9573221,26.1354,35.0592,486,36754,0.032556,0.98,1,251644,251158,486
9576141,32.4271,40.6118,478,36811,0.0305112,0.87,1,251678,251200,478
9579061,52.8854,65.7224,464,36868,0.0141022,0.81,1,251736,251272,464
9581981,36.1771,42.7445,459,36925,0.0108204,0.77,1,251768,251309,459
9584901,31.2354,34.1489,457,36982,0.0101641,0.65,1,251798,251341,457
9587821,31.0471,34.0298,454,37039,0.0260328,0.49,1,251829,251375,454
9590741,27.8094,34.006,447,37096,0.0132066,0.39,1,251856,251409,447
9593661,27.9619,29.2012,447,37153,0.0426413,0.39,1,251884,251437,447
9596581,30.3924,5.84024,478,37210,0.0325283,0.33,1,251915,251437,478
9599501,50.0785,33.968,492,37267,0.0945057,0,1,251970,251478,492
9602421,41.2157,61.9936,462,37324,0.0909011,0,1,252009,251547,462
